time,subj_course_id,sec_code,sec_id,prof,available,waitlist,total,enrolled_ct
1713301172882,ANAR 153,A00,487222,Braswell; Geoffrey E.,55,0,60,5
1713301173907,ANBI 134,A00,487223,Staff,14,0,20,6
1713301174938,ANBI 143GS,A00,487224,Noel; Geoffroy Pierre Jean,23,0,24,1
1713301175965,ANBI 144GS,A00,519548,Noel; Geoffroy Pierre Jean,23,0,24,1
1713301176990,ANSC 101,A00,487225,Staff,19,0,20,1
1713301178016,ANSC 125,A00,487227,Brenner; Suzanne A,40,0,40,0
1713301180079,ANSC 146,A00,487229,Staff,37,0,40,3
1713301181103,ANSC 148,A00,487230,Olivas Hernandez; Olga Lid,39,0,40,1
1713301182134,ANSC 150,A00,504165,Sloane; Julia Kathryn,19,0,20,1
1713301183159,ANSC 180,A00,487232,Staff,13,0,15,2
1713301184186,ANTH 5,A00,519529,Semendeferi; Ekaterini,15,0,15,0
1713301185214,ANTH 10,A00,487219,Staff,58,0,60,2
1713301186241,ANTH 23,A01,487221,Staff,19,0,20,1
1713301187266,ANTH 102,A00,487233,Wilder; Linnea Lorene,55,0,60,5
1713301188297,ANTH 103,A00,487234,Varma; Saiba,57,0,60,3
1713301189325,ANTH 105,A00,487235,Stewart; Alexander B,57,0,60,3
1713301190358,BENG 100,A01,516685,Taylor Amos; Alyssa C,28,0,30,2
1713301191387,BIBC 102,A01,491316,Flagg; Matthew Paul,65,0,88,23
1713301191387,BIBC 102,A02,491366,Flagg; Matthew Paul,84,0,88,4
1713301192419,BIBC 103,A01,491486,Boumechache; Miyyada,17,0,24,7
1713301192419,BIBC 103,A02,491487,Boumechache; Miyyada,24,0,24,0
1713301193450,BICD 100,A01,516882,Staff,75,0,75,0
1713301193450,BICD 100,A02,516890,Staff,71,0,75,4
1713301194474,BICD 102GS,A00,491488,Lo; Stanley M.,27,0,28,1
1713301195501,BIEB 136GS,A00,516940,Holway; David A. & Shurin; Jonathan,20,0,24,4
1713301196535,BIEB 137GS,A01,517034,Holway; David A. & Shurin; Jonathan,20,0,24,4
1713301197567,BIEB 138GS,A01,491492,Pirino; Giorgia,22,0,28,6
1713301198593,BILD 1,A01,491296,Staff,62,0,63,1
1713301198593,BILD 1,A02,491297,Staff,63,0,63,0
1713301199623,BILD 4,A01,517099,Gonzalez Gamboa; Ivonne,23,0,24,1
1713301199623,BILD 4,A02,517100,Gonzalez Gamboa; Ivonne,24,0,24,0
1713301200650,BILD 60GS,A00,491309,Lo; Stanley M.,27,0,28,1
1713301201686,BIMM 100,A01,517136,Staff,94,0,100,6
1713301202714,BIMM 110,A01,517182,Staff,81,0,100,19
1713301203743,BIMM 120,A01,517228,Pickett; Brooke Elizabeth,46,0,63,17
1713301203743,BIMM 120,A02,517240,Pickett; Brooke Elizabeth,50,0,63,13
1713301204769,BIMM 132GS,A01,491498,Pirino; Giorgia,22,0,28,6
1713301205800,BIMM 143,A01,491589,Bozinovic; Goran,21,0,40,19
1713301206831,BIPN 100,A01,491594,Armour; Jon Christopher,93,0,100,7
1713301207858,BIPN 140,A01,491602,Marino; Marc J,35,0,50,15
1713301208885,BISP 194,A00,517241,Staff,0,6,0,0
1713301209909,CAT 125,A00,515973,Staff,20,0,20,0
1713301210938,CAT 125GS,A00,515974,Rahimi; Babak,20,0,20,0
1713301211968,CAT 125R,A00,515980,Staff,16,0,20,4
1713301211968,CAT 125R,B00,515981,Tosun; Adriana,19,0,20,1
1713301211968,CAT 125R,C00,515987,Hyland; Tina Mae,8,0,20,12
1713301211968,CAT 125R,D00,515988,Bronstein; Phoebe Malan,19,0,20,1
1713301212999,CENG 15,A01,488699,Drews; Aaron,25,0,25,0
1713301214027,CENG 100,A00,505196,Opatkiewicz; Justin Paul,25,0,25,0
1713301215053,CGS 2A,A01,489598,Staff,33,0,35,2
1713301216079,CGS 112,A00,489599,Staff,15,0,15,0
1713301217104,CGS 119,A00,489603,Staff,10,0,10,0
1713301218130,CGS 120,A00,489604,Staff,14,0,15,1
1713301219157,CGS 150,A00,489607,Staff,15,0,15,0
1713301220182,CHEM 6A,A01,488715,Staff,98,0,100,2
1713301221209,CHEM 6B,A01,488719,Piercy; Marc Anthony,100,0,100,0
1713301222238,CHEM 6C,A01,488723,Albizati; Kim F.,94,0,100,6
1713301223270,CHEM 7L,A01,488728,Schurmeier; Kimberly,18,0,24,6
1713301223270,CHEM 7L,A02,488730,Schurmeier; Kimberly,23,0,24,1
1713301223270,CHEM 7L,A03,488734,Schurmeier; Kimberly,24,0,24,0
1713301223270,CHEM 7L,A04,488763,Schurmeier; Kimberly,23,0,24,1
1713301223270,CHEM 7L,B01,488798,Schurmeier; Kimberly,18,0,24,6
1713301223270,CHEM 7L,B02,488801,Schurmeier; Kimberly,24,0,24,0
1713301223270,CHEM 7L,B03,488808,Schurmeier; Kimberly,24,0,24,0
1713301223270,CHEM 7L,B04,488811,Schurmeier; Kimberly,24,0,24,0
1713301224298,CHEM 11,A01,488897,Stallings; Dontarie M,98,0,100,2
1713301225325,CHEM 40A,A01,488913,Albizati; Kim F.,93,0,100,7
1713301226356,CHEM 40B,A01,488920,Weizman; Haim,48,0,50,2
1713301226356,CHEM 40B,A02,488938,Weizman; Haim,47,0,50,3
1713301227381,CHEM 41A,A01,489029,Klosterman; Jeremy K,58,0,60,2
1713301228411,CHEM 41C,A01,500436,Tor; Yitzhak,56,0,60,4
1713301229440,CHEM 43A,A01,500426,Weizman; Haim,8,0,24,16
1713301229440,CHEM 43A,A02,500430,Weizman; Haim,16,0,24,8
1713301229440,CHEM 43A,B01,514041,Klosterman; Jeremy K,18,0,24,6
1713301229440,CHEM 43A,B02,514047,Klosterman; Jeremy K,23,0,24,1
1713301230464,CHEM 108,A01,489140,Jennings; Patricia A.,15,0,24,9
1713301230464,CHEM 108,A02,489142,Jennings; Patricia A.,18,0,24,6
1713301231489,CHEM 114A,A01,489147,Stallings; Dontarie M,83,0,100,17
1713301232521,CHIN 169A,A00,489171,Wang; Xiao,19,0,20,1
1713301234576,COGS 3,A01,518827,Boyle; Mary E. T.,33,0,40,7
1713301235604,COGS 11,A01,489175,Staff,28,0,30,2
1713301236630,COGS 14A,A01,518829,Staff,56,0,60,4
1713301237655,COGS 14B,A01,489177,Hoffman; Drew Ellen,69,0,75,6
1713301238685,COGS 100,A01,489181,Allen; Michael Gordon,69,0,75,6
1713301239716,COGS 101A,A01,489183,Staff,52,0,60,8
1713301240741,COGS 101B,A01,489185,Allen; Michael Gordon,17,0,30,13
1713301241767,COGS 101C,A01,526786,Staff,25,0,30,5
1713301243824,COGS 107A,A01,489189,Boyle; Mary E. T.,28,0,35,7
1713301244852,COGS 107B,A01,627144,Mooshagian; Eric Frederick,60,0,60,0
1713301245880,COGS 118A,A01,489191,Staff,0,18,40,40
1713301247929,COGS 171GS,A01,489194,Pineda; Jaime A,22,0,28,6
1713301248963,COGS 172,A01,489196,Staff,10,0,30,20
1713301249991,COGS 174GS,A01,489264,Pineda; Jaime A,22,0,28,6
1713301251017,COGS 180,A01,627150,Staff,30,0,30,0
1713301252045,COGS 186,A01,489274,Staff,6,0,30,24
1713301253072,COMM 10,A01,489276,Staff,25,0,25,0
1713301253072,COMM 10,A02,489303,Staff,23,0,25,2
1713301254099,COMM 100A,A01,489312,Staff,21,0,25,4
1713301254099,COMM 100A,A02,489313,Staff,24,0,25,1
1713301255123,COMM 106T,A00,512540,Staff,33,0,35,2
1713301256148,COMM 107,A00,489347,Staff,31,0,35,4
1713301257173,COMM 109P,A00,489358,Staff,31,0,35,4
1713301258206,COMM 132,A00,489361,McKenna; Denise,29,0,30,1
1713301259235,COMM 146,A00,489362,Halm; Gavin Patrick,27,0,30,3
1713301260266,COMM 190,A00,489363,Abuelhiga; Soraya Jill,21,0,23,2
1713301261304,CSE 8A,A50,489366,Staff,24,0,25,1
1713301261304,CSE 8A,A51,489367,Staff,24,0,25,1
1713301262335,CSE 11,A01,489398,Cao; Yingjun,87,0,100,13
1713301263420,CSE 12,A01,489487,Staff,43,0,50,7
1713301264449,CSE 20,A01,489497,Staff,49,0,50,1
1713301265483,CSE 21,A01,489517,Braun; Oliver,44,0,50,6
1713301266512,CSE 101,A01,489524,Braun; Oliver,3,0,50,47
1713301267537,CSE 105,A01,512594,Jones; Miles E,87,0,100,13
1713301267537,CSE 105,B01,512598,Jones; Miles E,74,0,100,26
1713301268566,CSE 140,A01,489538,Staff,45,0,50,5
1713301269590,CSE 141,A01,489550,Eldon; John,79,0,100,21
1713301270620,CSE 141L,A01,489571,Eldon; John,78,0,100,22
1713301271651,CSE 151A,A01,489583,Solares; Edwin A,159,0,200,41
1713301272681,CSE 175,A01,510886,Kumar; Rakesh,30,0,30,0
1713301273706,CSE 190,A00,516828,Dubnov; Shlomo,41,0,49,8
1713301274732,DOC 100D,A00,489667,Pass; Natalye Joann,23,0,25,2
1713301275757,DSC 10,A01,624268,Staff,72,0,75,3
1713301276783,DSC 20,A01,624476,Staff,50,0,50,0
1713301277808,DSC 40A,A01,624608,Staff,40,0,40,0
1713301278838,DSGN 1,A01,489179,Rill; Bryan,39,0,50,11
1713301279867,ECE 17,A01,490489,Sahay; Rajeev,21,0,30,9
1713301280897,ECE 65,A50,490492,Staff,17,0,20,3
1713301280897,ECE 65,A51,490493,Staff,20,0,20,0
1713301281927,ECON 1,A01,489715,Famulari; Melissa,69,0,70,1
1713301282953,ECON 2,A01,489717,Levkoff; Steven B.,69,0,70,1
1713301283979,ECON 3,A01,489948,Staff,70,0,70,0
1713301286032,ECON 5,A01,490103,Staff,28,0,30,2
1713301286032,ECON 5,B01,626281,Dai; Yinlin,45,0,45,0
1713301287056,ECON 100A,A01,490127,Famulari; Melissa,70,0,70,0
1713301288081,ECON 100B,A01,490129,Staff,64,0,70,6
1713301289112,ECON 109,A01,490187,Shishkin; Denis,30,0,35,5
1713301290142,ECON 110A,A01,490190,Levkoff; Steven B.,66,0,70,4
1713301291169,ECON 120A,A01,490245,Dai; Yinlin,70,0,70,0
1713301292194,ECON 120B,A01,490247,Nieto-Barthaburu; Augusto,61,0,70,9
1713301293220,ECON 120C,A01,490253,Sun; Yixiao,32,0,35,3
1713301293220,ECON 120C,B01,490255,Sun; Yixiao,34,0,35,1
1713301294248,ECON 129,A00,490256,Eckert; Fabian Paul,28,0,35,7
1713301295283,ECON 131,A00,490257,Nieto-Barthaburu; Augusto,8,0,35,27
1713301296313,ECON 138,A00,490258,Bharadwaj; Prashant,25,0,35,10
1713301296313,ECON 138,B00,490259,Bharadwaj; Prashant,22,0,35,13
1713301297342,ECON 159,A00,490260,Hendrickson; Gerald M.,0,6,0,0
1713301298368,ECON 178,A01,553995,Zhu; Ying,29,0,35,6
1713301299398,EDS 40,A01,512576,Black; Alison Michelle,20,0,20,0
1713301300428,EDS 107,A01,515848,Staff,30,0,30,0
1713301301454,EDS 110R,A01,490262,Staff,26,0,30,4
1713301302478,EDS 112,A01,490264,Chapman; Thandeka K,45,0,50,5
1713301303503,EDS 113,A00,490266,Staff,28,0,30,2
1713301304527,EDS 118,A00,490267,Warstadt; Melissa Fawn,27,0,30,3
1713301305551,EDS 124BR,A00,490268,Eguchi; Emi,10,0,25,15
1713301305551,EDS 124BR,B00,490269,Eguchi; Emi,25,0,25,0
1713301306575,EDS 126,A01,490271,Jones; Makeba,47,0,50,3
1713301307606,EDS 135,A01,490316,Staff,20,0,20,0
1713301308635,ENVR 142GS,A00,519514,Chang; Edmond Yi-Teh,28,0,28,0
1713301309660,ETHN 103,A00,490504,Staff,33,0,36,3
1713301310690,ETHN 103A,A00,490505,Man; Simeon S,7,0,9,2
1713301311715,ETHN 109,A00,490506,Staff,30,0,30,0
1713301312740,ETHN 118,A00,490507,Staff,35,0,36,1
1713301313769,ETHN 119,A00,490508,Staff,36,0,36,0
1713301314796,ETHN 121R,A00,490518,Choi; Esther Min,30,0,36,6
1713301315826,ETHN 127,A00,490528,Staff,15,0,15,0
1713301316850,ETHN 139,A00,490573,Staff,10,0,10,0
1713301317879,ETHN 150,A00,490575,Staff,15,0,15,0
1713301318906,GLBH 20,A00,491705,Elwardani; Nile Regina,38,0,40,2
1713301319931,GLBH 101,A00,491706,Staff,20,0,20,0
1713301320957,GLBH 111,A01,491708,Burgos; Jose L.,15,0,15,0
1713301321988,GLBH 146,A00,491709,Staff,15,0,20,5
1713301323017,GLBH 148,A00,491710,Olivas Hernandez; Olga Lid,17,0,20,3
1713301324047,GLBH 150,A00,491711,Sloane; Julia Kathryn,20,0,20,0
1713301325076,HIEA 131,A00,491760,Staff,30,0,32,2
1713301326103,HIEA 153,A00,491762,Staff,29,0,30,1
1713301327128,HIEU 124,A00,491811,Staff,29,0,32,3
1713301328155,HIEU 124GS,A00,491812,Markman; Kristina,28,0,28,0
1713301329184,HIEU 147,A00,491813,Staff,31,0,32,1
1713301330207,HIEU 149GS,A00,491816,Caldwell; Michael Alan,28,0,28,0
1713301331236,HILD 2C,A01,491713,Hendrickson; Gerald M.,28,0,30,2
1713301332264,HILD 7B,A01,491715,Kwak; Nancy,18,0,30,12
1713301333290,HILD 10,A01,491717,Staff,17,0,20,3
1713301334316,HILD 30GS,A00,491719,Edington; Claire Ellen,24,0,28,4
1713301335343,HINE 109,A00,491818,Shafir; Nir,31,0,32,1
1713301336368,HINE 128,A00,491821,Shafir; Nir,32,0,32,0
1713301337396,HISC 117,A00,491830,Staff,29,0,32,3
1713301338424,HIUS 103,A00,491834,Man; Simeon S,18,0,23,5
1713301339449,HIUS 108B,A00,491835,Staff,30,0,30,0
1713301340476,HIUS 141,A00,491836,Hendrickson; Gerald M.,29,0,32,3
1713301341503,HIUS 149,A00,491839,Staff,28,0,32,4
1713301342534,HUM 3,A01,512617,Crum; Matthew Stephen,46,0,50,4
1713301342534,HUM 3,A02,512618,Crum; Matthew Stephen,49,0,50,1
1713301343563,HUM 3GS,A00,512663,Markman; Kristina,0,0,0,0
1713301343563,HUM 3GS,B00,512664,Staff,0,0,0,0
1713301344591,HUM 4,A01,512620,West; Geoffrey Scott,39,0,50,11
1713301345618,HUM 4GS,A00,512666,Lyon; Antony J.,0,0,0,3
1713301346790,HUM 4R,A01,512625,Watkins; Eric,49,0,50,1
1713301347827,HUM 5,A01,512649,Zavodny; Tatiana Sophia,35,0,50,15
1713301347827,HUM 5,B01,512661,Zroka; Ryan Edward,49,0,50,1
1713301348852,INTL 190,A00,490577,Segui; Alan S,0,0,0,5
1713301349885,JAPN 20AR,A01,491267,Ross; Kayoko F,12,0,20,8
1713301350913,JAPN 180,A00,491285,Berman; Michael David,36,0,40,4
1713301351946,LATI 50,A01,502536,Kokinis; Troy Andreas,19,0,22,3
1713301351946,LATI 50,A02,502551,Kokinis; Troy Andreas,22,0,22,0
1713301351946,LATI 50,A03,502650,Kokinis; Troy Andreas,22,0,22,0
1713301351946,LATI 50,A04,502909,Kokinis; Troy Andreas,22,0,22,0
1713301352977,LATI 160,A01,502920,Kokinis; Troy Andreas,30,0,30,0
1713301354007,LIFR 1A,A00,490494,Van Moer; Vinciane G,18,0,20,2
1713301355031,LIFR 1AX,A00,490495,Van Moer; Vinciane G,18,0,20,2
1713301356059,LIFR 1B,A00,490496,Van Moer; Vinciane G,20,0,20,0
1713301357085,LIFR 1BX,A00,490497,Van Moer; Vinciane G,20,0,20,0
1713301358109,LIGN 8,A00,505198,McIntosh; Justin Daniel,144,0,150,6
1713301359133,LIGN 9GS,A00,491239,Lott; Margaret S.,19,0,20,1
1713301360157,LIGN 101,A01,505200,McIntosh; Justin Daniel,26,0,30,4
1713301361187,LIGN 120,A01,491244,Staff,26,0,30,4
1713301362212,LIGN 149GS,A00,491245,Lott; Margaret S.,19,0,20,1
1713301363240,LIGN 170,A00,491247,Staff,25,0,30,5
1713301364265,LISP 1D,A00,490498,Munoz Sanchez; Alicia,12,0,14,2
1713301364265,LISP 1D,B00,490499,Munoz Sanchez; Alicia,8,0,14,6
1713301364265,LISP 1D,C00,490500,Munoz Sanchez; Alicia,10,0,14,4
1713301364265,LISP 1D,D00,490501,Munoz Sanchez; Alicia,11,0,14,3
1713301365295,LISP 1DX,A00,490502,Munoz Sanchez; Alicia,21,0,28,7
1713301365295,LISP 1DX,B00,490503,Munoz Sanchez; Alicia,19,0,28,9
1713301367400,LTAM 110,A00,491847,Staff,23,0,25,2
1713301368428,LTCS 119,A00,491848,Staff,13,0,15,2
1713301369459,LTCS 130,A00,491849,Staff,24,0,25,1
1713301371514,LTEA 120C,A00,491852,Staff,35,0,40,5
1713301372540,LTEN 130GS,A00,491853,Lyon; Antony J.,25,0,28,3
1713301373563,LTEN 148,A00,491855,Staff,23,0,25,2
1713301374590,LTEN 159,A00,491856,Staff,21,0,25,4
1713301375616,LTEN 180,A00,491857,Staff,11,0,15,4
1713301377669,LTSP 123GS,A00,505928,Bessett; Ryan Matthew,25,0,28,3
1713301378697,LTSP 174GS,A00,506037,Bessett; Ryan Matthew,25,0,28,3
1713301380746,LTWR 102,A00,491861,Staff,12,0,15,3
1713301381773,LTWR 106,A00,491862,Staff,11,0,15,4
1713301382799,MAE 11,A00,490930,Bahadori; Mohammad Yousef,98,0,100,2
1713301383829,MAE 30A,A00,490931,Qi; Huihui,38,0,40,2
1713301384857,MAE 101A,A00,491036,Sadeghizadeh; Zahra,98,0,100,2
1713301385887,MAE 101C,A00,491037,Seshadri; Kalyanasundaram,79,0,100,21
1713301386912,MAE 113,A00,491040,Seshadri; Kalyanasundaram,67,0,80,13
1713301387937,MAE 131A,A00,491041,Ghazinejad; Maziar,39,0,40,1
1713301388965,MAE 142,A00,491053,Staff,39,0,40,1
1713301389999,MAE 143A,A00,491054,Staff,44,0,50,6
1713301391027,MAE 150,A00,491092,Truong; Phuong Thi Ngoc,26,0,35,9
1713301392053,MATH 3C,A01,494031,Pardo Guerra; Sebastian,30,0,30,0
1713301392053,MATH 3C,A02,494032,Pardo Guerra; Sebastian,29,0,30,1
1713301393079,MATH 10A,A01,494034,Staff,29,0,30,1
1713301393079,MATH 10A,A02,494035,Staff,29,0,30,1
1713301393079,MATH 10A,B01,494037,Staff,28,0,30,2
1713301393079,MATH 10A,B02,494038,Staff,29,0,30,1
1713301394112,MATH 10B,A01,494040,Habib; Yousaf,24,0,30,6
1713301394112,MATH 10B,A02,494041,Habib; Yousaf,28,0,30,2
1713301394112,MATH 10B,A03,494042,Habib; Yousaf,30,0,30,0
1713301394112,MATH 10B,A04,494043,Habib; Yousaf,30,0,30,0
1713301394112,MATH 10B,B01,494045,Habib; Yousaf,28,0,30,2
1713301394112,MATH 10B,B02,494046,Habib; Yousaf,30,0,30,0
1713301394112,MATH 10B,B03,494047,Habib; Yousaf,30,0,30,0
1713301394112,MATH 10B,B04,494048,Habib; Yousaf,30,0,30,0
1713301395138,MATH 18,A01,494050,Kemp; Todd Aahron,29,0,30,1
1713301395138,MATH 18,A02,494051,Kemp; Todd Aahron,29,0,30,1
1713301395138,MATH 18,B01,494054,Kemp; Todd Aahron,28,0,30,2
1713301395138,MATH 18,B02,494055,Kemp; Todd Aahron,29,0,30,1
1713301396162,MATH 20A,A01,494059,Suk; Andrew Hoon,30,0,30,0
1713301397189,MATH 20B,A01,494061,Briones; Jor-el Thomas Caparas,34,0,35,1
1713301397189,MATH 20B,B01,494063,Bach; Quang Tran,35,0,35,0
1713301398215,MATH 20C,A01,494065,Staff,29,0,30,1
1713301398215,MATH 20C,A02,494066,Staff,30,0,30,0
1713301398215,MATH 20C,A03,494067,Staff,30,0,30,0
1713301398215,MATH 20C,A04,494068,Staff,30,0,30,0
1713301398215,MATH 20C,B01,494070,Zhang; Ming,27,0,30,3
1713301398215,MATH 20C,B02,494071,Zhang; Ming,30,0,30,0
1713301398215,MATH 20C,B03,494072,Zhang; Ming,29,0,30,1
1713301398215,MATH 20C,B04,494073,Zhang; Ming,29,0,30,1
1713301399240,MATH 20D,A01,494075,Staff,27,0,30,3
1713301399240,MATH 20D,A02,494076,Staff,30,0,30,0
1713301400265,MATH 20E,A01,494079,Staff,25,0,30,5
1713301400265,MATH 20E,A02,494080,Staff,28,0,30,2
1713301400265,MATH 20E,B01,494082,Staff,28,0,30,2
1713301400265,MATH 20E,B02,494083,Staff,26,0,30,4
1713301401294,MATH 103A,A01,494085,Aliabadi Sr.; Mohsen,22,0,30,8
1713301401294,MATH 103A,A02,494086,Aliabadi Sr.; Mohsen,29,0,30,1
1713301401294,MATH 103A,B01,494088,Aliabadi Sr.; Mohsen,22,0,30,8
1713301401294,MATH 103A,B02,494089,Aliabadi Sr.; Mohsen,28,0,30,2
1713301402325,MATH 109,A01,494091,Staff,30,0,30,0
1713301402325,MATH 109,A02,494092,Staff,30,0,30,0
1713301402325,MATH 109,B01,494094,Staff,28,0,30,2
1713301402325,MATH 109,B02,494095,Staff,29,0,30,1
1713301403352,MATH 142A,A01,494097,Chow; Bennett,17,0,30,13
1713301403352,MATH 142A,A02,494098,Chow; Bennett,26,0,30,4
1713301403352,MATH 142A,B01,494100,Chow; Bennett,23,0,30,7
1713301403352,MATH 142A,B02,494101,Chow; Bennett,29,0,30,1
1713301405407,MATH 168A,A01,516677,Dumitriu; Ioana,17,0,35,18
1713301406436,MATH 170A,A01,516679,Dumitriu; Ioana,23,0,30,7
1713301406436,MATH 170A,A02,516680,Dumitriu; Ioana,28,0,30,2
1713301407463,MATH 193A,A01,494107,Staff,19,0,30,11
1713301407463,MATH 193A,A02,494108,Staff,27,0,30,3
1713301407463,MATH 193A,A03,494109,Staff,29,0,30,1
1713301407463,MATH 193A,A04,494110,Staff,27,0,30,3
1713301410539,MGT 16,A00,491930,McKay; Michael J,94,0,98,4
1713301411569,MGT 18,A00,491992,McKay; Michael J,97,0,98,1
1713301412595,MGT 71,A00,492003,Staff,79,0,98,19
1713301413619,MGT 103,A00,505209,Eberhard; Craig A,88,0,98,10
1713301414645,MGT 131A,A00,505210,Anderson; John Charles,91,0,98,7
1713301416698,MGT 153,A00,492077,Perols; Johan Lars,57,0,90,33
1713301419780,MGT 164,A00,492222,McKay; Mary A,94,0,98,4
1713301420812,MGT 172,A00,492245,Staff,59,0,60,1
1713301420812,MGT 172,B00,505526,Hedges; Kathleen,82,0,98,16
1713301421841,MGT 181,A00,505669,Dunn; Louis Jean,89,0,98,9
1713301422867,MMW 14,A01,494399,Staff,25,0,28,3
1713301422867,MMW 14,A02,494400,Staff,27,0,28,1
1713301422867,MMW 14,A03,494401,Staff,28,0,28,0
1713301422867,MMW 14,A04,494402,Staff,28,0,28,0
1713301422867,MMW 14,B01,494404,Carreras; Maria Victoria,18,0,28,10
1713301422867,MMW 14,B02,494405,Carreras; Maria Victoria,27,0,28,1
1713301422867,MMW 14,B03,494406,Carreras; Maria Victoria,28,0,28,0
1713301422867,MMW 14,B04,494407,Carreras; Maria Victoria,28,0,28,0
1713301423893,MMW 14GS,A00,506250,Chang; Edmond Yi-Teh,0,0,0,0
1713301424923,MMW 121R,A01,494415,Adamiak; Patrick John,16,0,28,12
1713301424923,MMW 121R,A02,494416,Adamiak; Patrick John,26,0,28,2
1713301425953,MUS 1A,A01,494113,Staff,14,0,25,11
1713301425953,MUS 1A,A02,494114,Staff,25,0,25,0
1713301426979,MUS 4,A01,494116,Staff,24,0,25,1
1713301426979,MUS 4,A02,494117,Staff,22,0,25,3
1713301428011,MUS 5R,A01,494236,Dubnov; Shlomo,14,0,25,11
1713301428011,MUS 5R,A02,494237,Dubnov; Shlomo,25,0,25,0
1713301429040,MUS 6,A01,494122,Staff,18,0,25,7
1713301429040,MUS 6,A02,494123,Staff,24,0,25,1
1713301430066,MUS 7,A01,494125,Staff,20,0,25,5
1713301430066,MUS 7,A02,494126,Staff,24,0,25,1
1713301431094,MUS 11,A01,494128,Staff,23,0,25,2
1713301431094,MUS 11,A02,494129,Staff,25,0,25,0
1713301432221,MUS 13,A01,494131,Staff,25,0,25,0
1713301432221,MUS 13,A02,494132,Staff,25,0,25,0
1713301433245,MUS 15,A01,494134,Staff,21,0,25,4
1713301433245,MUS 15,A02,494135,Staff,25,0,25,0
1713301433245,MUS 15,B01,494137,Staff,25,0,25,0
1713301434272,MUS 80,A00,494232,Staff,25,0,25,0
1713301434272,MUS 80,B00,494233,Staff,25,0,25,0
1713301434272,MUS 80,C00,494234,Staff,23,0,25,2
1713301435299,MUS 95C,A00,494141,Staff,73,0,75,2
1713301436325,MUS 114,A00,494142,Staff,43,0,50,7
1713301437352,NANO 15,A01,490636,Drews; Aaron,7,0,7,0
1713301438382,PHIL 1,A00,490578,Grush; Rick Scott,50,0,50,0
1713301439409,PHIL 10,A01,490580,Grush; Rick Scott,34,0,35,1
1713301439409,PHIL 10,A02,490586,Grush; Rick Scott,34,0,35,1
1713301440437,PHIL 27,A01,490591,Staff,24,0,25,1
1713301440437,PHIL 27,A02,490592,Staff,25,0,25,0
1713301440437,PHIL 27,A03,490593,Staff,25,0,25,0
1713301440437,PHIL 27,A04,490598,Staff,25,0,25,0
1713301441462,PHIL 32,A01,490611,Staff,20,0,20,0
1713301441462,PHIL 32,A02,490618,Staff,20,0,20,0
1713301442487,PHIL 90,A00,490624,Staff,40,0,40,0
1713301443513,PHIL 136,A00,490627,Cohen; Jonathan David,38,0,40,2
1713301444537,PHIL 155,A00,490634,Staff,67,0,70,3
1713301445575,PHYS 1A,A00,491610,Staff,246,0,250,4
1713301446599,PHYS 1AL,001,491616,Tsai; Philbert S,28,0,30,2
1713301446599,PHYS 1AL,002,491618,Tsai; Philbert S,30,0,30,0
1713301447625,PHYS 1B,A00,491623,Staff,245,0,250,5
1713301448649,PHYS 1BL,001,491626,Tsai; Philbert S,27,0,30,3
1713301448649,PHYS 1BL,002,491628,Tsai; Philbert S,28,0,30,2
1713301449673,PHYS 1C,A00,491632,Staff,229,0,245,16
1713301450698,PHYS 1CL,001,491635,Tsai; Philbert S,13,0,30,17
1713301450698,PHYS 1CL,002,491643,Tsai; Philbert S,26,0,30,4
1713301451723,PHYS 2AR,A01,491651,Meyertholen; Andrew D.,46,0,50,4
1713301452752,PHYS 2B,A01,491659,Staff,107,0,115,8
1713301453781,PHYS 2BL,A01,491685,Staff,24,0,24,0
1713301453781,PHYS 2BL,A02,491700,Staff,23,0,24,1
1713301454811,PHYS 2C,A01,505161,Staff,109,0,115,6
1713301455836,PHYS 4A,A01,491704,Grinstein; Benjamin,100,0,100,0
1713301456865,POLI 5D,A01,494144,Staff,3,0,5,2
1713301456865,POLI 5D,B01,626283,Dai; Yinlin,5,0,5,0
1713301457891,POLI 12,A00,494145,Staff,44,0,45,1
1713301458917,POLI 13R,A00,494146,Forman; Fonna,47,0,50,3
1713301459946,POLI 27,A01,494148,Staff,60,0,60,0
1713301460974,POLI 30,A00,494149,Staff,49,0,50,1
1713301462001,POLI 100DA,A00,494150,Staff,23,0,25,2
1713301464053,POLI 100I,A00,494152,Staff,29,0,30,1
1713301465082,POLI 104B,A00,494153,Smith; Glenn Chatmas,54,0,55,1
1713301466110,POLI 104F,A00,494154,Staff,29,0,30,1
1713301467135,POLI 104I,A00,494155,Smith; Glenn Chatmas,30,0,30,0
1713301468162,POLI 110C,A00,494156,Ingham; Sean,23,0,25,2
1713301469186,POLI 117R,A00,494157,Forman; Fonna,17,0,20,3
1713301470211,POLI 118,A00,494158,Ingham; Sean,23,0,25,2
1713301471291,POLI 120H,A00,494159,Fisk; David Lee,42,0,45,3
1713301472319,POLI 131CR,A00,494160,Hoston; Germaine,43,0,45,2
1713301473343,POLI 133J,A00,494161,Staff,33,0,35,2
1713301474370,POLI 135,A00,494162,Fisk; David Lee,34,0,35,1
1713301475408,POLI 140A,A00,494164,Staff,23,0,30,7
1713301476436,POLI 142I,A00,494165,Staff,30,0,30,0
1713301477461,POLI 144D,A00,494166,Staff,23,0,25,2
1713301478488,POLI 151,A00,494167,Staff,30,0,30,0
1713301479511,POLI 153,A00,494168,Staff,34,0,35,1
1713301480538,POLI 160AA,A00,494169,Staff,36,0,40,4
1713301481567,POLI 162,A00,494170,Mignozzetti; Umberto,22,0,25,3
1713301482595,POLI 171,A00,494171,Mignozzetti; Umberto,23,0,25,2
1713301483622,PSYC 1,A00,494172,Staff,97,0,100,3
1713301484649,PSYC 2,A00,494173,Moranton; Nirelia Melbina-,48,0,50,2
1713301485674,PSYC 3,A00,494174,Staff,30,0,30,0
1713301486697,PSYC 6,A00,494175,Staff,17,0,20,3
1713301487721,PSYC 60,A01,494177,Staff,45,0,45,0
1713301488750,PSYC 70,A01,505724,Geller; Emma Harlan,42,0,45,3
1713301489776,PSYC 101,A00,494180,Heyman; Gail D.,93,0,100,7
1713301490804,PSYC 105,A00,494181,Geller; Emma Harlan,71,0,90,19
1713301491830,PSYC 106,A00,494182,Dobkins; Karen R.,34,0,45,11
1713301492857,PSYC 108,A00,494183,Adrian; Julia Anna,94,0,100,6
1713301493891,PSYC 114,A01,494185,Winkielman; Piotr,8,0,30,22
1713301494915,PSYC 122,A00,494186,Moranton; Nirelia Melbina-,41,0,50,9
1713301495943,PSYC 124,A00,494187,Chapman; Eddie Nathaniel,74,0,80,6
1713301496972,PSYC 131,A00,494188,Anagnostaras; Stephan,64,0,80,16
1713301497997,PSYC 144,A00,494189,Staff,24,0,50,26
1713301499028,PSYC 154,A00,494190,Lacefield; Katharine I,146,0,180,34
1713301500053,PSYC 162,A00,494191,Wixted; John T,92,0,100,8
1713301501078,PSYC 172,A00,494192,Gorman; Michael R.,38,0,45,7
1713301502106,PSYC 178,A00,494193,Glaser; Dale,42,0,45,3
1713301503130,PSYC 193,A00,505725,Chapman; Eddie Nathaniel,20,0,20,0
1713301504158,RELI 145GS,A00,519817,Rahimi; Babak,19,0,20,1
1713301505186,SE 101A,A01,490862,Chadha; Mayank,25,0,25,0
1713301506217,SE 101C,A01,490924,Krysl; Petr,18,0,20,2
1713301507242,SE 110A,A01,490928,Staff,20,0,20,0
1713301508272,SE 130A,A00,490929,Morrison; Machel Leigh,66,0,70,4
1713301509298,SIO 1,A01,519325,Staff,39,0,40,1
1713301510326,SIO 30,A01,519327,Staff,40,0,40,0
1713301511351,SIO 40,A00,519328,Staff,40,0,40,0
1713301512376,SIO 46GS,A00,519819,Cook; Geoffrey W,19,0,25,6
1713301513401,SIO 109R,A00,494197,Forman; Fonna,11,0,20,9
1713301514428,SIO 121GS,A00,519827,Cook; Geoffrey W,19,0,25,6
1713301515455,SIO 132,A01,519330,Staff,38,0,40,2
1713301516479,SIO 133,A01,519397,Staff,40,0,40,0
1713301517507,SIO 139,A00,519396,Kacev; David,35,0,40,5
1713301518536,SOCI 1,A01,494199,Thorpe; Charles Robert,24,0,30,6
1713301518536,SOCI 1,A02,494200,Thorpe; Charles Robert,30,0,30,0
1713301518536,SOCI 1,A03,494201,Thorpe; Charles Robert,30,0,30,0
1713301518536,SOCI 1,A04,494202,Thorpe; Charles Robert,29,0,30,1
1713301518536,SOCI 1,A05,494203,Thorpe; Charles Robert,30,0,30,0
1713301518536,SOCI 1,A06,494204,Thorpe; Charles Robert,30,0,30,0
1713301518536,SOCI 1,A07,494205,Thorpe; Charles Robert,29,0,30,1
1713301519563,SOCI 60,A01,494207,Staff,36,0,40,4
1713301519563,SOCI 60,A02,494208,Staff,39,0,40,1
1713301520588,SOCI 100,A01,494210,Payne; Christine Anna,28,0,30,2
1713301520588,SOCI 100,A02,494211,Payne; Christine Anna,28,0,30,2
1713301521615,SOCI 109M,A00,494212,Staff,20,0,20,0
1713301522640,SOCI 110,A00,494213,Staff,36,0,40,4
1713301524701,SOCI 118E,A00,494215,Ng; Kwai,39,0,40,1
1713301525730,SOCI 125,A00,494216,Calderon-Zaks; Michael Aar,43,0,45,2
1713301526755,SOCI 126,A01,494218,Jones; Makeba,4,0,5,1
1713301527792,SOCI 131,A00,494219,Thorpe; Charles Robert,30,0,30,0
1713301529840,SOCI 135,A00,494221,Payne; Christine Anna,44,0,50,6
1713301530875,SOCI 136E,A00,626690,Ruiz; Jonathan Joseph,25,0,25,0
1713301531900,SOCI 138GS,A00,494222,Navon; Daniel,24,0,28,4
1713301533951,SOCI 145,A00,494224,Staff,45,0,45,0
1713301534983,SOCI 153,A00,494225,Staff,29,0,30,1
1713301536014,SOCI 160E,A00,494226,Ng; Kwai,34,0,40,6
1713301537038,SOCI 180,A00,494227,Staff,29,0,30,1
1713301538063,SOCI 189GS,A00,494228,Ribas Norris; Janet Vanesa,11,0,11,0
1713301539092,SOCI 190GS,A00,553232,Ribas Norris; Janet Vanesa,11,0,11,0
1713301540122,SYN 2,001,490768,Staff,14,0,15,1
1713301540122,SYN 2,002,490769,Staff,15,0,15,0
1713301540122,SYN 2,004,490775,Staff,0,0,0,0
1713301540122,SYN 2,003,490774,Staff,0,0,0,0
1713301540122,SYN 2,005,490776,Staff,0,0,0,0
1713301541151,SYN 2R,001,490779,Staff,14,0,15,1
1713301541151,SYN 2R,002,514635,Staff,14,0,15,1
1713301542175,SYN 100,A01,490783,Staff,17,0,20,3
1713301542175,SYN 100,B01,490787,Staff,13,0,20,7
1713301542175,SYN 100,C01,490789,Staff,15,0,20,5
1713301543199,SYN 150,A00,490817,Staff,14,0,15,1
1713301543199,SYN 150,B00,514610,Staff,15,0,15,0
1713301544229,TDAC 1,A00,492753,Walsh; Kim C.,19,0,20,1
1713301544229,TDAC 1,B00,492754,Harting; Carla Kelso,19,0,20,1
1713301544229,TDAC 1,C00,513995,Salovey; Todd,18,0,20,2
1713301545254,TDAC 101,A00,492766,Harting; Carla Kelso,19,0,20,1
1713301546282,TDAC 102,A00,492768,Basso; Beatrice,20,0,20,0
1713301547314,TDDE 111,A00,492769,Staff,25,0,25,0
1713301548466,TDDE 131,A00,492770,Staff,15,0,15,0
1713301548466,TDDE 131,B00,492771,Staff,15,0,15,0
1713301549494,TDDE 131GS,A00,523716,Guirguis; Mark C,25,0,28,3
1713301550520,TDGE 1,A01,492756,Salovey; Todd,58,0,60,2
1713301551549,TDGE 5,A01,492758,Staff,24,0,25,1
1713301552572,TDGE 10,A00,492759,Fulton; Julia,216,0,220,4
1713301553599,TDGE 11,A00,492760,Castro; Robert Jess,200,0,200,0
1713301554627,TDGE 50,A00,492761,Blair; Kyle Adam,0,0,0,0
1713301555652,TDGE 124,A00,492772,Fulton; Julia,202,0,220,18
1713301556683,TDGE 125,A00,492773,Meyer; Ursula,43,0,50,7
1713301556683,TDGE 125,B00,492774,Staff,50,0,50,0
1713301556683,TDGE 125,C00,523565,Staff,50,0,50,0
1713301557709,TDGE 125GS,A00,523580,Guirguis; Mark C,25,0,28,3
1713301558735,TDGE 127,A00,492775,Havis; Allan,45,0,50,5
1713301559765,TDHT 101,A00,492776,Staff,35,0,35,0
1713301560800,TDMV 1,A00,492762,Caligagan; Maria T.,30,0,30,0
1713301560800,TDMV 1,B00,492763,Arcidiacono; Kristin,26,0,30,4
1713301561827,TDMV 2,A00,492764,Weinberg; Sadie,29,0,30,1
1713301562858,TDMV 3,A00,492765,Mack; Kara Shanai',40,0,40,0
1713301563887,TDMV 138,A00,492777,Mack; Kara Shanai',37,0,40,3
1713301564912,TDMV 140,A00,492778,Lima; Paulo Henrique,40,0,40,0
1713301565943,TDMV 142,A00,492779,Caligagan; Maria T.,37,0,40,3
1713301565943,TDMV 142,B00,492780,Caligagan; Tony,38,0,40,2
1713301566969,TDMV 143,A00,492781,Fyall; Daunte Edward,40,0,40,0
1713301568001,USP 1,A01,492401,Kwak; Nancy,30,0,35,5
1713301569027,USP 2,A01,492453,Hinds; Juli Beth,35,0,35,0
1713301570059,USP 3,A01,492516,Staff,32,0,35,3
1713301571085,USP 4,A00,492522,McTague; Sarah,22,0,25,3
1713301572107,USP 100,A00,492523,Staff,33,0,35,2
1713301573133,USP 101,A00,492524,Staff,13,0,15,2
1713301574158,USP 105,A00,492525,Staff,22,0,25,3
1713301575239,USP 151,A00,492526,Shenkman; Michael Thomas,33,0,35,2
1713301576269,USP 170,A00,492545,Hinds; Juli Beth,33,0,35,2
1713301577297,USP 171GS,A00,492608,Bussell; Mirle Rabinowitz,26,0,28,2
1713301578323,USP 183GS,A00,492613,Peerson; Susan,26,0,28,2
1713301579357,VIS 30,A01,490693,Yoldas; Pinar,21,0,22,1
1713301579357,VIS 30,A02,490694,Yoldas; Pinar,19,0,22,3
1713301580393,VIS 83,A00,490695,Kester; Grant,68,0,75,7
1713301581421,VIS 105D,A00,490696,Staff,22,0,25,3
1713301582447,VIS 124CN,A00,490699,Rose; Jordan M,68,0,75,7
1713301583474,VIS 125GS,A00,511221,Williams; Alena J,21,0,22,1
1713301584501,VIS 128D,A00,490700,Staff,74,0,75,1
1713301585527,VIS 151,A01,490717,Staff,34,0,34,0
1713301585527,VIS 151,A02,490766,Staff,33,0,34,1
1713301586553,VIS 154GS,A00,511972,Williams; Alena J,21,0,22,1
1713301587581,VIS 160A,A00,490767,Stone; Patricia,7,0,10,3
1713301588607,WCWP 10A,A00,490638,Staff,15,0,15,0
1713301588607,WCWP 10A,B00,490640,Staff,15,0,15,0
1713301589632,WCWP 10B,A00,490641,Staff,0,0,0,0
1713301589632,WCWP 10B,B00,490642,Staff,14,0,15,1
1713301589632,WCWP 10B,C00,490644,Staff,14,0,15,1
1713301589632,WCWP 10B,D00,490647,Staff,0,0,0,0
1713301590658,WCWP 100,A00,490655,Staff,0,0,0,0
1713301590658,WCWP 100,B00,490687,Staff,12,0,15,3
1713301592741,ANAR 153,A00,487222,Braswell; Geoffrey E.,55,0,60,5
1713301593769,ANBI 134,A00,487223,Staff,14,0,20,6
1713301594797,ANBI 143GS,A00,487224,Noel; Geoffroy Pierre Jean,23,0,24,1
1713301595822,ANBI 144GS,A00,519548,Noel; Geoffroy Pierre Jean,23,0,24,1
1713301596847,ANSC 101,A00,487225,Staff,19,0,20,1
1713301597873,ANSC 125,A00,487227,Brenner; Suzanne A,40,0,40,0
1713301599926,ANSC 146,A00,487229,Staff,37,0,40,3
1713301600952,ANSC 148,A00,487230,Olivas Hernandez; Olga Lid,39,0,40,1
1713301601981,ANSC 150,A00,504165,Sloane; Julia Kathryn,19,0,20,1
1713301603005,ANSC 180,A00,487232,Staff,13,0,15,2
1713301604034,ANTH 5,A00,519529,Semendeferi; Ekaterini,15,0,15,0
1713301605065,ANTH 10,A00,487219,Staff,58,0,60,2
1713301606088,ANTH 23,A01,487221,Staff,19,0,20,1
1713301607115,ANTH 102,A00,487233,Wilder; Linnea Lorene,55,0,60,5
1713301608147,ANTH 103,A00,487234,Varma; Saiba,57,0,60,3
1713301609175,ANTH 105,A00,487235,Stewart; Alexander B,57,0,60,3
1713301610200,BENG 100,A01,516685,Taylor Amos; Alyssa C,28,0,30,2
1713301611226,BIBC 102,A01,491316,Flagg; Matthew Paul,65,0,88,23
1713301611226,BIBC 102,A02,491366,Flagg; Matthew Paul,84,0,88,4
1713301612258,BIBC 103,A01,491486,Boumechache; Miyyada,17,0,24,7
1713301612258,BIBC 103,A02,491487,Boumechache; Miyyada,24,0,24,0
1713301613283,BICD 100,A01,516882,Staff,75,0,75,0
1713301613283,BICD 100,A02,516890,Staff,71,0,75,4
1713301614307,BICD 102GS,A00,491488,Lo; Stanley M.,27,0,28,1
1713301615337,BIEB 136GS,A00,516940,Holway; David A. & Shurin; Jonathan,20,0,24,4
1713301616370,BIEB 137GS,A01,517034,Holway; David A. & Shurin; Jonathan,20,0,24,4
1713301617395,BIEB 138GS,A01,491492,Pirino; Giorgia,22,0,28,6
1713301618423,BILD 1,A01,491296,Staff,62,0,63,1
1713301618423,BILD 1,A02,491297,Staff,63,0,63,0
1713301619447,BILD 4,A01,517099,Gonzalez Gamboa; Ivonne,23,0,24,1
1713301619447,BILD 4,A02,517100,Gonzalez Gamboa; Ivonne,24,0,24,0
1713301620474,BILD 60GS,A00,491309,Lo; Stanley M.,27,0,28,1
1713301621502,BIMM 100,A01,517136,Staff,94,0,100,6
1713301622527,BIMM 110,A01,517182,Staff,80,0,100,20
1713301623553,BIMM 120,A01,517228,Pickett; Brooke Elizabeth,45,0,63,18
1713301623553,BIMM 120,A02,517240,Pickett; Brooke Elizabeth,50,0,63,13
1713301624582,BIMM 132GS,A01,491498,Pirino; Giorgia,22,0,28,6
1713301625608,BIMM 143,A01,491589,Bozinovic; Goran,21,0,40,19
1713301626632,BIPN 100,A01,491594,Armour; Jon Christopher,93,0,100,7
1713301627658,BIPN 140,A01,491602,Marino; Marc J,35,0,50,15
1713301628687,BISP 194,A00,517241,Staff,0,6,0,0
1713301629713,CAT 125,A00,515973,Staff,20,0,20,0
1713301630737,CAT 125GS,A00,515974,Rahimi; Babak,20,0,20,0
1713301631770,CAT 125R,A00,515980,Staff,16,0,20,4
1713301631770,CAT 125R,B00,515981,Tosun; Adriana,19,0,20,1
1713301631770,CAT 125R,C00,515987,Hyland; Tina Mae,8,0,20,12
1713301631770,CAT 125R,D00,515988,Bronstein; Phoebe Malan,19,0,20,1
1713301632804,CENG 15,A01,488699,Drews; Aaron,25,0,25,0
1713301633832,CENG 100,A00,505196,Opatkiewicz; Justin Paul,25,0,25,0
1713301634861,CGS 2A,A01,489598,Staff,33,0,35,2
1713301635889,CGS 112,A00,489599,Staff,15,0,15,0
1713301636918,CGS 119,A00,489603,Staff,10,0,10,0
1713301637943,CGS 120,A00,489604,Staff,14,0,15,1
1713301638968,CGS 150,A00,489607,Staff,15,0,15,0
1713301639993,CHEM 6A,A01,488715,Staff,98,0,100,2
1713301641019,CHEM 6B,A01,488719,Piercy; Marc Anthony,100,0,100,0
1713301642049,CHEM 6C,A01,488723,Albizati; Kim F.,94,0,100,6
1713301643084,CHEM 7L,A01,488728,Schurmeier; Kimberly,18,0,24,6
1713301643084,CHEM 7L,A02,488730,Schurmeier; Kimberly,23,0,24,1
1713301643084,CHEM 7L,A03,488734,Schurmeier; Kimberly,24,0,24,0
1713301643084,CHEM 7L,A04,488763,Schurmeier; Kimberly,23,0,24,1
1713301643084,CHEM 7L,B01,488798,Schurmeier; Kimberly,18,0,24,6
1713301643084,CHEM 7L,B02,488801,Schurmeier; Kimberly,24,0,24,0
1713301643084,CHEM 7L,B03,488808,Schurmeier; Kimberly,24,0,24,0
1713301643084,CHEM 7L,B04,488811,Schurmeier; Kimberly,24,0,24,0
1713301644112,CHEM 11,A01,488897,Stallings; Dontarie M,98,0,100,2
1713301645139,CHEM 40A,A01,488913,Albizati; Kim F.,93,0,100,7
1713301646170,CHEM 40B,A01,488920,Weizman; Haim,48,0,50,2
1713301646170,CHEM 40B,A02,488938,Weizman; Haim,47,0,50,3
1713301647196,CHEM 41A,A01,489029,Klosterman; Jeremy K,58,0,60,2
1713301648225,CHEM 41C,A01,500436,Tor; Yitzhak,56,0,60,4
1713301649253,CHEM 43A,A01,500426,Weizman; Haim,8,0,24,16
1713301649253,CHEM 43A,A02,500430,Weizman; Haim,16,0,24,8
1713301649253,CHEM 43A,B01,514041,Klosterman; Jeremy K,18,0,24,6
1713301649253,CHEM 43A,B02,514047,Klosterman; Jeremy K,23,0,24,1
1713301650279,CHEM 108,A01,489140,Jennings; Patricia A.,15,0,24,9
1713301650279,CHEM 108,A02,489142,Jennings; Patricia A.,18,0,24,6
1713301651304,CHEM 114A,A01,489147,Stallings; Dontarie M,83,0,100,17
1713301652333,CHIN 169A,A00,489171,Wang; Xiao,19,0,20,1
1713301654392,COGS 3,A01,518827,Boyle; Mary E. T.,33,0,40,7
1713301655419,COGS 11,A01,489175,Staff,28,0,30,2
1713301656445,COGS 14A,A01,518829,Staff,56,0,60,4
1713301657479,COGS 14B,A01,489177,Hoffman; Drew Ellen,69,0,75,6
1713301658506,COGS 100,A01,489181,Allen; Michael Gordon,68,0,75,7
1713301659534,COGS 101A,A01,489183,Staff,52,0,60,8
1713301660558,COGS 101B,A01,489185,Allen; Michael Gordon,17,0,30,13
1713301661585,COGS 101C,A01,526786,Staff,25,0,30,5
1713301663643,COGS 107A,A01,489189,Boyle; Mary E. T.,28,0,35,7
1713301664670,COGS 107B,A01,627144,Mooshagian; Eric Frederick,60,0,60,0
1713301665696,COGS 118A,A01,489191,Staff,0,20,40,40
1713301667744,COGS 171GS,A01,489194,Pineda; Jaime A,22,0,28,6
1713301668770,COGS 172,A01,489196,Staff,10,0,30,20
1713301669794,COGS 174GS,A01,489264,Pineda; Jaime A,22,0,28,6
1713301670823,COGS 180,A01,627150,Staff,30,0,30,0
1713301671848,COGS 186,A01,489274,Staff,5,0,30,25
1713301672875,COMM 10,A01,489276,Staff,25,0,25,0
1713301672875,COMM 10,A02,489303,Staff,23,0,25,2
1713301673900,COMM 100A,A01,489312,Staff,21,0,25,4
1713301673900,COMM 100A,A02,489313,Staff,24,0,25,1
1713301674929,COMM 106T,A00,512540,Staff,33,0,35,2
1713301675955,COMM 107,A00,489347,Staff,31,0,35,4
1713301676983,COMM 109P,A00,489358,Staff,31,0,35,4
1713301678015,COMM 132,A00,489361,McKenna; Denise,29,0,30,1
1713301679099,COMM 146,A00,489362,Halm; Gavin Patrick,27,0,30,3
1713301680127,COMM 190,A00,489363,Abuelhiga; Soraya Jill,21,0,23,2
1713301681154,CSE 8A,A50,489366,Staff,24,0,25,1
1713301681154,CSE 8A,A51,489367,Staff,24,0,25,1
1713301682185,CSE 11,A01,489398,Cao; Yingjun,87,0,100,13
1713301683214,CSE 12,A01,489487,Staff,43,0,50,7
1713301684243,CSE 20,A01,489497,Staff,49,0,50,1
1713301685271,CSE 21,A01,489517,Braun; Oliver,44,0,50,6
1713301686295,CSE 101,A01,489524,Braun; Oliver,3,0,50,47
1713301687426,CSE 105,A01,512594,Jones; Miles E,86,0,100,14
1713301687426,CSE 105,B01,512598,Jones; Miles E,74,0,100,26
1713301688458,CSE 140,A01,489538,Staff,45,0,50,5
1713301689485,CSE 141,A01,489550,Eldon; John,78,0,100,22
1713301690511,CSE 141L,A01,489571,Eldon; John,77,0,100,23
1713301691538,CSE 151A,A01,489583,Solares; Edwin A,159,0,200,41
1713301692565,CSE 175,A01,510886,Kumar; Rakesh,30,0,30,0
1713301693591,CSE 190,A00,516828,Dubnov; Shlomo,41,0,49,8
1713301694618,DOC 100D,A00,489667,Pass; Natalye Joann,23,0,25,2
1713301695646,DSC 10,A01,624268,Staff,72,0,75,3
1713301696671,DSC 20,A01,624476,Staff,50,0,50,0
1713301697699,DSC 40A,A01,624608,Staff,40,0,40,0
1713301698724,DSGN 1,A01,489179,Rill; Bryan,39,0,50,11
1713301699753,ECE 17,A01,490489,Sahay; Rajeev,21,0,30,9
1713301700780,ECE 65,A50,490492,Staff,17,0,20,3
1713301700780,ECE 65,A51,490493,Staff,20,0,20,0
1713301701808,ECON 1,A01,489715,Famulari; Melissa,69,0,70,1
1713301702838,ECON 2,A01,489717,Levkoff; Steven B.,69,0,70,1
1713301703866,ECON 3,A01,489948,Staff,70,0,70,0
1713301705918,ECON 5,A01,490103,Staff,28,0,30,2
1713301705918,ECON 5,B01,626281,Dai; Yinlin,45,0,45,0
1713301706947,ECON 100A,A01,490127,Famulari; Melissa,70,0,70,0
1713301707973,ECON 100B,A01,490129,Staff,64,0,70,6
1713301708999,ECON 109,A01,490187,Shishkin; Denis,30,0,35,5
1713301710024,ECON 110A,A01,490190,Levkoff; Steven B.,65,0,70,5
1713301711055,ECON 120A,A01,490245,Dai; Yinlin,69,0,70,1
1713301712081,ECON 120B,A01,490247,Nieto-Barthaburu; Augusto,61,0,70,9
1713301713110,ECON 120C,A01,490253,Sun; Yixiao,32,0,35,3
1713301713110,ECON 120C,B01,490255,Sun; Yixiao,34,0,35,1
1713301714140,ECON 129,A00,490256,Eckert; Fabian Paul,28,0,35,7
1713301715165,ECON 131,A00,490257,Nieto-Barthaburu; Augusto,8,0,35,27
1713301716190,ECON 138,A00,490258,Bharadwaj; Prashant,25,0,35,10
1713301716190,ECON 138,B00,490259,Bharadwaj; Prashant,21,0,35,14
1713301717220,ECON 159,A00,490260,Hendrickson; Gerald M.,0,6,0,0
1713301718248,ECON 178,A01,553995,Zhu; Ying,29,0,35,6
1713301719275,EDS 40,A01,512576,Black; Alison Michelle,20,0,20,0
1713301720306,EDS 107,A01,515848,Staff,30,0,30,0
1713301721334,EDS 110R,A01,490262,Staff,26,0,30,4
1713301722362,EDS 112,A01,490264,Chapman; Thandeka K,45,0,50,5
1713301723392,EDS 113,A00,490266,Staff,28,0,30,2
1713301724418,EDS 118,A00,490267,Warstadt; Melissa Fawn,27,0,30,3
1713301725445,EDS 124BR,A00,490268,Eguchi; Emi,10,0,25,15
1713301725445,EDS 124BR,B00,490269,Eguchi; Emi,25,0,25,0
1713301726475,EDS 126,A01,490271,Jones; Makeba,47,0,50,3
1713301727501,EDS 135,A01,490316,Staff,20,0,20,0
1713301728525,ENVR 142GS,A00,519514,Chang; Edmond Yi-Teh,28,0,28,0
1713301729554,ETHN 103,A00,490504,Staff,33,0,36,3
1713301730579,ETHN 103A,A00,490505,Man; Simeon S,7,0,9,2
1713301731606,ETHN 109,A00,490506,Staff,30,0,30,0
1713301732633,ETHN 118,A00,490507,Staff,35,0,36,1
1713301733659,ETHN 119,A00,490508,Staff,36,0,36,0
1713301734690,ETHN 121R,A00,490518,Choi; Esther Min,30,0,36,6
1713301735716,ETHN 127,A00,490528,Staff,15,0,15,0
1713301736741,ETHN 139,A00,490573,Staff,10,0,10,0
1713301737769,ETHN 150,A00,490575,Staff,15,0,15,0
1713301738801,GLBH 20,A00,491705,Elwardani; Nile Regina,38,0,40,2
1713301739826,GLBH 101,A00,491706,Staff,20,0,20,0
1713301740854,GLBH 111,A01,491708,Burgos; Jose L.,15,0,15,0
1713301741879,GLBH 146,A00,491709,Staff,15,0,20,5
1713301742905,GLBH 148,A00,491710,Olivas Hernandez; Olga Lid,17,0,20,3
1713301743933,GLBH 150,A00,491711,Sloane; Julia Kathryn,20,0,20,0
1713301744962,HIEA 131,A00,491760,Staff,30,0,32,2
1713301745989,HIEA 153,A00,491762,Staff,29,0,30,1
1713301747015,HIEU 124,A00,491811,Staff,29,0,32,3
1713301748040,HIEU 124GS,A00,491812,Markman; Kristina,28,0,28,0
1713301749067,HIEU 147,A00,491813,Staff,31,0,32,1
1713301750092,HIEU 149GS,A00,491816,Caldwell; Michael Alan,28,0,28,0
1713301751121,HILD 2C,A01,491713,Hendrickson; Gerald M.,28,0,30,2
1713301752145,HILD 7B,A01,491715,Kwak; Nancy,18,0,30,12
1713301753175,HILD 10,A01,491717,Staff,17,0,20,3
1713301754200,HILD 30GS,A00,491719,Edington; Claire Ellen,24,0,28,4
1713301755227,HINE 109,A00,491818,Shafir; Nir,31,0,32,1
1713301756252,HINE 128,A00,491821,Shafir; Nir,32,0,32,0
1713301757278,HISC 117,A00,491830,Staff,29,0,32,3
1713301758303,HIUS 103,A00,491834,Man; Simeon S,18,0,23,5
1713301759328,HIUS 108B,A00,491835,Staff,30,0,30,0
1713301760353,HIUS 141,A00,491836,Hendrickson; Gerald M.,29,0,32,3
1713301761378,HIUS 149,A00,491839,Staff,28,0,32,4
1713301762404,HUM 3,A01,512617,Crum; Matthew Stephen,46,0,50,4
1713301762404,HUM 3,A02,512618,Crum; Matthew Stephen,49,0,50,1
1713301763429,HUM 3GS,A00,512663,Markman; Kristina,0,0,0,0
1713301763429,HUM 3GS,B00,512664,Staff,0,0,0,0
1713301764459,HUM 4,A01,512620,West; Geoffrey Scott,39,0,50,11
1713301765485,HUM 4GS,A00,512666,Lyon; Antony J.,0,0,0,3
1713301766578,HUM 4R,A01,512625,Watkins; Eric,49,0,50,1
1713301767608,HUM 5,A01,512649,Zavodny; Tatiana Sophia,35,0,50,15
1713301767608,HUM 5,B01,512661,Zroka; Ryan Edward,49,0,50,1
1713301768633,INTL 190,A00,490577,Segui; Alan S,0,0,0,5
1713301769659,JAPN 20AR,A01,491267,Ross; Kayoko F,12,0,20,8
1713301770686,JAPN 180,A00,491285,Berman; Michael David,35,0,40,5
1713301771712,LATI 50,A01,502536,Kokinis; Troy Andreas,19,0,22,3
1713301771712,LATI 50,A02,502551,Kokinis; Troy Andreas,22,0,22,0
1713301771712,LATI 50,A03,502650,Kokinis; Troy Andreas,22,0,22,0
1713301771712,LATI 50,A04,502909,Kokinis; Troy Andreas,22,0,22,0
1713301772738,LATI 160,A01,502920,Kokinis; Troy Andreas,30,0,30,0
1713301773770,LIFR 1A,A00,490494,Van Moer; Vinciane G,18,0,20,2
1713301774795,LIFR 1AX,A00,490495,Van Moer; Vinciane G,18,0,20,2
1713301775826,LIFR 1B,A00,490496,Van Moer; Vinciane G,20,0,20,0
1713301776854,LIFR 1BX,A00,490497,Van Moer; Vinciane G,20,0,20,0
1713301777880,LIGN 8,A00,505198,McIntosh; Justin Daniel,144,0,150,6
1713301778906,LIGN 9GS,A00,491239,Lott; Margaret S.,19,0,20,1
1713301779934,LIGN 101,A01,505200,McIntosh; Justin Daniel,26,0,30,4
1713301780959,LIGN 120,A01,491244,Staff,26,0,30,4
1713301781985,LIGN 149GS,A00,491245,Lott; Margaret S.,19,0,20,1
1713301783065,LIGN 170,A00,491247,Staff,25,0,30,5
1713301784091,LISP 1D,A00,490498,Munoz Sanchez; Alicia,12,0,14,2
1713301784091,LISP 1D,B00,490499,Munoz Sanchez; Alicia,8,0,14,6
1713301784091,LISP 1D,C00,490500,Munoz Sanchez; Alicia,10,0,14,4
1713301784091,LISP 1D,D00,490501,Munoz Sanchez; Alicia,11,0,14,3
1713301785117,LISP 1DX,A00,490502,Munoz Sanchez; Alicia,21,0,28,7
1713301785117,LISP 1DX,B00,490503,Munoz Sanchez; Alicia,19,0,28,9
1713301787168,LTAM 110,A00,491847,Staff,23,0,25,2
1713301788195,LTCS 119,A00,491848,Staff,13,0,15,2
1713301789219,LTCS 130,A00,491849,Staff,24,0,25,1
1713301791272,LTEA 120C,A00,491852,Staff,35,0,40,5
1713301792302,LTEN 130GS,A00,491853,Lyon; Antony J.,25,0,28,3
1713301793326,LTEN 148,A00,491855,Staff,23,0,25,2
1713301794350,LTEN 159,A00,491856,Staff,21,0,25,4
1713301795377,LTEN 180,A00,491857,Staff,11,0,15,4
1713301797436,LTSP 123GS,A00,505928,Bessett; Ryan Matthew,25,0,28,3
1713301798460,LTSP 174GS,A00,506037,Bessett; Ryan Matthew,25,0,28,3
1713301800513,LTWR 102,A00,491861,Staff,12,0,15,3
1713301801551,LTWR 106,A00,491862,Staff,11,0,15,4
1713301802581,MAE 11,A00,490930,Bahadori; Mohammad Yousef,98,0,100,2
1713301803606,MAE 30A,A00,490931,Qi; Huihui,38,0,40,2
1713301804636,MAE 101A,A00,491036,Sadeghizadeh; Zahra,98,0,100,2
1713301805662,MAE 101C,A00,491037,Seshadri; Kalyanasundaram,79,0,100,21
1713301806688,MAE 113,A00,491040,Seshadri; Kalyanasundaram,67,0,80,13
1713301807717,MAE 131A,A00,491041,Ghazinejad; Maziar,39,0,40,1
1713301808745,MAE 142,A00,491053,Staff,39,0,40,1
1713301809770,MAE 143A,A00,491054,Staff,44,0,50,6
1713301810798,MAE 150,A00,491092,Truong; Phuong Thi Ngoc,26,0,35,9
1713301811823,MATH 3C,A01,494031,Pardo Guerra; Sebastian,30,0,30,0
1713301811823,MATH 3C,A02,494032,Pardo Guerra; Sebastian,29,0,30,1
1713301812847,MATH 10A,A01,494034,Staff,29,0,30,1
1713301812847,MATH 10A,A02,494035,Staff,29,0,30,1
1713301812847,MATH 10A,B01,494037,Staff,28,0,30,2
1713301812847,MATH 10A,B02,494038,Staff,29,0,30,1
1713301813874,MATH 10B,A01,494040,Habib; Yousaf,24,0,30,6
1713301813874,MATH 10B,A02,494041,Habib; Yousaf,28,0,30,2
1713301813874,MATH 10B,A03,494042,Habib; Yousaf,30,0,30,0
1713301813874,MATH 10B,A04,494043,Habib; Yousaf,30,0,30,0
1713301813874,MATH 10B,B01,494045,Habib; Yousaf,28,0,30,2
1713301813874,MATH 10B,B02,494046,Habib; Yousaf,30,0,30,0
1713301813874,MATH 10B,B03,494047,Habib; Yousaf,30,0,30,0
1713301813874,MATH 10B,B04,494048,Habib; Yousaf,30,0,30,0
1713301814906,MATH 18,A01,494050,Kemp; Todd Aahron,29,0,30,1
1713301814906,MATH 18,A02,494051,Kemp; Todd Aahron,29,0,30,1
1713301814906,MATH 18,B01,494054,Kemp; Todd Aahron,28,0,30,2
1713301814906,MATH 18,B02,494055,Kemp; Todd Aahron,29,0,30,1
1713301815931,MATH 20A,A01,494059,Suk; Andrew Hoon,30,0,30,0
1713301816960,MATH 20B,A01,494061,Briones; Jor-el Thomas Caparas,34,0,35,1
1713301816960,MATH 20B,B01,494063,Bach; Quang Tran,35,0,35,0
1713301817993,MATH 20C,A01,494065,Staff,29,0,30,1
1713301817993,MATH 20C,A02,494066,Staff,30,0,30,0
1713301817993,MATH 20C,A03,494067,Staff,30,0,30,0
1713301817993,MATH 20C,A04,494068,Staff,30,0,30,0
1713301817993,MATH 20C,B01,494070,Zhang; Ming,27,0,30,3
1713301817993,MATH 20C,B02,494071,Zhang; Ming,30,0,30,0
1713301817993,MATH 20C,B03,494072,Zhang; Ming,29,0,30,1
1713301817993,MATH 20C,B04,494073,Zhang; Ming,29,0,30,1
1713301819025,MATH 20D,A01,494075,Staff,27,0,30,3
1713301819025,MATH 20D,A02,494076,Staff,30,0,30,0
1713301820049,MATH 20E,A01,494079,Staff,25,0,30,5
1713301820049,MATH 20E,A02,494080,Staff,28,0,30,2
1713301820049,MATH 20E,B01,494082,Staff,28,0,30,2
1713301820049,MATH 20E,B02,494083,Staff,26,0,30,4
1713301821076,MATH 103A,A01,494085,Aliabadi Sr.; Mohsen,22,0,30,8
1713301821076,MATH 103A,A02,494086,Aliabadi Sr.; Mohsen,29,0,30,1
1713301821076,MATH 103A,B01,494088,Aliabadi Sr.; Mohsen,22,0,30,8
1713301821076,MATH 103A,B02,494089,Aliabadi Sr.; Mohsen,28,0,30,2
1713301822103,MATH 109,A01,494091,Staff,30,0,30,0
1713301822103,MATH 109,A02,494092,Staff,30,0,30,0
1713301822103,MATH 109,B01,494094,Staff,28,0,30,2
1713301822103,MATH 109,B02,494095,Staff,29,0,30,1
1713301823130,MATH 142A,A01,494097,Chow; Bennett,17,0,30,13
1713301823130,MATH 142A,A02,494098,Chow; Bennett,26,0,30,4
1713301823130,MATH 142A,B01,494100,Chow; Bennett,23,0,30,7
1713301823130,MATH 142A,B02,494101,Chow; Bennett,29,0,30,1
1713301825189,MATH 168A,A01,516677,Dumitriu; Ioana,17,0,35,18
1713301826218,MATH 170A,A01,516679,Dumitriu; Ioana,23,0,30,7
1713301826218,MATH 170A,A02,516680,Dumitriu; Ioana,28,0,30,2
1713301827248,MATH 193A,A01,494107,Staff,19,0,30,11
1713301827248,MATH 193A,A02,494108,Staff,26,0,30,4
1713301827248,MATH 193A,A03,494109,Staff,29,0,30,1
1713301827248,MATH 193A,A04,494110,Staff,27,0,30,3
1713301830343,MGT 16,A00,491930,McKay; Michael J,94,0,98,4
1713301831372,MGT 18,A00,491992,McKay; Michael J,97,0,98,1
1713301832397,MGT 71,A00,492003,Staff,79,0,98,19
1713301833421,MGT 103,A00,505209,Eberhard; Craig A,88,0,98,10
1713301834447,MGT 131A,A00,505210,Anderson; John Charles,91,0,98,7
1713301836498,MGT 153,A00,492077,Perols; Johan Lars,57,0,90,33
1713301839575,MGT 164,A00,492222,McKay; Mary A,94,0,98,4
1713301840604,MGT 172,A00,492245,Staff,59,0,60,1
1713301840604,MGT 172,B00,505526,Hedges; Kathleen,82,0,98,16
1713301841629,MGT 181,A00,505669,Dunn; Louis Jean,89,0,98,9
1713301842656,MMW 14,A01,494399,Staff,25,0,28,3
1713301842656,MMW 14,A02,494400,Staff,27,0,28,1
1713301842656,MMW 14,A03,494401,Staff,28,0,28,0
1713301842656,MMW 14,A04,494402,Staff,28,0,28,0
1713301842656,MMW 14,B01,494404,Carreras; Maria Victoria,18,0,28,10
1713301842656,MMW 14,B02,494405,Carreras; Maria Victoria,27,0,28,1
1713301842656,MMW 14,B03,494406,Carreras; Maria Victoria,28,0,28,0
1713301842656,MMW 14,B04,494407,Carreras; Maria Victoria,28,0,28,0
1713301843680,MMW 14GS,A00,506250,Chang; Edmond Yi-Teh,0,0,0,0
1713301844704,MMW 121R,A01,494415,Adamiak; Patrick John,16,0,28,12
1713301844704,MMW 121R,A02,494416,Adamiak; Patrick John,26,0,28,2
1713301845729,MUS 1A,A01,494113,Staff,14,0,25,11
1713301845729,MUS 1A,A02,494114,Staff,25,0,25,0
1713301846757,MUS 4,A01,494116,Staff,24,0,25,1
1713301846757,MUS 4,A02,494117,Staff,22,0,25,3
1713301847782,MUS 5R,A01,494236,Dubnov; Shlomo,14,0,25,11
1713301847782,MUS 5R,A02,494237,Dubnov; Shlomo,25,0,25,0
1713301848807,MUS 6,A01,494122,Staff,18,0,25,7
1713301848807,MUS 6,A02,494123,Staff,24,0,25,1
1713301849831,MUS 7,A01,494125,Staff,20,0,25,5
1713301849831,MUS 7,A02,494126,Staff,24,0,25,1
1713301850860,MUS 11,A01,494128,Staff,23,0,25,2
1713301850860,MUS 11,A02,494129,Staff,25,0,25,0
1713301851886,MUS 13,A01,494131,Staff,25,0,25,0
1713301851886,MUS 13,A02,494132,Staff,25,0,25,0
1713301852912,MUS 15,A01,494134,Staff,21,0,25,4
1713301852912,MUS 15,A02,494135,Staff,25,0,25,0
1713301852912,MUS 15,B01,494137,Staff,25,0,25,0
1713301853938,MUS 80,A00,494232,Staff,25,0,25,0
1713301853938,MUS 80,B00,494233,Staff,25,0,25,0
1713301853938,MUS 80,C00,494234,Staff,23,0,25,2
1713301854966,MUS 95C,A00,494141,Staff,73,0,75,2
1713301855995,MUS 114,A00,494142,Staff,43,0,50,7
1713301857032,NANO 15,A01,490636,Drews; Aaron,7,0,7,0
1713301858058,PHIL 1,A00,490578,Grush; Rick Scott,50,0,50,0
1713301859090,PHIL 10,A01,490580,Grush; Rick Scott,34,0,35,1
1713301859090,PHIL 10,A02,490586,Grush; Rick Scott,34,0,35,1
1713301860116,PHIL 27,A01,490591,Staff,24,0,25,1
1713301860116,PHIL 27,A02,490592,Staff,25,0,25,0
1713301860116,PHIL 27,A03,490593,Staff,25,0,25,0
1713301860116,PHIL 27,A04,490598,Staff,25,0,25,0
1713301861141,PHIL 32,A01,490611,Staff,20,0,20,0
1713301861141,PHIL 32,A02,490618,Staff,20,0,20,0
1713301862168,PHIL 90,A00,490624,Staff,40,0,40,0
1713301863197,PHIL 136,A00,490627,Cohen; Jonathan David,38,0,40,2
1713301864225,PHIL 155,A00,490634,Staff,67,0,70,3
1713301865250,PHYS 1A,A00,491610,Staff,246,0,250,4
1713301866277,PHYS 1AL,001,491616,Tsai; Philbert S,28,0,30,2
1713301866277,PHYS 1AL,002,491618,Tsai; Philbert S,30,0,30,0
1713301867303,PHYS 1B,A00,491623,Staff,245,0,250,5
1713301868328,PHYS 1BL,001,491626,Tsai; Philbert S,27,0,30,3
1713301868328,PHYS 1BL,002,491628,Tsai; Philbert S,28,0,30,2
1713301869353,PHYS 1C,A00,491632,Staff,228,0,245,17
1713301870378,PHYS 1CL,001,491635,Tsai; Philbert S,13,0,30,17
1713301870378,PHYS 1CL,002,491643,Tsai; Philbert S,26,0,30,4
1713301871402,PHYS 2AR,A01,491651,Meyertholen; Andrew D.,46,0,50,4
1713301872428,PHYS 2B,A01,491659,Staff,107,0,115,8
1713301873452,PHYS 2BL,A01,491685,Staff,24,0,24,0
1713301873452,PHYS 2BL,A02,491700,Staff,23,0,24,1
1713301874479,PHYS 2C,A01,505161,Staff,109,0,115,6
1713301875503,PHYS 4A,A01,491704,Grinstein; Benjamin,100,0,100,0
1713301876530,POLI 5D,A01,494144,Staff,3,0,5,2
1713301876530,POLI 5D,B01,626283,Dai; Yinlin,5,0,5,0
1713301877559,POLI 12,A00,494145,Staff,44,0,45,1
1713301878591,POLI 13R,A00,494146,Forman; Fonna,47,0,50,3
1713301879617,POLI 27,A01,494148,Staff,60,0,60,0
1713301880642,POLI 30,A00,494149,Staff,49,0,50,1
1713301881671,POLI 100DA,A00,494150,Staff,23,0,25,2
1713301883728,POLI 100I,A00,494152,Staff,29,0,30,1
1713301884754,POLI 104B,A00,494153,Smith; Glenn Chatmas,54,0,55,1
1713301885778,POLI 104F,A00,494154,Staff,29,0,30,1
1713301886859,POLI 104I,A00,494155,Smith; Glenn Chatmas,30,0,30,0
1713301887890,POLI 110C,A00,494156,Ingham; Sean,23,0,25,2
1713301888918,POLI 117R,A00,494157,Forman; Fonna,17,0,20,3
1713301889947,POLI 118,A00,494158,Ingham; Sean,23,0,25,2
1713301890976,POLI 120H,A00,494159,Fisk; David Lee,42,0,45,3
1713301892003,POLI 131CR,A00,494160,Hoston; Germaine,43,0,45,2
1713301893028,POLI 133J,A00,494161,Staff,33,0,35,2
1713301894054,POLI 135,A00,494162,Fisk; David Lee,34,0,35,1
1713301895079,POLI 140A,A00,494164,Staff,23,0,30,7
1713301896104,POLI 142I,A00,494165,Staff,30,0,30,0
1713301897129,POLI 144D,A00,494166,Staff,23,0,25,2
1713301898152,POLI 151,A00,494167,Staff,30,0,30,0
1713301899175,POLI 153,A00,494168,Staff,34,0,35,1
1713301900202,POLI 160AA,A00,494169,Staff,36,0,40,4
1713301901229,POLI 162,A00,494170,Mignozzetti; Umberto,22,0,25,3
1713301902254,POLI 171,A00,494171,Mignozzetti; Umberto,23,0,25,2
1713301903280,PSYC 1,A00,494172,Staff,97,0,100,3
1713301904308,PSYC 2,A00,494173,Moranton; Nirelia Melbina-,48,0,50,2
1713301905335,PSYC 3,A00,494174,Staff,30,0,30,0
1713301906360,PSYC 6,A00,494175,Staff,17,0,20,3
1713301907385,PSYC 60,A01,494177,Staff,44,0,45,1
1713301908414,PSYC 70,A01,505724,Geller; Emma Harlan,42,0,45,3
1713301909442,PSYC 101,A00,494180,Heyman; Gail D.,93,0,100,7
1713301910467,PSYC 105,A00,494181,Geller; Emma Harlan,71,0,90,19
1713301911491,PSYC 106,A00,494182,Dobkins; Karen R.,34,0,45,11
1713301912517,PSYC 108,A00,494183,Adrian; Julia Anna,94,0,100,6
1713301913546,PSYC 114,A01,494185,Winkielman; Piotr,8,0,30,22
1713301914572,PSYC 122,A00,494186,Moranton; Nirelia Melbina-,41,0,50,9
1713301915600,PSYC 124,A00,494187,Chapman; Eddie Nathaniel,74,0,80,6
1713301916627,PSYC 131,A00,494188,Anagnostaras; Stephan,64,0,80,16
1713301928187,PSYC 144,A00,494189,Staff,24,0,50,26
1713301929218,PSYC 154,A00,494190,Lacefield; Katharine I,145,0,180,35
1713301930247,PSYC 162,A00,494191,Wixted; John T,92,0,100,8
1713301931271,PSYC 172,A00,494192,Gorman; Michael R.,38,0,45,7
1713301932302,PSYC 178,A00,494193,Glaser; Dale,41,0,45,4
1713301933328,PSYC 193,A00,505725,Chapman; Eddie Nathaniel,20,0,20,0
1713301934351,RELI 145GS,A00,519817,Rahimi; Babak,19,0,20,1
1713301935376,SE 101A,A01,490862,Chadha; Mayank,25,0,25,0
1713301936401,SE 101C,A01,490924,Krysl; Petr,18,0,20,2
1713301937432,SE 110A,A01,490928,Staff,20,0,20,0
1713301938456,SE 130A,A00,490929,Morrison; Machel Leigh,66,0,70,4
1713301939481,SIO 1,A01,519325,Staff,39,0,40,1
1713301940506,SIO 30,A01,519327,Staff,40,0,40,0
1713301941535,SIO 40,A00,519328,Staff,40,0,40,0
1713301942560,SIO 46GS,A00,519819,Cook; Geoffrey W,19,0,25,6
1713301943593,SIO 109R,A00,494197,Forman; Fonna,11,0,20,9
1713301944620,SIO 121GS,A00,519827,Cook; Geoffrey W,19,0,25,6
1713301945645,SIO 132,A01,519330,Staff,38,0,40,2
1713301946735,SIO 133,A01,519397,Staff,40,0,40,0
1713301947764,SIO 139,A00,519396,Kacev; David,35,0,40,5
1713301948792,SOCI 1,A01,494199,Thorpe; Charles Robert,24,0,30,6
1713301948792,SOCI 1,A02,494200,Thorpe; Charles Robert,30,0,30,0
1713301948792,SOCI 1,A03,494201,Thorpe; Charles Robert,30,0,30,0
1713301948792,SOCI 1,A04,494202,Thorpe; Charles Robert,29,0,30,1
1713301948792,SOCI 1,A05,494203,Thorpe; Charles Robert,30,0,30,0
1713301948792,SOCI 1,A06,494204,Thorpe; Charles Robert,30,0,30,0
1713301948792,SOCI 1,A07,494205,Thorpe; Charles Robert,29,0,30,1
1713301949816,SOCI 60,A01,494207,Staff,36,0,40,4
1713301949816,SOCI 60,A02,494208,Staff,39,0,40,1
1713301950842,SOCI 100,A01,494210,Payne; Christine Anna,28,0,30,2
1713301950842,SOCI 100,A02,494211,Payne; Christine Anna,28,0,30,2
1713301951866,SOCI 109M,A00,494212,Staff,20,0,20,0
1713301952893,SOCI 110,A00,494213,Staff,36,0,40,4
1713301954944,SOCI 118E,A00,494215,Ng; Kwai,39,0,40,1
1713301955970,SOCI 125,A00,494216,Calderon-Zaks; Michael Aar,43,0,45,2
1713301956996,SOCI 126,A01,494218,Jones; Makeba,4,0,5,1
1713301958022,SOCI 131,A00,494219,Thorpe; Charles Robert,30,0,30,0
1713301960076,SOCI 135,A00,494221,Payne; Christine Anna,44,0,50,6
1713301961101,SOCI 136E,A00,626690,Ruiz; Jonathan Joseph,25,0,25,0
1713301962128,SOCI 138GS,A00,494222,Navon; Daniel,24,0,28,4
1713301964177,SOCI 145,A00,494224,Staff,45,0,45,0
1713301965203,SOCI 153,A00,494225,Staff,29,0,30,1
1713301966233,SOCI 160E,A00,494226,Ng; Kwai,34,0,40,6
1713301967259,SOCI 180,A00,494227,Staff,29,0,30,1
1713301968284,SOCI 189GS,A00,494228,Ribas Norris; Janet Vanesa,11,0,11,0
1713301969310,SOCI 190GS,A00,553232,Ribas Norris; Janet Vanesa,11,0,11,0
1713301970336,SYN 2,001,490768,Staff,14,0,15,1
1713301970336,SYN 2,002,490769,Staff,15,0,15,0
1713301970336,SYN 2,004,490775,Staff,0,0,0,0
1713301970336,SYN 2,003,490774,Staff,0,0,0,0
1713301970336,SYN 2,005,490776,Staff,0,0,0,0
1713301971363,SYN 2R,001,490779,Staff,14,0,15,1
1713301971363,SYN 2R,002,514635,Staff,14,0,15,1
1713301972392,SYN 100,A01,490783,Staff,17,0,20,3
1713301972392,SYN 100,B01,490787,Staff,13,0,20,7
1713301972392,SYN 100,C01,490789,Staff,15,0,20,5
1713301973421,SYN 150,A00,490817,Staff,14,0,15,1
1713301973421,SYN 150,B00,514610,Staff,15,0,15,0
1713301974453,TDAC 1,A00,492753,Walsh; Kim C.,19,0,20,1
1713301974453,TDAC 1,B00,492754,Harting; Carla Kelso,19,0,20,1
1713301974453,TDAC 1,C00,513995,Salovey; Todd,18,0,20,2
1713301975482,TDAC 101,A00,492766,Harting; Carla Kelso,19,0,20,1
1713301976508,TDAC 102,A00,492768,Basso; Beatrice,20,0,20,0
1713301977532,TDDE 111,A00,492769,Staff,25,0,25,0
1713301978563,TDDE 131,A00,492770,Staff,15,0,15,0
1713301978563,TDDE 131,B00,492771,Staff,15,0,15,0
1713301979588,TDDE 131GS,A00,523716,Guirguis; Mark C,25,0,28,3
1713301980612,TDGE 1,A01,492756,Salovey; Todd,58,0,60,2
1713301981638,TDGE 5,A01,492758,Staff,24,0,25,1
1713301982666,TDGE 10,A00,492759,Fulton; Julia,216,0,220,4
1713301983692,TDGE 11,A00,492760,Castro; Robert Jess,200,0,200,0
1713301984721,TDGE 50,A00,492761,Blair; Kyle Adam,0,0,0,0
1713301985750,TDGE 124,A00,492772,Fulton; Julia,202,0,220,18
1713301986777,TDGE 125,A00,492773,Meyer; Ursula,43,0,50,7
1713301986777,TDGE 125,B00,492774,Staff,50,0,50,0
1713301986777,TDGE 125,C00,523565,Staff,50,0,50,0
1713301987802,TDGE 125GS,A00,523580,Guirguis; Mark C,25,0,28,3
1713301988826,TDGE 127,A00,492775,Havis; Allan,45,0,50,5
1713301989852,TDHT 101,A00,492776,Staff,35,0,35,0
1713301990883,TDMV 1,A00,492762,Caligagan; Maria T.,30,0,30,0
1713301990883,TDMV 1,B00,492763,Arcidiacono; Kristin,26,0,30,4
1713301991912,TDMV 2,A00,492764,Weinberg; Sadie,29,0,30,1
1713301992938,TDMV 3,A00,492765,Mack; Kara Shanai',40,0,40,0
1713301993966,TDMV 138,A00,492777,Mack; Kara Shanai',37,0,40,3
1713301994993,TDMV 140,A00,492778,Lima; Paulo Henrique,40,0,40,0
1713301996022,TDMV 142,A00,492779,Caligagan; Maria T.,37,0,40,3
1713301996022,TDMV 142,B00,492780,Caligagan; Tony,38,0,40,2
1713301997047,TDMV 143,A00,492781,Fyall; Daunte Edward,40,0,40,0
1713301998074,USP 1,A01,492401,Kwak; Nancy,30,0,35,5
1713301999107,USP 2,A01,492453,Hinds; Juli Beth,35,0,35,0
1713302000132,USP 3,A01,492516,Staff,32,0,35,3
1713302001216,USP 4,A00,492522,McTague; Sarah,22,0,25,3
1713302002244,USP 100,A00,492523,Staff,33,0,35,2
1713302003272,USP 101,A00,492524,Staff,13,0,15,2
1713302004300,USP 105,A00,492525,Staff,22,0,25,3
1713302005327,USP 151,A00,492526,Shenkman; Michael Thomas,33,0,35,2
1713302006353,USP 170,A00,492545,Hinds; Juli Beth,33,0,35,2
1713302007380,USP 171GS,A00,492608,Bussell; Mirle Rabinowitz,26,0,28,2
1713302008405,USP 183GS,A00,492613,Peerson; Susan,26,0,28,2
1713302009431,VIS 30,A01,490693,Yoldas; Pinar,21,0,22,1
1713302009431,VIS 30,A02,490694,Yoldas; Pinar,19,0,22,3
1713302010456,VIS 83,A00,490695,Kester; Grant,68,0,75,7
1713302011481,VIS 105D,A00,490696,Staff,22,0,25,3
1713302012505,VIS 124CN,A00,490699,Rose; Jordan M,68,0,75,7
1713302013534,VIS 125GS,A00,511221,Williams; Alena J,21,0,22,1
1713302014560,VIS 128D,A00,490700,Staff,74,0,75,1
1713302015589,VIS 151,A01,490717,Staff,34,0,34,0
1713302015589,VIS 151,A02,490766,Staff,33,0,34,1
1713302016612,VIS 154GS,A00,511972,Williams; Alena J,21,0,22,1
1713302017643,VIS 160A,A00,490767,Stone; Patricia,7,0,10,3
1713302018669,WCWP 10A,A00,490638,Staff,15,0,15,0
1713302018669,WCWP 10A,B00,490640,Staff,15,0,15,0
1713302019700,WCWP 10B,A00,490641,Staff,0,0,0,0
1713302019700,WCWP 10B,B00,490642,Staff,14,0,15,1
1713302019700,WCWP 10B,C00,490644,Staff,14,0,15,1
1713302019700,WCWP 10B,D00,490647,Staff,0,0,0,0
1713302020728,WCWP 100,A00,490655,Staff,0,0,0,0
1713302020728,WCWP 100,B00,490687,Staff,12,0,15,3
1713302022830,ANAR 153,A00,487222,Braswell; Geoffrey E.,55,0,60,5
1713302023856,ANBI 134,A00,487223,Staff,15,0,20,5
1713302024880,ANBI 143GS,A00,487224,Noel; Geoffroy Pierre Jean,23,0,24,1
1713302025906,ANBI 144GS,A00,519548,Noel; Geoffroy Pierre Jean,23,0,24,1
1713302026932,ANSC 101,A00,487225,Staff,19,0,20,1
1713302027961,ANSC 125,A00,487227,Brenner; Suzanne A,40,0,40,0
1713302030011,ANSC 146,A00,487229,Staff,37,0,40,3
1713302031037,ANSC 148,A00,487230,Olivas Hernandez; Olga Lid,39,0,40,1
1713302032063,ANSC 150,A00,504165,Sloane; Julia Kathryn,19,0,20,1
1713302033089,ANSC 180,A00,487232,Staff,13,0,15,2
1713302034121,ANTH 5,A00,519529,Semendeferi; Ekaterini,15,0,15,0
1713302035145,ANTH 10,A00,487219,Staff,58,0,60,2
1713302036169,ANTH 23,A01,487221,Staff,19,0,20,1
1713302037196,ANTH 102,A00,487233,Wilder; Linnea Lorene,55,0,60,5
1713302038221,ANTH 103,A00,487234,Varma; Saiba,57,0,60,3
1713302039248,ANTH 105,A00,487235,Stewart; Alexander B,57,0,60,3
1713302040360,BENG 100,A01,516685,Taylor Amos; Alyssa C,28,0,30,2
1713302041391,BIBC 102,A01,491316,Flagg; Matthew Paul,62,0,88,26
1713302041391,BIBC 102,A02,491366,Flagg; Matthew Paul,84,0,88,4
1713302042417,BIBC 103,A01,491486,Boumechache; Miyyada,17,0,24,7
1713302042417,BIBC 103,A02,491487,Boumechache; Miyyada,24,0,24,0
1713302043444,BICD 100,A01,516882,Staff,75,0,75,0
1713302043444,BICD 100,A02,516890,Staff,71,0,75,4
1713302044472,BICD 102GS,A00,491488,Lo; Stanley M.,27,0,28,1
1713302045506,BIEB 136GS,A00,516940,Holway; David A. & Shurin; Jonathan,20,0,24,4
1713302046557,BIEB 137GS,A01,517034,Holway; David A. & Shurin; Jonathan,20,0,24,4
1713302047582,BIEB 138GS,A01,491492,Pirino; Giorgia,22,0,28,6
1713302048612,BILD 1,A01,491296,Staff,62,0,63,1
1713302048612,BILD 1,A02,491297,Staff,63,0,63,0
1713302049645,BILD 4,A01,517099,Gonzalez Gamboa; Ivonne,23,0,24,1
1713302049645,BILD 4,A02,517100,Gonzalez Gamboa; Ivonne,24,0,24,0
1713302050674,BILD 60GS,A00,491309,Lo; Stanley M.,27,0,28,1
1713302051705,BIMM 100,A01,517136,Staff,95,0,100,5
1713302052733,BIMM 110,A01,517182,Staff,80,0,100,20
1713302053770,BIMM 120,A01,517228,Pickett; Brooke Elizabeth,43,0,63,20
1713302053770,BIMM 120,A02,517240,Pickett; Brooke Elizabeth,49,0,63,14
1713302054800,BIMM 132GS,A01,491498,Pirino; Giorgia,22,0,28,6
1713302055827,BIMM 143,A01,491589,Bozinovic; Goran,21,0,40,19
1713302056854,BIPN 100,A01,491594,Armour; Jon Christopher,93,0,100,7
1713302057884,BIPN 140,A01,491602,Marino; Marc J,35,0,50,15
1713302059935,CAT 125,A00,515973,Staff,20,0,20,0
1713302060972,CAT 125GS,A00,515974,Rahimi; Babak,20,0,20,0
1713302062000,CAT 125R,A00,515980,Staff,15,0,20,5
1713302062000,CAT 125R,B00,515981,Tosun; Adriana,19,0,20,1
1713302062000,CAT 125R,C00,515987,Hyland; Tina Mae,7,0,20,13
1713302062000,CAT 125R,D00,515988,Bronstein; Phoebe Malan,19,0,20,1
1713302063026,CENG 15,A01,488699,Drews; Aaron,25,0,25,0
1713302064059,CENG 100,A00,505196,Opatkiewicz; Justin Paul,25,0,25,0
1713302065083,CGS 2A,A01,489598,Staff,33,0,35,2
1713302066108,CGS 112,A00,489599,Staff,15,0,15,0
1713302067141,CGS 119,A00,489603,Staff,10,0,10,0
1713302068171,CGS 120,A00,489604,Staff,14,0,15,1
1713302069197,CGS 150,A00,489607,Staff,15,0,15,0
1713302070222,CHEM 6A,A01,488715,Staff,98,0,100,2
1713302071252,CHEM 6B,A01,488719,Piercy; Marc Anthony,100,0,100,0
1713302072277,CHEM 6C,A01,488723,Albizati; Kim F.,94,0,100,6
1713302073342,CHEM 7L,A01,488728,Schurmeier; Kimberly,18,0,24,6
1713302073342,CHEM 7L,A02,488730,Schurmeier; Kimberly,23,0,24,1
1713302073342,CHEM 7L,A03,488734,Schurmeier; Kimberly,24,0,24,0
1713302073342,CHEM 7L,A04,488763,Schurmeier; Kimberly,23,0,24,1
1713302073342,CHEM 7L,B01,488798,Schurmeier; Kimberly,18,0,24,6
1713302073342,CHEM 7L,B02,488801,Schurmeier; Kimberly,24,0,24,0
1713302073342,CHEM 7L,B03,488808,Schurmeier; Kimberly,24,0,24,0
1713302073342,CHEM 7L,B04,488811,Schurmeier; Kimberly,24,0,24,0
1713302074368,CHEM 11,A01,488897,Stallings; Dontarie M,98,0,100,2
1713302075414,CHEM 40A,A01,488913,Albizati; Kim F.,93,0,100,7
1713302076441,CHEM 40B,A01,488920,Weizman; Haim,48,0,50,2
1713302076441,CHEM 40B,A02,488938,Weizman; Haim,47,0,50,3
1713302077473,CHEM 41A,A01,489029,Klosterman; Jeremy K,58,0,60,2
1713302078502,CHEM 41C,A01,500436,Tor; Yitzhak,56,0,60,4
1713302079529,CHEM 43A,A01,500426,Weizman; Haim,8,0,24,16
1713302079529,CHEM 43A,A02,500430,Weizman; Haim,16,0,24,8
1713302079529,CHEM 43A,B01,514041,Klosterman; Jeremy K,18,0,24,6
1713302079529,CHEM 43A,B02,514047,Klosterman; Jeremy K,23,0,24,1
1713302080556,CHEM 108,A01,489140,Jennings; Patricia A.,15,0,24,9
1713302080556,CHEM 108,A02,489142,Jennings; Patricia A.,18,0,24,6
1713302081584,CHEM 114A,A01,489147,Stallings; Dontarie M,83,0,100,17
1713302082612,CHIN 169A,A00,489171,Wang; Xiao,19,0,20,1
1713302084673,COGS 3,A01,518827,Boyle; Mary E. T.,31,0,40,9
1713302085702,COGS 11,A01,489175,Staff,28,0,30,2
1713302086728,COGS 14A,A01,518829,Staff,56,0,60,4
1713302087755,COGS 14B,A01,489177,Hoffman; Drew Ellen,69,0,75,6
1713302088781,COGS 100,A01,489181,Allen; Michael Gordon,68,0,75,7
1713302089810,COGS 101A,A01,489183,Staff,52,0,60,8
1713302090835,COGS 101B,A01,489185,Allen; Michael Gordon,15,0,30,15
1713302091861,COGS 101C,A01,526786,Staff,25,0,30,5
1713302093912,COGS 107A,A01,489189,Boyle; Mary E. T.,28,0,35,7
1713302094942,COGS 107B,A01,627144,Mooshagian; Eric Frederick,60,0,60,0
1713302095967,COGS 118A,A01,489191,Staff,0,21,40,40
1713302098023,COGS 171GS,A01,489194,Pineda; Jaime A,22,0,28,6
1713302099049,COGS 172,A01,489196,Staff,9,0,30,21
1713302100092,COGS 174GS,A01,489264,Pineda; Jaime A,22,0,28,6
1713302101121,COGS 180,A01,627150,Staff,29,0,30,1
1713302102152,COGS 186,A01,489274,Staff,5,0,30,25
1713302103176,COMM 10,A01,489276,Staff,25,0,25,0
1713302103176,COMM 10,A02,489303,Staff,23,0,25,2
1713302104205,COMM 100A,A01,489312,Staff,21,0,25,4
1713302104205,COMM 100A,A02,489313,Staff,24,0,25,1
1713302105289,COMM 106T,A00,512540,Staff,33,0,35,2
1713302106320,COMM 107,A00,489347,Staff,31,0,35,4
1713302107350,COMM 109P,A00,489358,Staff,31,0,35,4
1713302108381,COMM 132,A00,489361,McKenna; Denise,29,0,30,1
1713302109405,COMM 146,A00,489362,Halm; Gavin Patrick,27,0,30,3
1713302110434,COMM 190,A00,489363,Abuelhiga; Soraya Jill,21,0,23,2
1713302111464,CSE 8A,A50,489366,Staff,24,0,25,1
1713302111464,CSE 8A,A51,489367,Staff,24,0,25,1
1713302112489,CSE 11,A01,489398,Cao; Yingjun,87,0,100,13
1713302113519,CSE 12,A01,489487,Staff,43,0,50,7
1713302114546,CSE 20,A01,489497,Staff,49,0,50,1
1713302115573,CSE 21,A01,489517,Braun; Oliver,44,0,50,6
1713302116597,CSE 101,A01,489524,Braun; Oliver,2,0,50,48
1713302117624,CSE 105,A01,512594,Jones; Miles E,86,0,100,14
1713302117624,CSE 105,B01,512598,Jones; Miles E,74,0,100,26
1713302118650,CSE 140,A01,489538,Staff,45,0,50,5
1713302119687,CSE 141,A01,489550,Eldon; John,78,0,100,22
1713302120714,CSE 141L,A01,489571,Eldon; John,77,0,100,23
1713302121750,CSE 151A,A01,489583,Solares; Edwin A,159,0,200,41
1713302122779,CSE 175,A01,510886,Kumar; Rakesh,30,0,30,0
1713302123810,CSE 190,A00,516828,Dubnov; Shlomo,41,0,49,8
1713302124836,DOC 100D,A00,489667,Pass; Natalye Joann,23,0,25,2
1713302125863,DSC 10,A01,624268,Staff,72,0,75,3
1713302126886,DSC 20,A01,624476,Staff,50,0,50,0
1713302127913,DSC 40A,A01,624608,Staff,40,0,40,0
1713302128944,DSGN 1,A01,489179,Rill; Bryan,39,0,50,11
1713302129975,ECE 17,A01,490489,Sahay; Rajeev,21,0,30,9
1713302131001,ECE 65,A50,490492,Staff,17,0,20,3
1713302131001,ECE 65,A51,490493,Staff,20,0,20,0
1713302132032,ECON 1,A01,489715,Famulari; Melissa,69,0,70,1
1713302133058,ECON 2,A01,489717,Levkoff; Steven B.,69,0,70,1
1713302134086,ECON 3,A01,489948,Staff,70,0,70,0
1713302136138,ECON 5,A01,490103,Staff,28,0,30,2
1713302136138,ECON 5,B01,626281,Dai; Yinlin,45,0,45,0
1713302137167,ECON 100A,A01,490127,Famulari; Melissa,70,0,70,0
1713302138197,ECON 100B,A01,490129,Staff,64,0,70,6
1713302139222,ECON 109,A01,490187,Shishkin; Denis,30,0,35,5
1713302140249,ECON 110A,A01,490190,Levkoff; Steven B.,65,0,70,5
1713302141279,ECON 120A,A01,490245,Dai; Yinlin,69,0,70,1
1713302142305,ECON 120B,A01,490247,Nieto-Barthaburu; Augusto,61,0,70,9
1713302143332,ECON 120C,A01,490253,Sun; Yixiao,32,0,35,3
1713302143332,ECON 120C,B01,490255,Sun; Yixiao,34,0,35,1
1713302144362,ECON 129,A00,490256,Eckert; Fabian Paul,28,0,35,7
1713302145386,ECON 131,A00,490257,Nieto-Barthaburu; Augusto,8,0,35,27
1713302146414,ECON 138,A00,490258,Bharadwaj; Prashant,25,0,35,10
1713302146414,ECON 138,B00,490259,Bharadwaj; Prashant,21,0,35,14
1713302147440,ECON 159,A00,490260,Hendrickson; Gerald M.,0,6,0,0
1713302148465,ECON 178,A01,553995,Zhu; Ying,29,0,35,6
1713302149496,EDS 40,A01,512576,Black; Alison Michelle,20,0,20,0
1713302150524,EDS 107,A01,515848,Staff,30,0,30,0
1713302151551,EDS 110R,A01,490262,Staff,26,0,30,4
1713302152576,EDS 112,A01,490264,Chapman; Thandeka K,45,0,50,5
1713302153602,EDS 113,A00,490266,Staff,28,0,30,2
1713302154628,EDS 118,A00,490267,Warstadt; Melissa Fawn,27,0,30,3
1713302155657,EDS 124BR,A00,490268,Eguchi; Emi,10,0,25,15
1713302155657,EDS 124BR,B00,490269,Eguchi; Emi,25,0,25,0
1713302156686,EDS 126,A01,490271,Jones; Makeba,47,0,50,3
1713302157715,EDS 135,A01,490316,Staff,20,0,20,0
1713302158744,ENVR 142GS,A00,519514,Chang; Edmond Yi-Teh,28,0,28,0
1713302159768,ETHN 103,A00,490504,Staff,33,0,36,3
1713302160866,ETHN 103A,A00,490505,Man; Simeon S,7,0,9,2
1713302161894,ETHN 109,A00,490506,Staff,30,0,30,0
1713302162921,ETHN 118,A00,490507,Staff,35,0,36,1
1713302163949,ETHN 119,A00,490508,Staff,36,0,36,0
1713302164975,ETHN 121R,A00,490518,Choi; Esther Min,30,0,36,6
1713302166001,ETHN 127,A00,490528,Staff,15,0,15,0
1713302167029,ETHN 139,A00,490573,Staff,10,0,10,0
1713302168057,ETHN 150,A00,490575,Staff,15,0,15,0
1713302169085,GLBH 20,A00,491705,Elwardani; Nile Regina,38,0,40,2
1713302170109,GLBH 101,A00,491706,Staff,20,0,20,0
1713302171140,GLBH 111,A01,491708,Burgos; Jose L.,15,0,15,0
1713302172169,GLBH 146,A00,491709,Staff,15,0,20,5
1713302173198,GLBH 148,A00,491710,Olivas Hernandez; Olga Lid,17,0,20,3
1713302174224,GLBH 150,A00,491711,Sloane; Julia Kathryn,20,0,20,0
1713302175251,HIEA 131,A00,491760,Staff,30,0,32,2
1713302176279,HIEA 153,A00,491762,Staff,29,0,30,1
1713302177305,HIEU 124,A00,491811,Staff,29,0,32,3
1713302178331,HIEU 124GS,A00,491812,Markman; Kristina,28,0,28,0
1713302179359,HIEU 147,A00,491813,Staff,31,0,32,1
1713302180387,HIEU 149GS,A00,491816,Caldwell; Michael Alan,28,0,28,0
1713302181412,HILD 2C,A01,491713,Hendrickson; Gerald M.,28,0,30,2
1713302182440,HILD 7B,A01,491715,Kwak; Nancy,17,0,30,13
1713302183463,HILD 10,A01,491717,Staff,17,0,20,3
1713302184487,HILD 30GS,A00,491719,Edington; Claire Ellen,24,0,28,4
1713302185513,HINE 109,A00,491818,Shafir; Nir,31,0,32,1
1713302186541,HINE 128,A00,491821,Shafir; Nir,32,0,32,0
1713302187565,HISC 117,A00,491830,Staff,29,0,32,3
1713302188594,HIUS 103,A00,491834,Man; Simeon S,18,0,23,5
1713302189618,HIUS 108B,A00,491835,Staff,30,0,30,0
1713302190643,HIUS 141,A00,491836,Hendrickson; Gerald M.,29,0,32,3
1713302191671,HIUS 149,A00,491839,Staff,28,0,32,4
1713302192696,HUM 3,A01,512617,Crum; Matthew Stephen,46,0,50,4
1713302192696,HUM 3,A02,512618,Crum; Matthew Stephen,49,0,50,1
1713302193726,HUM 3GS,A00,512663,Markman; Kristina,0,0,0,0
1713302193726,HUM 3GS,B00,512664,Staff,0,0,0,0
1713302194759,HUM 4,A01,512620,West; Geoffrey Scott,39,0,50,11
1713302195788,HUM 4GS,A00,512666,Lyon; Antony J.,0,0,0,3
1713302196813,HUM 4R,A01,512625,Watkins; Eric,49,0,50,1
1713302197840,HUM 5,A01,512649,Zavodny; Tatiana Sophia,35,0,50,15
1713302197840,HUM 5,B01,512661,Zroka; Ryan Edward,49,0,50,1
1713302198865,INTL 190,A00,490577,Segui; Alan S,0,0,0,5
1713302199890,JAPN 20AR,A01,491267,Ross; Kayoko F,12,0,20,8
1713302200915,JAPN 180,A00,491285,Berman; Michael David,35,0,40,5
1713302201948,LATI 50,A01,502536,Kokinis; Troy Andreas,19,0,22,3
1713302201948,LATI 50,A02,502551,Kokinis; Troy Andreas,22,0,22,0
1713302201948,LATI 50,A03,502650,Kokinis; Troy Andreas,22,0,22,0
1713302201948,LATI 50,A04,502909,Kokinis; Troy Andreas,22,0,22,0
1713302202972,LATI 160,A01,502920,Kokinis; Troy Andreas,30,0,30,0
1713302203998,LIFR 1A,A00,490494,Van Moer; Vinciane G,18,0,20,2
1713302205022,LIFR 1AX,A00,490495,Van Moer; Vinciane G,18,0,20,2
1713302206048,LIFR 1B,A00,490496,Van Moer; Vinciane G,20,0,20,0
1713302207077,LIFR 1BX,A00,490497,Van Moer; Vinciane G,20,0,20,0
1713302208107,LIGN 8,A00,505198,McIntosh; Justin Daniel,144,0,150,6
1713302209191,LIGN 9GS,A00,491239,Lott; Margaret S.,18,0,20,2
1713302210215,LIGN 101,A01,505200,McIntosh; Justin Daniel,26,0,30,4
1713302211241,LIGN 120,A01,491244,Staff,26,0,30,4
1713302212269,LIGN 149GS,A00,491245,Lott; Margaret S.,18,0,20,2
1713302213300,LIGN 170,A00,491247,Staff,25,0,30,5
1713302214329,LISP 1D,A00,490498,Munoz Sanchez; Alicia,12,0,14,2
1713302214329,LISP 1D,B00,490499,Munoz Sanchez; Alicia,8,0,14,6
1713302214329,LISP 1D,C00,490500,Munoz Sanchez; Alicia,10,0,14,4
1713302214329,LISP 1D,D00,490501,Munoz Sanchez; Alicia,11,0,14,3
1713302215357,LISP 1DX,A00,490502,Munoz Sanchez; Alicia,21,0,28,7
1713302215357,LISP 1DX,B00,490503,Munoz Sanchez; Alicia,19,0,28,9
1713302217410,LTAM 110,A00,491847,Staff,23,0,25,2
1713302218442,LTCS 119,A00,491848,Staff,13,0,15,2
1713302219467,LTCS 130,A00,491849,Staff,24,0,25,1
1713302221518,LTEA 120C,A00,491852,Staff,35,0,40,5
1713302222549,LTEN 130GS,A00,491853,Lyon; Antony J.,25,0,28,3
1713302223574,LTEN 148,A00,491855,Staff,23,0,25,2
1713302224603,LTEN 159,A00,491856,Staff,21,0,25,4
1713302225633,LTEN 180,A00,491857,Staff,11,0,15,4
1713302227685,LTSP 123GS,A00,505928,Bessett; Ryan Matthew,25,0,28,3
1713302228709,LTSP 174GS,A00,506037,Bessett; Ryan Matthew,25,0,28,3
1713302230760,LTWR 102,A00,491861,Staff,11,0,15,4
1713302231785,LTWR 106,A00,491862,Staff,11,0,15,4
1713302232816,MAE 11,A00,490930,Bahadori; Mohammad Yousef,98,0,100,2
1713302233859,MAE 30A,A00,490931,Qi; Huihui,38,0,40,2
1713302234890,MAE 101A,A00,491036,Sadeghizadeh; Zahra,98,0,100,2
1713302235916,MAE 101C,A00,491037,Seshadri; Kalyanasundaram,78,0,100,22
1713302236946,MAE 113,A00,491040,Seshadri; Kalyanasundaram,67,0,80,13
1713302237971,MAE 131A,A00,491041,Ghazinejad; Maziar,39,0,40,1
1713302238995,MAE 142,A00,491053,Staff,39,0,40,1
1713302240021,MAE 143A,A00,491054,Staff,44,0,50,6
1713302241046,MAE 150,A00,491092,Truong; Phuong Thi Ngoc,25,0,35,10
1713302242077,MATH 3C,A01,494031,Pardo Guerra; Sebastian,30,0,30,0
1713302242077,MATH 3C,A02,494032,Pardo Guerra; Sebastian,29,0,30,1
1713302243102,MATH 10A,A01,494034,Staff,29,0,30,1
1713302243102,MATH 10A,A02,494035,Staff,29,0,30,1
1713302243102,MATH 10A,B01,494037,Staff,28,0,30,2
1713302243102,MATH 10A,B02,494038,Staff,29,0,30,1
1713302244130,MATH 10B,A01,494040,Habib; Yousaf,24,0,30,6
1713302244130,MATH 10B,A02,494041,Habib; Yousaf,28,0,30,2
1713302244130,MATH 10B,A03,494042,Habib; Yousaf,30,0,30,0
1713302244130,MATH 10B,A04,494043,Habib; Yousaf,30,0,30,0
1713302244130,MATH 10B,B01,494045,Habib; Yousaf,28,0,30,2
1713302244130,MATH 10B,B02,494046,Habib; Yousaf,30,0,30,0
1713302244130,MATH 10B,B03,494047,Habib; Yousaf,30,0,30,0
1713302244130,MATH 10B,B04,494048,Habib; Yousaf,30,0,30,0
1713302245156,MATH 18,A01,494050,Kemp; Todd Aahron,29,0,30,1
1713302245156,MATH 18,A02,494051,Kemp; Todd Aahron,29,0,30,1
1713302245156,MATH 18,B01,494054,Kemp; Todd Aahron,28,0,30,2
1713302245156,MATH 18,B02,494055,Kemp; Todd Aahron,29,0,30,1
1713302246181,MATH 20A,A01,494059,Suk; Andrew Hoon,30,0,30,0
1713302247212,MATH 20B,A01,494061,Briones; Jor-el Thomas Caparas,34,0,35,1
1713302247212,MATH 20B,B01,494063,Bach; Quang Tran,35,0,35,0
1713302248238,MATH 20C,A01,494065,Staff,29,0,30,1
1713302248238,MATH 20C,A02,494066,Staff,30,0,30,0
1713302248238,MATH 20C,A03,494067,Staff,30,0,30,0
1713302248238,MATH 20C,A04,494068,Staff,30,0,30,0
1713302248238,MATH 20C,B01,494070,Zhang; Ming,27,0,30,3
1713302248238,MATH 20C,B02,494071,Zhang; Ming,30,0,30,0
1713302248238,MATH 20C,B03,494072,Zhang; Ming,29,0,30,1
1713302248238,MATH 20C,B04,494073,Zhang; Ming,29,0,30,1
1713302249268,MATH 20D,A01,494075,Staff,27,0,30,3
1713302249268,MATH 20D,A02,494076,Staff,30,0,30,0
1713302250298,MATH 20E,A01,494079,Staff,25,0,30,5
1713302250298,MATH 20E,A02,494080,Staff,28,0,30,2
1713302250298,MATH 20E,B01,494082,Staff,28,0,30,2
1713302250298,MATH 20E,B02,494083,Staff,25,0,30,5
1713302251322,MATH 103A,A01,494085,Aliabadi Sr.; Mohsen,22,0,30,8
1713302251322,MATH 103A,A02,494086,Aliabadi Sr.; Mohsen,29,0,30,1
1713302251322,MATH 103A,B01,494088,Aliabadi Sr.; Mohsen,22,0,30,8
1713302251322,MATH 103A,B02,494089,Aliabadi Sr.; Mohsen,28,0,30,2
1713302252352,MATH 109,A01,494091,Staff,30,0,30,0
1713302252352,MATH 109,A02,494092,Staff,30,0,30,0
1713302252352,MATH 109,B01,494094,Staff,28,0,30,2
1713302252352,MATH 109,B02,494095,Staff,29,0,30,1
1713302253382,MATH 142A,A01,494097,Chow; Bennett,17,0,30,13
1713302253382,MATH 142A,A02,494098,Chow; Bennett,26,0,30,4
1713302253382,MATH 142A,B01,494100,Chow; Bennett,23,0,30,7
1713302253382,MATH 142A,B02,494101,Chow; Bennett,29,0,30,1
1713302255445,MATH 168A,A01,516677,Dumitriu; Ioana,17,0,35,18
1713302256476,MATH 170A,A01,516679,Dumitriu; Ioana,23,0,30,7
1713302256476,MATH 170A,A02,516680,Dumitriu; Ioana,28,0,30,2
1713302257509,MATH 193A,A01,494107,Staff,19,0,30,11
1713302257509,MATH 193A,A02,494108,Staff,26,0,30,4
1713302257509,MATH 193A,A03,494109,Staff,29,0,30,1
1713302257509,MATH 193A,A04,494110,Staff,27,0,30,3
1713302260586,MGT 16,A00,491930,McKay; Michael J,94,0,98,4
1713302261614,MGT 18,A00,491992,McKay; Michael J,97,0,98,1
1713302262639,MGT 71,A00,492003,Staff,79,0,98,19
1713302263667,MGT 103,A00,505209,Eberhard; Craig A,88,0,98,10
1713302264696,MGT 131A,A00,505210,Anderson; John Charles,91,0,98,7
1713302266751,MGT 153,A00,492077,Perols; Johan Lars,56,0,90,34
1713302269831,MGT 164,A00,492222,McKay; Mary A,94,0,98,4
1713302270856,MGT 172,A00,492245,Staff,59,0,60,1
1713302270856,MGT 172,B00,505526,Hedges; Kathleen,82,0,98,16
1713302271881,MGT 181,A00,505669,Dunn; Louis Jean,89,0,98,9
1713302272910,MMW 14,A01,494399,Staff,25,0,28,3
1713302272910,MMW 14,A02,494400,Staff,27,0,28,1
1713302272910,MMW 14,A03,494401,Staff,28,0,28,0
1713302272910,MMW 14,A04,494402,Staff,28,0,28,0
1713302272910,MMW 14,B01,494404,Carreras; Maria Victoria,18,0,28,10
1713302272910,MMW 14,B02,494405,Carreras; Maria Victoria,27,0,28,1
1713302272910,MMW 14,B03,494406,Carreras; Maria Victoria,28,0,28,0
1713302272910,MMW 14,B04,494407,Carreras; Maria Victoria,28,0,28,0
1713302273940,MMW 14GS,A00,506250,Chang; Edmond Yi-Teh,0,0,0,0
1713302274967,MMW 121R,A01,494415,Adamiak; Patrick John,16,0,28,12
1713302274967,MMW 121R,A02,494416,Adamiak; Patrick John,26,0,28,2
1713302275996,MUS 1A,A01,494113,Staff,14,0,25,11
1713302275996,MUS 1A,A02,494114,Staff,25,0,25,0
1713302277021,MUS 4,A01,494116,Staff,24,0,25,1
1713302277021,MUS 4,A02,494117,Staff,22,0,25,3
1713302278051,MUS 5R,A01,494236,Dubnov; Shlomo,14,0,25,11
1713302278051,MUS 5R,A02,494237,Dubnov; Shlomo,25,0,25,0
1713302279076,MUS 6,A01,494122,Staff,17,0,25,8
1713302279076,MUS 6,A02,494123,Staff,24,0,25,1
1713302280102,MUS 7,A01,494125,Staff,20,0,25,5
1713302280102,MUS 7,A02,494126,Staff,24,0,25,1
1713302281133,MUS 11,A01,494128,Staff,23,0,25,2
1713302281133,MUS 11,A02,494129,Staff,25,0,25,0
1713302282159,MUS 13,A01,494131,Staff,25,0,25,0
1713302282159,MUS 13,A02,494132,Staff,25,0,25,0
1713302283183,MUS 15,A01,494134,Staff,21,0,25,4
1713302283183,MUS 15,A02,494135,Staff,25,0,25,0
1713302283183,MUS 15,B01,494137,Staff,25,0,25,0
1713302284213,MUS 80,A00,494232,Staff,25,0,25,0
1713302284213,MUS 80,B00,494233,Staff,25,0,25,0
1713302284213,MUS 80,C00,494234,Staff,23,0,25,2
1713302285237,MUS 95C,A00,494141,Staff,73,0,75,2
1713302286263,MUS 114,A00,494142,Staff,42,0,50,8
1713302287296,NANO 15,A01,490636,Drews; Aaron,7,0,7,0
1713302288324,PHIL 1,A00,490578,Grush; Rick Scott,50,0,50,0
1713302289352,PHIL 10,A01,490580,Grush; Rick Scott,34,0,35,1
1713302289352,PHIL 10,A02,490586,Grush; Rick Scott,33,0,35,2
1713302290382,PHIL 27,A01,490591,Staff,24,0,25,1
1713302290382,PHIL 27,A02,490592,Staff,25,0,25,0
1713302290382,PHIL 27,A03,490593,Staff,25,0,25,0
1713302290382,PHIL 27,A04,490598,Staff,25,0,25,0
1713302291407,PHIL 32,A01,490611,Staff,20,0,20,0
1713302291407,PHIL 32,A02,490618,Staff,20,0,20,0
1713302292433,PHIL 90,A00,490624,Staff,40,0,40,0
1713302293464,PHIL 136,A00,490627,Cohen; Jonathan David,38,0,40,2
1713302294493,PHIL 155,A00,490634,Staff,67,0,70,3
1713302295522,PHYS 1A,A00,491610,Staff,246,0,250,4
1713302296547,PHYS 1AL,001,491616,Tsai; Philbert S,28,0,30,2
1713302296547,PHYS 1AL,002,491618,Tsai; Philbert S,30,0,30,0
1713302297577,PHYS 1B,A00,491623,Staff,245,0,250,5
1713302298603,PHYS 1BL,001,491626,Tsai; Philbert S,27,0,30,3
1713302298603,PHYS 1BL,002,491628,Tsai; Philbert S,28,0,30,2
1713302299640,PHYS 1C,A00,491632,Staff,228,0,245,17
1713302300665,PHYS 1CL,001,491635,Tsai; Philbert S,12,0,30,18
1713302300665,PHYS 1CL,002,491643,Tsai; Philbert S,26,0,30,4
1713302301694,PHYS 2AR,A01,491651,Meyertholen; Andrew D.,46,0,50,4
1713302302720,PHYS 2B,A01,491659,Staff,107,0,115,8
1713302303746,PHYS 2BL,A01,491685,Staff,24,0,24,0
1713302303746,PHYS 2BL,A02,491700,Staff,23,0,24,1
1713302304775,PHYS 2C,A01,505161,Staff,109,0,115,6
1713302305801,PHYS 4A,A01,491704,Grinstein; Benjamin,100,0,100,0
1713302306827,POLI 5D,A01,494144,Staff,3,0,5,2
1713302306827,POLI 5D,B01,626283,Dai; Yinlin,5,0,5,0
1713302307854,POLI 12,A00,494145,Staff,44,0,45,1
1713302308886,POLI 13R,A00,494146,Forman; Fonna,47,0,50,3
1713302309914,POLI 27,A01,494148,Staff,60,0,60,0
1713302310939,POLI 30,A00,494149,Staff,49,0,50,1
1713302311968,POLI 100DA,A00,494150,Staff,23,0,25,2
1713302314080,POLI 100I,A00,494152,Staff,29,0,30,1
1713302315104,POLI 104B,A00,494153,Smith; Glenn Chatmas,54,0,55,1
1713302316132,POLI 104F,A00,494154,Staff,29,0,30,1
1713302317158,POLI 104I,A00,494155,Smith; Glenn Chatmas,30,0,30,0
1713302318185,POLI 110C,A00,494156,Ingham; Sean,23,0,25,2
1713302319210,POLI 117R,A00,494157,Forman; Fonna,17,0,20,3
1713302320240,POLI 118,A00,494158,Ingham; Sean,23,0,25,2
1713302321266,POLI 120H,A00,494159,Fisk; David Lee,42,0,45,3
1713302322292,POLI 131CR,A00,494160,Hoston; Germaine,43,0,45,2
1713302323318,POLI 133J,A00,494161,Staff,33,0,35,2
1713302324343,POLI 135,A00,494162,Fisk; David Lee,34,0,35,1
1713302325368,POLI 140A,A00,494164,Staff,23,0,30,7
1713302326392,POLI 142I,A00,494165,Staff,30,0,30,0
1713302327417,POLI 144D,A00,494166,Staff,23,0,25,2
1713302328443,POLI 151,A00,494167,Staff,30,0,30,0
1713302329468,POLI 153,A00,494168,Staff,34,0,35,1
1713302330498,POLI 160AA,A00,494169,Staff,36,0,40,4
1713302331523,POLI 162,A00,494170,Mignozzetti; Umberto,22,0,25,3
1713302332548,POLI 171,A00,494171,Mignozzetti; Umberto,23,0,25,2
1713302333577,PSYC 1,A00,494172,Staff,97,0,100,3
1713302334601,PSYC 2,A00,494173,Moranton; Nirelia Melbina-,48,0,50,2
1713302335630,PSYC 3,A00,494174,Staff,30,0,30,0
1713302336655,PSYC 6,A00,494175,Staff,17,0,20,3
1713302337679,PSYC 60,A01,494177,Staff,44,0,45,1
1713302338705,PSYC 70,A01,505724,Geller; Emma Harlan,42,0,45,3
1713302339731,PSYC 101,A00,494180,Heyman; Gail D.,93,0,100,7
1713302340760,PSYC 105,A00,494181,Geller; Emma Harlan,70,0,90,20
1713302341788,PSYC 106,A00,494182,Dobkins; Karen R.,34,0,45,11
1713302342817,PSYC 108,A00,494183,Adrian; Julia Anna,94,0,100,6
1713302343842,PSYC 114,A01,494185,Winkielman; Piotr,8,0,30,22
1713302344865,PSYC 122,A00,494186,Moranton; Nirelia Melbina-,41,0,50,9
1713302345895,PSYC 124,A00,494187,Chapman; Eddie Nathaniel,74,0,80,6
1713302346920,PSYC 131,A00,494188,Anagnostaras; Stephan,64,0,80,16
1713302347949,PSYC 144,A00,494189,Staff,24,0,50,26
1713302348974,PSYC 154,A00,494190,Lacefield; Katharine I,145,0,180,35
1713302349999,PSYC 162,A00,494191,Wixted; John T,92,0,100,8
1713302351024,PSYC 172,A00,494192,Gorman; Michael R.,38,0,45,7
1713302352051,PSYC 178,A00,494193,Glaser; Dale,41,0,45,4
1713302353079,PSYC 193,A00,505725,Chapman; Eddie Nathaniel,20,0,20,0
1713302354105,RELI 145GS,A00,519817,Rahimi; Babak,19,0,20,1
1713302355138,SE 101A,A01,490862,Chadha; Mayank,25,0,25,0
1713302356169,SE 101C,A01,490924,Krysl; Petr,18,0,20,2
1713302357195,SE 110A,A01,490928,Staff,20,0,20,0
1713302358222,SE 130A,A00,490929,Morrison; Machel Leigh,66,0,70,4
1713302359247,SIO 1,A01,519325,Staff,39,0,40,1
1713302360271,SIO 30,A01,519327,Staff,40,0,40,0
1713302361299,SIO 40,A00,519328,Staff,40,0,40,0
1713302362327,SIO 46GS,A00,519819,Cook; Geoffrey W,19,0,25,6
1713302363352,SIO 109R,A00,494197,Forman; Fonna,11,0,20,9
1713302364377,SIO 121GS,A00,519827,Cook; Geoffrey W,19,0,25,6
1713302365404,SIO 132,A01,519330,Staff,38,0,40,2
1713302366435,SIO 133,A01,519397,Staff,40,0,40,0
1713302367463,SIO 139,A00,519396,Kacev; David,35,0,40,5
1713302368489,SOCI 1,A01,494199,Thorpe; Charles Robert,24,0,30,6
1713302368489,SOCI 1,A02,494200,Thorpe; Charles Robert,30,0,30,0
1713302368489,SOCI 1,A03,494201,Thorpe; Charles Robert,30,0,30,0
1713302368489,SOCI 1,A04,494202,Thorpe; Charles Robert,29,0,30,1
1713302368489,SOCI 1,A05,494203,Thorpe; Charles Robert,30,0,30,0
1713302368489,SOCI 1,A06,494204,Thorpe; Charles Robert,30,0,30,0
1713302368489,SOCI 1,A07,494205,Thorpe; Charles Robert,29,0,30,1
1713302369518,SOCI 60,A01,494207,Staff,36,0,40,4
1713302369518,SOCI 60,A02,494208,Staff,39,0,40,1
1713302370543,SOCI 100,A01,494210,Payne; Christine Anna,28,0,30,2
1713302370543,SOCI 100,A02,494211,Payne; Christine Anna,28,0,30,2
1713302371574,SOCI 109M,A00,494212,Staff,20,0,20,0
1713302372603,SOCI 110,A00,494213,Staff,36,0,40,4
1713302374657,SOCI 118E,A00,494215,Ng; Kwai,39,0,40,1
1713302375686,SOCI 125,A00,494216,Calderon-Zaks; Michael Aar,43,0,45,2
1713302376711,SOCI 126,A01,494218,Jones; Makeba,4,0,5,1
1713302377739,SOCI 131,A00,494219,Thorpe; Charles Robert,30,0,30,0
1713302379790,SOCI 135,A00,494221,Payne; Christine Anna,44,0,50,6
1713302380816,SOCI 136E,A00,626690,Ruiz; Jonathan Joseph,25,0,25,0
1713302381846,SOCI 138GS,A00,494222,Navon; Daniel,24,0,28,4
1713302383899,SOCI 145,A00,494224,Staff,44,0,45,1
1713302384930,SOCI 153,A00,494225,Staff,28,0,30,2
1713302385954,SOCI 160E,A00,494226,Ng; Kwai,34,0,40,6
1713302386984,SOCI 180,A00,494227,Staff,29,0,30,1
1713302388010,SOCI 189GS,A00,494228,Ribas Norris; Janet Vanesa,11,0,11,0
1713302389039,SOCI 190GS,A00,553232,Ribas Norris; Janet Vanesa,11,0,11,0
1713302390064,SYN 2,001,490768,Staff,14,0,15,1
1713302390064,SYN 2,002,490769,Staff,15,0,15,0
1713302390064,SYN 2,004,490775,Staff,0,0,0,0
1713302390064,SYN 2,003,490774,Staff,0,0,0,0
1713302390064,SYN 2,005,490776,Staff,0,0,0,0
1713302391092,SYN 2R,001,490779,Staff,14,0,15,1
1713302391092,SYN 2R,002,514635,Staff,14,0,15,1
1713302392117,SYN 100,A01,490783,Staff,17,0,20,3
1713302392117,SYN 100,B01,490787,Staff,13,0,20,7
1713302392117,SYN 100,C01,490789,Staff,15,0,20,5
1713302393142,SYN 150,A00,490817,Staff,14,0,15,1
1713302393142,SYN 150,B00,514610,Staff,15,0,15,0
1713302394170,TDAC 1,A00,492753,Walsh; Kim C.,19,0,20,1
1713302394170,TDAC 1,B00,492754,Harting; Carla Kelso,19,0,20,1
1713302394170,TDAC 1,C00,513995,Salovey; Todd,18,0,20,2
1713302395200,TDAC 101,A00,492766,Harting; Carla Kelso,19,0,20,1
1713302396226,TDAC 102,A00,492768,Basso; Beatrice,20,0,20,0
1713302397256,TDDE 111,A00,492769,Staff,25,0,25,0
1713302398286,TDDE 131,A00,492770,Staff,15,0,15,0
1713302398286,TDDE 131,B00,492771,Staff,15,0,15,0
1713302399312,TDDE 131GS,A00,523716,Guirguis; Mark C,25,0,28,3
1713302400349,TDGE 1,A01,492756,Salovey; Todd,58,0,60,2
1713302401375,TDGE 5,A01,492758,Staff,24,0,25,1
1713302402408,TDGE 10,A00,492759,Fulton; Julia,216,0,220,4
1713302403437,TDGE 11,A00,492760,Castro; Robert Jess,200,0,200,0
1713302404508,TDGE 50,A00,492761,Blair; Kyle Adam,0,0,0,0
1713302405536,TDGE 124,A00,492772,Fulton; Julia,202,0,220,18
1713302406567,TDGE 125,A00,492773,Meyer; Ursula,43,0,50,7
1713302406567,TDGE 125,B00,492774,Staff,50,0,50,0
1713302406567,TDGE 125,C00,523565,Staff,50,0,50,0
1713302407594,TDGE 125GS,A00,523580,Guirguis; Mark C,25,0,28,3
1713302408621,TDGE 127,A00,492775,Havis; Allan,45,0,50,5
1713302409645,TDHT 101,A00,492776,Staff,35,0,35,0
1713302410676,TDMV 1,A00,492762,Caligagan; Maria T.,30,0,30,0
1713302410676,TDMV 1,B00,492763,Arcidiacono; Kristin,26,0,30,4
1713302411703,TDMV 2,A00,492764,Weinberg; Sadie,29,0,30,1
1713302412729,TDMV 3,A00,492765,Mack; Kara Shanai',40,0,40,0
1713302413758,TDMV 138,A00,492777,Mack; Kara Shanai',37,0,40,3
1713302414783,TDMV 140,A00,492778,Lima; Paulo Henrique,40,0,40,0
1713302415808,TDMV 142,A00,492779,Caligagan; Maria T.,37,0,40,3
1713302415808,TDMV 142,B00,492780,Caligagan; Tony,38,0,40,2
1713302416886,TDMV 143,A00,492781,Fyall; Daunte Edward,40,0,40,0
1713302417924,USP 1,A01,492401,Kwak; Nancy,30,0,35,5
1713302418953,USP 2,A01,492453,Hinds; Juli Beth,35,0,35,0
1713302419978,USP 3,A01,492516,Staff,32,0,35,3
1713302421003,USP 4,A00,492522,McTague; Sarah,22,0,25,3
1713302422042,USP 100,A00,492523,Staff,33,0,35,2
1713302423072,USP 101,A00,492524,Staff,13,0,15,2
1713302424095,USP 105,A00,492525,Staff,22,0,25,3
1713302425125,USP 151,A00,492526,Shenkman; Michael Thomas,33,0,35,2
1713302426154,USP 170,A00,492545,Hinds; Juli Beth,33,0,35,2
1713302427182,USP 171GS,A00,492608,Bussell; Mirle Rabinowitz,26,0,28,2
1713302428212,USP 183GS,A00,492613,Peerson; Susan,26,0,28,2
1713302429237,VIS 30,A01,490693,Yoldas; Pinar,21,0,22,1
1713302429237,VIS 30,A02,490694,Yoldas; Pinar,19,0,22,3
1713302430263,VIS 83,A00,490695,Kester; Grant,68,0,75,7
1713302431290,VIS 105D,A00,490696,Staff,22,0,25,3
1713302432316,VIS 124CN,A00,490699,Rose; Jordan M,68,0,75,7
1713302433340,VIS 125GS,A00,511221,Williams; Alena J,21,0,22,1
1713302434364,VIS 128D,A00,490700,Staff,74,0,75,1
1713302435389,VIS 151,A01,490717,Staff,34,0,34,0
1713302435389,VIS 151,A02,490766,Staff,33,0,34,1
1713302436414,VIS 154GS,A00,511972,Williams; Alena J,21,0,22,1
1713302437440,VIS 160A,A00,490767,Stone; Patricia,7,0,10,3
1713302438467,WCWP 10A,A00,490638,Staff,15,0,15,0
1713302438467,WCWP 10A,B00,490640,Staff,15,0,15,0
1713302439494,WCWP 10B,A00,490641,Staff,0,0,0,0
1713302439494,WCWP 10B,B00,490642,Staff,14,0,15,1
1713302439494,WCWP 10B,C00,490644,Staff,14,0,15,1
1713302439494,WCWP 10B,D00,490647,Staff,0,0,0,0
1713302440522,WCWP 100,A00,490655,Staff,0,0,0,0
1713302440522,WCWP 100,B00,490687,Staff,12,0,15,3
1713302442617,ANAR 153,A00,487222,Braswell; Geoffrey E.,55,0,60,5
1713302443642,ANBI 134,A00,487223,Staff,15,0,20,5
1713302444669,ANBI 143GS,A00,487224,Noel; Geoffroy Pierre Jean,23,0,24,1
1713302445694,ANBI 144GS,A00,519548,Noel; Geoffroy Pierre Jean,23,0,24,1
1713302446724,ANSC 101,A00,487225,Staff,19,0,20,1
1713302447749,ANSC 125,A00,487227,Brenner; Suzanne A,40,0,40,0
1713302449800,ANSC 146,A00,487229,Staff,37,0,40,3
1713302450826,ANSC 148,A00,487230,Olivas Hernandez; Olga Lid,39,0,40,1
1713302451854,ANSC 150,A00,504165,Sloane; Julia Kathryn,19,0,20,1
1713302452883,ANSC 180,A00,487232,Staff,13,0,15,2
1713302453911,ANTH 5,A00,519529,Semendeferi; Ekaterini,15,0,15,0
1713302454941,ANTH 10,A00,487219,Staff,58,0,60,2
1713302455967,ANTH 23,A01,487221,Staff,19,0,20,1
1713302456992,ANTH 102,A00,487233,Wilder; Linnea Lorene,54,0,60,6
1713302458018,ANTH 103,A00,487234,Varma; Saiba,57,0,60,3
1713302459048,ANTH 105,A00,487235,Stewart; Alexander B,57,0,60,3
1713302460071,BENG 100,A01,516685,Taylor Amos; Alyssa C,28,0,30,2
1713302461099,BIBC 102,A01,491316,Flagg; Matthew Paul,62,0,88,26
1713302461099,BIBC 102,A02,491366,Flagg; Matthew Paul,84,0,88,4
1713302462125,BIBC 103,A01,491486,Boumechache; Miyyada,17,0,24,7
1713302462125,BIBC 103,A02,491487,Boumechache; Miyyada,24,0,24,0
1713302463159,BICD 100,A01,516882,Staff,75,0,75,0
1713302463159,BICD 100,A02,516890,Staff,71,0,75,4
1713302464184,BICD 102GS,A00,491488,Lo; Stanley M.,27,0,28,1
1713302465213,BIEB 136GS,A00,516940,Holway; David A. & Shurin; Jonathan,20,0,24,4
1713302466241,BIEB 137GS,A01,517034,Holway; David A. & Shurin; Jonathan,20,0,24,4
1713302467273,BIEB 138GS,A01,491492,Pirino; Giorgia,22,0,28,6
1713302468298,BILD 1,A01,491296,Staff,62,0,63,1
1713302468298,BILD 1,A02,491297,Staff,63,0,63,0
1713302469328,BILD 4,A01,517099,Gonzalez Gamboa; Ivonne,23,0,24,1
1713302469328,BILD 4,A02,517100,Gonzalez Gamboa; Ivonne,24,0,24,0
1713302470352,BILD 60GS,A00,491309,Lo; Stanley M.,27,0,28,1
1713302471384,BIMM 100,A01,517136,Staff,95,0,100,5
1713302472416,BIMM 110,A01,517182,Staff,80,0,100,20
1713302473442,BIMM 120,A01,517228,Pickett; Brooke Elizabeth,43,0,63,20
1713302473442,BIMM 120,A02,517240,Pickett; Brooke Elizabeth,49,0,63,14
1713302474471,BIMM 132GS,A01,491498,Pirino; Giorgia,22,0,28,6
1713302475501,BIMM 143,A01,491589,Bozinovic; Goran,21,0,40,19
1713302476527,BIPN 100,A01,491594,Armour; Jon Christopher,93,0,100,7
1713302477557,BIPN 140,A01,491602,Marino; Marc J,34,0,50,16
1713302479612,CAT 125,A00,515973,Staff,20,0,20,0
1713302480642,CAT 125GS,A00,515974,Rahimi; Babak,20,0,20,0
1713302481669,CAT 125R,A00,515980,Staff,15,0,20,5
1713302481669,CAT 125R,B00,515981,Tosun; Adriana,19,0,20,1
1713302481669,CAT 125R,C00,515987,Hyland; Tina Mae,7,0,20,13
1713302481669,CAT 125R,D00,515988,Bronstein; Phoebe Malan,19,0,20,1
1713302482695,CENG 15,A01,488699,Drews; Aaron,25,0,25,0
1713302483720,CENG 100,A00,505196,Opatkiewicz; Justin Paul,25,0,25,0
1713302484750,CGS 2A,A01,489598,Staff,33,0,35,2
1713302485774,CGS 112,A00,489599,Staff,15,0,15,0
1713302486800,CGS 119,A00,489603,Staff,10,0,10,0
1713302487825,CGS 120,A00,489604,Staff,14,0,15,1
1713302488850,CGS 150,A00,489607,Staff,15,0,15,0
1713302489874,CHEM 6A,A01,488715,Staff,98,0,100,2
1713302490898,CHEM 6B,A01,488719,Piercy; Marc Anthony,100,0,100,0
1713302491923,CHEM 6C,A01,488723,Albizati; Kim F.,94,0,100,6
1713302492958,CHEM 7L,A01,488728,Schurmeier; Kimberly,18,0,24,6
1713302492958,CHEM 7L,A02,488730,Schurmeier; Kimberly,23,0,24,1
1713302492958,CHEM 7L,A03,488734,Schurmeier; Kimberly,24,0,24,0
1713302492958,CHEM 7L,A04,488763,Schurmeier; Kimberly,23,0,24,1
1713302492958,CHEM 7L,B01,488798,Schurmeier; Kimberly,18,0,24,6
1713302492958,CHEM 7L,B02,488801,Schurmeier; Kimberly,24,0,24,0
1713302492958,CHEM 7L,B03,488808,Schurmeier; Kimberly,24,0,24,0
1713302492958,CHEM 7L,B04,488811,Schurmeier; Kimberly,24,0,24,0
1713302493984,CHEM 11,A01,488897,Stallings; Dontarie M,98,0,100,2
1713302495009,CHEM 40A,A01,488913,Albizati; Kim F.,93,0,100,7
1713302496036,CHEM 40B,A01,488920,Weizman; Haim,48,0,50,2
1713302496036,CHEM 40B,A02,488938,Weizman; Haim,47,0,50,3
1713302497064,CHEM 41A,A01,489029,Klosterman; Jeremy K,58,0,60,2
1713302498089,CHEM 41C,A01,500436,Tor; Yitzhak,56,0,60,4
1713302499115,CHEM 43A,A01,500426,Weizman; Haim,7,0,24,17
1713302499115,CHEM 43A,A02,500430,Weizman; Haim,16,0,24,8
1713302499115,CHEM 43A,B01,514041,Klosterman; Jeremy K,18,0,24,6
1713302499115,CHEM 43A,B02,514047,Klosterman; Jeremy K,23,0,24,1
1713302500141,CHEM 108,A01,489140,Jennings; Patricia A.,15,0,24,9
1713302500141,CHEM 108,A02,489142,Jennings; Patricia A.,18,0,24,6
1713302501167,CHEM 114A,A01,489147,Stallings; Dontarie M,82,0,100,18
1713302502196,CHIN 169A,A00,489171,Wang; Xiao,19,0,20,1
1713302504250,COGS 3,A01,518827,Boyle; Mary E. T.,31,0,40,9
1713302505276,COGS 11,A01,489175,Staff,28,0,30,2
1713302506302,COGS 14A,A01,518829,Staff,56,0,60,4
1713302507327,COGS 14B,A01,489177,Hoffman; Drew Ellen,69,0,75,6
1713302508353,COGS 100,A01,489181,Allen; Michael Gordon,68,0,75,7
1713302509378,COGS 101A,A01,489183,Staff,52,0,60,8
1713302510407,COGS 101B,A01,489185,Allen; Michael Gordon,15,0,30,15
1713302511433,COGS 101C,A01,526786,Staff,25,0,30,5
1713302513487,COGS 107A,A01,489189,Boyle; Mary E. T.,26,0,35,9
1713302514510,COGS 107B,A01,627144,Mooshagian; Eric Frederick,60,0,60,0
1713302515535,COGS 118A,A01,489191,Staff,0,21,40,40
1713302517589,COGS 171GS,A01,489194,Pineda; Jaime A,22,0,28,6
1713302518620,COGS 172,A01,489196,Staff,9,0,30,21
1713302519646,COGS 174GS,A01,489264,Pineda; Jaime A,22,0,28,6
1713302520728,COGS 180,A01,627150,Staff,29,0,30,1
1713302521752,COGS 186,A01,489274,Staff,5,0,30,25
1713302522777,COMM 10,A01,489276,Staff,25,0,25,0
1713302522777,COMM 10,A02,489303,Staff,23,0,25,2
1713302523803,COMM 100A,A01,489312,Staff,21,0,25,4
1713302523803,COMM 100A,A02,489313,Staff,24,0,25,1
1713302524830,COMM 106T,A00,512540,Staff,34,0,35,1
1713302525853,COMM 107,A00,489347,Staff,31,0,35,4
1713302526881,COMM 109P,A00,489358,Staff,31,0,35,4
1713302527912,COMM 132,A00,489361,McKenna; Denise,29,0,30,1
1713302528942,COMM 146,A00,489362,Halm; Gavin Patrick,27,0,30,3
1713302529969,COMM 190,A00,489363,Abuelhiga; Soraya Jill,21,0,23,2
1713302531001,CSE 8A,A50,489366,Staff,24,0,25,1
1713302531001,CSE 8A,A51,489367,Staff,24,0,25,1
1713302532029,CSE 11,A01,489398,Cao; Yingjun,87,0,100,13
1713302533055,CSE 12,A01,489487,Staff,43,0,50,7
1713302534079,CSE 20,A01,489497,Staff,49,0,50,1
1713302535108,CSE 21,A01,489517,Braun; Oliver,44,0,50,6
1713302536134,CSE 101,A01,489524,Braun; Oliver,2,0,50,48
1713302537160,CSE 105,A01,512594,Jones; Miles E,86,0,100,14
1713302537160,CSE 105,B01,512598,Jones; Miles E,74,0,100,26
1713302538187,CSE 140,A01,489538,Staff,45,0,50,5
1713302539213,CSE 141,A01,489550,Eldon; John,78,0,100,22
1713302540244,CSE 141L,A01,489571,Eldon; John,77,0,100,23
1713302541269,CSE 151A,A01,489583,Solares; Edwin A,157,0,200,43
1713302542302,CSE 175,A01,510886,Kumar; Rakesh,30,0,30,0
1713302543333,CSE 190,A00,516828,Dubnov; Shlomo,41,0,49,8
1713302544360,DOC 100D,A00,489667,Pass; Natalye Joann,23,0,25,2
1713302545386,DSC 10,A01,624268,Staff,72,0,75,3
1713302546412,DSC 20,A01,624476,Staff,50,0,50,0
1713302547439,DSC 40A,A01,624608,Staff,40,0,40,0
1713302548506,DSGN 1,A01,489179,Rill; Bryan,39,0,50,11
1713302549533,ECE 17,A01,490489,Sahay; Rajeev,21,0,30,9
1713302550562,ECE 65,A50,490492,Staff,17,0,20,3
1713302550562,ECE 65,A51,490493,Staff,20,0,20,0
1713302551594,ECON 1,A01,489715,Famulari; Melissa,69,0,70,1
1713302552621,ECON 2,A01,489717,Levkoff; Steven B.,69,0,70,1
1713302553648,ECON 3,A01,489948,Staff,70,0,70,0
1713302555699,ECON 5,A01,490103,Staff,28,0,30,2
1713302555699,ECON 5,B01,626281,Dai; Yinlin,45,0,45,0
1713302556725,ECON 100A,A01,490127,Famulari; Melissa,70,0,70,0
1713302557750,ECON 100B,A01,490129,Staff,64,0,70,6
1713302558774,ECON 109,A01,490187,Shishkin; Denis,29,0,35,6
1713302559832,ECON 110A,A01,490190,Levkoff; Steven B.,65,0,70,5
1713302560859,ECON 120A,A01,490245,Dai; Yinlin,69,0,70,1
1713302561883,ECON 120B,A01,490247,Nieto-Barthaburu; Augusto,61,0,70,9
1713302562914,ECON 120C,A01,490253,Sun; Yixiao,32,0,35,3
1713302562914,ECON 120C,B01,490255,Sun; Yixiao,34,0,35,1
1713302563941,ECON 129,A00,490256,Eckert; Fabian Paul,28,0,35,7
1713302564965,ECON 131,A00,490257,Nieto-Barthaburu; Augusto,7,0,35,28
1713302565992,ECON 138,A00,490258,Bharadwaj; Prashant,25,0,35,10
1713302565992,ECON 138,B00,490259,Bharadwaj; Prashant,21,0,35,14
1713302567018,ECON 159,A00,490260,Hendrickson; Gerald M.,0,6,0,0
1713302568043,ECON 178,A01,553995,Zhu; Ying,29,0,35,6
1713302569069,EDS 40,A01,512576,Black; Alison Michelle,20,0,20,0
1713302570099,EDS 107,A01,515848,Staff,30,0,30,0
1713302571125,EDS 110R,A01,490262,Staff,26,0,30,4
1713302572151,EDS 112,A01,490264,Chapman; Thandeka K,45,0,50,5
1713302573178,EDS 113,A00,490266,Staff,28,0,30,2
1713302574205,EDS 118,A00,490267,Warstadt; Melissa Fawn,27,0,30,3
1713302575235,EDS 124BR,A00,490268,Eguchi; Emi,10,0,25,15
1713302575235,EDS 124BR,B00,490269,Eguchi; Emi,25,0,25,0
1713302576260,EDS 126,A01,490271,Jones; Makeba,47,0,50,3
1713302577285,EDS 135,A01,490316,Staff,20,0,20,0
1713302578312,ENVR 142GS,A00,519514,Chang; Edmond Yi-Teh,28,0,28,0
1713302579337,ETHN 103,A00,490504,Staff,33,0,36,3
1713302580371,ETHN 103A,A00,490505,Man; Simeon S,7,0,9,2
1713302581396,ETHN 109,A00,490506,Staff,30,0,30,0
1713302582421,ETHN 118,A00,490507,Staff,35,0,36,1
1713302583444,ETHN 119,A00,490508,Staff,36,0,36,0
1713302584473,ETHN 121R,A00,490518,Choi; Esther Min,30,0,36,6
1713302585501,ETHN 127,A00,490528,Staff,15,0,15,0
1713302586529,ETHN 139,A00,490573,Staff,10,0,10,0
1713302587553,ETHN 150,A00,490575,Staff,15,0,15,0
1713302588579,GLBH 20,A00,491705,Elwardani; Nile Regina,38,0,40,2
1713302589605,GLBH 101,A00,491706,Staff,20,0,20,0
1713302590631,GLBH 111,A01,491708,Burgos; Jose L.,15,0,15,0
1713302591658,GLBH 146,A00,491709,Staff,15,0,20,5
1713302592684,GLBH 148,A00,491710,Olivas Hernandez; Olga Lid,17,0,20,3
1713302593710,GLBH 150,A00,491711,Sloane; Julia Kathryn,20,0,20,0
1713302594739,HIEA 131,A00,491760,Staff,30,0,32,2
1713302595770,HIEA 153,A00,491762,Staff,29,0,30,1
1713302596810,HIEU 124,A00,491811,Staff,29,0,32,3
1713302597837,HIEU 124GS,A00,491812,Markman; Kristina,28,0,28,0
1713302598865,HIEU 147,A00,491813,Staff,31,0,32,1
1713302599893,HIEU 149GS,A00,491816,Caldwell; Michael Alan,28,0,28,0
1713302600920,HILD 2C,A01,491713,Hendrickson; Gerald M.,28,0,30,2
1713302601949,HILD 7B,A01,491715,Kwak; Nancy,17,0,30,13
1713302602974,HILD 10,A01,491717,Staff,16,0,20,4
1713302604002,HILD 30GS,A00,491719,Edington; Claire Ellen,24,0,28,4
1713302605026,HINE 109,A00,491818,Shafir; Nir,31,0,32,1
1713302606054,HINE 128,A00,491821,Shafir; Nir,32,0,32,0
1713302607084,HISC 117,A00,491830,Staff,29,0,32,3
1713302608113,HIUS 103,A00,491834,Man; Simeon S,18,0,23,5
1713302609141,HIUS 108B,A00,491835,Staff,30,0,30,0
1713302610166,HIUS 141,A00,491836,Hendrickson; Gerald M.,29,0,32,3
1713302611194,HIUS 149,A00,491839,Staff,28,0,32,4
1713302612220,HUM 3,A01,512617,Crum; Matthew Stephen,46,0,50,4
1713302612220,HUM 3,A02,512618,Crum; Matthew Stephen,49,0,50,1
1713302613247,HUM 3GS,A00,512663,Markman; Kristina,0,0,0,0
1713302613247,HUM 3GS,B00,512664,Staff,0,0,0,0
1713302614276,HUM 4,A01,512620,West; Geoffrey Scott,39,0,50,11
1713302615304,HUM 4GS,A00,512666,Lyon; Antony J.,0,0,0,3
1713302616334,HUM 4R,A01,512625,Watkins; Eric,49,0,50,1
1713302617364,HUM 5,A01,512649,Zavodny; Tatiana Sophia,35,0,50,15
1713302617364,HUM 5,B01,512661,Zroka; Ryan Edward,49,0,50,1
1713302618388,INTL 190,A00,490577,Segui; Alan S,0,0,0,5
1713302619418,JAPN 20AR,A01,491267,Ross; Kayoko F,12,0,20,8
1713302620444,JAPN 180,A00,491285,Berman; Michael David,35,0,40,5
1713302621468,LATI 50,A01,502536,Kokinis; Troy Andreas,19,0,22,3
1713302621468,LATI 50,A02,502551,Kokinis; Troy Andreas,22,0,22,0
1713302621468,LATI 50,A03,502650,Kokinis; Troy Andreas,22,0,22,0
1713302621468,LATI 50,A04,502909,Kokinis; Troy Andreas,22,0,22,0
1713302622493,LATI 160,A01,502920,Kokinis; Troy Andreas,30,0,30,0
1713302623521,LIFR 1A,A00,490494,Van Moer; Vinciane G,18,0,20,2
1713302624602,LIFR 1AX,A00,490495,Van Moer; Vinciane G,18,0,20,2
1713302625628,LIFR 1B,A00,490496,Van Moer; Vinciane G,20,0,20,0
1713302626653,LIFR 1BX,A00,490497,Van Moer; Vinciane G,20,0,20,0
1713302627679,LIGN 8,A00,505198,McIntosh; Justin Daniel,144,0,150,6
1713302628705,LIGN 9GS,A00,491239,Lott; Margaret S.,18,0,20,2
1713302629728,LIGN 101,A01,505200,McIntosh; Justin Daniel,26,0,30,4
1713302630754,LIGN 120,A01,491244,Staff,26,0,30,4
1713302631781,LIGN 149GS,A00,491245,Lott; Margaret S.,18,0,20,2
1713302632810,LIGN 170,A00,491247,Staff,25,0,30,5
1713302633835,LISP 1D,A00,490498,Munoz Sanchez; Alicia,12,0,14,2
1713302633835,LISP 1D,B00,490499,Munoz Sanchez; Alicia,8,0,14,6
1713302633835,LISP 1D,C00,490500,Munoz Sanchez; Alicia,10,0,14,4
1713302633835,LISP 1D,D00,490501,Munoz Sanchez; Alicia,11,0,14,3
1713302634864,LISP 1DX,A00,490502,Munoz Sanchez; Alicia,21,0,28,7
1713302634864,LISP 1DX,B00,490503,Munoz Sanchez; Alicia,19,0,28,9
1713302636915,LTAM 110,A00,491847,Staff,23,0,25,2
1713302637944,LTCS 119,A00,491848,Staff,13,0,15,2
1713302638973,LTCS 130,A00,491849,Staff,24,0,25,1
1713302641022,LTEA 120C,A00,491852,Staff,35,0,40,5
1713302642049,LTEN 130GS,A00,491853,Lyon; Antony J.,25,0,28,3
1713302643076,LTEN 148,A00,491855,Staff,23,0,25,2
1713302644107,LTEN 159,A00,491856,Staff,21,0,25,4
1713302645132,LTEN 180,A00,491857,Staff,11,0,15,4
1713302647185,LTSP 123GS,A00,505928,Bessett; Ryan Matthew,25,0,28,3
1713302648214,LTSP 174GS,A00,506037,Bessett; Ryan Matthew,25,0,28,3
1713302650272,LTWR 102,A00,491861,Staff,12,0,15,3
1713302651296,LTWR 106,A00,491862,Staff,11,0,15,4
1713302652321,MAE 11,A00,490930,Bahadori; Mohammad Yousef,98,0,100,2
1713302653356,MAE 30A,A00,490931,Qi; Huihui,38,0,40,2
1713302654382,MAE 101A,A00,491036,Sadeghizadeh; Zahra,98,0,100,2
1713302655410,MAE 101C,A00,491037,Seshadri; Kalyanasundaram,78,0,100,22
1713302656439,MAE 113,A00,491040,Seshadri; Kalyanasundaram,67,0,80,13
1713302657465,MAE 131A,A00,491041,Ghazinejad; Maziar,39,0,40,1
1713302658493,MAE 142,A00,491053,Staff,39,0,40,1
1713302659520,MAE 143A,A00,491054,Staff,43,0,50,7
1713302660546,MAE 150,A00,491092,Truong; Phuong Thi Ngoc,25,0,35,10
1713302661574,MATH 3C,A01,494031,Pardo Guerra; Sebastian,30,0,30,0
1713302661574,MATH 3C,A02,494032,Pardo Guerra; Sebastian,29,0,30,1
1713302662604,MATH 10A,A01,494034,Staff,29,0,30,1
1713302662604,MATH 10A,A02,494035,Staff,29,0,30,1
1713302662604,MATH 10A,B01,494037,Staff,28,0,30,2
1713302662604,MATH 10A,B02,494038,Staff,29,0,30,1
1713302663638,MATH 10B,A01,494040,Habib; Yousaf,24,0,30,6
1713302663638,MATH 10B,A02,494041,Habib; Yousaf,28,0,30,2
1713302663638,MATH 10B,A03,494042,Habib; Yousaf,30,0,30,0
1713302663638,MATH 10B,A04,494043,Habib; Yousaf,30,0,30,0
1713302663638,MATH 10B,B01,494045,Habib; Yousaf,28,0,30,2
1713302663638,MATH 10B,B02,494046,Habib; Yousaf,30,0,30,0
1713302663638,MATH 10B,B03,494047,Habib; Yousaf,30,0,30,0
1713302663638,MATH 10B,B04,494048,Habib; Yousaf,30,0,30,0
1713302664666,MATH 18,A01,494050,Kemp; Todd Aahron,29,0,30,1
1713302664666,MATH 18,A02,494051,Kemp; Todd Aahron,29,0,30,1
1713302664666,MATH 18,B01,494054,Kemp; Todd Aahron,28,0,30,2
1713302664666,MATH 18,B02,494055,Kemp; Todd Aahron,29,0,30,1
1713302665696,MATH 20A,A01,494059,Suk; Andrew Hoon,30,0,30,0
1713302666730,MATH 20B,A01,494061,Briones; Jor-el Thomas Caparas,34,0,35,1
1713302666730,MATH 20B,B01,494063,Bach; Quang Tran,35,0,35,0
1713302667757,MATH 20C,A01,494065,Staff,29,0,30,1
1713302667757,MATH 20C,A02,494066,Staff,30,0,30,0
1713302667757,MATH 20C,A03,494067,Staff,30,0,30,0
1713302667757,MATH 20C,A04,494068,Staff,30,0,30,0
1713302667757,MATH 20C,B01,494070,Zhang; Ming,27,0,30,3
1713302667757,MATH 20C,B02,494071,Zhang; Ming,30,0,30,0
1713302667757,MATH 20C,B03,494072,Zhang; Ming,29,0,30,1
1713302667757,MATH 20C,B04,494073,Zhang; Ming,29,0,30,1
1713302668785,MATH 20D,A01,494075,Staff,27,0,30,3
1713302668785,MATH 20D,A02,494076,Staff,30,0,30,0
1713302669811,MATH 20E,A01,494079,Staff,25,0,30,5
1713302669811,MATH 20E,A02,494080,Staff,28,0,30,2
1713302669811,MATH 20E,B01,494082,Staff,28,0,30,2
1713302669811,MATH 20E,B02,494083,Staff,25,0,30,5
1713302670841,MATH 103A,A01,494085,Aliabadi Sr.; Mohsen,22,0,30,8
1713302670841,MATH 103A,A02,494086,Aliabadi Sr.; Mohsen,29,0,30,1
1713302670841,MATH 103A,B01,494088,Aliabadi Sr.; Mohsen,22,0,30,8
1713302670841,MATH 103A,B02,494089,Aliabadi Sr.; Mohsen,28,0,30,2
1713302671873,MATH 109,A01,494091,Staff,30,0,30,0
1713302671873,MATH 109,A02,494092,Staff,30,0,30,0
1713302671873,MATH 109,B01,494094,Staff,28,0,30,2
1713302671873,MATH 109,B02,494095,Staff,29,0,30,1
1713302672904,MATH 142A,A01,494097,Chow; Bennett,17,0,30,13
1713302672904,MATH 142A,A02,494098,Chow; Bennett,26,0,30,4
1713302672904,MATH 142A,B01,494100,Chow; Bennett,23,0,30,7
1713302672904,MATH 142A,B02,494101,Chow; Bennett,29,0,30,1
1713302674960,MATH 168A,A01,516677,Dumitriu; Ioana,17,0,35,18
1713302675985,MATH 170A,A01,516679,Dumitriu; Ioana,23,0,30,7
1713302675985,MATH 170A,A02,516680,Dumitriu; Ioana,28,0,30,2
1713302677011,MATH 193A,A01,494107,Staff,19,0,30,11
1713302677011,MATH 193A,A02,494108,Staff,26,0,30,4
1713302677011,MATH 193A,A03,494109,Staff,29,0,30,1
1713302677011,MATH 193A,A04,494110,Staff,27,0,30,3
1713302680094,MGT 16,A00,491930,McKay; Michael J,94,0,98,4
1713302681121,MGT 18,A00,491992,McKay; Michael J,97,0,98,1
1713302682150,MGT 71,A00,492003,Staff,79,0,98,19
1713302683180,MGT 103,A00,505209,Eberhard; Craig A,88,0,98,10
1713302684205,MGT 131A,A00,505210,Anderson; John Charles,91,0,98,7
1713302686258,MGT 153,A00,492077,Perols; Johan Lars,55,0,90,35
1713302689336,MGT 164,A00,492222,McKay; Mary A,94,0,98,4
1713302690367,MGT 172,A00,492245,Staff,59,0,60,1
1713302690367,MGT 172,B00,505526,Hedges; Kathleen,82,0,98,16
1713302691393,MGT 181,A00,505669,Dunn; Louis Jean,89,0,98,9
1713302692424,MMW 14,A01,494399,Staff,25,0,28,3
1713302692424,MMW 14,A02,494400,Staff,27,0,28,1
1713302692424,MMW 14,A03,494401,Staff,28,0,28,0
1713302692424,MMW 14,A04,494402,Staff,28,0,28,0
1713302692424,MMW 14,B01,494404,Carreras; Maria Victoria,18,0,28,10
1713302692424,MMW 14,B02,494405,Carreras; Maria Victoria,27,0,28,1
1713302692424,MMW 14,B03,494406,Carreras; Maria Victoria,28,0,28,0
1713302692424,MMW 14,B04,494407,Carreras; Maria Victoria,28,0,28,0
1713302693450,MMW 14GS,A00,506250,Chang; Edmond Yi-Teh,0,0,0,0
1713302694474,MMW 121R,A01,494415,Adamiak; Patrick John,16,0,28,12
1713302694474,MMW 121R,A02,494416,Adamiak; Patrick John,25,0,28,3
1713302695504,MUS 1A,A01,494113,Staff,14,0,25,11
1713302695504,MUS 1A,A02,494114,Staff,25,0,25,0
1713302696528,MUS 4,A01,494116,Staff,24,0,25,1
1713302696528,MUS 4,A02,494117,Staff,22,0,25,3
1713302697552,MUS 5R,A01,494236,Dubnov; Shlomo,13,0,25,12
1713302697552,MUS 5R,A02,494237,Dubnov; Shlomo,25,0,25,0
1713302698581,MUS 6,A01,494122,Staff,17,0,25,8
1713302698581,MUS 6,A02,494123,Staff,24,0,25,1
1713302699607,MUS 7,A01,494125,Staff,20,0,25,5
1713302699607,MUS 7,A02,494126,Staff,24,0,25,1
1713302700633,MUS 11,A01,494128,Staff,23,0,25,2
1713302700633,MUS 11,A02,494129,Staff,25,0,25,0
1713302701661,MUS 13,A01,494131,Staff,25,0,25,0
1713302701661,MUS 13,A02,494132,Staff,25,0,25,0
1713302702687,MUS 15,A01,494134,Staff,21,0,25,4
1713302702687,MUS 15,A02,494135,Staff,25,0,25,0
1713302702687,MUS 15,B01,494137,Staff,25,0,25,0
1713302703712,MUS 80,A00,494232,Staff,25,0,25,0
1713302703712,MUS 80,B00,494233,Staff,25,0,25,0
1713302703712,MUS 80,C00,494234,Staff,23,0,25,2
1713302704746,MUS 95C,A00,494141,Staff,73,0,75,2
1713302705775,MUS 114,A00,494142,Staff,42,0,50,8
1713302706801,NANO 15,A01,490636,Drews; Aaron,7,0,7,0
1713302707826,PHIL 1,A00,490578,Grush; Rick Scott,50,0,50,0
1713302708857,PHIL 10,A01,490580,Grush; Rick Scott,34,0,35,1
1713302708857,PHIL 10,A02,490586,Grush; Rick Scott,33,0,35,2
1713302709888,PHIL 27,A01,490591,Staff,24,0,25,1
1713302709888,PHIL 27,A02,490592,Staff,25,0,25,0
1713302709888,PHIL 27,A03,490593,Staff,25,0,25,0
1713302709888,PHIL 27,A04,490598,Staff,25,0,25,0
1713302710932,PHIL 32,A01,490611,Staff,20,0,20,0
1713302710932,PHIL 32,A02,490618,Staff,20,0,20,0
1713302711962,PHIL 90,A00,490624,Staff,40,0,40,0
1713302712991,PHIL 136,A00,490627,Cohen; Jonathan David,38,0,40,2
1713302714018,PHIL 155,A00,490634,Staff,67,0,70,3
1713302715043,PHYS 1A,A00,491610,Staff,246,0,250,4
1713302716069,PHYS 1AL,001,491616,Tsai; Philbert S,28,0,30,2
1713302716069,PHYS 1AL,002,491618,Tsai; Philbert S,30,0,30,0
1713302717097,PHYS 1B,A00,491623,Staff,245,0,250,5
1713302718121,PHYS 1BL,001,491626,Tsai; Philbert S,27,0,30,3
1713302718121,PHYS 1BL,002,491628,Tsai; Philbert S,28,0,30,2
1713302719146,PHYS 1C,A00,491632,Staff,228,0,245,17
1713302720173,PHYS 1CL,001,491635,Tsai; Philbert S,12,0,30,18
1713302720173,PHYS 1CL,002,491643,Tsai; Philbert S,26,0,30,4
1713302721203,PHYS 2AR,A01,491651,Meyertholen; Andrew D.,46,0,50,4
1713302722235,PHYS 2B,A01,491659,Staff,107,0,115,8
1713302723265,PHYS 2BL,A01,491685,Staff,24,0,24,0
1713302723265,PHYS 2BL,A02,491700,Staff,23,0,24,1
1713302724301,PHYS 2C,A01,505161,Staff,109,0,115,6
1713302725326,PHYS 4A,A01,491704,Grinstein; Benjamin,100,0,100,0
1713302726365,POLI 5D,A01,494144,Staff,3,0,5,2
1713302726365,POLI 5D,B01,626283,Dai; Yinlin,5,0,5,0
1713302727393,POLI 12,A00,494145,Staff,44,0,45,1
1713302728476,POLI 13R,A00,494146,Forman; Fonna,47,0,50,3
1713302729503,POLI 27,A01,494148,Staff,60,0,60,0
1713302730531,POLI 30,A00,494149,Staff,49,0,50,1
1713302731555,POLI 100DA,A00,494150,Staff,23,0,25,2
1713302733610,POLI 100I,A00,494152,Staff,29,0,30,1
1713302734643,POLI 104B,A00,494153,Smith; Glenn Chatmas,54,0,55,1
1713302735673,POLI 104F,A00,494154,Staff,29,0,30,1
1713302736696,POLI 104I,A00,494155,Smith; Glenn Chatmas,30,0,30,0
1713302737724,POLI 110C,A00,494156,Ingham; Sean,23,0,25,2
1713302738749,POLI 117R,A00,494157,Forman; Fonna,17,0,20,3
1713302739779,POLI 118,A00,494158,Ingham; Sean,23,0,25,2
1713302740807,POLI 120H,A00,494159,Fisk; David Lee,41,0,45,4
1713302741834,POLI 131CR,A00,494160,Hoston; Germaine,43,0,45,2
1713302742861,POLI 133J,A00,494161,Staff,33,0,35,2
1713302743888,POLI 135,A00,494162,Fisk; David Lee,34,0,35,1
1713302744913,POLI 140A,A00,494164,Staff,23,0,30,7
1713302745938,POLI 142I,A00,494165,Staff,30,0,30,0
1713302746967,POLI 144D,A00,494166,Staff,23,0,25,2
1713302747996,POLI 151,A00,494167,Staff,30,0,30,0
1713302749025,POLI 153,A00,494168,Staff,34,0,35,1
1713302750059,POLI 160AA,A00,494169,Staff,36,0,40,4
1713302751086,POLI 162,A00,494170,Mignozzetti; Umberto,22,0,25,3
1713302752111,POLI 171,A00,494171,Mignozzetti; Umberto,23,0,25,2
1713302753141,PSYC 1,A00,494172,Staff,97,0,100,3
1713302754171,PSYC 2,A00,494173,Moranton; Nirelia Melbina-,48,0,50,2
1713302755196,PSYC 3,A00,494174,Staff,30,0,30,0
1713302756224,PSYC 6,A00,494175,Staff,17,0,20,3
1713302757248,PSYC 60,A01,494177,Staff,44,0,45,1
1713302758273,PSYC 70,A01,505724,Geller; Emma Harlan,42,0,45,3
1713302759302,PSYC 101,A00,494180,Heyman; Gail D.,93,0,100,7
1713302760329,PSYC 105,A00,494181,Geller; Emma Harlan,70,0,90,20
1713302761362,PSYC 106,A00,494182,Dobkins; Karen R.,34,0,45,11
1713302762387,PSYC 108,A00,494183,Adrian; Julia Anna,94,0,100,6
1713302763413,PSYC 114,A01,494185,Winkielman; Piotr,8,0,30,22
1713302764440,PSYC 122,A00,494186,Moranton; Nirelia Melbina-,41,0,50,9
1713302765466,PSYC 124,A00,494187,Chapman; Eddie Nathaniel,74,0,80,6
1713302766490,PSYC 131,A00,494188,Anagnostaras; Stephan,63,0,80,17
1713302767514,PSYC 144,A00,494189,Staff,24,0,50,26
1713302768543,PSYC 154,A00,494190,Lacefield; Katharine I,145,0,180,35
1713302769568,PSYC 162,A00,494191,Wixted; John T,91,0,100,9
1713302770598,PSYC 172,A00,494192,Gorman; Michael R.,38,0,45,7
1713302771628,PSYC 178,A00,494193,Glaser; Dale,41,0,45,4
1713302772654,PSYC 193,A00,505725,Chapman; Eddie Nathaniel,20,0,20,0
1713302773679,RELI 145GS,A00,519817,Rahimi; Babak,19,0,20,1
1713302774710,SE 101A,A01,490862,Chadha; Mayank,24,0,25,1
1713302775736,SE 101C,A01,490924,Krysl; Petr,18,0,20,2
1713302776768,SE 110A,A01,490928,Staff,20,0,20,0
1713302777799,SE 130A,A00,490929,Morrison; Machel Leigh,66,0,70,4
1713302778825,SIO 1,A01,519325,Staff,39,0,40,1
1713302779851,SIO 30,A01,519327,Staff,40,0,40,0
1713302780876,SIO 40,A00,519328,Staff,40,0,40,0
1713302781901,SIO 46GS,A00,519819,Cook; Geoffrey W,19,0,25,6
1713302782930,SIO 109R,A00,494197,Forman; Fonna,11,0,20,9
1713302783955,SIO 121GS,A00,519827,Cook; Geoffrey W,19,0,25,6
1713302784992,SIO 132,A01,519330,Staff,38,0,40,2
1713302786020,SIO 133,A01,519397,Staff,40,0,40,0
1713302787051,SIO 139,A00,519396,Kacev; David,35,0,40,5
1713302788076,SOCI 1,A01,494199,Thorpe; Charles Robert,24,0,30,6
1713302788076,SOCI 1,A02,494200,Thorpe; Charles Robert,30,0,30,0
1713302788076,SOCI 1,A03,494201,Thorpe; Charles Robert,30,0,30,0
1713302788076,SOCI 1,A04,494202,Thorpe; Charles Robert,29,0,30,1
1713302788076,SOCI 1,A05,494203,Thorpe; Charles Robert,30,0,30,0
1713302788076,SOCI 1,A06,494204,Thorpe; Charles Robert,30,0,30,0
1713302788076,SOCI 1,A07,494205,Thorpe; Charles Robert,29,0,30,1
1713302789100,SOCI 60,A01,494207,Staff,36,0,40,4
1713302789100,SOCI 60,A02,494208,Staff,39,0,40,1
1713302790127,SOCI 100,A01,494210,Payne; Christine Anna,28,0,30,2
1713302790127,SOCI 100,A02,494211,Payne; Christine Anna,28,0,30,2
1713302791156,SOCI 109M,A00,494212,Staff,20,0,20,0
1713302792180,SOCI 110,A00,494213,Staff,36,0,40,4
1713302794234,SOCI 118E,A00,494215,Ng; Kwai,39,0,40,1
1713302795264,SOCI 125,A00,494216,Calderon-Zaks; Michael Aar,43,0,45,2
1713302796293,SOCI 126,A01,494218,Jones; Makeba,4,0,5,1
1713302797317,SOCI 131,A00,494219,Thorpe; Charles Robert,30,0,30,0
1713302799365,SOCI 135,A00,494221,Payne; Christine Anna,44,0,50,6
1713302800394,SOCI 136E,A00,626690,Ruiz; Jonathan Joseph,25,0,25,0
1713302801423,SOCI 138GS,A00,494222,Navon; Daniel,24,0,28,4
1713302803476,SOCI 145,A00,494224,Staff,44,0,45,1
1713302804506,SOCI 153,A00,494225,Staff,28,0,30,2
1713302805529,SOCI 160E,A00,494226,Ng; Kwai,34,0,40,6
1713302806555,SOCI 180,A00,494227,Staff,29,0,30,1
1713302807580,SOCI 189GS,A00,494228,Ribas Norris; Janet Vanesa,11,0,11,0
1713302808607,SOCI 190GS,A00,553232,Ribas Norris; Janet Vanesa,11,0,11,0
1713302809638,SYN 2,001,490768,Staff,14,0,15,1
1713302809638,SYN 2,002,490769,Staff,15,0,15,0
1713302809638,SYN 2,004,490775,Staff,0,0,0,0
1713302809638,SYN 2,003,490774,Staff,0,0,0,0
1713302809638,SYN 2,005,490776,Staff,0,0,0,0
1713302810665,SYN 2R,001,490779,Staff,14,0,15,1
1713302810665,SYN 2R,002,514635,Staff,14,0,15,1
1713302811695,SYN 100,A01,490783,Staff,17,0,20,3
1713302811695,SYN 100,B01,490787,Staff,13,0,20,7
1713302811695,SYN 100,C01,490789,Staff,15,0,20,5
1713302812723,SYN 150,A00,490817,Staff,14,0,15,1
1713302812723,SYN 150,B00,514610,Staff,15,0,15,0
1713302813757,TDAC 1,A00,492753,Walsh; Kim C.,19,0,20,1
1713302813757,TDAC 1,B00,492754,Harting; Carla Kelso,19,0,20,1
1713302813757,TDAC 1,C00,513995,Salovey; Todd,18,0,20,2
1713302814781,TDAC 101,A00,492766,Harting; Carla Kelso,19,0,20,1
1713302815810,TDAC 102,A00,492768,Basso; Beatrice,20,0,20,0
1713302816836,TDDE 111,A00,492769,Staff,25,0,25,0
1713302817865,TDDE 131,A00,492770,Staff,15,0,15,0
1713302817865,TDDE 131,B00,492771,Staff,15,0,15,0
1713302818888,TDDE 131GS,A00,523716,Guirguis; Mark C,25,0,28,3
1713302819915,TDGE 1,A01,492756,Salovey; Todd,58,0,60,2
1713302820945,TDGE 5,A01,492758,Staff,24,0,25,1
1713302821970,TDGE 10,A00,492759,Fulton; Julia,216,0,220,4
1713302822997,TDGE 11,A00,492760,Castro; Robert Jess,200,0,200,0
1713302824027,TDGE 50,A00,492761,Blair; Kyle Adam,0,0,0,0
1713302825057,TDGE 124,A00,492772,Fulton; Julia,202,0,220,18
1713302826084,TDGE 125,A00,492773,Meyer; Ursula,43,0,50,7
1713302826084,TDGE 125,B00,492774,Staff,50,0,50,0
1713302826084,TDGE 125,C00,523565,Staff,50,0,50,0
1713302827111,TDGE 125GS,A00,523580,Guirguis; Mark C,25,0,28,3
1713302828142,TDGE 127,A00,492775,Havis; Allan,45,0,50,5
1713302829167,TDHT 101,A00,492776,Staff,35,0,35,0
1713302830193,TDMV 1,A00,492762,Caligagan; Maria T.,30,0,30,0
1713302830193,TDMV 1,B00,492763,Arcidiacono; Kristin,26,0,30,4
1713302831225,TDMV 2,A00,492764,Weinberg; Sadie,29,0,30,1
1713302832311,TDMV 3,A00,492765,Mack; Kara Shanai',40,0,40,0
1713302833336,TDMV 138,A00,492777,Mack; Kara Shanai',37,0,40,3
1713302834368,TDMV 140,A00,492778,Lima; Paulo Henrique,40,0,40,0
1713302835400,TDMV 142,A00,492779,Caligagan; Maria T.,37,0,40,3
1713302835400,TDMV 142,B00,492780,Caligagan; Tony,38,0,40,2
1713302836428,TDMV 143,A00,492781,Fyall; Daunte Edward,40,0,40,0
1713302837459,USP 1,A01,492401,Kwak; Nancy,29,0,35,6
1713302838484,USP 2,A01,492453,Hinds; Juli Beth,35,0,35,0
1713302839511,USP 3,A01,492516,Staff,32,0,35,3
1713302840537,USP 4,A00,492522,McTague; Sarah,21,0,25,4
1713302841562,USP 100,A00,492523,Staff,33,0,35,2
1713302842590,USP 101,A00,492524,Staff,13,0,15,2
1713302843615,USP 105,A00,492525,Staff,22,0,25,3
1713302844643,USP 151,A00,492526,Shenkman; Michael Thomas,33,0,35,2
1713302845669,USP 170,A00,492545,Hinds; Juli Beth,33,0,35,2
1713302846699,USP 171GS,A00,492608,Bussell; Mirle Rabinowitz,26,0,28,2
1713302847725,USP 183GS,A00,492613,Peerson; Susan,26,0,28,2
1713302848752,VIS 30,A01,490693,Yoldas; Pinar,21,0,22,1
1713302848752,VIS 30,A02,490694,Yoldas; Pinar,19,0,22,3
1713302849782,VIS 83,A00,490695,Kester; Grant,68,0,75,7
1713302850811,VIS 105D,A00,490696,Staff,22,0,25,3
1713302851839,VIS 124CN,A00,490699,Rose; Jordan M,68,0,75,7
1713302852865,VIS 125GS,A00,511221,Williams; Alena J,21,0,22,1
1713302853899,VIS 128D,A00,490700,Staff,74,0,75,1
1713302854924,VIS 151,A01,490717,Staff,34,0,34,0
1713302854924,VIS 151,A02,490766,Staff,33,0,34,1
1713302855953,VIS 154GS,A00,511972,Williams; Alena J,21,0,22,1
1713302856983,VIS 160A,A00,490767,Stone; Patricia,7,0,10,3
1713302858009,WCWP 10A,A00,490638,Staff,15,0,15,0
1713302858009,WCWP 10A,B00,490640,Staff,15,0,15,0
1713302859038,WCWP 10B,A00,490641,Staff,0,0,0,0
1713302859038,WCWP 10B,B00,490642,Staff,14,0,15,1
1713302859038,WCWP 10B,C00,490644,Staff,14,0,15,1
1713302859038,WCWP 10B,D00,490647,Staff,0,0,0,0
1713302860069,WCWP 100,A00,490655,Staff,0,0,0,0
1713302860069,WCWP 100,B00,490687,Staff,12,0,15,3
1713302862169,ANAR 153,A00,487222,Braswell; Geoffrey E.,55,0,60,5
1713302863198,ANBI 134,A00,487223,Staff,15,0,20,5
1713302864227,ANBI 143GS,A00,487224,Noel; Geoffroy Pierre Jean,23,0,24,1
1713302865253,ANBI 144GS,A00,519548,Noel; Geoffroy Pierre Jean,23,0,24,1
1713302866282,ANSC 101,A00,487225,Staff,19,0,20,1
1713302867310,ANSC 125,A00,487227,Brenner; Suzanne A,40,0,40,0
1713302869359,ANSC 146,A00,487229,Staff,37,0,40,3
1713302870387,ANSC 148,A00,487230,Olivas Hernandez; Olga Lid,39,0,40,1
1713302871416,ANSC 150,A00,504165,Sloane; Julia Kathryn,19,0,20,1
1713302872440,ANSC 180,A00,487232,Staff,13,0,15,2
1713302873468,ANTH 5,A00,519529,Semendeferi; Ekaterini,15,0,15,0
1713302874490,ANTH 10,A00,487219,Staff,58,0,60,2
1713302875515,ANTH 23,A01,487221,Staff,19,0,20,1
1713302876542,ANTH 102,A00,487233,Wilder; Linnea Lorene,54,0,60,6
1713302877567,ANTH 103,A00,487234,Varma; Saiba,57,0,60,3
1713302878595,ANTH 105,A00,487235,Stewart; Alexander B,57,0,60,3
1713302879621,BENG 100,A01,516685,Taylor Amos; Alyssa C,28,0,30,2
1713302880648,BIBC 102,A01,491316,Flagg; Matthew Paul,62,0,88,26
1713302880648,BIBC 102,A02,491366,Flagg; Matthew Paul,84,0,88,4
1713302881674,BIBC 103,A01,491486,Boumechache; Miyyada,17,0,24,7
1713302881674,BIBC 103,A02,491487,Boumechache; Miyyada,24,0,24,0
1713302882699,BICD 100,A01,516882,Staff,75,0,75,0
1713302882699,BICD 100,A02,516890,Staff,71,0,75,4
1713302883725,BICD 102GS,A00,491488,Lo; Stanley M.,27,0,28,1
1713302884755,BIEB 136GS,A00,516940,Holway; David A. & Shurin; Jonathan,20,0,24,4
1713302885780,BIEB 137GS,A01,517034,Holway; David A. & Shurin; Jonathan,20,0,24,4
1713302886805,BIEB 138GS,A01,491492,Pirino; Giorgia,22,0,28,6
1713302887831,BILD 1,A01,491296,Staff,62,0,63,1
1713302887831,BILD 1,A02,491297,Staff,63,0,63,0
1713302888855,BILD 4,A01,517099,Gonzalez Gamboa; Ivonne,23,0,24,1
1713302888855,BILD 4,A02,517100,Gonzalez Gamboa; Ivonne,24,0,24,0
1713302889880,BILD 60GS,A00,491309,Lo; Stanley M.,27,0,28,1
1713302890906,BIMM 100,A01,517136,Staff,95,0,100,5
1713302891931,BIMM 110,A01,517182,Staff,80,0,100,20
1713302892957,BIMM 120,A01,517228,Pickett; Brooke Elizabeth,43,0,63,20
1713302892957,BIMM 120,A02,517240,Pickett; Brooke Elizabeth,49,0,63,14
1713302893985,BIMM 132GS,A01,491498,Pirino; Giorgia,22,0,28,6
1713302895011,BIMM 143,A01,491589,Bozinovic; Goran,21,0,40,19
1713302896038,BIPN 100,A01,491594,Armour; Jon Christopher,93,0,100,7
1713302897065,BIPN 140,A01,491602,Marino; Marc J,34,0,50,16
1713302899115,CAT 125,A00,515973,Staff,20,0,20,0
1713302900140,CAT 125GS,A00,515974,Rahimi; Babak,20,0,20,0
1713302901174,CAT 125R,A00,515980,Staff,15,0,20,5
1713302901174,CAT 125R,B00,515981,Tosun; Adriana,19,0,20,1
1713302901174,CAT 125R,C00,515987,Hyland; Tina Mae,6,0,20,14
1713302901174,CAT 125R,D00,515988,Bronstein; Phoebe Malan,19,0,20,1
1713302902198,CENG 15,A01,488699,Drews; Aaron,25,0,25,0
1713302903225,CENG 100,A00,505196,Opatkiewicz; Justin Paul,25,0,25,0
1713302904253,CGS 2A,A01,489598,Staff,33,0,35,2
1713302905283,CGS 112,A00,489599,Staff,15,0,15,0
1713302906310,CGS 119,A00,489603,Staff,10,0,10,0
1713302907343,CGS 120,A00,489604,Staff,14,0,15,1
1713302908370,CGS 150,A00,489607,Staff,15,0,15,0
1713302909397,CHEM 6A,A01,488715,Staff,98,0,100,2
1713302910422,CHEM 6B,A01,488719,Piercy; Marc Anthony,100,0,100,0
1713302911451,CHEM 6C,A01,488723,Albizati; Kim F.,94,0,100,6
1713302912478,CHEM 7L,A01,488728,Schurmeier; Kimberly,18,0,24,6
1713302912478,CHEM 7L,A02,488730,Schurmeier; Kimberly,23,0,24,1
1713302912478,CHEM 7L,A03,488734,Schurmeier; Kimberly,24,0,24,0
1713302912478,CHEM 7L,A04,488763,Schurmeier; Kimberly,23,0,24,1
1713302912478,CHEM 7L,B01,488798,Schurmeier; Kimberly,18,0,24,6
1713302912478,CHEM 7L,B02,488801,Schurmeier; Kimberly,24,0,24,0
1713302912478,CHEM 7L,B03,488808,Schurmeier; Kimberly,24,0,24,0
1713302912478,CHEM 7L,B04,488811,Schurmeier; Kimberly,24,0,24,0
1713302913507,CHEM 11,A01,488897,Stallings; Dontarie M,98,0,100,2
1713302914533,CHEM 40A,A01,488913,Albizati; Kim F.,93,0,100,7
1713302915559,CHEM 40B,A01,488920,Weizman; Haim,48,0,50,2
1713302915559,CHEM 40B,A02,488938,Weizman; Haim,47,0,50,3
1713302916585,CHEM 41A,A01,489029,Klosterman; Jeremy K,58,0,60,2
1713302917611,CHEM 41C,A01,500436,Tor; Yitzhak,56,0,60,4
1713302918637,CHEM 43A,A01,500426,Weizman; Haim,7,0,24,17
1713302918637,CHEM 43A,A02,500430,Weizman; Haim,16,0,24,8
1713302918637,CHEM 43A,B01,514041,Klosterman; Jeremy K,18,0,24,6
1713302918637,CHEM 43A,B02,514047,Klosterman; Jeremy K,23,0,24,1
1713302919663,CHEM 108,A01,489140,Jennings; Patricia A.,15,0,24,9
1713302919663,CHEM 108,A02,489142,Jennings; Patricia A.,18,0,24,6
1713302920692,CHEM 114A,A01,489147,Stallings; Dontarie M,82,0,100,18
1713302921721,CHIN 169A,A00,489171,Wang; Xiao,19,0,20,1
1713302923773,COGS 3,A01,518827,Boyle; Mary E. T.,31,0,40,9
1713302924799,COGS 11,A01,489175,Staff,28,0,30,2
1713302925827,COGS 14A,A01,518829,Staff,55,0,60,5
1713302926852,COGS 14B,A01,489177,Hoffman; Drew Ellen,69,0,75,6
1713302927883,COGS 100,A01,489181,Allen; Michael Gordon,67,0,75,8
1713302928908,COGS 101A,A01,489183,Staff,52,0,60,8
1713302929939,COGS 101B,A01,489185,Allen; Michael Gordon,15,0,30,15
1713302930969,COGS 101C,A01,526786,Staff,25,0,30,5
1713302933021,COGS 107A,A01,489189,Boyle; Mary E. T.,26,0,35,9
1713302934051,COGS 107B,A01,627144,Mooshagian; Eric Frederick,60,0,60,0
1713302935079,COGS 118A,A01,489191,Staff,0,21,40,40
1713302937187,COGS 171GS,A01,489194,Pineda; Jaime A,22,0,28,6
1713302938213,COGS 172,A01,489196,Staff,9,0,30,21
1713302939242,COGS 174GS,A01,489264,Pineda; Jaime A,22,0,28,6
1713302940268,COGS 180,A01,627150,Staff,29,0,30,1
1713302941297,COGS 186,A01,489274,Staff,4,0,30,26
1713302942325,COMM 10,A01,489276,Staff,25,0,25,0
1713302942325,COMM 10,A02,489303,Staff,23,0,25,2
1713302943352,COMM 100A,A01,489312,Staff,21,0,25,4
1713302943352,COMM 100A,A02,489313,Staff,24,0,25,1
1713302944376,COMM 106T,A00,512540,Staff,34,0,35,1
1713302945404,COMM 107,A00,489347,Staff,31,0,35,4
1713302946430,COMM 109P,A00,489358,Staff,31,0,35,4
1713302947457,COMM 132,A00,489361,McKenna; Denise,29,0,30,1
1713302948485,COMM 146,A00,489362,Halm; Gavin Patrick,27,0,30,3
1713302949512,COMM 190,A00,489363,Abuelhiga; Soraya Jill,21,0,23,2
1713302950538,CSE 8A,A50,489366,Staff,24,0,25,1
1713302950538,CSE 8A,A51,489367,Staff,24,0,25,1
1713302951562,CSE 11,A01,489398,Cao; Yingjun,86,0,100,14
1713302952589,CSE 12,A01,489487,Staff,43,0,50,7
1713302953616,CSE 20,A01,489497,Staff,49,0,50,1
1713302954642,CSE 21,A01,489517,Braun; Oliver,44,0,50,6
1713302955667,CSE 101,A01,489524,Braun; Oliver,2,0,50,48
1713302956691,CSE 105,A01,512594,Jones; Miles E,85,0,100,15
1713302956691,CSE 105,B01,512598,Jones; Miles E,73,0,100,27
1713302957717,CSE 140,A01,489538,Staff,45,0,50,5
1713302958746,CSE 141,A01,489550,Eldon; John,77,0,100,23
1713302959770,CSE 141L,A01,489571,Eldon; John,76,0,100,24
1713302960797,CSE 151A,A01,489583,Solares; Edwin A,156,0,200,44
1713302961823,CSE 175,A01,510886,Kumar; Rakesh,30,0,30,0
1713302962858,CSE 190,A00,516828,Dubnov; Shlomo,41,0,49,8
1713302963888,DOC 100D,A00,489667,Pass; Natalye Joann,23,0,25,2
1713302964912,DSC 10,A01,624268,Staff,72,0,75,3
1713302965939,DSC 20,A01,624476,Staff,50,0,50,0
1713302966969,DSC 40A,A01,624608,Staff,40,0,40,0
1713302967996,DSGN 1,A01,489179,Rill; Bryan,38,0,50,12
1713302969021,ECE 17,A01,490489,Sahay; Rajeev,21,0,30,9
1713302970048,ECE 65,A50,490492,Staff,17,0,20,3
1713302970048,ECE 65,A51,490493,Staff,20,0,20,0
1713302971079,ECON 1,A01,489715,Famulari; Melissa,69,0,70,1
1713302972104,ECON 2,A01,489717,Levkoff; Steven B.,69,0,70,1
1713302973129,ECON 3,A01,489948,Staff,70,0,70,0
1713302975181,ECON 5,A01,490103,Staff,28,0,30,2
1713302975181,ECON 5,B01,626281,Dai; Yinlin,45,0,45,0
1713302976205,ECON 100A,A01,490127,Famulari; Melissa,70,0,70,0
1713302977231,ECON 100B,A01,490129,Staff,64,0,70,6
1713302978255,ECON 109,A01,490187,Shishkin; Denis,29,0,35,6
1713302979281,ECON 110A,A01,490190,Levkoff; Steven B.,65,0,70,5
1713302980307,ECON 120A,A01,490245,Dai; Yinlin,69,0,70,1
1713302981336,ECON 120B,A01,490247,Nieto-Barthaburu; Augusto,61,0,70,9
1713302982382,ECON 120C,A01,490253,Sun; Yixiao,32,0,35,3
1713302982382,ECON 120C,B01,490255,Sun; Yixiao,34,0,35,1
1713302983412,ECON 129,A00,490256,Eckert; Fabian Paul,28,0,35,7
1713302984438,ECON 131,A00,490257,Nieto-Barthaburu; Augusto,7,0,35,28
1713302985467,ECON 138,A00,490258,Bharadwaj; Prashant,25,0,35,10
1713302985467,ECON 138,B00,490259,Bharadwaj; Prashant,21,0,35,14
1713302986491,ECON 159,A00,490260,Hendrickson; Gerald M.,0,6,0,0
1713302987517,ECON 178,A01,553995,Zhu; Ying,29,0,35,6
1713302988551,EDS 40,A01,512576,Black; Alison Michelle,20,0,20,0
1713302989576,EDS 107,A01,515848,Staff,30,0,30,0
1713302990601,EDS 110R,A01,490262,Staff,26,0,30,4
1713302991627,EDS 112,A01,490264,Chapman; Thandeka K,45,0,50,5
1713302992655,EDS 113,A00,490266,Staff,28,0,30,2
1713302993679,EDS 118,A00,490267,Warstadt; Melissa Fawn,27,0,30,3
1713302994706,EDS 124BR,A00,490268,Eguchi; Emi,10,0,25,15
1713302994706,EDS 124BR,B00,490269,Eguchi; Emi,25,0,25,0
1713302995737,EDS 126,A01,490271,Jones; Makeba,47,0,50,3
1713302996763,EDS 135,A01,490316,Staff,20,0,20,0
1713302997791,ENVR 142GS,A00,519514,Chang; Edmond Yi-Teh,28,0,28,0
1713302998817,ETHN 103,A00,490504,Staff,33,0,36,3
1713302999845,ETHN 103A,A00,490505,Man; Simeon S,7,0,9,2
1713303000871,ETHN 109,A00,490506,Staff,30,0,30,0
1713303001903,ETHN 118,A00,490507,Staff,35,0,36,1
1713303002926,ETHN 119,A00,490508,Staff,36,0,36,0
1713303003951,ETHN 121R,A00,490518,Choi; Esther Min,30,0,36,6
1713303004979,ETHN 127,A00,490528,Staff,15,0,15,0
1713303006007,ETHN 139,A00,490573,Staff,10,0,10,0
1713303007034,ETHN 150,A00,490575,Staff,15,0,15,0
1713303008064,GLBH 20,A00,491705,Elwardani; Nile Regina,38,0,40,2
1713303009093,GLBH 101,A00,491706,Staff,20,0,20,0
1713303010123,GLBH 111,A01,491708,Burgos; Jose L.,15,0,15,0
1713303011148,GLBH 146,A00,491709,Staff,15,0,20,5
1713303012172,GLBH 148,A00,491710,Olivas Hernandez; Olga Lid,17,0,20,3
1713303013200,GLBH 150,A00,491711,Sloane; Julia Kathryn,20,0,20,0
1713303014227,HIEA 131,A00,491760,Staff,30,0,32,2
1713303015253,HIEA 153,A00,491762,Staff,29,0,30,1
1713303016282,HIEU 124,A00,491811,Staff,29,0,32,3
1713303017305,HIEU 124GS,A00,491812,Markman; Kristina,28,0,28,0
1713303018329,HIEU 147,A00,491813,Staff,31,0,32,1
1713303019354,HIEU 149GS,A00,491816,Caldwell; Michael Alan,28,0,28,0
1713303020381,HILD 2C,A01,491713,Hendrickson; Gerald M.,28,0,30,2
1713303021405,HILD 7B,A01,491715,Kwak; Nancy,17,0,30,13
1713303022430,HILD 10,A01,491717,Staff,16,0,20,4
1713303023459,HILD 30GS,A00,491719,Edington; Claire Ellen,24,0,28,4
1713303024483,HINE 109,A00,491818,Shafir; Nir,31,0,32,1
1713303025510,HINE 128,A00,491821,Shafir; Nir,32,0,32,0
1713303026535,HISC 117,A00,491830,Staff,29,0,32,3
1713303027560,HIUS 103,A00,491834,Man; Simeon S,18,0,23,5
1713303028587,HIUS 108B,A00,491835,Staff,30,0,30,0
1713303029613,HIUS 141,A00,491836,Hendrickson; Gerald M.,29,0,32,3
1713303030641,HIUS 149,A00,491839,Staff,28,0,32,4
1713303031666,HUM 3,A01,512617,Crum; Matthew Stephen,46,0,50,4
1713303031666,HUM 3,A02,512618,Crum; Matthew Stephen,49,0,50,1
1713303032689,HUM 3GS,A00,512663,Markman; Kristina,0,0,0,0
1713303032689,HUM 3GS,B00,512664,Staff,0,0,0,0
1713303033721,HUM 4,A01,512620,West; Geoffrey Scott,39,0,50,11
1713303034747,HUM 4GS,A00,512666,Lyon; Antony J.,0,0,0,3
1713303035772,HUM 4R,A01,512625,Watkins; Eric,49,0,50,1
1713303036799,HUM 5,A01,512649,Zavodny; Tatiana Sophia,35,0,50,15
1713303036799,HUM 5,B01,512661,Zroka; Ryan Edward,49,0,50,1
1713303037830,INTL 190,A00,490577,Segui; Alan S,0,0,0,5
1713303038856,JAPN 20AR,A01,491267,Ross; Kayoko F,12,0,20,8
1713303039935,JAPN 180,A00,491285,Berman; Michael David,35,0,40,5
1713303040961,LATI 50,A01,502536,Kokinis; Troy Andreas,19,0,22,3
1713303040961,LATI 50,A02,502551,Kokinis; Troy Andreas,22,0,22,0
1713303040961,LATI 50,A03,502650,Kokinis; Troy Andreas,22,0,22,0
1713303040961,LATI 50,A04,502909,Kokinis; Troy Andreas,22,0,22,0
1713303041985,LATI 160,A01,502920,Kokinis; Troy Andreas,30,0,30,0
1713303043013,LIFR 1A,A00,490494,Van Moer; Vinciane G,18,0,20,2
1713303044043,LIFR 1AX,A00,490495,Van Moer; Vinciane G,18,0,20,2
1713303045069,LIFR 1B,A00,490496,Van Moer; Vinciane G,20,0,20,0
1713303046094,LIFR 1BX,A00,490497,Van Moer; Vinciane G,20,0,20,0
1713303047119,LIGN 8,A00,505198,McIntosh; Justin Daniel,144,0,150,6
1713303048145,LIGN 9GS,A00,491239,Lott; Margaret S.,18,0,20,2
1713303049170,LIGN 101,A01,505200,McIntosh; Justin Daniel,26,0,30,4
1713303050198,LIGN 120,A01,491244,Staff,26,0,30,4
1713303051226,LIGN 149GS,A00,491245,Lott; Margaret S.,18,0,20,2
1713303052249,LIGN 170,A00,491247,Staff,25,0,30,5
1713303053279,LISP 1D,A00,490498,Munoz Sanchez; Alicia,12,0,14,2
1713303053279,LISP 1D,B00,490499,Munoz Sanchez; Alicia,8,0,14,6
1713303053279,LISP 1D,C00,490500,Munoz Sanchez; Alicia,10,0,14,4
1713303053279,LISP 1D,D00,490501,Munoz Sanchez; Alicia,11,0,14,3
1713303054307,LISP 1DX,A00,490502,Munoz Sanchez; Alicia,21,0,28,7
1713303054307,LISP 1DX,B00,490503,Munoz Sanchez; Alicia,19,0,28,9
1713303056360,LTAM 110,A00,491847,Staff,23,0,25,2
1713303057386,LTCS 119,A00,491848,Staff,13,0,15,2
1713303058411,LTCS 130,A00,491849,Staff,24,0,25,1
1713303060467,LTEA 120C,A00,491852,Staff,35,0,40,5
1713303061495,LTEN 130GS,A00,491853,Lyon; Antony J.,25,0,28,3
1713303062524,LTEN 148,A00,491855,Staff,23,0,25,2
1713303063549,LTEN 159,A00,491856,Staff,21,0,25,4
1713303064576,LTEN 180,A00,491857,Staff,10,0,15,5
1713303066627,LTSP 123GS,A00,505928,Bessett; Ryan Matthew,25,0,28,3
1713303067655,LTSP 174GS,A00,506037,Bessett; Ryan Matthew,25,0,28,3
1713303069710,LTWR 102,A00,491861,Staff,12,0,15,3
1713303070734,LTWR 106,A00,491862,Staff,11,0,15,4
1713303071760,MAE 11,A00,490930,Bahadori; Mohammad Yousef,98,0,100,2
1713303072787,MAE 30A,A00,490931,Qi; Huihui,38,0,40,2
1713303073817,MAE 101A,A00,491036,Sadeghizadeh; Zahra,98,0,100,2
1713303074844,MAE 101C,A00,491037,Seshadri; Kalyanasundaram,78,0,100,22
1713303075867,MAE 113,A00,491040,Seshadri; Kalyanasundaram,67,0,80,13
1713303076894,MAE 131A,A00,491041,Ghazinejad; Maziar,39,0,40,1
1713303077919,MAE 142,A00,491053,Staff,39,0,40,1
1713303078944,MAE 143A,A00,491054,Staff,43,0,50,7
1713303079978,MAE 150,A00,491092,Truong; Phuong Thi Ngoc,25,0,35,10
1713303081010,MATH 3C,A01,494031,Pardo Guerra; Sebastian,30,0,30,0
1713303081010,MATH 3C,A02,494032,Pardo Guerra; Sebastian,29,0,30,1
1713303082057,MATH 10A,A01,494034,Staff,29,0,30,1
1713303082057,MATH 10A,A02,494035,Staff,29,0,30,1
1713303082057,MATH 10A,B01,494037,Staff,28,0,30,2
1713303082057,MATH 10A,B02,494038,Staff,29,0,30,1
1713303083097,MATH 10B,A01,494040,Habib; Yousaf,24,0,30,6
1713303083097,MATH 10B,A02,494041,Habib; Yousaf,28,0,30,2
1713303083097,MATH 10B,A03,494042,Habib; Yousaf,30,0,30,0
1713303083097,MATH 10B,A04,494043,Habib; Yousaf,30,0,30,0
1713303083097,MATH 10B,B01,494045,Habib; Yousaf,28,0,30,2
1713303083097,MATH 10B,B02,494046,Habib; Yousaf,30,0,30,0
1713303083097,MATH 10B,B03,494047,Habib; Yousaf,30,0,30,0
1713303083097,MATH 10B,B04,494048,Habib; Yousaf,30,0,30,0
1713303084124,MATH 18,A01,494050,Kemp; Todd Aahron,29,0,30,1
1713303084124,MATH 18,A02,494051,Kemp; Todd Aahron,29,0,30,1
1713303084124,MATH 18,B01,494054,Kemp; Todd Aahron,28,0,30,2
1713303084124,MATH 18,B02,494055,Kemp; Todd Aahron,29,0,30,1
1713303085149,MATH 20A,A01,494059,Suk; Andrew Hoon,30,0,30,0
1713303086182,MATH 20B,A01,494061,Briones; Jor-el Thomas Caparas,34,0,35,1
1713303086182,MATH 20B,B01,494063,Bach; Quang Tran,35,0,35,0
1713303087210,MATH 20C,A01,494065,Staff,29,0,30,1
1713303087210,MATH 20C,A02,494066,Staff,30,0,30,0
1713303087210,MATH 20C,A03,494067,Staff,30,0,30,0
1713303087210,MATH 20C,A04,494068,Staff,30,0,30,0
1713303087210,MATH 20C,B01,494070,Zhang; Ming,27,0,30,3
1713303087210,MATH 20C,B02,494071,Zhang; Ming,30,0,30,0
1713303087210,MATH 20C,B03,494072,Zhang; Ming,29,0,30,1
1713303087210,MATH 20C,B04,494073,Zhang; Ming,29,0,30,1
1713303088237,MATH 20D,A01,494075,Staff,27,0,30,3
1713303088237,MATH 20D,A02,494076,Staff,30,0,30,0
1713303089263,MATH 20E,A01,494079,Staff,25,0,30,5
1713303089263,MATH 20E,A02,494080,Staff,28,0,30,2
1713303089263,MATH 20E,B01,494082,Staff,28,0,30,2
1713303089263,MATH 20E,B02,494083,Staff,25,0,30,5
1713303090294,MATH 103A,A01,494085,Aliabadi Sr.; Mohsen,22,0,30,8
1713303090294,MATH 103A,A02,494086,Aliabadi Sr.; Mohsen,29,0,30,1
1713303090294,MATH 103A,B01,494088,Aliabadi Sr.; Mohsen,22,0,30,8
1713303090294,MATH 103A,B02,494089,Aliabadi Sr.; Mohsen,28,0,30,2
1713303091326,MATH 109,A01,494091,Staff,30,0,30,0
1713303091326,MATH 109,A02,494092,Staff,30,0,30,0
1713303091326,MATH 109,B01,494094,Staff,28,0,30,2
1713303091326,MATH 109,B02,494095,Staff,29,0,30,1
1713303092352,MATH 142A,A01,494097,Chow; Bennett,17,0,30,13
1713303092352,MATH 142A,A02,494098,Chow; Bennett,26,0,30,4
1713303092352,MATH 142A,B01,494100,Chow; Bennett,23,0,30,7
1713303092352,MATH 142A,B02,494101,Chow; Bennett,29,0,30,1
1713303094403,MATH 168A,A01,516677,Dumitriu; Ioana,17,0,35,18
1713303095427,MATH 170A,A01,516679,Dumitriu; Ioana,23,0,30,7
1713303095427,MATH 170A,A02,516680,Dumitriu; Ioana,28,0,30,2
1713303096452,MATH 193A,A01,494107,Staff,19,0,30,11
1713303096452,MATH 193A,A02,494108,Staff,26,0,30,4
1713303096452,MATH 193A,A03,494109,Staff,29,0,30,1
1713303096452,MATH 193A,A04,494110,Staff,27,0,30,3
1713303099532,MGT 16,A00,491930,McKay; Michael J,94,0,98,4
1713303100556,MGT 18,A00,491992,McKay; Michael J,97,0,98,1
1713303101581,MGT 71,A00,492003,Staff,79,0,98,19
1713303102612,MGT 103,A00,505209,Eberhard; Craig A,88,0,98,10
1713303103639,MGT 131A,A00,505210,Anderson; John Charles,91,0,98,7
1713303105694,MGT 153,A00,492077,Perols; Johan Lars,55,0,90,35
1713303108780,MGT 164,A00,492222,McKay; Mary A,94,0,98,4
1713303109807,MGT 172,A00,492245,Staff,59,0,60,1
1713303109807,MGT 172,B00,505526,Hedges; Kathleen,81,0,98,17
1713303110833,MGT 181,A00,505669,Dunn; Louis Jean,89,0,98,9
1713303111861,MMW 14,A01,494399,Staff,25,0,28,3
1713303111861,MMW 14,A02,494400,Staff,27,0,28,1
1713303111861,MMW 14,A03,494401,Staff,28,0,28,0
1713303111861,MMW 14,A04,494402,Staff,28,0,28,0
1713303111861,MMW 14,B01,494404,Carreras; Maria Victoria,18,0,28,10
1713303111861,MMW 14,B02,494405,Carreras; Maria Victoria,27,0,28,1
1713303111861,MMW 14,B03,494406,Carreras; Maria Victoria,28,0,28,0
1713303111861,MMW 14,B04,494407,Carreras; Maria Victoria,28,0,28,0
1713303112888,MMW 14GS,A00,506250,Chang; Edmond Yi-Teh,0,0,0,0
1713303113918,MMW 121R,A01,494415,Adamiak; Patrick John,16,0,28,12
1713303113918,MMW 121R,A02,494416,Adamiak; Patrick John,25,0,28,3
1713303114943,MUS 1A,A01,494113,Staff,14,0,25,11
1713303114943,MUS 1A,A02,494114,Staff,25,0,25,0
1713303115969,MUS 4,A01,494116,Staff,24,0,25,1
1713303115969,MUS 4,A02,494117,Staff,22,0,25,3
1713303116997,MUS 5R,A01,494236,Dubnov; Shlomo,13,0,25,12
1713303116997,MUS 5R,A02,494237,Dubnov; Shlomo,25,0,25,0
1713303118025,MUS 6,A01,494122,Staff,17,0,25,8
1713303118025,MUS 6,A02,494123,Staff,24,0,25,1
1713303119052,MUS 7,A01,494125,Staff,20,0,25,5
1713303119052,MUS 7,A02,494126,Staff,24,0,25,1
1713303120084,MUS 11,A01,494128,Staff,23,0,25,2
1713303120084,MUS 11,A02,494129,Staff,25,0,25,0
1713303121109,MUS 13,A01,494131,Staff,25,0,25,0
1713303121109,MUS 13,A02,494132,Staff,25,0,25,0
1713303122134,MUS 15,A01,494134,Staff,21,0,25,4
1713303122134,MUS 15,A02,494135,Staff,25,0,25,0
1713303122134,MUS 15,B01,494137,Staff,25,0,25,0
1713303123164,MUS 80,A00,494232,Staff,25,0,25,0
1713303123164,MUS 80,B00,494233,Staff,25,0,25,0
1713303123164,MUS 80,C00,494234,Staff,23,0,25,2
1713303124191,MUS 95C,A00,494141,Staff,73,0,75,2
1713303125219,MUS 114,A00,494142,Staff,42,0,50,8
1713303126244,NANO 15,A01,490636,Drews; Aaron,7,0,7,0
1713303127271,PHIL 1,A00,490578,Grush; Rick Scott,50,0,50,0
1713303128306,PHIL 10,A01,490580,Grush; Rick Scott,34,0,35,1
1713303128306,PHIL 10,A02,490586,Grush; Rick Scott,33,0,35,2
1713303129330,PHIL 27,A01,490591,Staff,24,0,25,1
1713303129330,PHIL 27,A02,490592,Staff,25,0,25,0
1713303129330,PHIL 27,A03,490593,Staff,25,0,25,0
1713303129330,PHIL 27,A04,490598,Staff,25,0,25,0
1713303130359,PHIL 32,A01,490611,Staff,20,0,20,0
1713303130359,PHIL 32,A02,490618,Staff,20,0,20,0
1713303131387,PHIL 90,A00,490624,Staff,40,0,40,0
1713303132415,PHIL 136,A00,490627,Cohen; Jonathan David,38,0,40,2
1713303133443,PHIL 155,A00,490634,Staff,67,0,70,3
1713303134471,PHYS 1A,A00,491610,Staff,246,0,250,4
1713303135495,PHYS 1AL,001,491616,Tsai; Philbert S,28,0,30,2
1713303135495,PHYS 1AL,002,491618,Tsai; Philbert S,30,0,30,0
1713303136523,PHYS 1B,A00,491623,Staff,245,0,250,5
1713303137549,PHYS 1BL,001,491626,Tsai; Philbert S,27,0,30,3
1713303137549,PHYS 1BL,002,491628,Tsai; Philbert S,28,0,30,2
1713303138573,PHYS 1C,A00,491632,Staff,228,0,245,17
1713303139601,PHYS 1CL,001,491635,Tsai; Philbert S,12,0,30,18
1713303139601,PHYS 1CL,002,491643,Tsai; Philbert S,26,0,30,4
1713303140632,PHYS 2AR,A01,491651,Meyertholen; Andrew D.,46,0,50,4
1713303141661,PHYS 2B,A01,491659,Staff,107,0,115,8
1713303142687,PHYS 2BL,A01,491685,Staff,24,0,24,0
1713303142687,PHYS 2BL,A02,491700,Staff,23,0,24,1
1713303143768,PHYS 2C,A01,505161,Staff,108,0,115,7
1713303144796,PHYS 4A,A01,491704,Grinstein; Benjamin,100,0,100,0
1713303145823,POLI 5D,A01,494144,Staff,3,0,5,2
1713303145823,POLI 5D,B01,626283,Dai; Yinlin,5,0,5,0
1713303146849,POLI 12,A00,494145,Staff,44,0,45,1
1713303147874,POLI 13R,A00,494146,Forman; Fonna,47,0,50,3
1713303148898,POLI 27,A01,494148,Staff,60,0,60,0
1713303149926,POLI 30,A00,494149,Staff,49,0,50,1
1713303150954,POLI 100DA,A00,494150,Staff,23,0,25,2
1713303153005,POLI 100I,A00,494152,Staff,29,0,30,1
1713303154033,POLI 104B,A00,494153,Smith; Glenn Chatmas,54,0,55,1
1713303155060,POLI 104F,A00,494154,Staff,29,0,30,1
1713303156087,POLI 104I,A00,494155,Smith; Glenn Chatmas,30,0,30,0
1713303157113,POLI 110C,A00,494156,Ingham; Sean,23,0,25,2
1713303158139,POLI 117R,A00,494157,Forman; Fonna,16,0,20,4
1713303159162,POLI 118,A00,494158,Ingham; Sean,23,0,25,2
1713303160192,POLI 120H,A00,494159,Fisk; David Lee,41,0,45,4
1713303161221,POLI 131CR,A00,494160,Hoston; Germaine,43,0,45,2
1713303162246,POLI 133J,A00,494161,Staff,33,0,35,2
1713303163270,POLI 135,A00,494162,Fisk; David Lee,34,0,35,1
1713303164301,POLI 140A,A00,494164,Staff,23,0,30,7
1713303165325,POLI 142I,A00,494165,Staff,30,0,30,0
1713303166350,POLI 144D,A00,494166,Staff,23,0,25,2
1713303167379,POLI 151,A00,494167,Staff,30,0,30,0
1713303168405,POLI 153,A00,494168,Staff,34,0,35,1
1713303169429,POLI 160AA,A00,494169,Staff,36,0,40,4
1713303170458,POLI 162,A00,494170,Mignozzetti; Umberto,22,0,25,3
1713303171484,POLI 171,A00,494171,Mignozzetti; Umberto,23,0,25,2
1713303172512,PSYC 1,A00,494172,Staff,97,0,100,3
1713303173551,PSYC 2,A00,494173,Moranton; Nirelia Melbina-,48,0,50,2
1713303174577,PSYC 3,A00,494174,Staff,30,0,30,0
1713303175606,PSYC 6,A00,494175,Staff,17,0,20,3
1713303176635,PSYC 60,A01,494177,Staff,44,0,45,1
1713303177661,PSYC 70,A01,505724,Geller; Emma Harlan,42,0,45,3
1713303178690,PSYC 101,A00,494180,Heyman; Gail D.,93,0,100,7
1713303179713,PSYC 105,A00,494181,Geller; Emma Harlan,69,0,90,21
1713303180751,PSYC 106,A00,494182,Dobkins; Karen R.,34,0,45,11
1713303181775,PSYC 108,A00,494183,Adrian; Julia Anna,94,0,100,6
1713303182801,PSYC 114,A01,494185,Winkielman; Piotr,8,0,30,22
1713303183829,PSYC 122,A00,494186,Moranton; Nirelia Melbina-,41,0,50,9
1713303184855,PSYC 124,A00,494187,Chapman; Eddie Nathaniel,74,0,80,6
1713303185880,PSYC 131,A00,494188,Anagnostaras; Stephan,63,0,80,17
1713303186905,PSYC 144,A00,494189,Staff,24,0,50,26
1713303187932,PSYC 154,A00,494190,Lacefield; Katharine I,145,0,180,35
1713303188959,PSYC 162,A00,494191,Wixted; John T,91,0,100,9
1713303189983,PSYC 172,A00,494192,Gorman; Michael R.,38,0,45,7
1713303191011,PSYC 178,A00,494193,Glaser; Dale,41,0,45,4
1713303192037,PSYC 193,A00,505725,Chapman; Eddie Nathaniel,20,0,20,0
1713303193065,RELI 145GS,A00,519817,Rahimi; Babak,19,0,20,1
1713303194092,SE 101A,A01,490862,Chadha; Mayank,24,0,25,1
1713303195118,SE 101C,A01,490924,Krysl; Petr,18,0,20,2
1713303196143,SE 110A,A01,490928,Staff,20,0,20,0
1713303197172,SE 130A,A00,490929,Morrison; Machel Leigh,66,0,70,4
1713303198196,SIO 1,A01,519325,Staff,39,0,40,1
1713303199225,SIO 30,A01,519327,Staff,40,0,40,0
1713303200255,SIO 40,A00,519328,Staff,40,0,40,0
1713303201280,SIO 46GS,A00,519819,Cook; Geoffrey W,19,0,25,6
1713303202306,SIO 109R,A00,494197,Forman; Fonna,10,0,20,10
1713303203335,SIO 121GS,A00,519827,Cook; Geoffrey W,19,0,25,6
1713303204360,SIO 132,A01,519330,Staff,38,0,40,2
1713303205390,SIO 133,A01,519397,Staff,40,0,40,0
1713303206416,SIO 139,A00,519396,Kacev; David,34,0,40,6
1713303207445,SOCI 1,A01,494199,Thorpe; Charles Robert,24,0,30,6
1713303207445,SOCI 1,A02,494200,Thorpe; Charles Robert,30,0,30,0
1713303207445,SOCI 1,A03,494201,Thorpe; Charles Robert,29,0,30,1
1713303207445,SOCI 1,A04,494202,Thorpe; Charles Robert,29,0,30,1
1713303207445,SOCI 1,A05,494203,Thorpe; Charles Robert,30,0,30,0
1713303207445,SOCI 1,A06,494204,Thorpe; Charles Robert,30,0,30,0
1713303207445,SOCI 1,A07,494205,Thorpe; Charles Robert,29,0,30,1
1713303208474,SOCI 60,A01,494207,Staff,36,0,40,4
1713303208474,SOCI 60,A02,494208,Staff,39,0,40,1
1713303209507,SOCI 100,A01,494210,Payne; Christine Anna,28,0,30,2
1713303209507,SOCI 100,A02,494211,Payne; Christine Anna,28,0,30,2
1713303210532,SOCI 109M,A00,494212,Staff,20,0,20,0
1713303211561,SOCI 110,A00,494213,Staff,36,0,40,4
1713303213613,SOCI 118E,A00,494215,Ng; Kwai,39,0,40,1
1713303214639,SOCI 125,A00,494216,Calderon-Zaks; Michael Aar,43,0,45,2
1713303215665,SOCI 126,A01,494218,Jones; Makeba,4,0,5,1
1713303216696,SOCI 131,A00,494219,Thorpe; Charles Robert,30,0,30,0
1713303218754,SOCI 135,A00,494221,Payne; Christine Anna,44,0,50,6
1713303219787,SOCI 136E,A00,626690,Ruiz; Jonathan Joseph,25,0,25,0
1713303220813,SOCI 138GS,A00,494222,Navon; Daniel,24,0,28,4
1713303222866,SOCI 145,A00,494224,Staff,44,0,45,1
1713303223895,SOCI 153,A00,494225,Staff,28,0,30,2
1713303224920,SOCI 160E,A00,494226,Ng; Kwai,34,0,40,6
1713303225943,SOCI 180,A00,494227,Staff,29,0,30,1
1713303226971,SOCI 189GS,A00,494228,Ribas Norris; Janet Vanesa,11,0,11,0
1713303227994,SOCI 190GS,A00,553232,Ribas Norris; Janet Vanesa,11,0,11,0
1713303229022,SYN 2,001,490768,Staff,14,0,15,1
1713303229022,SYN 2,002,490769,Staff,15,0,15,0
1713303229022,SYN 2,004,490775,Staff,0,0,0,0
1713303229022,SYN 2,003,490774,Staff,0,0,0,0
1713303229022,SYN 2,005,490776,Staff,0,0,0,0
1713303230051,SYN 2R,001,490779,Staff,14,0,15,1
1713303230051,SYN 2R,002,514635,Staff,14,0,15,1
1713303231083,SYN 100,A01,490783,Staff,17,0,20,3
1713303231083,SYN 100,B01,490787,Staff,13,0,20,7
1713303231083,SYN 100,C01,490789,Staff,15,0,20,5
1713303232108,SYN 150,A00,490817,Staff,14,0,15,1
1713303232108,SYN 150,B00,514610,Staff,15,0,15,0
1713303233133,TDAC 1,A00,492753,Walsh; Kim C.,19,0,20,1
1713303233133,TDAC 1,B00,492754,Harting; Carla Kelso,19,0,20,1
1713303233133,TDAC 1,C00,513995,Salovey; Todd,18,0,20,2
1713303234159,TDAC 101,A00,492766,Harting; Carla Kelso,19,0,20,1
1713303235184,TDAC 102,A00,492768,Basso; Beatrice,20,0,20,0
1713303236212,TDDE 111,A00,492769,Staff,25,0,25,0
1713303237241,TDDE 131,A00,492770,Staff,15,0,15,0
1713303237241,TDDE 131,B00,492771,Staff,15,0,15,0
1713303238272,TDDE 131GS,A00,523716,Guirguis; Mark C,25,0,28,3
1713303239297,TDGE 1,A01,492756,Salovey; Todd,58,0,60,2
1713303240322,TDGE 5,A01,492758,Staff,24,0,25,1
1713303241345,TDGE 10,A00,492759,Fulton; Julia,216,0,220,4
1713303242374,TDGE 11,A00,492760,Castro; Robert Jess,200,0,200,0
1713303243428,TDGE 50,A00,492761,Blair; Kyle Adam,0,0,0,0
1713303244454,TDGE 124,A00,492772,Fulton; Julia,202,0,220,18
1713303245481,TDGE 125,A00,492773,Meyer; Ursula,43,0,50,7
1713303245481,TDGE 125,B00,492774,Staff,50,0,50,0
1713303245481,TDGE 125,C00,523565,Staff,50,0,50,0
1713303246505,TDGE 125GS,A00,523580,Guirguis; Mark C,25,0,28,3
1713303247583,TDGE 127,A00,492775,Havis; Allan,44,0,50,6
1713303248610,TDHT 101,A00,492776,Staff,35,0,35,0
1713303249634,TDMV 1,A00,492762,Caligagan; Maria T.,30,0,30,0
1713303249634,TDMV 1,B00,492763,Arcidiacono; Kristin,26,0,30,4
1713303250665,TDMV 2,A00,492764,Weinberg; Sadie,29,0,30,1
1713303251691,TDMV 3,A00,492765,Mack; Kara Shanai',40,0,40,0
1713303252717,TDMV 138,A00,492777,Mack; Kara Shanai',37,0,40,3
1713303253745,TDMV 140,A00,492778,Lima; Paulo Henrique,40,0,40,0
1713303254770,TDMV 142,A00,492779,Caligagan; Maria T.,37,0,40,3
1713303254770,TDMV 142,B00,492780,Caligagan; Tony,38,0,40,2
1713303255801,TDMV 143,A00,492781,Fyall; Daunte Edward,40,0,40,0
1713303256828,USP 1,A01,492401,Kwak; Nancy,29,0,35,6
1713303257853,USP 2,A01,492453,Hinds; Juli Beth,35,0,35,0
1713303258876,USP 3,A01,492516,Staff,32,0,35,3
1713303259908,USP 4,A00,492522,McTague; Sarah,21,0,25,4
1713303260931,USP 100,A00,492523,Staff,33,0,35,2
1713303261955,USP 101,A00,492524,Staff,13,0,15,2
1713303262980,USP 105,A00,492525,Staff,22,0,25,3
1713303264006,USP 151,A00,492526,Shenkman; Michael Thomas,33,0,35,2
1713303265031,USP 170,A00,492545,Hinds; Juli Beth,33,0,35,2
1713303266061,USP 171GS,A00,492608,Bussell; Mirle Rabinowitz,26,0,28,2
1713303267088,USP 183GS,A00,492613,Peerson; Susan,26,0,28,2
1713303268119,VIS 30,A01,490693,Yoldas; Pinar,21,0,22,1
1713303268119,VIS 30,A02,490694,Yoldas; Pinar,19,0,22,3
1713303269149,VIS 83,A00,490695,Kester; Grant,68,0,75,7
1713303270173,VIS 105D,A00,490696,Staff,22,0,25,3
1713303271205,VIS 124CN,A00,490699,Rose; Jordan M,68,0,75,7
1713303272230,VIS 125GS,A00,511221,Williams; Alena J,21,0,22,1
1713303273255,VIS 128D,A00,490700,Staff,74,0,75,1
1713303274283,VIS 151,A01,490717,Staff,34,0,34,0
1713303274283,VIS 151,A02,490766,Staff,33,0,34,1
1713303275311,VIS 154GS,A00,511972,Williams; Alena J,21,0,22,1
1713303276340,VIS 160A,A00,490767,Stone; Patricia,7,0,10,3
1713303277370,WCWP 10A,A00,490638,Staff,15,0,15,0
1713303277370,WCWP 10A,B00,490640,Staff,15,0,15,0
1713303278403,WCWP 10B,A00,490641,Staff,0,0,0,0
1713303278403,WCWP 10B,B00,490642,Staff,14,0,15,1
1713303278403,WCWP 10B,C00,490644,Staff,14,0,15,1
1713303278403,WCWP 10B,D00,490647,Staff,0,0,0,0
1713303279426,WCWP 100,A00,490655,Staff,0,0,0,0
1713303279426,WCWP 100,B00,490687,Staff,12,0,15,3
1713303281524,ANAR 153,A00,487222,Braswell; Geoffrey E.,55,0,60,5
1713303282549,ANBI 134,A00,487223,Staff,15,0,20,5
1713303283573,ANBI 143GS,A00,487224,Noel; Geoffroy Pierre Jean,23,0,24,1
1713303284600,ANBI 144GS,A00,519548,Noel; Geoffroy Pierre Jean,23,0,24,1
1713303285625,ANSC 101,A00,487225,Staff,19,0,20,1
1713303286657,ANSC 125,A00,487227,Brenner; Suzanne A,40,0,40,0
1713303288711,ANSC 146,A00,487229,Staff,37,0,40,3
1713303289744,ANSC 148,A00,487230,Olivas Hernandez; Olga Lid,39,0,40,1
1713303290807,ANSC 150,A00,504165,Sloane; Julia Kathryn,19,0,20,1
1713303291835,ANSC 180,A00,487232,Staff,13,0,15,2
1713303292860,ANTH 5,A00,519529,Semendeferi; Ekaterini,15,0,15,0
1713303293898,ANTH 10,A00,487219,Staff,58,0,60,2
1713303294927,ANTH 23,A01,487221,Staff,19,0,20,1
1713303295953,ANTH 102,A00,487233,Wilder; Linnea Lorene,54,0,60,6
1713303296977,ANTH 103,A00,487234,Varma; Saiba,57,0,60,3
1713303298002,ANTH 105,A00,487235,Stewart; Alexander B,57,0,60,3
1713303299032,BENG 100,A01,516685,Taylor Amos; Alyssa C,28,0,30,2
1713303300058,BIBC 102,A01,491316,Flagg; Matthew Paul,60,0,88,28
1713303300058,BIBC 102,A02,491366,Flagg; Matthew Paul,84,0,88,4
1713303301085,BIBC 103,A01,491486,Boumechache; Miyyada,17,0,24,7
1713303301085,BIBC 103,A02,491487,Boumechache; Miyyada,24,0,24,0
1713303302113,BICD 100,A01,516882,Staff,75,0,75,0
1713303302113,BICD 100,A02,516890,Staff,71,0,75,4
1713303303140,BICD 102GS,A00,491488,Lo; Stanley M.,27,0,28,1
1713303304167,BIEB 136GS,A00,516940,Holway; David A. & Shurin; Jonathan,20,0,24,4
1713303305193,BIEB 137GS,A01,517034,Holway; David A. & Shurin; Jonathan,20,0,24,4
1713303306220,BIEB 138GS,A01,491492,Pirino; Giorgia,22,0,28,6
1713303307256,BILD 1,A01,491296,Staff,62,0,63,1
1713303307256,BILD 1,A02,491297,Staff,63,0,63,0
1713303308288,BILD 4,A01,517099,Gonzalez Gamboa; Ivonne,23,0,24,1
1713303308288,BILD 4,A02,517100,Gonzalez Gamboa; Ivonne,24,0,24,0
1713303309312,BILD 60GS,A00,491309,Lo; Stanley M.,27,0,28,1
1713303310343,BIMM 100,A01,517136,Staff,94,0,100,6
1713303311373,BIMM 110,A01,517182,Staff,80,0,100,20
1713303312400,BIMM 120,A01,517228,Pickett; Brooke Elizabeth,42,0,63,21
1713303312400,BIMM 120,A02,517240,Pickett; Brooke Elizabeth,49,0,63,14
1713303313426,BIMM 132GS,A01,491498,Pirino; Giorgia,22,0,28,6
1713303314455,BIMM 143,A01,491589,Bozinovic; Goran,21,0,40,19
1713303315480,BIPN 100,A01,491594,Armour; Jon Christopher,93,0,100,7
1713303316505,BIPN 140,A01,491602,Marino; Marc J,34,0,50,16
1713303318554,CAT 125,A00,515973,Staff,20,0,20,0
1713303319585,CAT 125GS,A00,515974,Rahimi; Babak,20,0,20,0
1713303320618,CAT 125R,A00,515980,Staff,15,0,20,5
1713303320618,CAT 125R,B00,515981,Tosun; Adriana,19,0,20,1
1713303320618,CAT 125R,C00,515987,Hyland; Tina Mae,6,0,20,14
1713303320618,CAT 125R,D00,515988,Bronstein; Phoebe Malan,19,0,20,1
1713303321644,CENG 15,A01,488699,Drews; Aaron,25,0,25,0
1713303322670,CENG 100,A00,505196,Opatkiewicz; Justin Paul,25,0,25,0
1713303323698,CGS 2A,A01,489598,Staff,33,0,35,2
1713303324723,CGS 112,A00,489599,Staff,15,0,15,0
1713303325748,CGS 119,A00,489603,Staff,10,0,10,0
1713303326773,CGS 120,A00,489604,Staff,14,0,15,1
1713303327801,CGS 150,A00,489607,Staff,15,0,15,0
1713303328824,CHEM 6A,A01,488715,Staff,98,0,100,2
1713303329855,CHEM 6B,A01,488719,Piercy; Marc Anthony,100,0,100,0
1713303330881,CHEM 6C,A01,488723,Albizati; Kim F.,94,0,100,6
1713303331909,CHEM 7L,A01,488728,Schurmeier; Kimberly,18,0,24,6
1713303331909,CHEM 7L,A02,488730,Schurmeier; Kimberly,23,0,24,1
1713303331909,CHEM 7L,A03,488734,Schurmeier; Kimberly,24,0,24,0
1713303331909,CHEM 7L,A04,488763,Schurmeier; Kimberly,23,0,24,1
1713303331909,CHEM 7L,B01,488798,Schurmeier; Kimberly,18,0,24,6
1713303331909,CHEM 7L,B02,488801,Schurmeier; Kimberly,24,0,24,0
1713303331909,CHEM 7L,B03,488808,Schurmeier; Kimberly,24,0,24,0
1713303331909,CHEM 7L,B04,488811,Schurmeier; Kimberly,24,0,24,0
1713303332936,CHEM 11,A01,488897,Stallings; Dontarie M,98,0,100,2
1713303333966,CHEM 40A,A01,488913,Albizati; Kim F.,93,0,100,7
1713303334992,CHEM 40B,A01,488920,Weizman; Haim,48,0,50,2
1713303334992,CHEM 40B,A02,488938,Weizman; Haim,47,0,50,3
1713303336018,CHEM 41A,A01,489029,Klosterman; Jeremy K,58,0,60,2
1713303337044,CHEM 41C,A01,500436,Tor; Yitzhak,56,0,60,4
1713303338075,CHEM 43A,A01,500426,Weizman; Haim,7,0,24,17
1713303338075,CHEM 43A,A02,500430,Weizman; Haim,16,0,24,8
1713303338075,CHEM 43A,B01,514041,Klosterman; Jeremy K,18,0,24,6
1713303338075,CHEM 43A,B02,514047,Klosterman; Jeremy K,23,0,24,1
1713303339101,CHEM 108,A01,489140,Jennings; Patricia A.,15,0,24,9
1713303339101,CHEM 108,A02,489142,Jennings; Patricia A.,18,0,24,6
1713303340130,CHEM 114A,A01,489147,Stallings; Dontarie M,81,0,100,19
1713303341162,CHIN 169A,A00,489171,Wang; Xiao,19,0,20,1
1713303343214,COGS 3,A01,518827,Boyle; Mary E. T.,31,0,40,9
1713303344238,COGS 11,A01,489175,Staff,28,0,30,2
1713303345264,COGS 14A,A01,518829,Staff,55,0,60,5
1713303346289,COGS 14B,A01,489177,Hoffman; Drew Ellen,69,0,75,6
1713303347314,COGS 100,A01,489181,Allen; Michael Gordon,66,0,75,9
1713303348343,COGS 101A,A01,489183,Staff,52,0,60,8
1713303349373,COGS 101B,A01,489185,Allen; Michael Gordon,15,0,30,15
1713303350402,COGS 101C,A01,526786,Staff,25,0,30,5
1713303352508,COGS 107A,A01,489189,Boyle; Mary E. T.,26,0,35,9
1713303353539,COGS 107B,A01,627144,Mooshagian; Eric Frederick,60,0,60,0
1713303354568,COGS 118A,A01,489191,Staff,0,22,40,40
1713303356623,COGS 171GS,A01,489194,Pineda; Jaime A,22,0,28,6
1713303357654,COGS 172,A01,489196,Staff,9,0,30,21
1713303358682,COGS 174GS,A01,489264,Pineda; Jaime A,22,0,28,6
1713303359708,COGS 180,A01,627150,Staff,29,0,30,1
1713303360735,COGS 186,A01,489274,Staff,4,0,30,26
1713303361762,COMM 10,A01,489276,Staff,25,0,25,0
1713303361762,COMM 10,A02,489303,Staff,23,0,25,2
1713303362787,COMM 100A,A01,489312,Staff,21,0,25,4
1713303362787,COMM 100A,A02,489313,Staff,24,0,25,1
1713303363814,COMM 106T,A00,512540,Staff,34,0,35,1
1713303364838,COMM 107,A00,489347,Staff,31,0,35,4
1713303365864,COMM 109P,A00,489358,Staff,31,0,35,4
1713303366889,COMM 132,A00,489361,McKenna; Denise,29,0,30,1
1713303367918,COMM 146,A00,489362,Halm; Gavin Patrick,27,0,30,3
1713303368944,COMM 190,A00,489363,Abuelhiga; Soraya Jill,21,0,23,2
1713303369977,CSE 8A,A50,489366,Staff,24,0,25,1
1713303369977,CSE 8A,A51,489367,Staff,24,0,25,1
1713303371003,CSE 11,A01,489398,Cao; Yingjun,86,0,100,14
1713303372034,CSE 12,A01,489487,Staff,43,0,50,7
1713303373064,CSE 20,A01,489497,Staff,49,0,50,1
1713303374095,CSE 21,A01,489517,Braun; Oliver,44,0,50,6
1713303375119,CSE 101,A01,489524,Braun; Oliver,1,0,50,49
1713303376150,CSE 105,A01,512594,Jones; Miles E,85,0,100,15
1713303376150,CSE 105,B01,512598,Jones; Miles E,73,0,100,27
1713303377180,CSE 140,A01,489538,Staff,45,0,50,5
1713303378206,CSE 141,A01,489550,Eldon; John,77,0,100,23
1713303379232,CSE 141L,A01,489571,Eldon; John,76,0,100,24
1713303380256,CSE 151A,A01,489583,Solares; Edwin A,155,0,200,45
1713303381282,CSE 175,A01,510886,Kumar; Rakesh,30,0,30,0
1713303382313,CSE 190,A00,516828,Dubnov; Shlomo,41,0,49,8
1713303383337,DOC 100D,A00,489667,Pass; Natalye Joann,23,0,25,2
1713303384367,DSC 10,A01,624268,Staff,72,0,75,3
1713303385395,DSC 20,A01,624476,Staff,50,0,50,0
1713303386420,DSC 40A,A01,624608,Staff,40,0,40,0
1713303387450,DSGN 1,A01,489179,Rill; Bryan,38,0,50,12
1713303388475,ECE 17,A01,490489,Sahay; Rajeev,21,0,30,9
1713303389505,ECE 65,A50,490492,Staff,17,0,20,3
1713303389505,ECE 65,A51,490493,Staff,20,0,20,0
1713303390531,ECON 1,A01,489715,Famulari; Melissa,69,0,70,1
1713303391563,ECON 2,A01,489717,Levkoff; Steven B.,69,0,70,1
1713303392592,ECON 3,A01,489948,Staff,70,0,70,0
1713303394644,ECON 5,A01,490103,Staff,28,0,30,2
1713303394644,ECON 5,B01,626281,Dai; Yinlin,45,0,45,0
1713303395677,ECON 100A,A01,490127,Famulari; Melissa,70,0,70,0
1713303396703,ECON 100B,A01,490129,Staff,64,0,70,6
1713303397729,ECON 109,A01,490187,Shishkin; Denis,29,0,35,6
1713303398759,ECON 110A,A01,490190,Levkoff; Steven B.,65,0,70,5
1713303399786,ECON 120A,A01,490245,Dai; Yinlin,69,0,70,1
1713303400816,ECON 120B,A01,490247,Nieto-Barthaburu; Augusto,60,0,70,10
1713303401843,ECON 120C,A01,490253,Sun; Yixiao,32,0,35,3
1713303401843,ECON 120C,B01,490255,Sun; Yixiao,34,0,35,1
1713303402870,ECON 129,A00,490256,Eckert; Fabian Paul,28,0,35,7
1713303403899,ECON 131,A00,490257,Nieto-Barthaburu; Augusto,5,0,35,30
1713303404926,ECON 138,A00,490258,Bharadwaj; Prashant,25,0,35,10
1713303404926,ECON 138,B00,490259,Bharadwaj; Prashant,20,0,35,15
1713303405952,ECON 159,A00,490260,Hendrickson; Gerald M.,0,6,0,0
1713303406976,ECON 178,A01,553995,Zhu; Ying,29,0,35,6
1713303408007,EDS 40,A01,512576,Black; Alison Michelle,20,0,20,0
1713303409032,EDS 107,A01,515848,Staff,30,0,30,0
1713303410063,EDS 110R,A01,490262,Staff,26,0,30,4
1713303411089,EDS 112,A01,490264,Chapman; Thandeka K,45,0,50,5
1713303412119,EDS 113,A00,490266,Staff,28,0,30,2
1713303413143,EDS 118,A00,490267,Warstadt; Melissa Fawn,27,0,30,3
1713303414173,EDS 124BR,A00,490268,Eguchi; Emi,10,0,25,15
1713303414173,EDS 124BR,B00,490269,Eguchi; Emi,25,0,25,0
1713303415196,EDS 126,A01,490271,Jones; Makeba,47,0,50,3
1713303416222,EDS 135,A01,490316,Staff,20,0,20,0
1713303417252,ENVR 142GS,A00,519514,Chang; Edmond Yi-Teh,28,0,28,0
1713303418278,ETHN 103,A00,490504,Staff,33,0,36,3
1713303419310,ETHN 103A,A00,490505,Man; Simeon S,7,0,9,2
1713303420339,ETHN 109,A00,490506,Staff,30,0,30,0
1713303421368,ETHN 118,A00,490507,Staff,35,0,36,1
1713303422397,ETHN 119,A00,490508,Staff,36,0,36,0
1713303423433,ETHN 121R,A00,490518,Choi; Esther Min,30,0,36,6
1713303424460,ETHN 127,A00,490528,Staff,15,0,15,0
1713303425487,ETHN 139,A00,490573,Staff,10,0,10,0
1713303426517,ETHN 150,A00,490575,Staff,15,0,15,0
1713303427541,GLBH 20,A00,491705,Elwardani; Nile Regina,38,0,40,2
1713303428566,GLBH 101,A00,491706,Staff,20,0,20,0
1713303429599,GLBH 111,A01,491708,Burgos; Jose L.,15,0,15,0
1713303430625,GLBH 146,A00,491709,Staff,15,0,20,5
1713303431652,GLBH 148,A00,491710,Olivas Hernandez; Olga Lid,17,0,20,3
1713303432681,GLBH 150,A00,491711,Sloane; Julia Kathryn,20,0,20,0
1713303433709,HIEA 131,A00,491760,Staff,30,0,32,2
1713303434733,HIEA 153,A00,491762,Staff,29,0,30,1
1713303435757,HIEU 124,A00,491811,Staff,29,0,32,3
1713303436782,HIEU 124GS,A00,491812,Markman; Kristina,28,0,28,0
1713303437812,HIEU 147,A00,491813,Staff,31,0,32,1
1713303438843,HIEU 149GS,A00,491816,Caldwell; Michael Alan,28,0,28,0
1713303439871,HILD 2C,A01,491713,Hendrickson; Gerald M.,28,0,30,2
1713303440894,HILD 7B,A01,491715,Kwak; Nancy,17,0,30,13
1713303441919,HILD 10,A01,491717,Staff,16,0,20,4
1713303442947,HILD 30GS,A00,491719,Edington; Claire Ellen,24,0,28,4
1713303443974,HINE 109,A00,491818,Shafir; Nir,31,0,32,1
1713303445011,HINE 128,A00,491821,Shafir; Nir,32,0,32,0
1713303446040,HISC 117,A00,491830,Staff,29,0,32,3
1713303447068,HIUS 103,A00,491834,Man; Simeon S,18,0,23,5
1713303448096,HIUS 108B,A00,491835,Staff,30,0,30,0
1713303449126,HIUS 141,A00,491836,Hendrickson; Gerald M.,29,0,32,3
1713303450151,HIUS 149,A00,491839,Staff,28,0,32,4
1713303451178,HUM 3,A01,512617,Crum; Matthew Stephen,46,0,50,4
1713303451178,HUM 3,A02,512618,Crum; Matthew Stephen,49,0,50,1
1713303452208,HUM 3GS,A00,512663,Markman; Kristina,0,0,0,0
1713303452208,HUM 3GS,B00,512664,Staff,0,0,0,0
1713303453235,HUM 4,A01,512620,West; Geoffrey Scott,39,0,50,11
1713303454258,HUM 4GS,A00,512666,Lyon; Antony J.,0,0,0,3
1713303455338,HUM 4R,A01,512625,Watkins; Eric,49,0,50,1
1713303456368,HUM 5,A01,512649,Zavodny; Tatiana Sophia,35,0,50,15
1713303456368,HUM 5,B01,512661,Zroka; Ryan Edward,49,0,50,1
1713303457397,INTL 190,A00,490577,Segui; Alan S,0,0,0,5
1713303458427,JAPN 20AR,A01,491267,Ross; Kayoko F,12,0,20,8
1713303459455,JAPN 180,A00,491285,Berman; Michael David,35,0,40,5
1713303460487,LATI 50,A01,502536,Kokinis; Troy Andreas,19,0,22,3
1713303460487,LATI 50,A02,502551,Kokinis; Troy Andreas,22,0,22,0
1713303460487,LATI 50,A03,502650,Kokinis; Troy Andreas,22,0,22,0
1713303460487,LATI 50,A04,502909,Kokinis; Troy Andreas,22,0,22,0
1713303461516,LATI 160,A01,502920,Kokinis; Troy Andreas,30,0,30,0
1713303462700,LIFR 1A,A00,490494,Van Moer; Vinciane G,18,0,20,2
1713303463730,LIFR 1AX,A00,490495,Van Moer; Vinciane G,18,0,20,2
1713303464755,LIFR 1B,A00,490496,Van Moer; Vinciane G,20,0,20,0
1713303465782,LIFR 1BX,A00,490497,Van Moer; Vinciane G,20,0,20,0
1713303466807,LIGN 8,A00,505198,McIntosh; Justin Daniel,144,0,150,6
1713303467832,LIGN 9GS,A00,491239,Lott; Margaret S.,18,0,20,2
1713303468857,LIGN 101,A01,505200,McIntosh; Justin Daniel,26,0,30,4
1713303469888,LIGN 120,A01,491244,Staff,26,0,30,4
1713303470916,LIGN 149GS,A00,491245,Lott; Margaret S.,18,0,20,2
1713303471945,LIGN 170,A00,491247,Staff,25,0,30,5
1713303472971,LISP 1D,A00,490498,Munoz Sanchez; Alicia,11,0,14,3
1713303472971,LISP 1D,B00,490499,Munoz Sanchez; Alicia,7,0,14,7
1713303472971,LISP 1D,C00,490500,Munoz Sanchez; Alicia,10,0,14,4
1713303472971,LISP 1D,D00,490501,Munoz Sanchez; Alicia,11,0,14,3
1713303473995,LISP 1DX,A00,490502,Munoz Sanchez; Alicia,19,0,28,9
1713303473995,LISP 1DX,B00,490503,Munoz Sanchez; Alicia,19,0,28,9
1713303476046,LTAM 110,A00,491847,Staff,23,0,25,2
1713303477071,LTCS 119,A00,491848,Staff,13,0,15,2
1713303478099,LTCS 130,A00,491849,Staff,24,0,25,1
1713303480162,LTEA 120C,A00,491852,Staff,35,0,40,5
1713303481189,LTEN 130GS,A00,491853,Lyon; Antony J.,25,0,28,3
1713303482217,LTEN 148,A00,491855,Staff,23,0,25,2
1713303483244,LTEN 159,A00,491856,Staff,21,0,25,4
1713303484269,LTEN 180,A00,491857,Staff,10,0,15,5
1713303486320,LTSP 123GS,A00,505928,Bessett; Ryan Matthew,25,0,28,3
1713303487347,LTSP 174GS,A00,506037,Bessett; Ryan Matthew,25,0,28,3
1713303489401,LTWR 102,A00,491861,Staff,12,0,15,3
1713303490426,LTWR 106,A00,491862,Staff,11,0,15,4
1713303491453,MAE 11,A00,490930,Bahadori; Mohammad Yousef,98,0,100,2
1713303492481,MAE 30A,A00,490931,Qi; Huihui,38,0,40,2
1713303493512,MAE 101A,A00,491036,Sadeghizadeh; Zahra,98,0,100,2
1713303494540,MAE 101C,A00,491037,Seshadri; Kalyanasundaram,78,0,100,22
1713303495569,MAE 113,A00,491040,Seshadri; Kalyanasundaram,67,0,80,13
1713303496598,MAE 131A,A00,491041,Ghazinejad; Maziar,39,0,40,1
1713303497626,MAE 142,A00,491053,Staff,39,0,40,1
1713303498651,MAE 143A,A00,491054,Staff,43,0,50,7
1713303499677,MAE 150,A00,491092,Truong; Phuong Thi Ngoc,25,0,35,10
1713303500702,MATH 3C,A01,494031,Pardo Guerra; Sebastian,30,0,30,0
1713303500702,MATH 3C,A02,494032,Pardo Guerra; Sebastian,29,0,30,1
1713303501729,MATH 10A,A01,494034,Staff,29,0,30,1
1713303501729,MATH 10A,A02,494035,Staff,29,0,30,1
1713303501729,MATH 10A,B01,494037,Staff,28,0,30,2
1713303501729,MATH 10A,B02,494038,Staff,29,0,30,1
1713303502766,MATH 10B,A01,494040,Habib; Yousaf,24,0,30,6
1713303502766,MATH 10B,A02,494041,Habib; Yousaf,28,0,30,2
1713303502766,MATH 10B,A03,494042,Habib; Yousaf,30,0,30,0
1713303502766,MATH 10B,A04,494043,Habib; Yousaf,30,0,30,0
1713303502766,MATH 10B,B01,494045,Habib; Yousaf,28,0,30,2
1713303502766,MATH 10B,B02,494046,Habib; Yousaf,30,0,30,0
1713303502766,MATH 10B,B03,494047,Habib; Yousaf,30,0,30,0
1713303502766,MATH 10B,B04,494048,Habib; Yousaf,30,0,30,0
1713303503803,MATH 18,A01,494050,Kemp; Todd Aahron,28,0,30,2
1713303503803,MATH 18,A02,494051,Kemp; Todd Aahron,29,0,30,1
1713303503803,MATH 18,B01,494054,Kemp; Todd Aahron,28,0,30,2
1713303503803,MATH 18,B02,494055,Kemp; Todd Aahron,29,0,30,1
1713303504829,MATH 20A,A01,494059,Suk; Andrew Hoon,30,0,30,0
1713303505861,MATH 20B,A01,494061,Briones; Jor-el Thomas Caparas,34,0,35,1
1713303505861,MATH 20B,B01,494063,Bach; Quang Tran,34,0,35,1
1713303506897,MATH 20C,A01,494065,Staff,29,0,30,1
1713303506897,MATH 20C,A02,494066,Staff,30,0,30,0
1713303506897,MATH 20C,A03,494067,Staff,30,0,30,0
1713303506897,MATH 20C,A04,494068,Staff,30,0,30,0
1713303506897,MATH 20C,B01,494070,Zhang; Ming,27,0,30,3
1713303506897,MATH 20C,B02,494071,Zhang; Ming,30,0,30,0
1713303506897,MATH 20C,B03,494072,Zhang; Ming,29,0,30,1
1713303506897,MATH 20C,B04,494073,Zhang; Ming,29,0,30,1
1713303507922,MATH 20D,A01,494075,Staff,27,0,30,3
1713303507922,MATH 20D,A02,494076,Staff,30,0,30,0
1713303508953,MATH 20E,A01,494079,Staff,25,0,30,5
1713303508953,MATH 20E,A02,494080,Staff,28,0,30,2
1713303508953,MATH 20E,B01,494082,Staff,28,0,30,2
1713303508953,MATH 20E,B02,494083,Staff,25,0,30,5
1713303509980,MATH 103A,A01,494085,Aliabadi Sr.; Mohsen,22,0,30,8
1713303509980,MATH 103A,A02,494086,Aliabadi Sr.; Mohsen,29,0,30,1
1713303509980,MATH 103A,B01,494088,Aliabadi Sr.; Mohsen,22,0,30,8
1713303509980,MATH 103A,B02,494089,Aliabadi Sr.; Mohsen,28,0,30,2
1713303511011,MATH 109,A01,494091,Staff,30,0,30,0
1713303511011,MATH 109,A02,494092,Staff,30,0,30,0
1713303511011,MATH 109,B01,494094,Staff,28,0,30,2
1713303511011,MATH 109,B02,494095,Staff,29,0,30,1
1713303512039,MATH 142A,A01,494097,Chow; Bennett,17,0,30,13
1713303512039,MATH 142A,A02,494098,Chow; Bennett,26,0,30,4
1713303512039,MATH 142A,B01,494100,Chow; Bennett,23,0,30,7
1713303512039,MATH 142A,B02,494101,Chow; Bennett,29,0,30,1
1713303514089,MATH 168A,A01,516677,Dumitriu; Ioana,17,0,35,18
1713303515114,MATH 170A,A01,516679,Dumitriu; Ioana,23,0,30,7
1713303515114,MATH 170A,A02,516680,Dumitriu; Ioana,28,0,30,2
1713303516222,MATH 193A,A01,494107,Staff,19,0,30,11
1713303516222,MATH 193A,A02,494108,Staff,26,0,30,4
1713303516222,MATH 193A,A03,494109,Staff,29,0,30,1
1713303516222,MATH 193A,A04,494110,Staff,27,0,30,3
1713303519296,MGT 16,A00,491930,McKay; Michael J,94,0,98,4
1713303520322,MGT 18,A00,491992,McKay; Michael J,97,0,98,1
1713303521347,MGT 71,A00,492003,Staff,79,0,98,19
1713303522381,MGT 103,A00,505209,Eberhard; Craig A,88,0,98,10
1713303523408,MGT 131A,A00,505210,Anderson; John Charles,91,0,98,7
1713303525461,MGT 153,A00,492077,Perols; Johan Lars,55,0,90,35
1713303528535,MGT 164,A00,492222,McKay; Mary A,94,0,98,4
1713303529562,MGT 172,A00,492245,Staff,59,0,60,1
1713303529562,MGT 172,B00,505526,Hedges; Kathleen,80,0,98,18
1713303530590,MGT 181,A00,505669,Dunn; Louis Jean,89,0,98,9
1713303531620,MMW 14,A01,494399,Staff,24,0,28,4
1713303531620,MMW 14,A02,494400,Staff,27,0,28,1
1713303531620,MMW 14,A03,494401,Staff,28,0,28,0
1713303531620,MMW 14,A04,494402,Staff,28,0,28,0
1713303531620,MMW 14,B01,494404,Carreras; Maria Victoria,18,0,28,10
1713303531620,MMW 14,B02,494405,Carreras; Maria Victoria,27,0,28,1
1713303531620,MMW 14,B03,494406,Carreras; Maria Victoria,28,0,28,0
1713303531620,MMW 14,B04,494407,Carreras; Maria Victoria,28,0,28,0
1713303532645,MMW 14GS,A00,506250,Chang; Edmond Yi-Teh,0,0,0,0
1713303533674,MMW 121R,A01,494415,Adamiak; Patrick John,16,0,28,12
1713303533674,MMW 121R,A02,494416,Adamiak; Patrick John,25,0,28,3
1713303534700,MUS 1A,A01,494113,Staff,14,0,25,11
1713303534700,MUS 1A,A02,494114,Staff,25,0,25,0
1713303535732,MUS 4,A01,494116,Staff,24,0,25,1
1713303535732,MUS 4,A02,494117,Staff,22,0,25,3
1713303536762,MUS 5R,A01,494236,Dubnov; Shlomo,13,0,25,12
1713303536762,MUS 5R,A02,494237,Dubnov; Shlomo,25,0,25,0
1713303537784,MUS 6,A01,494122,Staff,17,0,25,8
1713303537784,MUS 6,A02,494123,Staff,24,0,25,1
1713303538850,MUS 7,A01,494125,Staff,20,0,25,5
1713303538850,MUS 7,A02,494126,Staff,24,0,25,1
1713303539875,MUS 11,A01,494128,Staff,23,0,25,2
1713303539875,MUS 11,A02,494129,Staff,25,0,25,0
1713303540899,MUS 13,A01,494131,Staff,25,0,25,0
1713303540899,MUS 13,A02,494132,Staff,25,0,25,0
1713303541926,MUS 15,A01,494134,Staff,21,0,25,4
1713303541926,MUS 15,A02,494135,Staff,25,0,25,0
1713303541926,MUS 15,B01,494137,Staff,25,0,25,0
1713303542951,MUS 80,A00,494232,Staff,25,0,25,0
1713303542951,MUS 80,B00,494233,Staff,25,0,25,0
1713303542951,MUS 80,C00,494234,Staff,23,0,25,2
1713303543976,MUS 95C,A00,494141,Staff,73,0,75,2
1713303545002,MUS 114,A00,494142,Staff,42,0,50,8
1713303546032,NANO 15,A01,490636,Drews; Aaron,7,0,7,0
1713303547061,PHIL 1,A00,490578,Grush; Rick Scott,50,0,50,0
1713303548086,PHIL 10,A01,490580,Grush; Rick Scott,34,0,35,1
1713303548086,PHIL 10,A02,490586,Grush; Rick Scott,33,0,35,2
1713303549110,PHIL 27,A01,490591,Staff,24,0,25,1
1713303549110,PHIL 27,A02,490592,Staff,25,0,25,0
1713303549110,PHIL 27,A03,490593,Staff,25,0,25,0
1713303549110,PHIL 27,A04,490598,Staff,25,0,25,0
1713303550140,PHIL 32,A01,490611,Staff,20,0,20,0
1713303550140,PHIL 32,A02,490618,Staff,20,0,20,0
1713303551163,PHIL 90,A00,490624,Staff,40,0,40,0
1713303552188,PHIL 136,A00,490627,Cohen; Jonathan David,38,0,40,2
1713303553213,PHIL 155,A00,490634,Staff,67,0,70,3
1713303554239,PHYS 1A,A00,491610,Staff,246,0,250,4
1713303555267,PHYS 1AL,001,491616,Tsai; Philbert S,28,0,30,2
1713303555267,PHYS 1AL,002,491618,Tsai; Philbert S,30,0,30,0
1713303556293,PHYS 1B,A00,491623,Staff,245,0,250,5
1713303557318,PHYS 1BL,001,491626,Tsai; Philbert S,27,0,30,3
1713303557318,PHYS 1BL,002,491628,Tsai; Philbert S,28,0,30,2
1713303558343,PHYS 1C,A00,491632,Staff,228,0,245,17
1713303559422,PHYS 1CL,001,491635,Tsai; Philbert S,12,0,30,18
1713303559422,PHYS 1CL,002,491643,Tsai; Philbert S,26,0,30,4
1713303560449,PHYS 2AR,A01,491651,Meyertholen; Andrew D.,46,0,50,4
1713303561473,PHYS 2B,A01,491659,Staff,107,0,115,8
1713303562502,PHYS 2BL,A01,491685,Staff,24,0,24,0
1713303562502,PHYS 2BL,A02,491700,Staff,23,0,24,1
1713303563527,PHYS 2C,A01,505161,Staff,108,0,115,7
1713303564553,PHYS 4A,A01,491704,Grinstein; Benjamin,100,0,100,0
1713303565584,POLI 5D,A01,494144,Staff,3,0,5,2
1713303565584,POLI 5D,B01,626283,Dai; Yinlin,5,0,5,0
1713303566608,POLI 12,A00,494145,Staff,44,0,45,1
1713303567636,POLI 13R,A00,494146,Forman; Fonna,47,0,50,3
1713303568659,POLI 27,A01,494148,Staff,60,0,60,0
1713303569687,POLI 30,A00,494149,Staff,49,0,50,1
1713303570711,POLI 100DA,A00,494150,Staff,23,0,25,2
1713303572765,POLI 100I,A00,494152,Staff,29,0,30,1
1713303573793,POLI 104B,A00,494153,Smith; Glenn Chatmas,54,0,55,1
1713303574819,POLI 104F,A00,494154,Staff,29,0,30,1
1713303575844,POLI 104I,A00,494155,Smith; Glenn Chatmas,30,0,30,0
1713303576869,POLI 110C,A00,494156,Ingham; Sean,23,0,25,2
1713303577895,POLI 117R,A00,494157,Forman; Fonna,16,0,20,4
1713303578923,POLI 118,A00,494158,Ingham; Sean,23,0,25,2
1713303579949,POLI 120H,A00,494159,Fisk; David Lee,41,0,45,4
1713303580974,POLI 131CR,A00,494160,Hoston; Germaine,43,0,45,2
1713303581999,POLI 133J,A00,494161,Staff,33,0,35,2
1713303583028,POLI 135,A00,494162,Fisk; David Lee,34,0,35,1
1713303584055,POLI 140A,A00,494164,Staff,23,0,30,7
1713303585083,POLI 142I,A00,494165,Staff,30,0,30,0
1713303586108,POLI 144D,A00,494166,Staff,23,0,25,2
1713303587134,POLI 151,A00,494167,Staff,30,0,30,0
1713303588159,POLI 153,A00,494168,Staff,34,0,35,1
1713303589184,POLI 160AA,A00,494169,Staff,36,0,40,4
1713303590215,POLI 162,A00,494170,Mignozzetti; Umberto,22,0,25,3
1713303591239,POLI 171,A00,494171,Mignozzetti; Umberto,23,0,25,2
1713303592270,PSYC 1,A00,494172,Staff,97,0,100,3
1713303593297,PSYC 2,A00,494173,Moranton; Nirelia Melbina-,48,0,50,2
1713303594321,PSYC 3,A00,494174,Staff,30,0,30,0
1713303595346,PSYC 6,A00,494175,Staff,17,0,20,3
1713303596375,PSYC 60,A01,494177,Staff,43,0,45,2
1713303597400,PSYC 70,A01,505724,Geller; Emma Harlan,42,0,45,3
1713303598425,PSYC 101,A00,494180,Heyman; Gail D.,93,0,100,7
1713303599451,PSYC 105,A00,494181,Geller; Emma Harlan,68,0,90,22
1713303600476,PSYC 106,A00,494182,Dobkins; Karen R.,34,0,45,11
1713303601504,PSYC 108,A00,494183,Adrian; Julia Anna,94,0,100,6
1713303602531,PSYC 114,A01,494185,Winkielman; Piotr,8,0,30,22
1713303603555,PSYC 122,A00,494186,Moranton; Nirelia Melbina-,41,0,50,9
1713303604581,PSYC 124,A00,494187,Chapman; Eddie Nathaniel,74,0,80,6
1713303605608,PSYC 131,A00,494188,Anagnostaras; Stephan,62,0,80,18
1713303606634,PSYC 144,A00,494189,Staff,23,0,50,27
1713303607664,PSYC 154,A00,494190,Lacefield; Katharine I,144,0,180,36
1713303608690,PSYC 162,A00,494191,Wixted; John T,91,0,100,9
1713303609716,PSYC 172,A00,494192,Gorman; Michael R.,38,0,45,7
1713303610746,PSYC 178,A00,494193,Glaser; Dale,41,0,45,4
1713303611778,PSYC 193,A00,505725,Chapman; Eddie Nathaniel,20,0,20,0
1713303612802,RELI 145GS,A00,519817,Rahimi; Babak,19,0,20,1
1713303613828,SE 101A,A01,490862,Chadha; Mayank,24,0,25,1
1713303614854,SE 101C,A01,490924,Krysl; Petr,18,0,20,2
1713303615882,SE 110A,A01,490928,Staff,20,0,20,0
1713303616914,SE 130A,A00,490929,Morrison; Machel Leigh,66,0,70,4
1713303617940,SIO 1,A01,519325,Staff,39,0,40,1
1713303618973,SIO 30,A01,519327,Staff,40,0,40,0
1713303620005,SIO 40,A00,519328,Staff,40,0,40,0
1713303621038,SIO 46GS,A00,519819,Cook; Geoffrey W,19,0,25,6
1713303622064,SIO 109R,A00,494197,Forman; Fonna,10,0,20,10
1713303623091,SIO 121GS,A00,519827,Cook; Geoffrey W,19,0,25,6
1713303624120,SIO 132,A01,519330,Staff,38,0,40,2
1713303625167,SIO 133,A01,519397,Staff,40,0,40,0
1713303626192,SIO 139,A00,519396,Kacev; David,34,0,40,6
1713303627219,SOCI 1,A01,494199,Thorpe; Charles Robert,24,0,30,6
1713303627219,SOCI 1,A02,494200,Thorpe; Charles Robert,30,0,30,0
1713303627219,SOCI 1,A03,494201,Thorpe; Charles Robert,29,0,30,1
1713303627219,SOCI 1,A04,494202,Thorpe; Charles Robert,29,0,30,1
1713303627219,SOCI 1,A05,494203,Thorpe; Charles Robert,29,0,30,1
1713303627219,SOCI 1,A06,494204,Thorpe; Charles Robert,30,0,30,0
1713303627219,SOCI 1,A07,494205,Thorpe; Charles Robert,29,0,30,1
1713303628244,SOCI 60,A01,494207,Staff,36,0,40,4
1713303628244,SOCI 60,A02,494208,Staff,39,0,40,1
1713303629271,SOCI 100,A01,494210,Payne; Christine Anna,28,0,30,2
1713303629271,SOCI 100,A02,494211,Payne; Christine Anna,28,0,30,2
1713303630299,SOCI 109M,A00,494212,Staff,20,0,20,0
1713303631331,SOCI 110,A00,494213,Staff,35,0,40,5
1713303633397,SOCI 118E,A00,494215,Ng; Kwai,38,0,40,2
1713303634423,SOCI 125,A00,494216,Calderon-Zaks; Michael Aar,43,0,45,2
1713303635454,SOCI 126,A01,494218,Jones; Makeba,4,0,5,1
1713303636481,SOCI 131,A00,494219,Thorpe; Charles Robert,30,0,30,0
1713303638530,SOCI 135,A00,494221,Payne; Christine Anna,44,0,50,6
1713303639555,SOCI 136E,A00,626690,Ruiz; Jonathan Joseph,25,0,25,0
1713303640616,SOCI 138GS,A00,494222,Navon; Daniel,24,0,28,4
1713303642665,SOCI 145,A00,494224,Staff,44,0,45,1
1713303643689,SOCI 153,A00,494225,Staff,28,0,30,2
1713303644719,SOCI 160E,A00,494226,Ng; Kwai,34,0,40,6
1713303645743,SOCI 180,A00,494227,Staff,29,0,30,1
1713303646768,SOCI 189GS,A00,494228,Ribas Norris; Janet Vanesa,11,0,11,0
1713303647796,SOCI 190GS,A00,553232,Ribas Norris; Janet Vanesa,11,0,11,0
1713303648826,SYN 2,001,490768,Staff,14,0,15,1
1713303648826,SYN 2,002,490769,Staff,15,0,15,0
1713303648826,SYN 2,004,490775,Staff,0,0,0,0
1713303648826,SYN 2,003,490774,Staff,0,0,0,0
1713303648826,SYN 2,005,490776,Staff,0,0,0,0
1713303649856,SYN 2R,001,490779,Staff,14,0,15,1
1713303649856,SYN 2R,002,514635,Staff,14,0,15,1
1713303650886,SYN 100,A01,490783,Staff,17,0,20,3
1713303650886,SYN 100,B01,490787,Staff,13,0,20,7
1713303650886,SYN 100,C01,490789,Staff,15,0,20,5
1713303651914,SYN 150,A00,490817,Staff,14,0,15,1
1713303651914,SYN 150,B00,514610,Staff,15,0,15,0
1713303652941,TDAC 1,A00,492753,Walsh; Kim C.,19,0,20,1
1713303652941,TDAC 1,B00,492754,Harting; Carla Kelso,19,0,20,1
1713303652941,TDAC 1,C00,513995,Salovey; Todd,18,0,20,2
1713303653966,TDAC 101,A00,492766,Harting; Carla Kelso,19,0,20,1
1713303654991,TDAC 102,A00,492768,Basso; Beatrice,20,0,20,0
1713303656018,TDDE 111,A00,492769,Staff,25,0,25,0
1713303657044,TDDE 131,A00,492770,Staff,15,0,15,0
1713303657044,TDDE 131,B00,492771,Staff,15,0,15,0
1713303658070,TDDE 131GS,A00,523716,Guirguis; Mark C,25,0,28,3
1713303659101,TDGE 1,A01,492756,Salovey; Todd,58,0,60,2
1713303660131,TDGE 5,A01,492758,Staff,24,0,25,1
1713303661160,TDGE 10,A00,492759,Fulton; Julia,216,0,220,4
1713303662186,TDGE 11,A00,492760,Castro; Robert Jess,200,0,200,0
1713303663271,TDGE 50,A00,492761,Blair; Kyle Adam,0,0,0,0
1713303664301,TDGE 124,A00,492772,Fulton; Julia,202,0,220,18
1713303665334,TDGE 125,A00,492773,Meyer; Ursula,43,0,50,7
1713303665334,TDGE 125,B00,492774,Staff,50,0,50,0
1713303665334,TDGE 125,C00,523565,Staff,50,0,50,0
1713303666361,TDGE 125GS,A00,523580,Guirguis; Mark C,25,0,28,3
1713303667387,TDGE 127,A00,492775,Havis; Allan,44,0,50,6
1713303668413,TDHT 101,A00,492776,Staff,35,0,35,0
1713303669441,TDMV 1,A00,492762,Caligagan; Maria T.,30,0,30,0
1713303669441,TDMV 1,B00,492763,Arcidiacono; Kristin,26,0,30,4
1713303670467,TDMV 2,A00,492764,Weinberg; Sadie,29,0,30,1
1713303671493,TDMV 3,A00,492765,Mack; Kara Shanai',40,0,40,0
1713303672520,TDMV 138,A00,492777,Mack; Kara Shanai',37,0,40,3
1713303673546,TDMV 140,A00,492778,Lima; Paulo Henrique,40,0,40,0
1713303674570,TDMV 142,A00,492779,Caligagan; Maria T.,37,0,40,3
1713303674570,TDMV 142,B00,492780,Caligagan; Tony,38,0,40,2
1713303675595,TDMV 143,A00,492781,Fyall; Daunte Edward,40,0,40,0
1713303676619,USP 1,A01,492401,Kwak; Nancy,29,0,35,6
1713303677651,USP 2,A01,492453,Hinds; Juli Beth,35,0,35,0
1713303678676,USP 3,A01,492516,Staff,32,0,35,3
1713303679709,USP 4,A00,492522,McTague; Sarah,20,0,25,5
1713303680738,USP 100,A00,492523,Staff,33,0,35,2
1713303681762,USP 101,A00,492524,Staff,13,0,15,2
1713303682791,USP 105,A00,492525,Staff,22,0,25,3
1713303683823,USP 151,A00,492526,Shenkman; Michael Thomas,33,0,35,2
1713303684853,USP 170,A00,492545,Hinds; Juli Beth,33,0,35,2
1713303685882,USP 171GS,A00,492608,Bussell; Mirle Rabinowitz,26,0,28,2
1713303686910,USP 183GS,A00,492613,Peerson; Susan,26,0,28,2
1713303687938,VIS 30,A01,490693,Yoldas; Pinar,21,0,22,1
1713303687938,VIS 30,A02,490694,Yoldas; Pinar,19,0,22,3
1713303688963,VIS 83,A00,490695,Kester; Grant,68,0,75,7
1713303689993,VIS 105D,A00,490696,Staff,22,0,25,3
1713303691018,VIS 124CN,A00,490699,Rose; Jordan M,68,0,75,7
1713303692046,VIS 125GS,A00,511221,Williams; Alena J,21,0,22,1
1713303693075,VIS 128D,A00,490700,Staff,74,0,75,1
1713303694099,VIS 151,A01,490717,Staff,34,0,34,0
1713303694099,VIS 151,A02,490766,Staff,33,0,34,1
1713303695130,VIS 154GS,A00,511972,Williams; Alena J,21,0,22,1
1713303696156,VIS 160A,A00,490767,Stone; Patricia,7,0,10,3
1713303697185,WCWP 10A,A00,490638,Staff,15,0,15,0
1713303697185,WCWP 10A,B00,490640,Staff,15,0,15,0
1713303698215,WCWP 10B,A00,490641,Staff,0,0,0,0
1713303698215,WCWP 10B,B00,490642,Staff,14,0,15,1
1713303698215,WCWP 10B,C00,490644,Staff,14,0,15,1
1713303698215,WCWP 10B,D00,490647,Staff,0,0,0,0
1713303699243,WCWP 100,A00,490655,Staff,0,0,0,0
1713303699243,WCWP 100,B00,490687,Staff,12,0,15,3
1713303701396,ANAR 153,A00,487222,Braswell; Geoffrey E.,55,0,60,5
1713303702423,ANBI 134,A00,487223,Staff,14,0,20,6
1713303703452,ANBI 143GS,A00,487224,Noel; Geoffroy Pierre Jean,22,0,24,2
1713303704476,ANBI 144GS,A00,519548,Noel; Geoffroy Pierre Jean,22,0,24,2
1713303705500,ANSC 101,A00,487225,Staff,19,0,20,1
1713303706533,ANSC 125,A00,487227,Brenner; Suzanne A,40,0,40,0
1713303708590,ANSC 146,A00,487229,Staff,37,0,40,3
1713303709615,ANSC 148,A00,487230,Olivas Hernandez; Olga Lid,39,0,40,1
1713303710641,ANSC 150,A00,504165,Sloane; Julia Kathryn,19,0,20,1
1713303711666,ANSC 180,A00,487232,Staff,13,0,15,2
1713303712691,ANSC 188,A00,627155,Staff,40,0,40,0
1713303713718,ANTH 5,A00,519529,Semendeferi; Ekaterini,15,0,15,0
1713303714745,ANTH 10,A00,487219,Staff,58,0,60,2
1713303715770,ANTH 23,A01,487221,Staff,19,0,20,1
1713303716796,ANTH 102,A00,487233,Wilder; Linnea Lorene,53,0,60,7
1713303717822,ANTH 103,A00,487234,Varma; Saiba,57,0,60,3
1713303718849,ANTH 105,A00,487235,Stewart; Alexander B,57,0,60,3
1713303719879,BENG 100,A01,516685,Taylor Amos; Alyssa C,28,0,30,2
1713303720904,BIBC 102,A01,491316,Flagg; Matthew Paul,60,0,88,28
1713303720904,BIBC 102,A02,491366,Flagg; Matthew Paul,84,0,88,4
1713303721930,BIBC 103,A01,491486,Boumechache; Miyyada,17,0,24,7
1713303721930,BIBC 103,A02,491487,Boumechache; Miyyada,24,0,24,0
1713303722960,BICD 100,A01,516882,Staff,75,0,75,0
1713303722960,BICD 100,A02,516890,Staff,71,0,75,4
1713303723984,BICD 102GS,A00,491488,Lo; Stanley M.,27,0,28,1
1713303725011,BIEB 136GS,A00,516940,Holway; David A. & Shurin; Jonathan,20,0,24,4
1713303726036,BIEB 137GS,A01,517034,Holway; David A. & Shurin; Jonathan,20,0,24,4
1713303727064,BIEB 138GS,A01,491492,Pirino; Giorgia,22,0,28,6
1713303728090,BILD 1,A01,491296,Staff,62,0,63,1
1713303728090,BILD 1,A02,491297,Staff,63,0,63,0
1713303729121,BILD 4,A01,517099,Gonzalez Gamboa; Ivonne,23,0,24,1
1713303729121,BILD 4,A02,517100,Gonzalez Gamboa; Ivonne,24,0,24,0
1713303730149,BILD 60GS,A00,491309,Lo; Stanley M.,27,0,28,1
1713303731178,BIMM 100,A01,517136,Staff,94,0,100,6
1713303732202,BIMM 110,A01,517182,Staff,80,0,100,20
1713303733231,BIMM 120,A01,517228,Pickett; Brooke Elizabeth,42,0,63,21
1713303733231,BIMM 120,A02,517240,Pickett; Brooke Elizabeth,49,0,63,14
1713303734256,BIMM 132GS,A01,491498,Pirino; Giorgia,22,0,28,6
1713303735282,BIMM 143,A01,491589,Bozinovic; Goran,21,0,40,19
1713303736312,BIPN 100,A01,491594,Armour; Jon Christopher,93,0,100,7
1713303737344,BIPN 140,A01,491602,Marino; Marc J,34,0,50,16
1713303739398,CAT 125,A00,515973,Staff,20,0,20,0
1713303740426,CAT 125GS,A00,515974,Rahimi; Babak,19,0,20,1
1713303741453,CAT 125R,A00,515980,Staff,15,0,20,5
1713303741453,CAT 125R,B00,515981,Tosun; Adriana,19,0,20,1
1713303741453,CAT 125R,C00,515987,Hyland; Tina Mae,6,0,20,14
1713303741453,CAT 125R,D00,515988,Bronstein; Phoebe Malan,19,0,20,1
1713303742477,CENG 15,A01,488699,Drews; Aaron,25,0,25,0
1713303743506,CENG 100,A00,505196,Opatkiewicz; Justin Paul,25,0,25,0
1713303744532,CGS 2A,A01,489598,Staff,33,0,35,2
1713303745557,CGS 112,A00,489599,Staff,15,0,15,0
1713303746583,CGS 119,A00,489603,Staff,10,0,10,0
1713303747609,CGS 120,A00,489604,Staff,14,0,15,1
1713303748635,CGS 150,A00,489607,Staff,15,0,15,0
1713303749667,CHEM 6A,A01,488715,Staff,98,0,100,2
1713303750694,CHEM 6B,A01,488719,Piercy; Marc Anthony,100,0,100,0
1713303751721,CHEM 6C,A01,488723,Albizati; Kim F.,94,0,100,6
1713303752746,CHEM 7L,A01,488728,Schurmeier; Kimberly,18,0,24,6
1713303752746,CHEM 7L,A02,488730,Schurmeier; Kimberly,23,0,24,1
1713303752746,CHEM 7L,A03,488734,Schurmeier; Kimberly,24,0,24,0
1713303752746,CHEM 7L,A04,488763,Schurmeier; Kimberly,23,0,24,1
1713303752746,CHEM 7L,B01,488798,Schurmeier; Kimberly,18,0,24,6
1713303752746,CHEM 7L,B02,488801,Schurmeier; Kimberly,24,0,24,0
1713303752746,CHEM 7L,B03,488808,Schurmeier; Kimberly,24,0,24,0
1713303752746,CHEM 7L,B04,488811,Schurmeier; Kimberly,24,0,24,0
1713303753777,CHEM 11,A01,488897,Stallings; Dontarie M,98,0,100,2
1713303754806,CHEM 40A,A01,488913,Albizati; Kim F.,93,0,100,7
1713303755836,CHEM 40B,A01,488920,Weizman; Haim,48,0,50,2
1713303755836,CHEM 40B,A02,488938,Weizman; Haim,47,0,50,3
1713303756863,CHEM 41A,A01,489029,Klosterman; Jeremy K,58,0,60,2
1713303757889,CHEM 41C,A01,500436,Tor; Yitzhak,56,0,60,4
1713303758914,CHEM 43A,A01,500426,Weizman; Haim,7,0,24,17
1713303758914,CHEM 43A,A02,500430,Weizman; Haim,16,0,24,8
1713303758914,CHEM 43A,B01,514041,Klosterman; Jeremy K,18,0,24,6
1713303758914,CHEM 43A,B02,514047,Klosterman; Jeremy K,23,0,24,1
1713303759942,CHEM 108,A01,489140,Jennings; Patricia A.,14,0,24,10
1713303759942,CHEM 108,A02,489142,Jennings; Patricia A.,17,0,24,7
1713303760968,CHEM 114A,A01,489147,Stallings; Dontarie M,81,0,100,19
1713303761995,CHIN 169A,A00,489171,Wang; Xiao,19,0,20,1
1713303764048,COGS 3,A01,518827,Boyle; Mary E. T.,32,0,40,8
1713303765074,COGS 11,A01,489175,Staff,28,0,30,2
1713303766097,COGS 14A,A01,518829,Staff,55,0,60,5
1713303767178,COGS 14B,A01,489177,Hoffman; Drew Ellen,69,0,75,6
1713303768201,COGS 100,A01,489181,Allen; Michael Gordon,66,0,75,9
1713303769226,COGS 101A,A01,489183,Staff,51,0,60,9
1713303770252,COGS 101B,A01,489185,Allen; Michael Gordon,15,0,30,15
1713303771279,COGS 101C,A01,526786,Staff,25,0,30,5
1713303773330,COGS 107A,A01,489189,Boyle; Mary E. T.,24,0,35,11
1713303774357,COGS 107B,A01,627144,Mooshagian; Eric Frederick,60,0,60,0
1713303775386,COGS 118A,A01,489191,Staff,0,22,40,40
1713303777441,COGS 171GS,A01,489194,Pineda; Jaime A,22,0,28,6
1713303778470,COGS 172,A01,489196,Staff,9,0,30,21
1713303779494,COGS 174GS,A01,489264,Pineda; Jaime A,22,0,28,6
1713303780520,COGS 180,A01,627150,Staff,29,0,30,1
1713303781545,COGS 186,A01,489274,Staff,4,0,30,26
1713303782572,COMM 10,A01,489276,Staff,25,0,25,0
1713303782572,COMM 10,A02,489303,Staff,23,0,25,2
1713303783601,COMM 100A,A01,489312,Staff,21,0,25,4
1713303783601,COMM 100A,A02,489313,Staff,24,0,25,1
1713303784628,COMM 106T,A00,512540,Staff,34,0,35,1
1713303785654,COMM 107,A00,489347,Staff,31,0,35,4
1713303786679,COMM 109P,A00,489358,Staff,31,0,35,4
1713303787710,COMM 132,A00,489361,McKenna; Denise,29,0,30,1
1713303788736,COMM 146,A00,489362,Halm; Gavin Patrick,27,0,30,3
1713303789767,COMM 190,A00,489363,Abuelhiga; Soraya Jill,21,0,23,2
1713303790797,CSE 8A,A50,489366,Staff,23,0,25,2
1713303790797,CSE 8A,A51,489367,Staff,24,0,25,1
1713303791823,CSE 11,A01,489398,Cao; Yingjun,85,0,100,15
1713303792848,CSE 12,A01,489487,Staff,43,0,50,7
1713303793873,CSE 20,A01,489497,Staff,49,0,50,1
1713303794902,CSE 21,A01,489517,Braun; Oliver,44,0,50,6
1713303795932,CSE 101,A01,489524,Braun; Oliver,1,0,50,49
1713303796958,CSE 105,A01,512594,Jones; Miles E,84,0,100,16
1713303796958,CSE 105,B01,512598,Jones; Miles E,73,0,100,27
1713303797982,CSE 140,A01,489538,Staff,45,0,50,5
1713303799011,CSE 141,A01,489550,Eldon; John,76,0,100,24
1713303800036,CSE 141L,A01,489571,Eldon; John,75,0,100,25
1713303801066,CSE 151A,A01,489583,Solares; Edwin A,155,0,200,45
1713303802103,CSE 175,A01,510886,Kumar; Rakesh,30,0,30,0
1713303803130,CSE 190,A00,516828,Dubnov; Shlomo,41,0,49,8
1713303804159,DOC 100D,A00,489667,Pass; Natalye Joann,23,0,25,2
1713303805185,DSC 10,A01,624268,Staff,72,0,75,3
1713303806214,DSC 20,A01,624476,Staff,50,0,50,0
1713303807238,DSC 40A,A01,624608,Staff,40,0,40,0
1713303808266,DSGN 1,A01,489179,Rill; Bryan,38,0,50,12
1713303809297,ECE 17,A01,490489,Sahay; Rajeev,21,0,30,9
1713303810321,ECE 65,A50,490492,Staff,17,0,20,3
1713303810321,ECE 65,A51,490493,Staff,20,0,20,0
1713303811352,ECON 1,A01,489715,Famulari; Melissa,69,0,70,1
1713303812379,ECON 2,A01,489717,Levkoff; Steven B.,69,0,70,1
1713303813408,ECON 3,A01,489948,Staff,70,0,70,0
1713303815459,ECON 5,A01,490103,Staff,28,0,30,2
1713303815459,ECON 5,B01,626281,Dai; Yinlin,45,0,45,0
1713303816488,ECON 100A,A01,490127,Famulari; Melissa,70,0,70,0
1713303817513,ECON 100B,A01,490129,Staff,64,0,70,6
1713303818545,ECON 109,A01,490187,Shishkin; Denis,29,0,35,6
1713303819569,ECON 110A,A01,490190,Levkoff; Steven B.,65,0,70,5
1713303820594,ECON 120A,A01,490245,Dai; Yinlin,69,0,70,1
1713303821626,ECON 120B,A01,490247,Nieto-Barthaburu; Augusto,60,0,70,10
1713303822661,ECON 120C,A01,490253,Sun; Yixiao,32,0,35,3
1713303822661,ECON 120C,B01,490255,Sun; Yixiao,34,0,35,1
1713303823693,ECON 129,A00,490256,Eckert; Fabian Paul,28,0,35,7
1713303824716,ECON 131,A00,490257,Nieto-Barthaburu; Augusto,6,0,35,29
1713303825748,ECON 138,A00,490258,Bharadwaj; Prashant,24,0,35,11
1713303825748,ECON 138,B00,490259,Bharadwaj; Prashant,20,0,35,15
1713303826777,ECON 159,A00,490260,Hendrickson; Gerald M.,0,6,0,0
1713303827808,ECON 178,A01,553995,Zhu; Ying,28,0,35,7
1713303828834,EDS 40,A01,512576,Black; Alison Michelle,20,0,20,0
1713303829863,EDS 107,A01,515848,Staff,30,0,30,0
1713303830891,EDS 110R,A01,490262,Staff,26,0,30,4
1713303831918,EDS 112,A01,490264,Chapman; Thandeka K,45,0,50,5
1713303832944,EDS 113,A00,490266,Staff,28,0,30,2
1713303833974,EDS 118,A00,490267,Warstadt; Melissa Fawn,27,0,30,3
1713303834998,EDS 124BR,A00,490268,Eguchi; Emi,10,0,25,15
1713303834998,EDS 124BR,B00,490269,Eguchi; Emi,25,0,25,0
1713303836027,EDS 126,A01,490271,Jones; Makeba,47,0,50,3
1713303837051,EDS 135,A01,490316,Staff,19,0,20,1
1713303838076,ENVR 142GS,A00,519514,Chang; Edmond Yi-Teh,28,0,28,0
1713303839106,ETHN 103,A00,490504,Staff,33,0,36,3
1713303840131,ETHN 103A,A00,490505,Man; Simeon S,7,0,9,2
1713303841156,ETHN 109,A00,490506,Staff,30,0,30,0
1713303842183,ETHN 118,A00,490507,Staff,35,0,36,1
1713303843211,ETHN 119,A00,490508,Staff,36,0,36,0
1713303844236,ETHN 121R,A00,490518,Choi; Esther Min,30,0,36,6
1713303845261,ETHN 127,A00,490528,Staff,15,0,15,0
1713303846286,ETHN 139,A00,490573,Staff,10,0,10,0
1713303847317,ETHN 150,A00,490575,Staff,15,0,15,0
1713303848351,GLBH 20,A00,491705,Elwardani; Nile Regina,38,0,40,2
1713303849379,GLBH 101,A00,491706,Staff,20,0,20,0
1713303850510,GLBH 111,A01,491708,Burgos; Jose L.,15,0,15,0
1713303851536,GLBH 146,A00,491709,Staff,15,0,20,5
1713303852568,GLBH 148,A00,491710,Olivas Hernandez; Olga Lid,17,0,20,3
1713303853594,GLBH 150,A00,491711,Sloane; Julia Kathryn,20,0,20,0
1713303854621,HIEA 131,A00,491760,Staff,30,0,32,2
1713303855649,HIEA 153,A00,491762,Staff,29,0,30,1
1713303856678,HIEU 124,A00,491811,Staff,28,0,32,4
1713303857704,HIEU 124GS,A00,491812,Markman; Kristina,28,0,28,0
1713303858729,HIEU 147,A00,491813,Staff,31,0,32,1
1713303859755,HIEU 149GS,A00,491816,Caldwell; Michael Alan,28,0,28,0
1713303860786,HILD 2C,A01,491713,Hendrickson; Gerald M.,28,0,30,2
1713303861811,HILD 7B,A01,491715,Kwak; Nancy,17,0,30,13
1713303862841,HILD 10,A01,491717,Staff,16,0,20,4
1713303863867,HILD 30GS,A00,491719,Edington; Claire Ellen,24,0,28,4
1713303864892,HINE 109,A00,491818,Shafir; Nir,31,0,32,1
1713303865922,HINE 128,A00,491821,Shafir; Nir,32,0,32,0
1713303866946,HISC 117,A00,491830,Staff,29,0,32,3
1713303867969,HIUS 103,A00,491834,Man; Simeon S,18,0,23,5
1713303868998,HIUS 108B,A00,491835,Staff,30,0,30,0
1713303870026,HIUS 141,A00,491836,Hendrickson; Gerald M.,29,0,32,3
1713303871105,HIUS 149,A00,491839,Staff,28,0,32,4
1713303872135,HUM 3,A01,512617,Crum; Matthew Stephen,46,0,50,4
1713303872135,HUM 3,A02,512618,Crum; Matthew Stephen,49,0,50,1
1713303873161,HUM 3GS,A00,512663,Markman; Kristina,0,0,0,0
1713303873161,HUM 3GS,B00,512664,Staff,0,0,0,0
1713303874191,HUM 4,A01,512620,West; Geoffrey Scott,38,0,50,12
1713303875219,HUM 4GS,A00,512666,Lyon; Antony J.,0,0,0,3
1713303876244,HUM 4R,A01,512625,Watkins; Eric,49,0,50,1
1713303877269,HUM 5,A01,512649,Zavodny; Tatiana Sophia,35,0,50,15
1713303877269,HUM 5,B01,512661,Zroka; Ryan Edward,49,0,50,1
1713303878299,INTL 190,A00,490577,Segui; Alan S,0,0,0,5
1713303879323,JAPN 20AR,A01,491267,Ross; Kayoko F,12,0,20,8
1713303880349,JAPN 180,A00,491285,Berman; Michael David,34,0,40,6
1713303881377,LATI 50,A01,502536,Kokinis; Troy Andreas,19,0,22,3
1713303881377,LATI 50,A02,502551,Kokinis; Troy Andreas,22,0,22,0
1713303881377,LATI 50,A03,502650,Kokinis; Troy Andreas,22,0,22,0
1713303881377,LATI 50,A04,502909,Kokinis; Troy Andreas,22,0,22,0
1713303882404,LATI 160,A01,502920,Kokinis; Troy Andreas,30,0,30,0
1713303883431,LIFR 1A,A00,490494,Van Moer; Vinciane G,18,0,20,2
1713303884457,LIFR 1AX,A00,490495,Van Moer; Vinciane G,18,0,20,2
1713303885481,LIFR 1B,A00,490496,Van Moer; Vinciane G,20,0,20,0
1713303886508,LIFR 1BX,A00,490497,Van Moer; Vinciane G,20,0,20,0
1713303887538,LIGN 8,A00,505198,McIntosh; Justin Daniel,143,0,150,7
1713303888567,LIGN 9GS,A00,491239,Lott; Margaret S.,18,0,20,2
1713303889593,LIGN 101,A01,505200,McIntosh; Justin Daniel,26,0,30,4
1713303890618,LIGN 120,A01,491244,Staff,26,0,30,4
1713303891641,LIGN 149GS,A00,491245,Lott; Margaret S.,18,0,20,2
1713303892666,LIGN 170,A00,491247,Staff,25,0,30,5
1713303893692,LISP 1D,A00,490498,Munoz Sanchez; Alicia,11,0,14,3
1713303893692,LISP 1D,B00,490499,Munoz Sanchez; Alicia,7,0,14,7
1713303893692,LISP 1D,C00,490500,Munoz Sanchez; Alicia,10,0,14,4
1713303893692,LISP 1D,D00,490501,Munoz Sanchez; Alicia,11,0,14,3
1713303894717,LISP 1DX,A00,490502,Munoz Sanchez; Alicia,19,0,28,9
1713303894717,LISP 1DX,B00,490503,Munoz Sanchez; Alicia,19,0,28,9
1713303896773,LTAM 110,A00,491847,Staff,23,0,25,2
1713303897803,LTCS 119,A00,491848,Staff,13,0,15,2
1713303898833,LTCS 130,A00,491849,Staff,24,0,25,1
1713303900883,LTEA 120C,A00,491852,Staff,35,0,40,5
1713303901913,LTEN 130GS,A00,491853,Lyon; Antony J.,25,0,28,3
1713303902942,LTEN 148,A00,491855,Staff,23,0,25,2
1713303903968,LTEN 159,A00,491856,Staff,21,0,25,4
1713303904994,LTEN 180,A00,491857,Staff,10,0,15,5
1713303907049,LTSP 123GS,A00,505928,Bessett; Ryan Matthew,25,0,28,3
1713303908079,LTSP 174GS,A00,506037,Bessett; Ryan Matthew,25,0,28,3
1713303910134,LTWR 102,A00,491861,Staff,12,0,15,3
1713303911168,LTWR 106,A00,491862,Staff,11,0,15,4
1713303912198,MAE 11,A00,490930,Bahadori; Mohammad Yousef,98,0,100,2
1713303913225,MAE 30A,A00,490931,Qi; Huihui,38,0,40,2
1713303914255,MAE 101A,A00,491036,Sadeghizadeh; Zahra,98,0,100,2
1713303915281,MAE 101C,A00,491037,Seshadri; Kalyanasundaram,78,0,100,22
1713303916307,MAE 113,A00,491040,Seshadri; Kalyanasundaram,67,0,80,13
1713303917336,MAE 131A,A00,491041,Ghazinejad; Maziar,39,0,40,1
1713303918362,MAE 142,A00,491053,Staff,39,0,40,1
1713303919391,MAE 143A,A00,491054,Staff,43,0,50,7
1713303920418,MAE 150,A00,491092,Truong; Phuong Thi Ngoc,25,0,35,10
1713303921449,MATH 3C,A01,494031,Pardo Guerra; Sebastian,30,0,30,0
1713303921449,MATH 3C,A02,494032,Pardo Guerra; Sebastian,29,0,30,1
1713303922482,MATH 10A,A01,494034,Staff,28,0,30,2
1713303922482,MATH 10A,A02,494035,Staff,29,0,30,1
1713303922482,MATH 10A,B01,494037,Staff,28,0,30,2
1713303922482,MATH 10A,B02,494038,Staff,29,0,30,1
1713303923520,MATH 10B,A01,494040,Habib; Yousaf,24,0,30,6
1713303923520,MATH 10B,A02,494041,Habib; Yousaf,28,0,30,2
1713303923520,MATH 10B,A03,494042,Habib; Yousaf,30,0,30,0
1713303923520,MATH 10B,A04,494043,Habib; Yousaf,30,0,30,0
1713303923520,MATH 10B,B01,494045,Habib; Yousaf,28,0,30,2
1713303923520,MATH 10B,B02,494046,Habib; Yousaf,30,0,30,0
1713303923520,MATH 10B,B03,494047,Habib; Yousaf,30,0,30,0
1713303923520,MATH 10B,B04,494048,Habib; Yousaf,30,0,30,0
1713303924553,MATH 18,A01,494050,Kemp; Todd Aahron,28,0,30,2
1713303924553,MATH 18,A02,494051,Kemp; Todd Aahron,29,0,30,1
1713303924553,MATH 18,B01,494054,Kemp; Todd Aahron,28,0,30,2
1713303924553,MATH 18,B02,494055,Kemp; Todd Aahron,29,0,30,1
1713303925582,MATH 20A,A01,494059,Suk; Andrew Hoon,30,0,30,0
1713303926608,MATH 20B,A01,494061,Briones; Jor-el Thomas Caparas,34,0,35,1
1713303926608,MATH 20B,B01,494063,Bach; Quang Tran,34,0,35,1
1713303927634,MATH 20C,A01,494065,Staff,29,0,30,1
1713303927634,MATH 20C,A02,494066,Staff,30,0,30,0
1713303927634,MATH 20C,A03,494067,Staff,30,0,30,0
1713303927634,MATH 20C,A04,494068,Staff,30,0,30,0
1713303927634,MATH 20C,B01,494070,Zhang; Ming,27,0,30,3
1713303927634,MATH 20C,B02,494071,Zhang; Ming,30,0,30,0
1713303927634,MATH 20C,B03,494072,Zhang; Ming,29,0,30,1
1713303927634,MATH 20C,B04,494073,Zhang; Ming,29,0,30,1
1713303928663,MATH 20D,A01,494075,Staff,26,0,30,4
1713303928663,MATH 20D,A02,494076,Staff,30,0,30,0
1713303929689,MATH 20E,A01,494079,Staff,25,0,30,5
1713303929689,MATH 20E,A02,494080,Staff,28,0,30,2
1713303929689,MATH 20E,B01,494082,Staff,28,0,30,2
1713303929689,MATH 20E,B02,494083,Staff,25,0,30,5
1713303930716,MATH 103A,A01,494085,Aliabadi Sr.; Mohsen,22,0,30,8
1713303930716,MATH 103A,A02,494086,Aliabadi Sr.; Mohsen,29,0,30,1
1713303930716,MATH 103A,B01,494088,Aliabadi Sr.; Mohsen,22,0,30,8
1713303930716,MATH 103A,B02,494089,Aliabadi Sr.; Mohsen,28,0,30,2
1713303931740,MATH 109,A01,494091,Staff,30,0,30,0
1713303931740,MATH 109,A02,494092,Staff,30,0,30,0
1713303931740,MATH 109,B01,494094,Staff,28,0,30,2
1713303931740,MATH 109,B02,494095,Staff,29,0,30,1
1713303932767,MATH 142A,A01,494097,Chow; Bennett,17,0,30,13
1713303932767,MATH 142A,A02,494098,Chow; Bennett,26,0,30,4
1713303932767,MATH 142A,B01,494100,Chow; Bennett,23,0,30,7
1713303932767,MATH 142A,B02,494101,Chow; Bennett,29,0,30,1
1713303934824,MATH 168A,A01,516677,Dumitriu; Ioana,17,0,35,18
1713303935852,MATH 170A,A01,516679,Dumitriu; Ioana,23,0,30,7
1713303935852,MATH 170A,A02,516680,Dumitriu; Ioana,28,0,30,2
1713303936878,MATH 193A,A01,494107,Staff,19,0,30,11
1713303936878,MATH 193A,A02,494108,Staff,25,0,30,5
1713303936878,MATH 193A,A03,494109,Staff,29,0,30,1
1713303936878,MATH 193A,A04,494110,Staff,27,0,30,3
1713303939959,MGT 16,A00,491930,McKay; Michael J,94,0,98,4
1713303940985,MGT 18,A00,491992,McKay; Michael J,97,0,98,1
1713303942011,MGT 71,A00,492003,Staff,79,0,98,19
1713303943041,MGT 103,A00,505209,Eberhard; Craig A,88,0,98,10
1713303944070,MGT 131A,A00,505210,Anderson; John Charles,91,0,98,7
1713303946121,MGT 153,A00,492077,Perols; Johan Lars,55,0,90,35
1713303949196,MGT 164,A00,492222,McKay; Mary A,94,0,98,4
1713303950221,MGT 172,A00,492245,Staff,59,0,60,1
1713303950221,MGT 172,B00,505526,Hedges; Kathleen,80,0,98,18
1713303951247,MGT 181,A00,505669,Dunn; Louis Jean,89,0,98,9
1713303952272,MMW 14,A01,494399,Staff,24,0,28,4
1713303952272,MMW 14,A02,494400,Staff,26,0,28,2
1713303952272,MMW 14,A03,494401,Staff,28,0,28,0
1713303952272,MMW 14,A04,494402,Staff,28,0,28,0
1713303952272,MMW 14,B01,494404,Carreras; Maria Victoria,18,0,28,10
1713303952272,MMW 14,B02,494405,Carreras; Maria Victoria,27,0,28,1
1713303952272,MMW 14,B03,494406,Carreras; Maria Victoria,28,0,28,0
1713303952272,MMW 14,B04,494407,Carreras; Maria Victoria,28,0,28,0
1713303953301,MMW 14GS,A00,506250,Chang; Edmond Yi-Teh,0,0,0,0
1713303954325,MMW 121R,A01,494415,Adamiak; Patrick John,16,0,28,12
1713303954325,MMW 121R,A02,494416,Adamiak; Patrick John,25,0,28,3
1713303955350,MUS 1A,A01,494113,Staff,14,0,25,11
1713303955350,MUS 1A,A02,494114,Staff,25,0,25,0
1713303956376,MUS 4,A01,494116,Staff,24,0,25,1
1713303956376,MUS 4,A02,494117,Staff,22,0,25,3
1713303957402,MUS 5R,A01,494236,Dubnov; Shlomo,13,0,25,12
1713303957402,MUS 5R,A02,494237,Dubnov; Shlomo,25,0,25,0
1713303958433,MUS 6,A01,494122,Staff,16,0,25,9
1713303958433,MUS 6,A02,494123,Staff,24,0,25,1
1713303959458,MUS 7,A01,494125,Staff,19,0,25,6
1713303959458,MUS 7,A02,494126,Staff,24,0,25,1
1713303960482,MUS 11,A01,494128,Staff,23,0,25,2
1713303960482,MUS 11,A02,494129,Staff,25,0,25,0
1713303961513,MUS 13,A01,494131,Staff,25,0,25,0
1713303961513,MUS 13,A02,494132,Staff,25,0,25,0
1713303962540,MUS 15,A01,494134,Staff,21,0,25,4
1713303962540,MUS 15,A02,494135,Staff,25,0,25,0
1713303962540,MUS 15,B01,494137,Staff,25,0,25,0
1713303963565,MUS 80,A00,494232,Staff,25,0,25,0
1713303963565,MUS 80,B00,494233,Staff,25,0,25,0
1713303963565,MUS 80,C00,494234,Staff,23,0,25,2
1713303964592,MUS 95C,A00,494141,Staff,73,0,75,2
1713303965621,MUS 114,A00,494142,Staff,42,0,50,8
1713303966653,NANO 15,A01,490636,Drews; Aaron,7,0,7,0
1713303967677,PHIL 1,A00,490578,Grush; Rick Scott,50,0,50,0
1713303968703,PHIL 10,A01,490580,Grush; Rick Scott,34,0,35,1
1713303968703,PHIL 10,A02,490586,Grush; Rick Scott,33,0,35,2
1713303969728,PHIL 27,A01,490591,Staff,24,0,25,1
1713303969728,PHIL 27,A02,490592,Staff,25,0,25,0
1713303969728,PHIL 27,A03,490593,Staff,25,0,25,0
1713303969728,PHIL 27,A04,490598,Staff,25,0,25,0
1713303970758,PHIL 32,A01,490611,Staff,20,0,20,0
1713303970758,PHIL 32,A02,490618,Staff,20,0,20,0
1713303971787,PHIL 90,A00,490624,Staff,40,0,40,0
1713303972815,PHIL 136,A00,490627,Cohen; Jonathan David,38,0,40,2
1713303973841,PHIL 155,A00,490634,Staff,67,0,70,3
1713303974921,PHYS 1A,A00,491610,Staff,246,0,250,4
1713303975951,PHYS 1AL,001,491616,Tsai; Philbert S,28,0,30,2
1713303975951,PHYS 1AL,002,491618,Tsai; Philbert S,30,0,30,0
1713303976981,PHYS 1B,A00,491623,Staff,245,0,250,5
1713303978012,PHYS 1BL,001,491626,Tsai; Philbert S,27,0,30,3
1713303978012,PHYS 1BL,002,491628,Tsai; Philbert S,28,0,30,2
1713303979037,PHYS 1C,A00,491632,Staff,228,0,245,17
1713303980068,PHYS 1CL,001,491635,Tsai; Philbert S,12,0,30,18
1713303980068,PHYS 1CL,002,491643,Tsai; Philbert S,26,0,30,4
1713303981098,PHYS 2AR,A01,491651,Meyertholen; Andrew D.,46,0,50,4
1713303982131,PHYS 2B,A01,491659,Staff,107,0,115,8
1713303983158,PHYS 2BL,A01,491685,Staff,24,0,24,0
1713303983158,PHYS 2BL,A02,491700,Staff,23,0,24,1
1713303984188,PHYS 2C,A01,505161,Staff,108,0,115,7
1713303985222,PHYS 4A,A01,491704,Grinstein; Benjamin,100,0,100,0
1713303986253,POLI 5D,A01,494144,Staff,3,0,5,2
1713303986253,POLI 5D,B01,626283,Dai; Yinlin,5,0,5,0
1713303987281,POLI 12,A00,494145,Staff,44,0,45,1
1713303988311,POLI 13R,A00,494146,Forman; Fonna,47,0,50,3
1713303989335,POLI 27,A01,494148,Staff,60,0,60,0
1713303990360,POLI 30,A00,494149,Staff,49,0,50,1
1713303991385,POLI 100DA,A00,494150,Staff,23,0,25,2
1713303993436,POLI 100I,A00,494152,Staff,29,0,30,1
1713303994464,POLI 104B,A00,494153,Smith; Glenn Chatmas,54,0,55,1
1713303995489,POLI 104F,A00,494154,Staff,29,0,30,1
1713303996513,POLI 104I,A00,494155,Smith; Glenn Chatmas,30,0,30,0
1713303997546,POLI 110C,A00,494156,Ingham; Sean,23,0,25,2
1713303998572,POLI 117R,A00,494157,Forman; Fonna,16,0,20,4
1713303999601,POLI 118,A00,494158,Ingham; Sean,23,0,25,2
1713304000631,POLI 120H,A00,494159,Fisk; David Lee,41,0,45,4
1713304001657,POLI 131CR,A00,494160,Hoston; Germaine,42,0,45,3
1713304002682,POLI 133J,A00,494161,Staff,33,0,35,2
1713304003706,POLI 135,A00,494162,Fisk; David Lee,34,0,35,1
1713304004741,POLI 140A,A00,494164,Staff,23,0,30,7
1713304005769,POLI 142I,A00,494165,Staff,30,0,30,0
1713304006797,POLI 144D,A00,494166,Staff,23,0,25,2
1713304007823,POLI 151,A00,494167,Staff,30,0,30,0
1713304008853,POLI 153,A00,494168,Staff,34,0,35,1
1713304009878,POLI 160AA,A00,494169,Staff,36,0,40,4
1713304010908,POLI 162,A00,494170,Mignozzetti; Umberto,22,0,25,3
1713304011933,POLI 171,A00,494171,Mignozzetti; Umberto,23,0,25,2
1713304012959,PSYC 1,A00,494172,Staff,97,0,100,3
1713304013984,PSYC 2,A00,494173,Moranton; Nirelia Melbina-,48,0,50,2
1713304015013,PSYC 3,A00,494174,Staff,30,0,30,0
1713304016039,PSYC 6,A00,494175,Staff,17,0,20,3
1713304017064,PSYC 60,A01,494177,Staff,43,0,45,2
1713304018090,PSYC 70,A01,505724,Geller; Emma Harlan,42,0,45,3
1713304019119,PSYC 101,A00,494180,Heyman; Gail D.,93,0,100,7
1713304020146,PSYC 105,A00,494181,Geller; Emma Harlan,67,0,90,23
1713304021172,PSYC 106,A00,494182,Dobkins; Karen R.,34,0,45,11
1713304022198,PSYC 108,A00,494183,Adrian; Julia Anna,94,0,100,6
1713304023228,PSYC 114,A01,494185,Winkielman; Piotr,7,0,30,23
1713304024258,PSYC 122,A00,494186,Moranton; Nirelia Melbina-,41,0,50,9
1713304025282,PSYC 124,A00,494187,Chapman; Eddie Nathaniel,74,0,80,6
1713304026307,PSYC 131,A00,494188,Anagnostaras; Stephan,62,0,80,18
1713304027335,PSYC 144,A00,494189,Staff,22,0,50,28
1713304028363,PSYC 154,A00,494190,Lacefield; Katharine I,143,0,180,37
1713304029388,PSYC 162,A00,494191,Wixted; John T,90,0,100,10
1713304030413,PSYC 172,A00,494192,Gorman; Michael R.,38,0,45,7
1713304031439,PSYC 178,A00,494193,Glaser; Dale,41,0,45,4
1713304032470,PSYC 193,A00,505725,Chapman; Eddie Nathaniel,20,0,20,0
1713304033495,RELI 145GS,A00,519817,Rahimi; Babak,19,0,20,1
1713304034522,SE 101A,A01,490862,Chadha; Mayank,24,0,25,1
1713304035548,SE 101C,A01,490924,Krysl; Petr,18,0,20,2
1713304036574,SE 110A,A01,490928,Staff,20,0,20,0
1713304037608,SE 130A,A00,490929,Morrison; Machel Leigh,66,0,70,4
1713304038632,SIO 1,A01,519325,Staff,39,0,40,1
1713304039657,SIO 30,A01,519327,Staff,40,0,40,0
1713304040690,SIO 40,A00,519328,Staff,40,0,40,0
1713304041720,SIO 46GS,A00,519819,Cook; Geoffrey W,19,0,25,6
1713304042744,SIO 109R,A00,494197,Forman; Fonna,9,0,20,11
1713304043772,SIO 121GS,A00,519827,Cook; Geoffrey W,19,0,25,6
1713304044796,SIO 132,A01,519330,Staff,38,0,40,2
1713304045823,SIO 133,A01,519397,Staff,40,0,40,0
1713304046850,SIO 139,A00,519396,Kacev; David,34,0,40,6
1713304047875,SOCI 1,A01,494199,Thorpe; Charles Robert,24,0,30,6
1713304047875,SOCI 1,A02,494200,Thorpe; Charles Robert,30,0,30,0
1713304047875,SOCI 1,A03,494201,Thorpe; Charles Robert,29,0,30,1
1713304047875,SOCI 1,A04,494202,Thorpe; Charles Robert,29,0,30,1
1713304047875,SOCI 1,A05,494203,Thorpe; Charles Robert,29,0,30,1
1713304047875,SOCI 1,A06,494204,Thorpe; Charles Robert,30,0,30,0
1713304047875,SOCI 1,A07,494205,Thorpe; Charles Robert,29,0,30,1
1713304048900,SOCI 60,A01,494207,Staff,36,0,40,4
1713304048900,SOCI 60,A02,494208,Staff,39,0,40,1
1713304049936,SOCI 100,A01,494210,Payne; Christine Anna,28,0,30,2
1713304049936,SOCI 100,A02,494211,Payne; Christine Anna,28,0,30,2
1713304050962,SOCI 109M,A00,494212,Staff,20,0,20,0
1713304051987,SOCI 110,A00,494213,Staff,35,0,40,5
1713304054044,SOCI 118E,A00,494215,Ng; Kwai,38,0,40,2
1713304055074,SOCI 125,A00,494216,Calderon-Zaks; Michael Aar,42,0,45,3
1713304056099,SOCI 126,A01,494218,Jones; Makeba,4,0,5,1
1713304057125,SOCI 131,A00,494219,Thorpe; Charles Robert,30,0,30,0
1713304059182,SOCI 135,A00,494221,Payne; Christine Anna,44,0,50,6
1713304060208,SOCI 136E,A00,626690,Ruiz; Jonathan Joseph,25,0,25,0
1713304061234,SOCI 138GS,A00,494222,Navon; Daniel,24,0,28,4
1713304063284,SOCI 145,A00,494224,Staff,44,0,45,1
1713304064312,SOCI 153,A00,494225,Staff,28,0,30,2
1713304065342,SOCI 160E,A00,494226,Ng; Kwai,34,0,40,6
1713304066373,SOCI 180,A00,494227,Staff,29,0,30,1
1713304067411,SOCI 189GS,A00,494228,Ribas Norris; Janet Vanesa,11,0,11,0
1713304068437,SOCI 190GS,A00,553232,Ribas Norris; Janet Vanesa,11,0,11,0
1713304069466,SYN 2,001,490768,Staff,14,0,15,1
1713304069466,SYN 2,002,490769,Staff,15,0,15,0
1713304069466,SYN 2,004,490775,Staff,0,0,0,0
1713304069466,SYN 2,003,490774,Staff,0,0,0,0
1713304069466,SYN 2,005,490776,Staff,0,0,0,0
1713304070494,SYN 2R,001,490779,Staff,14,0,15,1
1713304070494,SYN 2R,002,514635,Staff,14,0,15,1
1713304071524,SYN 100,A01,490783,Staff,17,0,20,3
1713304071524,SYN 100,B01,490787,Staff,12,0,20,8
1713304071524,SYN 100,C01,490789,Staff,15,0,20,5
1713304072551,SYN 150,A00,490817,Staff,14,0,15,1
1713304072551,SYN 150,B00,514610,Staff,15,0,15,0
1713304073583,TDAC 1,A00,492753,Walsh; Kim C.,19,0,20,1
1713304073583,TDAC 1,B00,492754,Harting; Carla Kelso,19,0,20,1
1713304073583,TDAC 1,C00,513995,Salovey; Todd,18,0,20,2
1713304074608,TDAC 101,A00,492766,Harting; Carla Kelso,19,0,20,1
1713304075640,TDAC 102,A00,492768,Basso; Beatrice,20,0,20,0
1713304076666,TDDE 111,A00,492769,Staff,25,0,25,0
1713304077692,TDDE 131,A00,492770,Staff,15,0,15,0
1713304077692,TDDE 131,B00,492771,Staff,15,0,15,0
1713304078775,TDDE 131GS,A00,523716,Guirguis; Mark C,25,0,28,3
1713304079803,TDGE 1,A01,492756,Salovey; Todd,58,0,60,2
1713304080828,TDGE 5,A01,492758,Staff,24,0,25,1
1713304081854,TDGE 10,A00,492759,Fulton; Julia,216,0,220,4
1713304082886,TDGE 11,A00,492760,Castro; Robert Jess,200,0,200,0
1713304083914,TDGE 50,A00,492761,Blair; Kyle Adam,0,0,0,0
1713304084940,TDGE 124,A00,492772,Fulton; Julia,201,0,220,19
1713304085966,TDGE 125,A00,492773,Meyer; Ursula,43,0,50,7
1713304085966,TDGE 125,B00,492774,Staff,50,0,50,0
1713304085966,TDGE 125,C00,523565,Staff,50,0,50,0
1713304086992,TDGE 125GS,A00,523580,Guirguis; Mark C,25,0,28,3
1713304088017,TDGE 127,A00,492775,Havis; Allan,44,0,50,6
1713304089047,TDHT 101,A00,492776,Staff,35,0,35,0
1713304090074,TDMV 1,A00,492762,Caligagan; Maria T.,30,0,30,0
1713304090074,TDMV 1,B00,492763,Arcidiacono; Kristin,26,0,30,4
1713304091103,TDMV 2,A00,492764,Weinberg; Sadie,29,0,30,1
1713304092127,TDMV 3,A00,492765,Mack; Kara Shanai',40,0,40,0
1713304093156,TDMV 138,A00,492777,Mack; Kara Shanai',37,0,40,3
1713304094182,TDMV 140,A00,492778,Lima; Paulo Henrique,40,0,40,0
1713304095209,TDMV 142,A00,492779,Caligagan; Maria T.,37,0,40,3
1713304095209,TDMV 142,B00,492780,Caligagan; Tony,38,0,40,2
1713304096235,TDMV 143,A00,492781,Fyall; Daunte Edward,40,0,40,0
1713304097263,USP 1,A01,492401,Kwak; Nancy,29,0,35,6
1713304098288,USP 2,A01,492453,Hinds; Juli Beth,35,0,35,0
1713304099314,USP 3,A01,492516,Staff,32,0,35,3
1713304100340,USP 4,A00,492522,McTague; Sarah,20,0,25,5
1713304101366,USP 100,A00,492523,Staff,33,0,35,2
1713304102392,USP 101,A00,492524,Staff,13,0,15,2
1713304103424,USP 105,A00,492525,Staff,22,0,25,3
1713304104450,USP 151,A00,492526,Shenkman; Michael Thomas,33,0,35,2
1713304105480,USP 170,A00,492545,Hinds; Juli Beth,33,0,35,2
1713304106507,USP 171GS,A00,492608,Bussell; Mirle Rabinowitz,26,0,28,2
1713304107532,USP 183GS,A00,492613,Peerson; Susan,26,0,28,2
1713304108568,VIS 30,A01,490693,Yoldas; Pinar,21,0,22,1
1713304108568,VIS 30,A02,490694,Yoldas; Pinar,19,0,22,3
1713304109600,VIS 83,A00,490695,Kester; Grant,68,0,75,7
1713304110636,VIS 105D,A00,490696,Staff,22,0,25,3
1713304111662,VIS 124CN,A00,490699,Rose; Jordan M,68,0,75,7
1713304112687,VIS 125GS,A00,511221,Williams; Alena J,21,0,22,1
1713304113713,VIS 128D,A00,490700,Staff,74,0,75,1
1713304114738,VIS 151,A01,490717,Staff,34,0,34,0
1713304114738,VIS 151,A02,490766,Staff,33,0,34,1
1713304115765,VIS 154GS,A00,511972,Williams; Alena J,21,0,22,1
1713304116797,VIS 160A,A00,490767,Stone; Patricia,7,0,10,3
1713304117824,WCWP 10A,A00,490638,Staff,15,0,15,0
1713304117824,WCWP 10A,B00,490640,Staff,15,0,15,0
1713304118854,WCWP 10B,A00,490641,Staff,0,0,0,0
1713304118854,WCWP 10B,B00,490642,Staff,14,0,15,1
1713304118854,WCWP 10B,C00,490644,Staff,14,0,15,1
1713304118854,WCWP 10B,D00,490647,Staff,0,0,0,0
1713304119879,WCWP 100,A00,490655,Staff,0,0,0,0
1713304119879,WCWP 100,B00,490687,Staff,12,0,15,3
1713304121988,ANAR 153,A00,487222,Braswell; Geoffrey E.,55,0,60,5
1713304123016,ANBI 134,A00,487223,Staff,14,0,20,6
1713304124045,ANBI 143GS,A00,487224,Noel; Geoffroy Pierre Jean,22,0,24,2
1713304125070,ANBI 144GS,A00,519548,Noel; Geoffroy Pierre Jean,22,0,24,2
1713304126095,ANSC 101,A00,487225,Staff,19,0,20,1
1713304127126,ANSC 125,A00,487227,Brenner; Suzanne A,40,0,40,0
1713304129177,ANSC 146,A00,487229,Staff,37,0,40,3
1713304130201,ANSC 148,A00,487230,Olivas Hernandez; Olga Lid,39,0,40,1
1713304131226,ANSC 150,A00,504165,Sloane; Julia Kathryn,19,0,20,1
1713304132253,ANSC 180,A00,487232,Staff,13,0,15,2
1713304133280,ANSC 188,A00,627155,Staff,40,0,40,0
1713304134314,ANTH 5,A00,519529,Semendeferi; Ekaterini,15,0,15,0
1713304135342,ANTH 10,A00,487219,Staff,58,0,60,2
1713304136368,ANTH 23,A01,487221,Staff,19,0,20,1
1713304137394,ANTH 102,A00,487233,Wilder; Linnea Lorene,53,0,60,7
1713304138419,ANTH 103,A00,487234,Varma; Saiba,57,0,60,3
1713304139451,ANTH 105,A00,487235,Stewart; Alexander B,57,0,60,3
1713304140492,BENG 100,A01,516685,Taylor Amos; Alyssa C,28,0,30,2
1713304141524,BIBC 102,A01,491316,Flagg; Matthew Paul,60,0,88,28
1713304141524,BIBC 102,A02,491366,Flagg; Matthew Paul,84,0,88,4
1713304142556,BIBC 103,A01,491486,Boumechache; Miyyada,17,0,24,7
1713304142556,BIBC 103,A02,491487,Boumechache; Miyyada,24,0,24,0
1713304143582,BICD 100,A01,516882,Staff,75,0,75,0
1713304143582,BICD 100,A02,516890,Staff,71,0,75,4
1713304144609,BICD 102GS,A00,491488,Lo; Stanley M.,27,0,28,1
1713304145640,BIEB 136GS,A00,516940,Holway; David A. & Shurin; Jonathan,20,0,24,4
1713304146667,BIEB 137GS,A01,517034,Holway; David A. & Shurin; Jonathan,20,0,24,4
1713304147691,BIEB 138GS,A01,491492,Pirino; Giorgia,22,0,28,6
1713304148716,BILD 1,A01,491296,Staff,62,0,63,1
1713304148716,BILD 1,A02,491297,Staff,63,0,63,0
1713304149753,BILD 4,A01,517099,Gonzalez Gamboa; Ivonne,23,0,24,1
1713304149753,BILD 4,A02,517100,Gonzalez Gamboa; Ivonne,24,0,24,0
1713304150778,BILD 60GS,A00,491309,Lo; Stanley M.,27,0,28,1
1713304151806,BIMM 100,A01,517136,Staff,94,0,100,6
1713304152832,BIMM 110,A01,517182,Staff,80,0,100,20
1713304153867,BIMM 120,A01,517228,Pickett; Brooke Elizabeth,41,0,63,22
1713304153867,BIMM 120,A02,517240,Pickett; Brooke Elizabeth,49,0,63,14
1713304154895,BIMM 132GS,A01,491498,Pirino; Giorgia,22,0,28,6
1713304155922,BIMM 143,A01,491589,Bozinovic; Goran,21,0,40,19
1713304156948,BIPN 100,A01,491594,Armour; Jon Christopher,93,0,100,7
1713304157975,BIPN 140,A01,491602,Marino; Marc J,34,0,50,16
1713304160031,CAT 125,A00,515973,Staff,20,0,20,0
1713304161058,CAT 125GS,A00,515974,Rahimi; Babak,19,0,20,1
1713304162089,CAT 125R,A00,515980,Staff,15,0,20,5
1713304162089,CAT 125R,B00,515981,Tosun; Adriana,19,0,20,1
1713304162089,CAT 125R,C00,515987,Hyland; Tina Mae,6,0,20,14
1713304162089,CAT 125R,D00,515988,Bronstein; Phoebe Malan,19,0,20,1
1713304163115,CENG 15,A01,488699,Drews; Aaron,25,0,25,0
1713304164142,CENG 100,A00,505196,Opatkiewicz; Justin Paul,25,0,25,0
1713304165167,CGS 2A,A01,489598,Staff,33,0,35,2
1713304166193,CGS 112,A00,489599,Staff,15,0,15,0
1713304167216,CGS 119,A00,489603,Staff,10,0,10,0
1713304168242,CGS 120,A00,489604,Staff,14,0,15,1
1713304169271,CGS 150,A00,489607,Staff,15,0,15,0
1713304170295,CHEM 6A,A01,488715,Staff,98,0,100,2
1713304171321,CHEM 6B,A01,488719,Piercy; Marc Anthony,100,0,100,0
1713304172350,CHEM 6C,A01,488723,Albizati; Kim F.,94,0,100,6
1713304173386,CHEM 7L,A01,488728,Schurmeier; Kimberly,18,0,24,6
1713304173386,CHEM 7L,A02,488730,Schurmeier; Kimberly,23,0,24,1
1713304173386,CHEM 7L,A03,488734,Schurmeier; Kimberly,24,0,24,0
1713304173386,CHEM 7L,A04,488763,Schurmeier; Kimberly,23,0,24,1
1713304173386,CHEM 7L,B01,488798,Schurmeier; Kimberly,18,0,24,6
1713304173386,CHEM 7L,B02,488801,Schurmeier; Kimberly,24,0,24,0
1713304173386,CHEM 7L,B03,488808,Schurmeier; Kimberly,24,0,24,0
1713304173386,CHEM 7L,B04,488811,Schurmeier; Kimberly,24,0,24,0
1713304174415,CHEM 11,A01,488897,Stallings; Dontarie M,98,0,100,2
1713304175443,CHEM 40A,A01,488913,Albizati; Kim F.,93,0,100,7
1713304176469,CHEM 40B,A01,488920,Weizman; Haim,48,0,50,2
1713304176469,CHEM 40B,A02,488938,Weizman; Haim,47,0,50,3
1713304177496,CHEM 41A,A01,489029,Klosterman; Jeremy K,58,0,60,2
1713304178521,CHEM 41C,A01,500436,Tor; Yitzhak,56,0,60,4
1713304179555,CHEM 43A,A01,500426,Weizman; Haim,6,0,24,18
1713304179555,CHEM 43A,A02,500430,Weizman; Haim,16,0,24,8
1713304179555,CHEM 43A,B01,514041,Klosterman; Jeremy K,18,0,24,6
1713304179555,CHEM 43A,B02,514047,Klosterman; Jeremy K,23,0,24,1
1713304180581,CHEM 108,A01,489140,Jennings; Patricia A.,14,0,24,10
1713304180581,CHEM 108,A02,489142,Jennings; Patricia A.,17,0,24,7
1713304181611,CHEM 114A,A01,489147,Stallings; Dontarie M,81,0,100,19
1713304182692,CHIN 169A,A00,489171,Wang; Xiao,19,0,20,1
1713304184749,COGS 3,A01,518827,Boyle; Mary E. T.,32,0,40,8
1713304185773,COGS 11,A01,489175,Staff,28,0,30,2
1713304186800,COGS 14A,A01,518829,Staff,55,0,60,5
1713304187830,COGS 14B,A01,489177,Hoffman; Drew Ellen,69,0,75,6
1713304188855,COGS 100,A01,489181,Allen; Michael Gordon,66,0,75,9
1713304189883,COGS 101A,A01,489183,Staff,51,0,60,9
1713304190910,COGS 101B,A01,489185,Allen; Michael Gordon,14,0,30,16
1713304191936,COGS 101C,A01,526786,Staff,25,0,30,5
1713304193992,COGS 107A,A01,489189,Boyle; Mary E. T.,24,0,35,11
1713304195019,COGS 107B,A01,627144,Mooshagian; Eric Frederick,60,0,60,0
1713304196044,COGS 118A,A01,489191,Staff,0,22,40,40
1713304198098,COGS 171GS,A01,489194,Pineda; Jaime A,22,0,28,6
1713304199122,COGS 172,A01,489196,Staff,9,0,30,21
1713304200149,COGS 174GS,A01,489264,Pineda; Jaime A,22,0,28,6
1713304201198,COGS 180,A01,627150,Staff,29,0,30,1
1713304202228,COGS 186,A01,489274,Staff,4,0,30,26
1713304203254,COMM 10,A01,489276,Staff,25,0,25,0
1713304203254,COMM 10,A02,489303,Staff,23,0,25,2
1713304204279,COMM 100A,A01,489312,Staff,21,0,25,4
1713304204279,COMM 100A,A02,489313,Staff,24,0,25,1
1713304205311,COMM 106T,A00,512540,Staff,34,0,35,1
1713304206339,COMM 107,A00,489347,Staff,31,0,35,4
1713304207365,COMM 109P,A00,489358,Staff,31,0,35,4
1713304208393,COMM 132,A00,489361,McKenna; Denise,29,0,30,1
1713304209418,COMM 146,A00,489362,Halm; Gavin Patrick,27,0,30,3
1713304210443,COMM 190,A00,489363,Abuelhiga; Soraya Jill,21,0,23,2
1713304211473,CSE 8A,A50,489366,Staff,23,0,25,2
1713304211473,CSE 8A,A51,489367,Staff,24,0,25,1
1713304212502,CSE 11,A01,489398,Cao; Yingjun,85,0,100,15
1713304213531,CSE 12,A01,489487,Staff,43,0,50,7
1713304214557,CSE 20,A01,489497,Staff,49,0,50,1
1713304215583,CSE 21,A01,489517,Braun; Oliver,44,0,50,6
1713304216617,CSE 101,A01,489524,Braun; Oliver,0,0,50,50
1713304217644,CSE 105,A01,512594,Jones; Miles E,84,0,100,16
1713304217644,CSE 105,B01,512598,Jones; Miles E,72,0,100,28
1713304218669,CSE 140,A01,489538,Staff,45,0,50,5
1713304219706,CSE 141,A01,489550,Eldon; John,76,0,100,24
1713304220732,CSE 141L,A01,489571,Eldon; John,75,0,100,25
1713304221759,CSE 151A,A01,489583,Solares; Edwin A,155,0,200,45
1713304222787,CSE 175,A01,510886,Kumar; Rakesh,30,0,30,0
1713304223815,CSE 190,A00,516828,Dubnov; Shlomo,41,0,49,8
1713304224846,DOC 100D,A00,489667,Pass; Natalye Joann,23,0,25,2
1713304225878,DSC 10,A01,624268,Staff,72,0,75,3
1713304226910,DSC 20,A01,624476,Staff,50,0,50,0
1713304227940,DSC 40A,A01,624608,Staff,40,0,40,0
1713304228970,DSGN 1,A01,489179,Rill; Bryan,38,0,50,12
1713304229996,ECE 17,A01,490489,Sahay; Rajeev,21,0,30,9
1713304231023,ECE 65,A50,490492,Staff,17,0,20,3
1713304231023,ECE 65,A51,490493,Staff,20,0,20,0
1713304232055,ECON 1,A01,489715,Famulari; Melissa,69,0,70,1
1713304233081,ECON 2,A01,489717,Levkoff; Steven B.,69,0,70,1
1713304234113,ECON 3,A01,489948,Staff,70,0,70,0
1713304236170,ECON 5,A01,490103,Staff,28,0,30,2
1713304236170,ECON 5,B01,626281,Dai; Yinlin,45,0,45,0
1713304237199,ECON 100A,A01,490127,Famulari; Melissa,70,0,70,0
1713304238229,ECON 100B,A01,490129,Staff,64,0,70,6
1713304239253,ECON 109,A01,490187,Shishkin; Denis,29,0,35,6
1713304240282,ECON 110A,A01,490190,Levkoff; Steven B.,65,0,70,5
1713304241314,ECON 120A,A01,490245,Dai; Yinlin,69,0,70,1
1713304242339,ECON 120B,A01,490247,Nieto-Barthaburu; Augusto,60,0,70,10
1713304243365,ECON 120C,A01,490253,Sun; Yixiao,32,0,35,3
1713304243365,ECON 120C,B01,490255,Sun; Yixiao,34,0,35,1
1713304244397,ECON 129,A00,490256,Eckert; Fabian Paul,28,0,35,7
1713304245426,ECON 131,A00,490257,Nieto-Barthaburu; Augusto,6,0,35,29
1713304246455,ECON 138,A00,490258,Bharadwaj; Prashant,24,0,35,11
1713304246455,ECON 138,B00,490259,Bharadwaj; Prashant,20,0,35,15
1713304247480,ECON 159,A00,490260,Hendrickson; Gerald M.,0,6,0,0
1713304248517,ECON 178,A01,553995,Zhu; Ying,28,0,35,7
1713304249545,EDS 40,A01,512576,Black; Alison Michelle,20,0,20,0
1713304250572,EDS 107,A01,515848,Staff,30,0,30,0
1713304251604,EDS 110R,A01,490262,Staff,26,0,30,4
1713304252629,EDS 112,A01,490264,Chapman; Thandeka K,45,0,50,5
1713304253655,EDS 113,A00,490266,Staff,28,0,30,2
1713304254680,EDS 118,A00,490267,Warstadt; Melissa Fawn,27,0,30,3
1713304255706,EDS 124BR,A00,490268,Eguchi; Emi,10,0,25,15
1713304255706,EDS 124BR,B00,490269,Eguchi; Emi,25,0,25,0
1713304256736,EDS 126,A01,490271,Jones; Makeba,47,0,50,3
1713304257760,EDS 135,A01,490316,Staff,19,0,20,1
1713304258786,ENVR 142GS,A00,519514,Chang; Edmond Yi-Teh,28,0,28,0
1713304259812,ETHN 103,A00,490504,Staff,33,0,36,3
1713304260839,ETHN 103A,A00,490505,Man; Simeon S,7,0,9,2
1713304261868,ETHN 109,A00,490506,Staff,30,0,30,0
1713304262893,ETHN 118,A00,490507,Staff,35,0,36,1
1713304263919,ETHN 119,A00,490508,Staff,36,0,36,0
1713304264947,ETHN 121R,A00,490518,Choi; Esther Min,30,0,36,6
1713304265978,ETHN 127,A00,490528,Staff,15,0,15,0
1713304267010,ETHN 139,A00,490573,Staff,10,0,10,0
1713304268036,ETHN 150,A00,490575,Staff,15,0,15,0
1713304269062,GLBH 20,A00,491705,Elwardani; Nile Regina,38,0,40,2
1713304270085,GLBH 101,A00,491706,Staff,20,0,20,0
1713304271111,GLBH 111,A01,491708,Burgos; Jose L.,15,0,15,0
1713304272141,GLBH 146,A00,491709,Staff,15,0,20,5
1713304273166,GLBH 148,A00,491710,Olivas Hernandez; Olga Lid,17,0,20,3
1713304274192,GLBH 150,A00,491711,Sloane; Julia Kathryn,20,0,20,0
1713304275219,HIEA 131,A00,491760,Staff,30,0,32,2
1713304276245,HIEA 153,A00,491762,Staff,29,0,30,1
1713304277270,HIEU 124,A00,491811,Staff,28,0,32,4
1713304278298,HIEU 124GS,A00,491812,Markman; Kristina,28,0,28,0
1713304279322,HIEU 147,A00,491813,Staff,31,0,32,1
1713304280346,HIEU 149GS,A00,491816,Caldwell; Michael Alan,28,0,28,0
1713304281376,HILD 2C,A01,491713,Hendrickson; Gerald M.,28,0,30,2
1713304282402,HILD 7B,A01,491715,Kwak; Nancy,17,0,30,13
1713304283429,HILD 10,A01,491717,Staff,16,0,20,4
1713304284458,HILD 30GS,A00,491719,Edington; Claire Ellen,24,0,28,4
1713304285484,HINE 109,A00,491818,Shafir; Nir,30,0,32,2
1713304286566,HINE 128,A00,491821,Shafir; Nir,32,0,32,0
1713304287592,HISC 117,A00,491830,Staff,29,0,32,3
1713304288616,HIUS 103,A00,491834,Man; Simeon S,18,0,23,5
1713304289642,HIUS 108B,A00,491835,Staff,30,0,30,0
1713304290668,HIUS 141,A00,491836,Hendrickson; Gerald M.,29,0,32,3
1713304291693,HIUS 149,A00,491839,Staff,28,0,32,4
1713304292722,HUM 3,A01,512617,Crum; Matthew Stephen,46,0,50,4
1713304292722,HUM 3,A02,512618,Crum; Matthew Stephen,48,0,50,2
1713304293749,HUM 3GS,A00,512663,Markman; Kristina,0,0,0,0
1713304293749,HUM 3GS,B00,512664,Staff,0,0,0,0
1713304294777,HUM 4,A01,512620,West; Geoffrey Scott,38,0,50,12
1713304295806,HUM 4GS,A00,512666,Lyon; Antony J.,0,0,0,3
1713304296835,HUM 4R,A01,512625,Watkins; Eric,49,0,50,1
1713304297862,HUM 5,A01,512649,Zavodny; Tatiana Sophia,35,0,50,15
1713304297862,HUM 5,B01,512661,Zroka; Ryan Edward,49,0,50,1
1713304298887,INTL 190,A00,490577,Segui; Alan S,0,0,0,5
1713304299914,JAPN 20AR,A01,491267,Ross; Kayoko F,12,0,20,8
1713304300940,JAPN 180,A00,491285,Berman; Michael David,34,0,40,6
1713304301971,LATI 50,A01,502536,Kokinis; Troy Andreas,19,0,22,3
1713304301971,LATI 50,A02,502551,Kokinis; Troy Andreas,22,0,22,0
1713304301971,LATI 50,A03,502650,Kokinis; Troy Andreas,22,0,22,0
1713304301971,LATI 50,A04,502909,Kokinis; Troy Andreas,22,0,22,0
1713304303000,LATI 160,A01,502920,Kokinis; Troy Andreas,30,0,30,0
1713304304025,LIFR 1A,A00,490494,Van Moer; Vinciane G,18,0,20,2
1713304305049,LIFR 1AX,A00,490495,Van Moer; Vinciane G,18,0,20,2
1713304306074,LIFR 1B,A00,490496,Van Moer; Vinciane G,20,0,20,0
1713304307099,LIFR 1BX,A00,490497,Van Moer; Vinciane G,20,0,20,0
1713304308125,LIGN 8,A00,505198,McIntosh; Justin Daniel,143,0,150,7
1713304309150,LIGN 9GS,A00,491239,Lott; Margaret S.,18,0,20,2
1713304310176,LIGN 101,A01,505200,McIntosh; Justin Daniel,26,0,30,4
1713304311200,LIGN 120,A01,491244,Staff,26,0,30,4
1713304312228,LIGN 149GS,A00,491245,Lott; Margaret S.,18,0,20,2
1713304313250,LIGN 170,A00,491247,Staff,25,0,30,5
1713304314277,LISP 1D,A00,490498,Munoz Sanchez; Alicia,11,0,14,3
1713304314277,LISP 1D,B00,490499,Munoz Sanchez; Alicia,7,0,14,7
1713304314277,LISP 1D,C00,490500,Munoz Sanchez; Alicia,10,0,14,4
1713304314277,LISP 1D,D00,490501,Munoz Sanchez; Alicia,11,0,14,3
1713304315302,LISP 1DX,A00,490502,Munoz Sanchez; Alicia,19,0,28,9
1713304315302,LISP 1DX,B00,490503,Munoz Sanchez; Alicia,19,0,28,9
1713304317355,LTAM 110,A00,491847,Staff,23,0,25,2
1713304318384,LTCS 119,A00,491848,Staff,13,0,15,2
1713304319412,LTCS 130,A00,491849,Staff,24,0,25,1
1713304321467,LTEA 120C,A00,491852,Staff,35,0,40,5
1713304322501,LTEN 130GS,A00,491853,Lyon; Antony J.,25,0,28,3
1713304323526,LTEN 148,A00,491855,Staff,23,0,25,2
1713304324556,LTEN 159,A00,491856,Staff,21,0,25,4
1713304325580,LTEN 180,A00,491857,Staff,10,0,15,5
1713304327632,LTSP 123GS,A00,505928,Bessett; Ryan Matthew,25,0,28,3
1713304328660,LTSP 174GS,A00,506037,Bessett; Ryan Matthew,25,0,28,3
1713304330710,LTWR 102,A00,491861,Staff,12,0,15,3
1713304331734,LTWR 106,A00,491862,Staff,11,0,15,4
1713304332762,MAE 11,A00,490930,Bahadori; Mohammad Yousef,98,0,100,2
1713304333789,MAE 30A,A00,490931,Qi; Huihui,38,0,40,2
1713304334815,MAE 101A,A00,491036,Sadeghizadeh; Zahra,98,0,100,2
1713304335842,MAE 101C,A00,491037,Seshadri; Kalyanasundaram,78,0,100,22
1713304336868,MAE 113,A00,491040,Seshadri; Kalyanasundaram,67,0,80,13
1713304337896,MAE 131A,A00,491041,Ghazinejad; Maziar,39,0,40,1
1713304338924,MAE 142,A00,491053,Staff,39,0,40,1
1713304339949,MAE 143A,A00,491054,Staff,43,0,50,7
1713304340975,MAE 150,A00,491092,Truong; Phuong Thi Ngoc,25,0,35,10
1713304342001,MATH 3C,A01,494031,Pardo Guerra; Sebastian,30,0,30,0
1713304342001,MATH 3C,A02,494032,Pardo Guerra; Sebastian,29,0,30,1
1713304343027,MATH 10A,A01,494034,Staff,28,0,30,2
1713304343027,MATH 10A,A02,494035,Staff,29,0,30,1
1713304343027,MATH 10A,B01,494037,Staff,28,0,30,2
1713304343027,MATH 10A,B02,494038,Staff,29,0,30,1
1713304344061,MATH 10B,A01,494040,Habib; Yousaf,24,0,30,6
1713304344061,MATH 10B,A02,494041,Habib; Yousaf,28,0,30,2
1713304344061,MATH 10B,A03,494042,Habib; Yousaf,30,0,30,0
1713304344061,MATH 10B,A04,494043,Habib; Yousaf,30,0,30,0
1713304344061,MATH 10B,B01,494045,Habib; Yousaf,28,0,30,2
1713304344061,MATH 10B,B02,494046,Habib; Yousaf,30,0,30,0
1713304344061,MATH 10B,B03,494047,Habib; Yousaf,30,0,30,0
1713304344061,MATH 10B,B04,494048,Habib; Yousaf,30,0,30,0
1713304345093,MATH 18,A01,494050,Kemp; Todd Aahron,28,0,30,2
1713304345093,MATH 18,A02,494051,Kemp; Todd Aahron,29,0,30,1
1713304345093,MATH 18,B01,494054,Kemp; Todd Aahron,28,0,30,2
1713304345093,MATH 18,B02,494055,Kemp; Todd Aahron,29,0,30,1
1713304346121,MATH 20A,A01,494059,Suk; Andrew Hoon,30,0,30,0
1713304347149,MATH 20B,A01,494061,Briones; Jor-el Thomas Caparas,34,0,35,1
1713304347149,MATH 20B,B01,494063,Bach; Quang Tran,34,0,35,1
1713304348181,MATH 20C,A01,494065,Staff,29,0,30,1
1713304348181,MATH 20C,A02,494066,Staff,30,0,30,0
1713304348181,MATH 20C,A03,494067,Staff,30,0,30,0
1713304348181,MATH 20C,A04,494068,Staff,30,0,30,0
1713304348181,MATH 20C,B01,494070,Zhang; Ming,27,0,30,3
1713304348181,MATH 20C,B02,494071,Zhang; Ming,30,0,30,0
1713304348181,MATH 20C,B03,494072,Zhang; Ming,29,0,30,1
1713304348181,MATH 20C,B04,494073,Zhang; Ming,29,0,30,1
1713304349225,MATH 20D,A01,494075,Staff,26,0,30,4
1713304349225,MATH 20D,A02,494076,Staff,30,0,30,0
1713304350250,MATH 20E,A01,494079,Staff,25,0,30,5
1713304350250,MATH 20E,A02,494080,Staff,28,0,30,2
1713304350250,MATH 20E,B01,494082,Staff,28,0,30,2
1713304350250,MATH 20E,B02,494083,Staff,25,0,30,5
1713304351282,MATH 103A,A01,494085,Aliabadi Sr.; Mohsen,22,0,30,8
1713304351282,MATH 103A,A02,494086,Aliabadi Sr.; Mohsen,29,0,30,1
1713304351282,MATH 103A,B01,494088,Aliabadi Sr.; Mohsen,22,0,30,8
1713304351282,MATH 103A,B02,494089,Aliabadi Sr.; Mohsen,28,0,30,2
1713304352309,MATH 109,A01,494091,Staff,30,0,30,0
1713304352309,MATH 109,A02,494092,Staff,30,0,30,0
1713304352309,MATH 109,B01,494094,Staff,28,0,30,2
1713304352309,MATH 109,B02,494095,Staff,29,0,30,1
1713304353341,MATH 142A,A01,494097,Chow; Bennett,17,0,30,13
1713304353341,MATH 142A,A02,494098,Chow; Bennett,25,0,30,5
1713304353341,MATH 142A,B01,494100,Chow; Bennett,23,0,30,7
1713304353341,MATH 142A,B02,494101,Chow; Bennett,29,0,30,1
1713304355395,MATH 168A,A01,516677,Dumitriu; Ioana,17,0,35,18
1713304356420,MATH 170A,A01,516679,Dumitriu; Ioana,23,0,30,7
1713304356420,MATH 170A,A02,516680,Dumitriu; Ioana,28,0,30,2
1713304357449,MATH 193A,A01,494107,Staff,18,0,30,12
1713304357449,MATH 193A,A02,494108,Staff,25,0,30,5
1713304357449,MATH 193A,A03,494109,Staff,29,0,30,1
1713304357449,MATH 193A,A04,494110,Staff,27,0,30,3
1713304360525,MGT 16,A00,491930,McKay; Michael J,94,0,98,4
1713304361557,MGT 18,A00,491992,McKay; Michael J,97,0,98,1
1713304362583,MGT 71,A00,492003,Staff,79,0,98,19
1713304363611,MGT 103,A00,505209,Eberhard; Craig A,88,0,98,10
1713304364641,MGT 131A,A00,505210,Anderson; John Charles,91,0,98,7
1713304366694,MGT 153,A00,492077,Perols; Johan Lars,55,0,90,35
1713304369772,MGT 164,A00,492222,McKay; Mary A,94,0,98,4
1713304370798,MGT 172,A00,492245,Staff,59,0,60,1
1713304370798,MGT 172,B00,505526,Hedges; Kathleen,80,0,98,18
1713304371828,MGT 181,A00,505669,Dunn; Louis Jean,89,0,98,9
1713304372865,MMW 14,A01,494399,Staff,23,0,28,5
1713304372865,MMW 14,A02,494400,Staff,26,0,28,2
1713304372865,MMW 14,A03,494401,Staff,28,0,28,0
1713304372865,MMW 14,A04,494402,Staff,28,0,28,0
1713304372865,MMW 14,B01,494404,Carreras; Maria Victoria,18,0,28,10
1713304372865,MMW 14,B02,494405,Carreras; Maria Victoria,27,0,28,1
1713304372865,MMW 14,B03,494406,Carreras; Maria Victoria,28,0,28,0
1713304372865,MMW 14,B04,494407,Carreras; Maria Victoria,28,0,28,0
1713304373903,MMW 14GS,A00,506250,Chang; Edmond Yi-Teh,0,0,0,0
1713304374933,MMW 121R,A01,494415,Adamiak; Patrick John,16,0,28,12
1713304374933,MMW 121R,A02,494416,Adamiak; Patrick John,25,0,28,3
1713304375958,MUS 1A,A01,494113,Staff,14,0,25,11
1713304375958,MUS 1A,A02,494114,Staff,25,0,25,0
1713304376990,MUS 4,A01,494116,Staff,24,0,25,1
1713304376990,MUS 4,A02,494117,Staff,22,0,25,3
1713304378016,MUS 5R,A01,494236,Dubnov; Shlomo,13,0,25,12
1713304378016,MUS 5R,A02,494237,Dubnov; Shlomo,25,0,25,0
1713304379043,MUS 6,A01,494122,Staff,16,0,25,9
1713304379043,MUS 6,A02,494123,Staff,24,0,25,1
1713304380074,MUS 7,A01,494125,Staff,19,0,25,6
1713304380074,MUS 7,A02,494126,Staff,24,0,25,1
1713304381099,MUS 11,A01,494128,Staff,23,0,25,2
1713304381099,MUS 11,A02,494129,Staff,25,0,25,0
1713304382124,MUS 13,A01,494131,Staff,25,0,25,0
1713304382124,MUS 13,A02,494132,Staff,25,0,25,0
1713304383149,MUS 15,A01,494134,Staff,21,0,25,4
1713304383149,MUS 15,A02,494135,Staff,25,0,25,0
1713304383149,MUS 15,B01,494137,Staff,25,0,25,0
1713304384176,MUS 80,A00,494232,Staff,25,0,25,0
1713304384176,MUS 80,B00,494233,Staff,25,0,25,0
1713304384176,MUS 80,C00,494234,Staff,23,0,25,2
1713304385201,MUS 95C,A00,494141,Staff,73,0,75,2
1713304386226,MUS 114,A00,494142,Staff,42,0,50,8
1713304387253,NANO 15,A01,490636,Drews; Aaron,7,0,7,0
1713304388280,PHIL 1,A00,490578,Grush; Rick Scott,50,0,50,0
1713304389304,PHIL 10,A01,490580,Grush; Rick Scott,34,0,35,1
1713304389304,PHIL 10,A02,490586,Grush; Rick Scott,33,0,35,2
1713304390390,PHIL 27,A01,490591,Staff,24,0,25,1
1713304390390,PHIL 27,A02,490592,Staff,25,0,25,0
1713304390390,PHIL 27,A03,490593,Staff,25,0,25,0
1713304390390,PHIL 27,A04,490598,Staff,25,0,25,0
1713304391422,PHIL 32,A01,490611,Staff,20,0,20,0
1713304391422,PHIL 32,A02,490618,Staff,20,0,20,0
1713304392450,PHIL 90,A00,490624,Staff,40,0,40,0
1713304393481,PHIL 136,A00,490627,Cohen; Jonathan David,38,0,40,2
1713304394508,PHIL 155,A00,490634,Staff,67,0,70,3
1713304395533,PHYS 1A,A00,491610,Staff,246,0,250,4
1713304396563,PHYS 1AL,001,491616,Tsai; Philbert S,28,0,30,2
1713304396563,PHYS 1AL,002,491618,Tsai; Philbert S,30,0,30,0
1713304397590,PHYS 1B,A00,491623,Staff,245,0,250,5
1713304398616,PHYS 1BL,001,491626,Tsai; Philbert S,27,0,30,3
1713304398616,PHYS 1BL,002,491628,Tsai; Philbert S,28,0,30,2
1713304399641,PHYS 1C,A00,491632,Staff,227,0,245,18
1713304400670,PHYS 1CL,001,491635,Tsai; Philbert S,12,0,30,18
1713304400670,PHYS 1CL,002,491643,Tsai; Philbert S,26,0,30,4
1713304401694,PHYS 2AR,A01,491651,Meyertholen; Andrew D.,46,0,50,4
1713304402720,PHYS 2B,A01,491659,Staff,107,0,115,8
1713304403747,PHYS 2BL,A01,491685,Staff,24,0,24,0
1713304403747,PHYS 2BL,A02,491700,Staff,23,0,24,1
1713304404773,PHYS 2C,A01,505161,Staff,108,0,115,7
1713304405805,PHYS 4A,A01,491704,Grinstein; Benjamin,100,0,100,0
1713304406830,POLI 5D,A01,494144,Staff,3,0,5,2
1713304406830,POLI 5D,B01,626283,Dai; Yinlin,5,0,5,0
1713304407856,POLI 12,A00,494145,Staff,44,0,45,1
1713304408884,POLI 13R,A00,494146,Forman; Fonna,47,0,50,3
1713304409909,POLI 27,A01,494148,Staff,60,0,60,0
1713304410935,POLI 30,A00,494149,Staff,49,0,50,1
1713304411960,POLI 100DA,A00,494150,Staff,23,0,25,2
1713304414012,POLI 100I,A00,494152,Staff,29,0,30,1
1713304415036,POLI 104B,A00,494153,Smith; Glenn Chatmas,54,0,55,1
1713304416062,POLI 104F,A00,494154,Staff,29,0,30,1
1713304417086,POLI 104I,A00,494155,Smith; Glenn Chatmas,30,0,30,0
1713304418113,POLI 110C,A00,494156,Ingham; Sean,23,0,25,2
1713304419140,POLI 117R,A00,494157,Forman; Fonna,16,0,20,4
1713304420170,POLI 118,A00,494158,Ingham; Sean,23,0,25,2
1713304421197,POLI 120H,A00,494159,Fisk; David Lee,41,0,45,4
1713304422220,POLI 131CR,A00,494160,Hoston; Germaine,41,0,45,4
1713304423247,POLI 133J,A00,494161,Staff,33,0,35,2
1713304424273,POLI 135,A00,494162,Fisk; David Lee,34,0,35,1
1713304425300,POLI 140A,A00,494164,Staff,23,0,30,7
1713304426324,POLI 142I,A00,494165,Staff,30,0,30,0
1713304427350,POLI 144D,A00,494166,Staff,23,0,25,2
1713304428375,POLI 151,A00,494167,Staff,30,0,30,0
1713304429471,POLI 153,A00,494168,Staff,34,0,35,1
1713304430497,POLI 160AA,A00,494169,Staff,36,0,40,4
1713304431526,POLI 162,A00,494170,Mignozzetti; Umberto,22,0,25,3
1713304432555,POLI 171,A00,494171,Mignozzetti; Umberto,23,0,25,2
1713304433580,PSYC 1,A00,494172,Staff,97,0,100,3
1713304434605,PSYC 2,A00,494173,Moranton; Nirelia Melbina-,48,0,50,2
1713304435632,PSYC 3,A00,494174,Staff,30,0,30,0
1713304436658,PSYC 6,A00,494175,Staff,17,0,20,3
1713304437685,PSYC 60,A01,494177,Staff,42,0,45,3
1713304438710,PSYC 70,A01,505724,Geller; Emma Harlan,42,0,45,3
1713304439736,PSYC 101,A00,494180,Heyman; Gail D.,93,0,100,7
1713304440764,PSYC 105,A00,494181,Geller; Emma Harlan,67,0,90,23
1713304441792,PSYC 106,A00,494182,Dobkins; Karen R.,34,0,45,11
1713304442818,PSYC 108,A00,494183,Adrian; Julia Anna,94,0,100,6
1713304443859,PSYC 114,A01,494185,Winkielman; Piotr,7,0,30,23
1713304444892,PSYC 122,A00,494186,Moranton; Nirelia Melbina-,41,0,50,9
1713304445916,PSYC 124,A00,494187,Chapman; Eddie Nathaniel,74,0,80,6
1713304446950,PSYC 131,A00,494188,Anagnostaras; Stephan,61,0,80,19
1713304447975,PSYC 144,A00,494189,Staff,22,0,50,28
1713304449006,PSYC 154,A00,494190,Lacefield; Katharine I,143,0,180,37
1713304450033,PSYC 162,A00,494191,Wixted; John T,90,0,100,10
1713304451067,PSYC 172,A00,494192,Gorman; Michael R.,38,0,45,7
1713304452093,PSYC 178,A00,494193,Glaser; Dale,41,0,45,4
1713304453120,PSYC 193,A00,505725,Chapman; Eddie Nathaniel,20,0,20,0
1713304454148,RELI 145GS,A00,519817,Rahimi; Babak,19,0,20,1
1713304455175,SE 101A,A01,490862,Chadha; Mayank,24,0,25,1
1713304456206,SE 101C,A01,490924,Krysl; Petr,18,0,20,2
1713304457237,SE 110A,A01,490928,Staff,20,0,20,0
1713304458268,SE 130A,A00,490929,Morrison; Machel Leigh,66,0,70,4
1713304459296,SIO 1,A01,519325,Staff,39,0,40,1
1713304460322,SIO 30,A01,519327,Staff,40,0,40,0
1713304461347,SIO 40,A00,519328,Staff,40,0,40,0
1713304462373,SIO 46GS,A00,519819,Cook; Geoffrey W,19,0,25,6
1713304463399,SIO 109R,A00,494197,Forman; Fonna,9,0,20,11
1713304464422,SIO 121GS,A00,519827,Cook; Geoffrey W,19,0,25,6
1713304465447,SIO 132,A01,519330,Staff,38,0,40,2
1713304466472,SIO 133,A01,519397,Staff,38,0,40,2
1713304467502,SIO 139,A00,519396,Kacev; David,33,0,40,7
1713304468528,SOCI 1,A01,494199,Thorpe; Charles Robert,24,0,30,6
1713304468528,SOCI 1,A02,494200,Thorpe; Charles Robert,30,0,30,0
1713304468528,SOCI 1,A03,494201,Thorpe; Charles Robert,29,0,30,1
1713304468528,SOCI 1,A04,494202,Thorpe; Charles Robert,29,0,30,1
1713304468528,SOCI 1,A05,494203,Thorpe; Charles Robert,29,0,30,1
1713304468528,SOCI 1,A06,494204,Thorpe; Charles Robert,30,0,30,0
1713304468528,SOCI 1,A07,494205,Thorpe; Charles Robert,29,0,30,1
1713304469553,SOCI 60,A01,494207,Staff,36,0,40,4
1713304469553,SOCI 60,A02,494208,Staff,39,0,40,1
1713304470581,SOCI 100,A01,494210,Payne; Christine Anna,28,0,30,2
1713304470581,SOCI 100,A02,494211,Payne; Christine Anna,28,0,30,2
1713304471613,SOCI 109M,A00,494212,Staff,20,0,20,0
1713304472643,SOCI 110,A00,494213,Staff,35,0,40,5
1713304474698,SOCI 118E,A00,494215,Ng; Kwai,38,0,40,2
1713304475724,SOCI 125,A00,494216,Calderon-Zaks; Michael Aar,42,0,45,3
1713304476750,SOCI 126,A01,494218,Jones; Makeba,4,0,5,1
1713304477776,SOCI 131,A00,494219,Thorpe; Charles Robert,30,0,30,0
1713304479828,SOCI 135,A00,494221,Payne; Christine Anna,44,0,50,6
1713304480855,SOCI 136E,A00,626690,Ruiz; Jonathan Joseph,25,0,25,0
1713304481881,SOCI 138GS,A00,494222,Navon; Daniel,24,0,28,4
1713304483939,SOCI 145,A00,494224,Staff,44,0,45,1
1713304484969,SOCI 153,A00,494225,Staff,28,0,30,2
1713304486005,SOCI 160E,A00,494226,Ng; Kwai,34,0,40,6
1713304487029,SOCI 180,A00,494227,Staff,29,0,30,1
1713304488057,SOCI 189GS,A00,494228,Ribas Norris; Janet Vanesa,11,0,11,0
1713304489084,SOCI 190GS,A00,553232,Ribas Norris; Janet Vanesa,11,0,11,0
1713304490112,SYN 2,001,490768,Staff,14,0,15,1
1713304490112,SYN 2,002,490769,Staff,15,0,15,0
1713304490112,SYN 2,004,490775,Staff,0,0,0,0
1713304490112,SYN 2,003,490774,Staff,0,0,0,0
1713304490112,SYN 2,005,490776,Staff,0,0,0,0
1713304491154,SYN 2R,001,490779,Staff,14,0,15,1
1713304491154,SYN 2R,002,514635,Staff,14,0,15,1
1713304492184,SYN 100,A01,490783,Staff,17,0,20,3
1713304492184,SYN 100,B01,490787,Staff,12,0,20,8
1713304492184,SYN 100,C01,490789,Staff,15,0,20,5
1713304493208,SYN 150,A00,490817,Staff,14,0,15,1
1713304493208,SYN 150,B00,514610,Staff,15,0,15,0
1713304494309,TDAC 1,A00,492753,Walsh; Kim C.,19,0,20,1
1713304494309,TDAC 1,B00,492754,Harting; Carla Kelso,19,0,20,1
1713304494309,TDAC 1,C00,513995,Salovey; Todd,18,0,20,2
1713304495335,TDAC 101,A00,492766,Harting; Carla Kelso,19,0,20,1
1713304496364,TDAC 102,A00,492768,Basso; Beatrice,20,0,20,0
1713304497392,TDDE 111,A00,492769,Staff,25,0,25,0
1713304498417,TDDE 131,A00,492770,Staff,15,0,15,0
1713304498417,TDDE 131,B00,492771,Staff,15,0,15,0
1713304499443,TDDE 131GS,A00,523716,Guirguis; Mark C,25,0,28,3
1713304500477,TDGE 1,A01,492756,Salovey; Todd,58,0,60,2
1713304501502,TDGE 5,A01,492758,Staff,24,0,25,1
1713304502530,TDGE 10,A00,492759,Fulton; Julia,216,0,220,4
1713304503562,TDGE 11,A00,492760,Castro; Robert Jess,200,0,200,0
1713304504593,TDGE 50,A00,492761,Blair; Kyle Adam,0,0,0,0
1713304505622,TDGE 124,A00,492772,Fulton; Julia,200,0,220,20
1713304506650,TDGE 125,A00,492773,Meyer; Ursula,43,0,50,7
1713304506650,TDGE 125,B00,492774,Staff,50,0,50,0
1713304506650,TDGE 125,C00,523565,Staff,50,0,50,0
1713304507675,TDGE 125GS,A00,523580,Guirguis; Mark C,25,0,28,3
1713304508702,TDGE 127,A00,492775,Havis; Allan,44,0,50,6
1713304509727,TDHT 101,A00,492776,Staff,35,0,35,0
1713304510753,TDMV 1,A00,492762,Caligagan; Maria T.,30,0,30,0
1713304510753,TDMV 1,B00,492763,Arcidiacono; Kristin,26,0,30,4
1713304511779,TDMV 2,A00,492764,Weinberg; Sadie,29,0,30,1
1713304512804,TDMV 3,A00,492765,Mack; Kara Shanai',40,0,40,0
1713304513836,TDMV 138,A00,492777,Mack; Kara Shanai',37,0,40,3
1713304514862,TDMV 140,A00,492778,Lima; Paulo Henrique,40,0,40,0
1713304515894,TDMV 142,A00,492779,Caligagan; Maria T.,37,0,40,3
1713304515894,TDMV 142,B00,492780,Caligagan; Tony,38,0,40,2
1713304516919,TDMV 143,A00,492781,Fyall; Daunte Edward,40,0,40,0
1713304517952,USP 1,A01,492401,Kwak; Nancy,29,0,35,6
1713304518979,USP 2,A01,492453,Hinds; Juli Beth,35,0,35,0
1713304520004,USP 3,A01,492516,Staff,32,0,35,3
1713304521030,USP 4,A00,492522,McTague; Sarah,20,0,25,5
1713304522057,USP 100,A00,492523,Staff,33,0,35,2
1713304523088,USP 101,A00,492524,Staff,13,0,15,2
1713304524114,USP 105,A00,492525,Staff,22,0,25,3
1713304525140,USP 151,A00,492526,Shenkman; Michael Thomas,33,0,35,2
1713304526167,USP 170,A00,492545,Hinds; Juli Beth,33,0,35,2
1713304527192,USP 171GS,A00,492608,Bussell; Mirle Rabinowitz,26,0,28,2
1713304528218,USP 183GS,A00,492613,Peerson; Susan,26,0,28,2
1713304529244,VIS 30,A01,490693,Yoldas; Pinar,21,0,22,1
1713304529244,VIS 30,A02,490694,Yoldas; Pinar,19,0,22,3
1713304530273,VIS 83,A00,490695,Kester; Grant,68,0,75,7
1713304531300,VIS 105D,A00,490696,Staff,22,0,25,3
1713304532326,VIS 124CN,A00,490699,Rose; Jordan M,68,0,75,7
1713304533351,VIS 125GS,A00,511221,Williams; Alena J,21,0,22,1
1713304534376,VIS 128D,A00,490700,Staff,74,0,75,1
1713304535403,VIS 151,A01,490717,Staff,34,0,34,0
1713304535403,VIS 151,A02,490766,Staff,33,0,34,1
1713304536432,VIS 154GS,A00,511972,Williams; Alena J,21,0,22,1
1713304537457,VIS 160A,A00,490767,Stone; Patricia,7,0,10,3
1713304538483,WCWP 10A,A00,490638,Staff,15,0,15,0
1713304538483,WCWP 10A,B00,490640,Staff,15,0,15,0
1713304539514,WCWP 10B,A00,490641,Staff,0,0,0,0
1713304539514,WCWP 10B,B00,490642,Staff,14,0,15,1
1713304539514,WCWP 10B,C00,490644,Staff,14,0,15,1
1713304539514,WCWP 10B,D00,490647,Staff,0,0,0,0
1713304540544,WCWP 100,A00,490655,Staff,0,0,0,0
1713304540544,WCWP 100,B00,490687,Staff,12,0,15,3
1713304542672,ANAR 153,A00,487222,Braswell; Geoffrey E.,55,0,60,5
1713304543703,ANBI 134,A00,487223,Staff,14,0,20,6
1713304544731,ANBI 143GS,A00,487224,Noel; Geoffroy Pierre Jean,20,0,24,4
1713304545757,ANBI 144GS,A00,519548,Noel; Geoffroy Pierre Jean,20,0,24,4
1713304546784,ANSC 101,A00,487225,Staff,19,0,20,1
1713304547809,ANSC 125,A00,487227,Brenner; Suzanne A,40,0,40,0
1713304549860,ANSC 146,A00,487229,Staff,37,0,40,3
1713304550885,ANSC 148,A00,487230,Olivas Hernandez; Olga Lid,39,0,40,1
1713304551913,ANSC 150,A00,504165,Sloane; Julia Kathryn,19,0,20,1
1713304552939,ANSC 180,A00,487232,Staff,13,0,15,2
1713304553966,ANSC 188,A00,627155,Staff,40,0,40,0
1713304554993,ANTH 5,A00,519529,Semendeferi; Ekaterini,15,0,15,0
1713304556019,ANTH 10,A00,487219,Staff,58,0,60,2
1713304557046,ANTH 23,A01,487221,Staff,19,0,20,1
1713304558075,ANTH 102,A00,487233,Wilder; Linnea Lorene,53,0,60,7
1713304559104,ANTH 103,A00,487234,Varma; Saiba,57,0,60,3
1713304560134,ANTH 105,A00,487235,Stewart; Alexander B,57,0,60,3
1713304561168,BENG 100,A01,516685,Taylor Amos; Alyssa C,28,0,30,2
1713304562194,BIBC 102,A01,491316,Flagg; Matthew Paul,60,0,88,28
1713304562194,BIBC 102,A02,491366,Flagg; Matthew Paul,84,0,88,4
1713304563218,BIBC 103,A01,491486,Boumechache; Miyyada,16,0,24,8
1713304563218,BIBC 103,A02,491487,Boumechache; Miyyada,24,0,24,0
1713304564245,BICD 100,A01,516882,Staff,75,0,75,0
1713304564245,BICD 100,A02,516890,Staff,71,0,75,4
1713304565278,BICD 102GS,A00,491488,Lo; Stanley M.,27,0,28,1
1713304566305,BIEB 136GS,A00,516940,Holway; David A. & Shurin; Jonathan,20,0,24,4
1713304567334,BIEB 137GS,A01,517034,Holway; David A. & Shurin; Jonathan,20,0,24,4
1713304568362,BIEB 138GS,A01,491492,Pirino; Giorgia,22,0,28,6
1713304569389,BILD 1,A01,491296,Staff,62,0,63,1
1713304569389,BILD 1,A02,491297,Staff,63,0,63,0
1713304570419,BILD 4,A01,517099,Gonzalez Gamboa; Ivonne,23,0,24,1
1713304570419,BILD 4,A02,517100,Gonzalez Gamboa; Ivonne,24,0,24,0
1713304571448,BILD 60GS,A00,491309,Lo; Stanley M.,27,0,28,1
1713304572474,BIMM 100,A01,517136,Staff,94,0,100,6
1713304573498,BIMM 110,A01,517182,Staff,80,0,100,20
1713304574529,BIMM 120,A01,517228,Pickett; Brooke Elizabeth,41,0,63,22
1713304574529,BIMM 120,A02,517240,Pickett; Brooke Elizabeth,49,0,63,14
1713304575558,BIMM 132GS,A01,491498,Pirino; Giorgia,22,0,28,6
1713304576585,BIMM 143,A01,491589,Bozinovic; Goran,21,0,40,19
1713304577612,BIPN 100,A01,491594,Armour; Jon Christopher,93,0,100,7
1713304578640,BIPN 140,A01,491602,Marino; Marc J,34,0,50,16
1713304580691,CAT 125,A00,515973,Staff,20,0,20,0
1713304581716,CAT 125GS,A00,515974,Rahimi; Babak,19,0,20,1
1713304582748,CAT 125R,A00,515980,Staff,15,0,20,5
1713304582748,CAT 125R,B00,515981,Tosun; Adriana,19,0,20,1
1713304582748,CAT 125R,C00,515987,Hyland; Tina Mae,6,0,20,14
1713304582748,CAT 125R,D00,515988,Bronstein; Phoebe Malan,19,0,20,1
1713304583779,CENG 15,A01,488699,Drews; Aaron,25,0,25,0
1713304584804,CENG 100,A00,505196,Opatkiewicz; Justin Paul,25,0,25,0
1713304585834,CGS 2A,A01,489598,Staff,33,0,35,2
1713304586860,CGS 112,A00,489599,Staff,15,0,15,0
1713304587884,CGS 119,A00,489603,Staff,10,0,10,0
1713304588912,CGS 120,A00,489604,Staff,14,0,15,1
1713304589935,CGS 150,A00,489607,Staff,15,0,15,0
1713304590964,CHEM 6A,A01,488715,Staff,98,0,100,2
1713304591994,CHEM 6B,A01,488719,Piercy; Marc Anthony,100,0,100,0
1713304593021,CHEM 6C,A01,488723,Albizati; Kim F.,94,0,100,6
1713304594049,CHEM 7L,A01,488728,Schurmeier; Kimberly,18,0,24,6
1713304594049,CHEM 7L,A02,488730,Schurmeier; Kimberly,23,0,24,1
1713304594049,CHEM 7L,A03,488734,Schurmeier; Kimberly,24,0,24,0
1713304594049,CHEM 7L,A04,488763,Schurmeier; Kimberly,23,0,24,1
1713304594049,CHEM 7L,B01,488798,Schurmeier; Kimberly,18,0,24,6
1713304594049,CHEM 7L,B02,488801,Schurmeier; Kimberly,24,0,24,0
1713304594049,CHEM 7L,B03,488808,Schurmeier; Kimberly,24,0,24,0
1713304594049,CHEM 7L,B04,488811,Schurmeier; Kimberly,24,0,24,0
1713304595079,CHEM 11,A01,488897,Stallings; Dontarie M,98,0,100,2
1713304596110,CHEM 40A,A01,488913,Albizati; Kim F.,93,0,100,7
1713304597136,CHEM 40B,A01,488920,Weizman; Haim,48,0,50,2
1713304597136,CHEM 40B,A02,488938,Weizman; Haim,47,0,50,3
1713304598217,CHEM 41A,A01,489029,Klosterman; Jeremy K,58,0,60,2
1713304599249,CHEM 41C,A01,500436,Tor; Yitzhak,56,0,60,4
1713304600282,CHEM 43A,A01,500426,Weizman; Haim,6,0,24,18
1713304600282,CHEM 43A,A02,500430,Weizman; Haim,16,0,24,8
1713304600282,CHEM 43A,B01,514041,Klosterman; Jeremy K,18,0,24,6
1713304600282,CHEM 43A,B02,514047,Klosterman; Jeremy K,23,0,24,1
1713304601309,CHEM 108,A01,489140,Jennings; Patricia A.,14,0,24,10
1713304601309,CHEM 108,A02,489142,Jennings; Patricia A.,16,0,24,8
1713304602334,CHEM 114A,A01,489147,Stallings; Dontarie M,81,0,100,19
1713304603361,CHIN 169A,A00,489171,Wang; Xiao,19,0,20,1
1713304605413,COGS 3,A01,518827,Boyle; Mary E. T.,31,0,40,9
1713304606440,COGS 11,A01,489175,Staff,28,0,30,2
1713304607465,COGS 14A,A01,518829,Staff,54,0,60,6
1713304608495,COGS 14B,A01,489177,Hoffman; Drew Ellen,69,0,75,6
1713304609521,COGS 100,A01,489181,Allen; Michael Gordon,66,0,75,9
1713304610546,COGS 101A,A01,489183,Staff,51,0,60,9
1713304611579,COGS 101B,A01,489185,Allen; Michael Gordon,13,0,30,17
1713304612604,COGS 101C,A01,526786,Staff,25,0,30,5
1713304614664,COGS 107A,A01,489189,Boyle; Mary E. T.,24,0,35,11
1713304615695,COGS 107B,A01,627144,Mooshagian; Eric Frederick,60,0,60,0
1713304616726,COGS 118A,A01,489191,Staff,0,22,40,40
1713304618775,COGS 171GS,A01,489194,Pineda; Jaime A,22,0,28,6
1713304619804,COGS 172,A01,489196,Staff,9,0,30,21
1713304620829,COGS 174GS,A01,489264,Pineda; Jaime A,22,0,28,6
1713304621855,COGS 180,A01,627150,Staff,29,0,30,1
1713304622883,COGS 186,A01,489274,Staff,4,0,30,26
1713304623908,COMM 10,A01,489276,Staff,25,0,25,0
1713304623908,COMM 10,A02,489303,Staff,23,0,25,2
1713304624932,COMM 100A,A01,489312,Staff,21,0,25,4
1713304624932,COMM 100A,A02,489313,Staff,24,0,25,1
1713304625958,COMM 106T,A00,512540,Staff,34,0,35,1
1713304626986,COMM 107,A00,489347,Staff,31,0,35,4
1713304628009,COMM 109P,A00,489358,Staff,31,0,35,4
1713304629034,COMM 132,A00,489361,McKenna; Denise,29,0,30,1
1713304630060,COMM 146,A00,489362,Halm; Gavin Patrick,27,0,30,3
1713304631089,COMM 190,A00,489363,Abuelhiga; Soraya Jill,21,0,23,2
1713304632118,CSE 8A,A50,489366,Staff,23,0,25,2
1713304632118,CSE 8A,A51,489367,Staff,24,0,25,1
1713304633142,CSE 11,A01,489398,Cao; Yingjun,85,0,100,15
1713304634171,CSE 12,A01,489487,Staff,43,0,50,7
1713304635198,CSE 20,A01,489497,Staff,49,0,50,1
1713304636223,CSE 21,A01,489517,Braun; Oliver,44,0,50,6
1713304637249,CSE 101,A01,489524,Braun; Oliver,0,2,50,50
1713304638277,CSE 105,A01,512594,Jones; Miles E,84,0,100,16
1713304638277,CSE 105,B01,512598,Jones; Miles E,72,0,100,28
1713304639309,CSE 140,A01,489538,Staff,45,0,50,5
1713304640340,CSE 141,A01,489550,Eldon; John,76,0,100,24
1713304641365,CSE 141L,A01,489571,Eldon; John,75,0,100,25
1713304642391,CSE 151A,A01,489583,Solares; Edwin A,155,0,200,45
1713304643418,CSE 175,A01,510886,Kumar; Rakesh,30,0,30,0
1713304644443,CSE 190,A00,516828,Dubnov; Shlomo,41,0,49,8
1713304645472,DOC 100D,A00,489667,Pass; Natalye Joann,23,0,25,2
1713304646499,DSC 10,A01,624268,Staff,72,0,75,3
1713304647531,DSC 20,A01,624476,Staff,50,0,50,0
1713304648558,DSC 40A,A01,624608,Staff,40,0,40,0
1713304649583,DSGN 1,A01,489179,Rill; Bryan,37,0,50,13
1713304650609,ECE 17,A01,490489,Sahay; Rajeev,21,0,30,9
1713304651635,ECE 65,A50,490492,Staff,17,0,20,3
1713304651635,ECE 65,A51,490493,Staff,20,0,20,0
1713304652670,ECON 1,A01,489715,Famulari; Melissa,69,0,70,1
1713304653695,ECON 2,A01,489717,Levkoff; Steven B.,69,0,70,1
1713304654722,ECON 3,A01,489948,Staff,70,0,70,0
1713304656776,ECON 5,A01,490103,Staff,28,0,30,2
1713304656776,ECON 5,B01,626281,Dai; Yinlin,45,0,45,0
1713304657807,ECON 100A,A01,490127,Famulari; Melissa,70,0,70,0
1713304658836,ECON 100B,A01,490129,Staff,64,0,70,6
1713304659863,ECON 109,A01,490187,Shishkin; Denis,29,0,35,6
1713304660891,ECON 110A,A01,490190,Levkoff; Steven B.,64,0,70,6
1713304661915,ECON 120A,A01,490245,Dai; Yinlin,69,0,70,1
1713304662940,ECON 120B,A01,490247,Nieto-Barthaburu; Augusto,60,0,70,10
1713304663967,ECON 120C,A01,490253,Sun; Yixiao,32,0,35,3
1713304663967,ECON 120C,B01,490255,Sun; Yixiao,34,0,35,1
1713304664993,ECON 129,A00,490256,Eckert; Fabian Paul,28,0,35,7
1713304666019,ECON 131,A00,490257,Nieto-Barthaburu; Augusto,6,0,35,29
1713304667046,ECON 138,A00,490258,Bharadwaj; Prashant,24,0,35,11
1713304667046,ECON 138,B00,490259,Bharadwaj; Prashant,20,0,35,15
1713304668077,ECON 159,A00,490260,Hendrickson; Gerald M.,0,6,0,0
1713304669103,ECON 178,A01,553995,Zhu; Ying,28,0,35,7
1713304670136,EDS 40,A01,512576,Black; Alison Michelle,20,0,20,0
1713304671163,EDS 107,A01,515848,Staff,30,0,30,0
1713304672193,EDS 110R,A01,490262,Staff,26,0,30,4
1713304673219,EDS 112,A01,490264,Chapman; Thandeka K,45,0,50,5
1713304674245,EDS 113,A00,490266,Staff,28,0,30,2
1713304675271,EDS 118,A00,490267,Warstadt; Melissa Fawn,27,0,30,3
1713304676300,EDS 124BR,A00,490268,Eguchi; Emi,10,0,25,15
1713304676300,EDS 124BR,B00,490269,Eguchi; Emi,25,0,25,0
1713304677324,EDS 126,A01,490271,Jones; Makeba,47,0,50,3
1713304678352,EDS 135,A01,490316,Staff,19,0,20,1
1713304679378,ENVR 142GS,A00,519514,Chang; Edmond Yi-Teh,28,0,28,0
1713304680407,ETHN 103,A00,490504,Staff,33,0,36,3
1713304681438,ETHN 103A,A00,490505,Man; Simeon S,7,0,9,2
1713304682463,ETHN 109,A00,490506,Staff,30,0,30,0
1713304683493,ETHN 118,A00,490507,Staff,35,0,36,1
1713304684521,ETHN 119,A00,490508,Staff,36,0,36,0
1713304685547,ETHN 121R,A00,490518,Choi; Esther Min,30,0,36,6
1713304686573,ETHN 127,A00,490528,Staff,15,0,15,0
1713304687602,ETHN 139,A00,490573,Staff,10,0,10,0
1713304688629,ETHN 150,A00,490575,Staff,15,0,15,0
1713304689656,GLBH 20,A00,491705,Elwardani; Nile Regina,38,0,40,2
1713304690684,GLBH 101,A00,491706,Staff,20,0,20,0
1713304691713,GLBH 111,A01,491708,Burgos; Jose L.,15,0,15,0
1713304692738,GLBH 146,A00,491709,Staff,14,0,20,6
1713304693767,GLBH 148,A00,491710,Olivas Hernandez; Olga Lid,17,0,20,3
1713304694796,GLBH 150,A00,491711,Sloane; Julia Kathryn,20,0,20,0
1713304695819,HIEA 131,A00,491760,Staff,30,0,32,2
1713304696845,HIEA 153,A00,491762,Staff,29,0,30,1
1713304697874,HIEU 124,A00,491811,Staff,28,0,32,4
1713304698899,HIEU 124GS,A00,491812,Markman; Kristina,28,0,28,0
1713304699926,HIEU 147,A00,491813,Staff,31,0,32,1
1713304700951,HIEU 149GS,A00,491816,Caldwell; Michael Alan,28,0,28,0
1713304702031,HILD 2C,A01,491713,Hendrickson; Gerald M.,28,0,30,2
1713304703056,HILD 7B,A01,491715,Kwak; Nancy,17,0,30,13
1713304704085,HILD 10,A01,491717,Staff,16,0,20,4
1713304705111,HILD 30GS,A00,491719,Edington; Claire Ellen,24,0,28,4
1713304706135,HINE 109,A00,491818,Shafir; Nir,30,0,32,2
1713304707160,HINE 128,A00,491821,Shafir; Nir,32,0,32,0
1713304708188,HISC 117,A00,491830,Staff,29,0,32,3
1713304709216,HIUS 103,A00,491834,Man; Simeon S,18,0,23,5
1713304710241,HIUS 108B,A00,491835,Staff,30,0,30,0
1713304711272,HIUS 141,A00,491836,Hendrickson; Gerald M.,29,0,32,3
1713304712296,HIUS 149,A00,491839,Staff,27,0,32,5
1713304713325,HUM 3,A01,512617,Crum; Matthew Stephen,46,0,50,4
1713304713325,HUM 3,A02,512618,Crum; Matthew Stephen,48,0,50,2
1713304714355,HUM 3GS,A00,512663,Markman; Kristina,0,0,0,0
1713304714355,HUM 3GS,B00,512664,Staff,0,0,0,0
1713304715388,HUM 4,A01,512620,West; Geoffrey Scott,38,0,50,12
1713304716420,HUM 4GS,A00,512666,Lyon; Antony J.,0,0,0,3
1713304717446,HUM 4R,A01,512625,Watkins; Eric,49,0,50,1
1713304718476,HUM 5,A01,512649,Zavodny; Tatiana Sophia,34,0,50,16
1713304718476,HUM 5,B01,512661,Zroka; Ryan Edward,49,0,50,1
1713304719506,INTL 190,A00,490577,Segui; Alan S,0,0,0,5
1713304720537,JAPN 20AR,A01,491267,Ross; Kayoko F,12,0,20,8
1713304721565,JAPN 180,A00,491285,Berman; Michael David,34,0,40,6
1713304722593,LATI 50,A01,502536,Kokinis; Troy Andreas,19,0,22,3
1713304722593,LATI 50,A02,502551,Kokinis; Troy Andreas,22,0,22,0
1713304722593,LATI 50,A03,502650,Kokinis; Troy Andreas,22,0,22,0
1713304722593,LATI 50,A04,502909,Kokinis; Troy Andreas,22,0,22,0
1713304723623,LATI 160,A01,502920,Kokinis; Troy Andreas,30,0,30,0
1713304724649,LIFR 1A,A00,490494,Van Moer; Vinciane G,18,0,20,2
1713304725678,LIFR 1AX,A00,490495,Van Moer; Vinciane G,18,0,20,2
1713304726708,LIFR 1B,A00,490496,Van Moer; Vinciane G,20,0,20,0
1713304727738,LIFR 1BX,A00,490497,Van Moer; Vinciane G,20,0,20,0
1713304728763,LIGN 8,A00,505198,McIntosh; Justin Daniel,143,0,150,7
1713304729791,LIGN 9GS,A00,491239,Lott; Margaret S.,18,0,20,2
1713304730818,LIGN 101,A01,505200,McIntosh; Justin Daniel,26,0,30,4
1713304731843,LIGN 120,A01,491244,Staff,26,0,30,4
1713304732869,LIGN 149GS,A00,491245,Lott; Margaret S.,18,0,20,2
1713304733898,LIGN 170,A00,491247,Staff,25,0,30,5
1713304734927,LISP 1D,A00,490498,Munoz Sanchez; Alicia,11,0,14,3
1713304734927,LISP 1D,B00,490499,Munoz Sanchez; Alicia,7,0,14,7
1713304734927,LISP 1D,C00,490500,Munoz Sanchez; Alicia,10,0,14,4
1713304734927,LISP 1D,D00,490501,Munoz Sanchez; Alicia,11,0,14,3
1713304735955,LISP 1DX,A00,490502,Munoz Sanchez; Alicia,19,0,28,9
1713304735955,LISP 1DX,B00,490503,Munoz Sanchez; Alicia,19,0,28,9
1713304738009,LTAM 110,A00,491847,Staff,23,0,25,2
1713304739035,LTCS 119,A00,491848,Staff,13,0,15,2
1713304740060,LTCS 130,A00,491849,Staff,24,0,25,1
1713304742109,LTEA 120C,A00,491852,Staff,35,0,40,5
1713304743134,LTEN 130GS,A00,491853,Lyon; Antony J.,25,0,28,3
1713304744160,LTEN 148,A00,491855,Staff,23,0,25,2
1713304745184,LTEN 159,A00,491856,Staff,21,0,25,4
1713304746210,LTEN 180,A00,491857,Staff,9,0,15,6
1713304748267,LTSP 123GS,A00,505928,Bessett; Ryan Matthew,25,0,28,3
1713304749290,LTSP 174GS,A00,506037,Bessett; Ryan Matthew,25,0,28,3
1713304751347,LTWR 102,A00,491861,Staff,12,0,15,3
1713304752375,LTWR 106,A00,491862,Staff,11,0,15,4
1713304753400,MAE 11,A00,490930,Bahadori; Mohammad Yousef,98,0,100,2
1713304754431,MAE 30A,A00,490931,Qi; Huihui,38,0,40,2
1713304755454,MAE 101A,A00,491036,Sadeghizadeh; Zahra,98,0,100,2
1713304756479,MAE 101C,A00,491037,Seshadri; Kalyanasundaram,78,0,100,22
1713304757503,MAE 113,A00,491040,Seshadri; Kalyanasundaram,67,0,80,13
1713304758528,MAE 131A,A00,491041,Ghazinejad; Maziar,39,0,40,1
1713304759553,MAE 142,A00,491053,Staff,39,0,40,1
1713304760582,MAE 143A,A00,491054,Staff,43,0,50,7
1713304761610,MAE 150,A00,491092,Truong; Phuong Thi Ngoc,25,0,35,10
1713304762641,MATH 3C,A01,494031,Pardo Guerra; Sebastian,30,0,30,0
1713304762641,MATH 3C,A02,494032,Pardo Guerra; Sebastian,29,0,30,1
1713304763671,MATH 10A,A01,494034,Staff,28,0,30,2
1713304763671,MATH 10A,A02,494035,Staff,29,0,30,1
1713304763671,MATH 10A,B01,494037,Staff,28,0,30,2
1713304763671,MATH 10A,B02,494038,Staff,29,0,30,1
1713304764705,MATH 10B,A01,494040,Habib; Yousaf,24,0,30,6
1713304764705,MATH 10B,A02,494041,Habib; Yousaf,28,0,30,2
1713304764705,MATH 10B,A03,494042,Habib; Yousaf,30,0,30,0
1713304764705,MATH 10B,A04,494043,Habib; Yousaf,30,0,30,0
1713304764705,MATH 10B,B01,494045,Habib; Yousaf,28,0,30,2
1713304764705,MATH 10B,B02,494046,Habib; Yousaf,30,0,30,0
1713304764705,MATH 10B,B03,494047,Habib; Yousaf,30,0,30,0
1713304764705,MATH 10B,B04,494048,Habib; Yousaf,30,0,30,0
1713304765732,MATH 18,A01,494050,Kemp; Todd Aahron,28,0,30,2
1713304765732,MATH 18,A02,494051,Kemp; Todd Aahron,29,0,30,1
1713304765732,MATH 18,B01,494054,Kemp; Todd Aahron,28,0,30,2
1713304765732,MATH 18,B02,494055,Kemp; Todd Aahron,29,0,30,1
1713304766763,MATH 20A,A01,494059,Suk; Andrew Hoon,30,0,30,0
1713304767794,MATH 20B,A01,494061,Briones; Jor-el Thomas Caparas,34,0,35,1
1713304767794,MATH 20B,B01,494063,Bach; Quang Tran,34,0,35,1
1713304768821,MATH 20C,A01,494065,Staff,29,0,30,1
1713304768821,MATH 20C,A02,494066,Staff,30,0,30,0
1713304768821,MATH 20C,A03,494067,Staff,30,0,30,0
1713304768821,MATH 20C,A04,494068,Staff,30,0,30,0
1713304768821,MATH 20C,B01,494070,Zhang; Ming,27,0,30,3
1713304768821,MATH 20C,B02,494071,Zhang; Ming,30,0,30,0
1713304768821,MATH 20C,B03,494072,Zhang; Ming,29,0,30,1
1713304768821,MATH 20C,B04,494073,Zhang; Ming,29,0,30,1
1713304769851,MATH 20D,A01,494075,Staff,26,0,30,4
1713304769851,MATH 20D,A02,494076,Staff,30,0,30,0
1713304770882,MATH 20E,A01,494079,Staff,25,0,30,5
1713304770882,MATH 20E,A02,494080,Staff,28,0,30,2
1713304770882,MATH 20E,B01,494082,Staff,28,0,30,2
1713304770882,MATH 20E,B02,494083,Staff,25,0,30,5
1713304771908,MATH 103A,A01,494085,Aliabadi Sr.; Mohsen,22,0,30,8
1713304771908,MATH 103A,A02,494086,Aliabadi Sr.; Mohsen,29,0,30,1
1713304771908,MATH 103A,B01,494088,Aliabadi Sr.; Mohsen,22,0,30,8
1713304771908,MATH 103A,B02,494089,Aliabadi Sr.; Mohsen,28,0,30,2
1713304772945,MATH 109,A01,494091,Staff,30,0,30,0
1713304772945,MATH 109,A02,494092,Staff,30,0,30,0
1713304772945,MATH 109,B01,494094,Staff,28,0,30,2
1713304772945,MATH 109,B02,494095,Staff,29,0,30,1
1713304773978,MATH 142A,A01,494097,Chow; Bennett,16,0,30,14
1713304773978,MATH 142A,A02,494098,Chow; Bennett,25,0,30,5
1713304773978,MATH 142A,B01,494100,Chow; Bennett,23,0,30,7
1713304773978,MATH 142A,B02,494101,Chow; Bennett,29,0,30,1
1713304776032,MATH 168A,A01,516677,Dumitriu; Ioana,17,0,35,18
1713304777064,MATH 170A,A01,516679,Dumitriu; Ioana,22,0,30,8
1713304777064,MATH 170A,A02,516680,Dumitriu; Ioana,28,0,30,2
1713304778089,MATH 193A,A01,494107,Staff,17,0,30,13
1713304778089,MATH 193A,A02,494108,Staff,25,0,30,5
1713304778089,MATH 193A,A03,494109,Staff,29,0,30,1
1713304778089,MATH 193A,A04,494110,Staff,26,0,30,4
1713304781172,MGT 16,A00,491930,McKay; Michael J,94,0,98,4
1713304782201,MGT 18,A00,491992,McKay; Michael J,97,0,98,1
1713304783226,MGT 71,A00,492003,Staff,79,0,98,19
1713304784256,MGT 103,A00,505209,Eberhard; Craig A,88,0,98,10
1713304785280,MGT 131A,A00,505210,Anderson; John Charles,91,0,98,7
1713304787334,MGT 153,A00,492077,Perols; Johan Lars,53,0,90,37
1713304790405,MGT 164,A00,492222,McKay; Mary A,94,0,98,4
1713304791432,MGT 172,A00,492245,Staff,59,0,60,1
1713304791432,MGT 172,B00,505526,Hedges; Kathleen,80,0,98,18
1713304792456,MGT 181,A00,505669,Dunn; Louis Jean,89,0,98,9
1713304793486,MMW 14,A01,494399,Staff,23,0,28,5
1713304793486,MMW 14,A02,494400,Staff,26,0,28,2
1713304793486,MMW 14,A03,494401,Staff,28,0,28,0
1713304793486,MMW 14,A04,494402,Staff,28,0,28,0
1713304793486,MMW 14,B01,494404,Carreras; Maria Victoria,18,0,28,10
1713304793486,MMW 14,B02,494405,Carreras; Maria Victoria,27,0,28,1
1713304793486,MMW 14,B03,494406,Carreras; Maria Victoria,28,0,28,0
1713304793486,MMW 14,B04,494407,Carreras; Maria Victoria,28,0,28,0
1713304794511,MMW 14GS,A00,506250,Chang; Edmond Yi-Teh,0,0,0,0
1713304795540,MMW 121R,A01,494415,Adamiak; Patrick John,16,0,28,12
1713304795540,MMW 121R,A02,494416,Adamiak; Patrick John,25,0,28,3
1713304796567,MUS 1A,A01,494113,Staff,14,0,25,11
1713304796567,MUS 1A,A02,494114,Staff,25,0,25,0
1713304797591,MUS 4,A01,494116,Staff,24,0,25,1
1713304797591,MUS 4,A02,494117,Staff,22,0,25,3
1713304798617,MUS 5R,A01,494236,Dubnov; Shlomo,12,0,25,13
1713304798617,MUS 5R,A02,494237,Dubnov; Shlomo,25,0,25,0
1713304799642,MUS 6,A01,494122,Staff,16,0,25,9
1713304799642,MUS 6,A02,494123,Staff,24,0,25,1
1713304800668,MUS 7,A01,494125,Staff,17,0,25,8
1713304800668,MUS 7,A02,494126,Staff,24,0,25,1
1713304801695,MUS 11,A01,494128,Staff,23,0,25,2
1713304801695,MUS 11,A02,494129,Staff,25,0,25,0
1713304802723,MUS 13,A01,494131,Staff,25,0,25,0
1713304802723,MUS 13,A02,494132,Staff,25,0,25,0
1713304803755,MUS 15,A01,494134,Staff,20,0,25,5
1713304803755,MUS 15,A02,494135,Staff,25,0,25,0
1713304803755,MUS 15,B01,494137,Staff,25,0,25,0
1713304804806,MUS 80,A00,494232,Staff,25,0,25,0
1713304804806,MUS 80,B00,494233,Staff,25,0,25,0
1713304804806,MUS 80,C00,494234,Staff,23,0,25,2
1713304805887,MUS 95C,A00,494141,Staff,73,0,75,2
1713304806911,MUS 114,A00,494142,Staff,42,0,50,8
1713304807936,NANO 15,A01,490636,Drews; Aaron,7,0,7,0
1713304808962,PHIL 1,A00,490578,Grush; Rick Scott,50,0,50,0
1713304810074,PHIL 10,A01,490580,Grush; Rick Scott,34,0,35,1
1713304810074,PHIL 10,A02,490586,Grush; Rick Scott,33,0,35,2
1713304811107,PHIL 27,A01,490591,Staff,24,0,25,1
1713304811107,PHIL 27,A02,490592,Staff,25,0,25,0
1713304811107,PHIL 27,A03,490593,Staff,25,0,25,0
1713304811107,PHIL 27,A04,490598,Staff,25,0,25,0
1713304812132,PHIL 32,A01,490611,Staff,20,0,20,0
1713304812132,PHIL 32,A02,490618,Staff,20,0,20,0
1713304813158,PHIL 90,A00,490624,Staff,40,0,40,0
1713304814187,PHIL 136,A00,490627,Cohen; Jonathan David,38,0,40,2
1713304815212,PHIL 155,A00,490634,Staff,67,0,70,3
1713304816237,PHYS 1A,A00,491610,Staff,246,0,250,4
1713304817267,PHYS 1AL,001,491616,Tsai; Philbert S,28,0,30,2
1713304817267,PHYS 1AL,002,491618,Tsai; Philbert S,30,0,30,0
1713304818294,PHYS 1B,A00,491623,Staff,245,0,250,5
1713304819320,PHYS 1BL,001,491626,Tsai; Philbert S,27,0,30,3
1713304819320,PHYS 1BL,002,491628,Tsai; Philbert S,28,0,30,2
1713304820348,PHYS 1C,A00,491632,Staff,227,0,245,18
1713304821371,PHYS 1CL,001,491635,Tsai; Philbert S,12,0,30,18
1713304821371,PHYS 1CL,002,491643,Tsai; Philbert S,26,0,30,4
1713304822439,PHYS 2AR,A01,491651,Meyertholen; Andrew D.,46,0,50,4
1713304823469,PHYS 2B,A01,491659,Staff,107,0,115,8
1713304824494,PHYS 2BL,A01,491685,Staff,24,0,24,0
1713304824494,PHYS 2BL,A02,491700,Staff,23,0,24,1
1713304825522,PHYS 2C,A01,505161,Staff,108,0,115,7
1713304826553,PHYS 4A,A01,491704,Grinstein; Benjamin,100,0,100,0
1713304827589,POLI 5D,A01,494144,Staff,3,0,5,2
1713304827589,POLI 5D,B01,626283,Dai; Yinlin,5,0,5,0
1713304828616,POLI 12,A00,494145,Staff,44,0,45,1
1713304829645,POLI 13R,A00,494146,Forman; Fonna,47,0,50,3
1713304830673,POLI 27,A01,494148,Staff,59,0,60,1
1713304831699,POLI 30,A00,494149,Staff,49,0,50,1
1713304832725,POLI 100DA,A00,494150,Staff,23,0,25,2
1713304834779,POLI 100I,A00,494152,Staff,29,0,30,1
1713304835815,POLI 104B,A00,494153,Smith; Glenn Chatmas,54,0,55,1
1713304836846,POLI 104F,A00,494154,Staff,29,0,30,1
1713304837919,POLI 104I,A00,494155,Smith; Glenn Chatmas,30,0,30,0
1713304838955,POLI 110C,A00,494156,Ingham; Sean,23,0,25,2
1713304840051,POLI 117R,A00,494157,Forman; Fonna,16,0,20,4
1713304841086,POLI 118,A00,494158,Ingham; Sean,23,0,25,2
1713304842110,POLI 120H,A00,494159,Fisk; David Lee,41,0,45,4
1713304843135,POLI 131CR,A00,494160,Hoston; Germaine,41,0,45,4
1713304844165,POLI 133J,A00,494161,Staff,33,0,35,2
1713304845195,POLI 135,A00,494162,Fisk; David Lee,34,0,35,1
1713304846219,POLI 140A,A00,494164,Staff,23,0,30,7
1713304847244,POLI 142I,A00,494165,Staff,30,0,30,0
1713304848266,POLI 144D,A00,494166,Staff,23,0,25,2
1713304849298,POLI 151,A00,494167,Staff,30,0,30,0
1713304850328,POLI 153,A00,494168,Staff,34,0,35,1
1713304851357,POLI 160AA,A00,494169,Staff,36,0,40,4
1713304852388,POLI 162,A00,494170,Mignozzetti; Umberto,22,0,25,3
1713304853412,POLI 171,A00,494171,Mignozzetti; Umberto,23,0,25,2
1713304854447,PSYC 1,A00,494172,Staff,97,0,100,3
1713304855474,PSYC 2,A00,494173,Moranton; Nirelia Melbina-,48,0,50,2
1713304856500,PSYC 3,A00,494174,Staff,30,0,30,0
1713304857527,PSYC 6,A00,494175,Staff,17,0,20,3
1713304858558,PSYC 60,A01,494177,Staff,42,0,45,3
1713304859625,PSYC 70,A01,505724,Geller; Emma Harlan,42,0,45,3
1713304860653,PSYC 101,A00,494180,Heyman; Gail D.,93,0,100,7
1713304861687,PSYC 105,A00,494181,Geller; Emma Harlan,67,0,90,23
1713304862718,PSYC 106,A00,494182,Dobkins; Karen R.,34,0,45,11
1713304863743,PSYC 108,A00,494183,Adrian; Julia Anna,94,0,100,6
1713304864773,PSYC 114,A01,494185,Winkielman; Piotr,7,0,30,23
1713304865805,PSYC 122,A00,494186,Moranton; Nirelia Melbina-,41,0,50,9
1713304866835,PSYC 124,A00,494187,Chapman; Eddie Nathaniel,74,0,80,6
1713304867858,PSYC 131,A00,494188,Anagnostaras; Stephan,61,0,80,19
1713304868885,PSYC 144,A00,494189,Staff,22,0,50,28
1713304869940,PSYC 154,A00,494190,Lacefield; Katharine I,142,0,180,38
1713304871003,PSYC 162,A00,494191,Wixted; John T,90,0,100,10
1713304872046,PSYC 172,A00,494192,Gorman; Michael R.,38,0,45,7
1713304873083,PSYC 178,A00,494193,Glaser; Dale,41,0,45,4
1713304874109,PSYC 193,A00,505725,Chapman; Eddie Nathaniel,20,0,20,0
1713304875137,RELI 145GS,A00,519817,Rahimi; Babak,19,0,20,1
1713304876166,SE 101A,A01,490862,Chadha; Mayank,24,0,25,1
1713304877191,SE 101C,A01,490924,Krysl; Petr,18,0,20,2
1713304878223,SE 110A,A01,490928,Staff,20,0,20,0
1713304879249,SE 130A,A00,490929,Morrison; Machel Leigh,66,0,70,4
1713304880275,SIO 1,A01,519325,Staff,39,0,40,1
1713304881301,SIO 30,A01,519327,Staff,40,0,40,0
1713304882328,SIO 40,A00,519328,Staff,40,0,40,0
1713304883351,SIO 46GS,A00,519819,Cook; Geoffrey W,19,0,25,6
1713304884377,SIO 109R,A00,494197,Forman; Fonna,9,0,20,11
1713304885400,SIO 121GS,A00,519827,Cook; Geoffrey W,19,0,25,6
1713304886429,SIO 132,A01,519330,Staff,38,0,40,2
1713304887463,SIO 133,A01,519397,Staff,38,0,40,2
1713304888494,SIO 139,A00,519396,Kacev; David,33,0,40,7
1713304889519,SOCI 1,A01,494199,Thorpe; Charles Robert,24,0,30,6
1713304889519,SOCI 1,A02,494200,Thorpe; Charles Robert,30,0,30,0
1713304889519,SOCI 1,A03,494201,Thorpe; Charles Robert,29,0,30,1
1713304889519,SOCI 1,A04,494202,Thorpe; Charles Robert,29,0,30,1
1713304889519,SOCI 1,A05,494203,Thorpe; Charles Robert,29,0,30,1
1713304889519,SOCI 1,A06,494204,Thorpe; Charles Robert,30,0,30,0
1713304889519,SOCI 1,A07,494205,Thorpe; Charles Robert,29,0,30,1
1713304890544,SOCI 60,A01,494207,Staff,36,0,40,4
1713304890544,SOCI 60,A02,494208,Staff,39,0,40,1
1713304891572,SOCI 100,A01,494210,Payne; Christine Anna,28,0,30,2
1713304891572,SOCI 100,A02,494211,Payne; Christine Anna,28,0,30,2
1713304892597,SOCI 109M,A00,494212,Staff,20,0,20,0
1713304893623,SOCI 110,A00,494213,Staff,35,0,40,5
1713304895677,SOCI 118E,A00,494215,Ng; Kwai,38,0,40,2
1713304896704,SOCI 125,A00,494216,Calderon-Zaks; Michael Aar,42,0,45,3
1713304897734,SOCI 126,A01,494218,Jones; Makeba,4,0,5,1
1713304898761,SOCI 131,A00,494219,Thorpe; Charles Robert,30,0,30,0
1713304900817,SOCI 135,A00,494221,Payne; Christine Anna,44,0,50,6
1713304901845,SOCI 136E,A00,626690,Ruiz; Jonathan Joseph,25,0,25,0
1713304902872,SOCI 138GS,A00,494222,Navon; Daniel,24,0,28,4
1713304904925,SOCI 145,A00,494224,Staff,44,0,45,1
1713304905949,SOCI 153,A00,494225,Staff,28,0,30,2
1713304906978,SOCI 160E,A00,494226,Ng; Kwai,34,0,40,6
1713304908003,SOCI 180,A00,494227,Staff,29,0,30,1
1713304909032,SOCI 189GS,A00,494228,Ribas Norris; Janet Vanesa,11,0,11,0
1713304910112,SOCI 190GS,A00,553232,Ribas Norris; Janet Vanesa,11,0,11,0
1713304911139,SYN 2,001,490768,Staff,14,0,15,1
1713304911139,SYN 2,002,490769,Staff,15,0,15,0
1713304911139,SYN 2,004,490775,Staff,0,0,0,0
1713304911139,SYN 2,003,490774,Staff,0,0,0,0
1713304911139,SYN 2,005,490776,Staff,0,0,0,0
1713304912172,SYN 2R,001,490779,Staff,14,0,15,1
1713304912172,SYN 2R,002,514635,Staff,14,0,15,1
1713304913198,SYN 100,A01,490783,Staff,17,0,20,3
1713304913198,SYN 100,B01,490787,Staff,12,0,20,8
1713304913198,SYN 100,C01,490789,Staff,15,0,20,5
1713304914254,SYN 150,A00,490817,Staff,14,0,15,1
1713304914254,SYN 150,B00,514610,Staff,15,0,15,0
1713304915283,TDAC 1,A00,492753,Walsh; Kim C.,19,0,20,1
1713304915283,TDAC 1,B00,492754,Harting; Carla Kelso,19,0,20,1
1713304915283,TDAC 1,C00,513995,Salovey; Todd,18,0,20,2
1713304916312,TDAC 101,A00,492766,Harting; Carla Kelso,19,0,20,1
1713304917340,TDAC 102,A00,492768,Basso; Beatrice,20,0,20,0
1713304918368,TDDE 111,A00,492769,Staff,25,0,25,0
1713304919392,TDDE 131,A00,492770,Staff,15,0,15,0
1713304919392,TDDE 131,B00,492771,Staff,15,0,15,0
1713304920423,TDDE 131GS,A00,523716,Guirguis; Mark C,25,0,28,3
1713304921448,TDGE 1,A01,492756,Salovey; Todd,57,0,60,3
1713304922476,TDGE 5,A01,492758,Staff,24,0,25,1
1713304923505,TDGE 10,A00,492759,Fulton; Julia,215,0,220,5
1713304924529,TDGE 11,A00,492760,Castro; Robert Jess,200,0,200,0
1713304925559,TDGE 50,A00,492761,Blair; Kyle Adam,0,0,0,0
1713304926585,TDGE 124,A00,492772,Fulton; Julia,199,0,220,21
1713304927624,TDGE 125,A00,492773,Meyer; Ursula,43,0,50,7
1713304927624,TDGE 125,B00,492774,Staff,50,0,50,0
1713304927624,TDGE 125,C00,523565,Staff,50,0,50,0
1713304928649,TDGE 125GS,A00,523580,Guirguis; Mark C,25,0,28,3
1713304929684,TDGE 127,A00,492775,Havis; Allan,44,0,50,6
1713304930710,TDHT 101,A00,492776,Staff,35,0,35,0
1713304931736,TDMV 1,A00,492762,Caligagan; Maria T.,30,0,30,0
1713304931736,TDMV 1,B00,492763,Arcidiacono; Kristin,26,0,30,4
1713304932768,TDMV 2,A00,492764,Weinberg; Sadie,29,0,30,1
1713304933795,TDMV 3,A00,492765,Mack; Kara Shanai',40,0,40,0
1713304934824,TDMV 138,A00,492777,Mack; Kara Shanai',37,0,40,3
1713304935849,TDMV 140,A00,492778,Lima; Paulo Henrique,40,0,40,0
1713304936878,TDMV 142,A00,492779,Caligagan; Maria T.,37,0,40,3
1713304936878,TDMV 142,B00,492780,Caligagan; Tony,38,0,40,2
1713304937905,TDMV 143,A00,492781,Fyall; Daunte Edward,40,0,40,0
1713304938932,USP 1,A01,492401,Kwak; Nancy,29,0,35,6
1713304939959,USP 2,A01,492453,Hinds; Juli Beth,35,0,35,0
1713304940990,USP 3,A01,492516,Staff,32,0,35,3
1713304942020,USP 4,A00,492522,McTague; Sarah,20,0,25,5
1713304943049,USP 100,A00,492523,Staff,33,0,35,2
1713304944072,USP 101,A00,492524,Staff,13,0,15,2
1713304945097,USP 105,A00,492525,Staff,22,0,25,3
1713304946124,USP 151,A00,492526,Shenkman; Michael Thomas,33,0,35,2
1713304947155,USP 170,A00,492545,Hinds; Juli Beth,33,0,35,2
1713304948189,USP 171GS,A00,492608,Bussell; Mirle Rabinowitz,26,0,28,2
1713304949211,USP 183GS,A00,492613,Peerson; Susan,26,0,28,2
1713304950261,VIS 30,A01,490693,Yoldas; Pinar,21,0,22,1
1713304950261,VIS 30,A02,490694,Yoldas; Pinar,19,0,22,3
1713304951290,VIS 83,A00,490695,Kester; Grant,68,0,75,7
1713304952314,VIS 105D,A00,490696,Staff,22,0,25,3
1713304953339,VIS 124CN,A00,490699,Rose; Jordan M,68,0,75,7
1713304954365,VIS 125GS,A00,511221,Williams; Alena J,21,0,22,1
1713304955392,VIS 128D,A00,490700,Staff,74,0,75,1
1713304956422,VIS 151,A01,490717,Staff,34,0,34,0
1713304956422,VIS 151,A02,490766,Staff,33,0,34,1
1713304957452,VIS 154GS,A00,511972,Williams; Alena J,21,0,22,1
1713304958476,VIS 160A,A00,490767,Stone; Patricia,7,0,10,3
1713304959503,WCWP 10A,A00,490638,Staff,15,0,15,0
1713304959503,WCWP 10A,B00,490640,Staff,15,0,15,0
1713304960530,WCWP 10B,A00,490641,Staff,0,0,0,0
1713304960530,WCWP 10B,B00,490642,Staff,14,0,15,1
1713304960530,WCWP 10B,C00,490644,Staff,14,0,15,1
1713304960530,WCWP 10B,D00,490647,Staff,0,0,0,0
1713304961563,WCWP 100,A00,490655,Staff,0,0,0,0
1713304961563,WCWP 100,B00,490687,Staff,12,0,15,3
1713304963712,ANAR 153,A00,487222,Braswell; Geoffrey E.,55,0,60,5
1713304964740,ANBI 134,A00,487223,Staff,14,0,20,6
1713304965765,ANBI 143GS,A00,487224,Noel; Geoffroy Pierre Jean,20,0,24,4
1713304966790,ANBI 144GS,A00,519548,Noel; Geoffroy Pierre Jean,20,0,24,4
1713304967814,ANSC 101,A00,487225,Staff,19,0,20,1
1713304968844,ANSC 125,A00,487227,Brenner; Suzanne A,40,0,40,0
1713304970896,ANSC 146,A00,487229,Staff,37,0,40,3
1713304971934,ANSC 148,A00,487230,Olivas Hernandez; Olga Lid,39,0,40,1
1713304972961,ANSC 150,A00,504165,Sloane; Julia Kathryn,19,0,20,1
1713304973989,ANSC 180,A00,487232,Staff,13,0,15,2
1713304975013,ANSC 188,A00,627155,Staff,40,0,40,0
1713304976040,ANTH 5,A00,519529,Semendeferi; Ekaterini,15,0,15,0
1713304977064,ANTH 10,A00,487219,Staff,58,0,60,2
1713304978090,ANTH 23,A01,487221,Staff,19,0,20,1
1713304979116,ANTH 102,A00,487233,Wilder; Linnea Lorene,53,0,60,7
1713304980144,ANTH 103,A00,487234,Varma; Saiba,57,0,60,3
1713304981169,ANTH 105,A00,487235,Stewart; Alexander B,57,0,60,3
1713304982199,BENG 100,A01,516685,Taylor Amos; Alyssa C,28,0,30,2
1713304983231,BIBC 102,A01,491316,Flagg; Matthew Paul,58,0,88,30
1713304983231,BIBC 102,A02,491366,Flagg; Matthew Paul,84,0,88,4
1713304984257,BIBC 103,A01,491486,Boumechache; Miyyada,16,0,24,8
1713304984257,BIBC 103,A02,491487,Boumechache; Miyyada,24,0,24,0
1713304985283,BICD 100,A01,516882,Staff,75,0,75,0
1713304985283,BICD 100,A02,516890,Staff,71,0,75,4
1713304986312,BICD 102GS,A00,491488,Lo; Stanley M.,27,0,28,1
1713304987338,BIEB 136GS,A00,516940,Holway; David A. & Shurin; Jonathan,20,0,24,4
1713304988366,BIEB 137GS,A01,517034,Holway; David A. & Shurin; Jonathan,20,0,24,4
1713304989390,BIEB 138GS,A01,491492,Pirino; Giorgia,22,0,28,6
1713304990421,BILD 1,A01,491296,Staff,62,0,63,1
1713304990421,BILD 1,A02,491297,Staff,63,0,63,0
1713304991446,BILD 4,A01,517099,Gonzalez Gamboa; Ivonne,23,0,24,1
1713304991446,BILD 4,A02,517100,Gonzalez Gamboa; Ivonne,24,0,24,0
1713304992470,BILD 60GS,A00,491309,Lo; Stanley M.,27,0,28,1
1713304993498,BIMM 100,A01,517136,Staff,93,0,100,7
1713304994526,BIMM 110,A01,517182,Staff,78,0,100,22
1713304995557,BIMM 120,A01,517228,Pickett; Brooke Elizabeth,40,0,63,23
1713304995557,BIMM 120,A02,517240,Pickett; Brooke Elizabeth,49,0,63,14
1713304996583,BIMM 132GS,A01,491498,Pirino; Giorgia,22,0,28,6
1713304997607,BIMM 143,A01,491589,Bozinovic; Goran,21,0,40,19
1713304998634,BIPN 100,A01,491594,Armour; Jon Christopher,93,0,100,7
1713304999659,BIPN 140,A01,491602,Marino; Marc J,32,0,50,18
1713305001711,CAT 125,A00,515973,Staff,20,0,20,0
1713305002741,CAT 125GS,A00,515974,Rahimi; Babak,19,0,20,1
1713305003766,CAT 125R,A00,515980,Staff,15,0,20,5
1713305003766,CAT 125R,B00,515981,Tosun; Adriana,19,0,20,1
1713305003766,CAT 125R,C00,515987,Hyland; Tina Mae,6,0,20,14
1713305003766,CAT 125R,D00,515988,Bronstein; Phoebe Malan,19,0,20,1
1713305004792,CENG 15,A01,488699,Drews; Aaron,25,0,25,0
1713305005819,CENG 100,A00,505196,Opatkiewicz; Justin Paul,25,0,25,0
1713305006845,CGS 2A,A01,489598,Staff,33,0,35,2
1713305007874,CGS 112,A00,489599,Staff,15,0,15,0
1713305008900,CGS 119,A00,489603,Staff,10,0,10,0
1713305009922,CGS 120,A00,489604,Staff,14,0,15,1
1713305010952,CGS 150,A00,489607,Staff,15,0,15,0
1713305011979,CHEM 6A,A01,488715,Staff,98,0,100,2
1713305013005,CHEM 6B,A01,488719,Piercy; Marc Anthony,100,0,100,0
1713305014089,CHEM 6C,A01,488723,Albizati; Kim F.,94,0,100,6
1713305015126,CHEM 7L,A01,488728,Schurmeier; Kimberly,18,0,24,6
1713305015126,CHEM 7L,A02,488730,Schurmeier; Kimberly,23,0,24,1
1713305015126,CHEM 7L,A03,488734,Schurmeier; Kimberly,24,0,24,0
1713305015126,CHEM 7L,A04,488763,Schurmeier; Kimberly,23,0,24,1
1713305015126,CHEM 7L,B01,488798,Schurmeier; Kimberly,18,0,24,6
1713305015126,CHEM 7L,B02,488801,Schurmeier; Kimberly,24,0,24,0
1713305015126,CHEM 7L,B03,488808,Schurmeier; Kimberly,24,0,24,0
1713305015126,CHEM 7L,B04,488811,Schurmeier; Kimberly,24,0,24,0
1713305016157,CHEM 11,A01,488897,Stallings; Dontarie M,98,0,100,2
1713305017182,CHEM 40A,A01,488913,Albizati; Kim F.,92,0,100,8
1713305018208,CHEM 40B,A01,488920,Weizman; Haim,48,0,50,2
1713305018208,CHEM 40B,A02,488938,Weizman; Haim,47,0,50,3
1713305019233,CHEM 41A,A01,489029,Klosterman; Jeremy K,58,0,60,2
1713305020259,CHEM 41C,A01,500436,Tor; Yitzhak,56,0,60,4
1713305021294,CHEM 43A,A01,500426,Weizman; Haim,6,0,24,18
1713305021294,CHEM 43A,A02,500430,Weizman; Haim,15,0,24,9
1713305021294,CHEM 43A,B01,514041,Klosterman; Jeremy K,18,0,24,6
1713305021294,CHEM 43A,B02,514047,Klosterman; Jeremy K,23,0,24,1
1713305022322,CHEM 108,A01,489140,Jennings; Patricia A.,14,0,24,10
1713305022322,CHEM 108,A02,489142,Jennings; Patricia A.,15,0,24,9
1713305023348,CHEM 114A,A01,489147,Stallings; Dontarie M,81,0,100,19
1713305024373,CHIN 169A,A00,489171,Wang; Xiao,19,0,20,1
1713305026424,COGS 3,A01,518827,Boyle; Mary E. T.,30,0,40,10
1713305027450,COGS 11,A01,489175,Staff,28,0,30,2
1713305028475,COGS 14A,A01,518829,Staff,54,0,60,6
1713305029502,COGS 14B,A01,489177,Hoffman; Drew Ellen,69,0,75,6
1713305030531,COGS 100,A01,489181,Allen; Michael Gordon,66,0,75,9
1713305031559,COGS 101A,A01,489183,Staff,51,0,60,9
1713305032585,COGS 101B,A01,489185,Allen; Michael Gordon,13,0,30,17
1713305033614,COGS 101C,A01,526786,Staff,25,0,30,5
1713305035672,COGS 107A,A01,489189,Boyle; Mary E. T.,24,0,35,11
1713305036698,COGS 107B,A01,627144,Mooshagian; Eric Frederick,60,0,60,0
1713305037727,COGS 118A,A01,489191,Staff,0,23,40,40
1713305039782,COGS 171GS,A01,489194,Pineda; Jaime A,22,0,28,6
1713305040813,COGS 172,A01,489196,Staff,9,0,30,21
1713305041838,COGS 174GS,A01,489264,Pineda; Jaime A,22,0,28,6
1713305042862,COGS 180,A01,627150,Staff,29,0,30,1
1713305043899,COGS 186,A01,489274,Staff,4,0,30,26
1713305044922,COMM 10,A01,489276,Staff,25,0,25,0
1713305044922,COMM 10,A02,489303,Staff,23,0,25,2
1713305045948,COMM 100A,A01,489312,Staff,21,0,25,4
1713305045948,COMM 100A,A02,489313,Staff,24,0,25,1
1713305046974,COMM 106T,A00,512540,Staff,34,0,35,1
1713305047999,COMM 107,A00,489347,Staff,31,0,35,4
1713305049024,COMM 109P,A00,489358,Staff,31,0,35,4
1713305050055,COMM 132,A00,489361,McKenna; Denise,29,0,30,1
1713305051081,COMM 146,A00,489362,Halm; Gavin Patrick,27,0,30,3
1713305052106,COMM 190,A00,489363,Abuelhiga; Soraya Jill,21,0,23,2
1713305053138,CSE 8A,A50,489366,Staff,23,0,25,2
1713305053138,CSE 8A,A51,489367,Staff,24,0,25,1
1713305054163,CSE 11,A01,489398,Cao; Yingjun,85,0,100,15
1713305055194,CSE 12,A01,489487,Staff,43,0,50,7
1713305056218,CSE 20,A01,489497,Staff,49,0,50,1
1713305057248,CSE 21,A01,489517,Braun; Oliver,44,0,50,6
1713305058276,CSE 101,A01,489524,Braun; Oliver,0,3,50,50
1713305059304,CSE 105,A01,512594,Jones; Miles E,84,0,100,16
1713305059304,CSE 105,B01,512598,Jones; Miles E,71,0,100,29
1713305060333,CSE 140,A01,489538,Staff,44,0,50,6
1713305061364,CSE 141,A01,489550,Eldon; John,76,0,100,24
1713305062390,CSE 141L,A01,489571,Eldon; John,75,0,100,25
1713305063417,CSE 151A,A01,489583,Solares; Edwin A,154,0,200,46
1713305064443,CSE 175,A01,510886,Kumar; Rakesh,30,0,30,0
1713305065473,CSE 190,A00,516828,Dubnov; Shlomo,41,0,49,8
1713305066498,DOC 100D,A00,489667,Pass; Natalye Joann,23,0,25,2
1713305067523,DSC 10,A01,624268,Staff,72,0,75,3
1713305068548,DSC 20,A01,624476,Staff,50,0,50,0
1713305069575,DSC 40A,A01,624608,Staff,40,0,40,0
1713305070603,DSGN 1,A01,489179,Rill; Bryan,37,0,50,13
1713305071630,ECE 17,A01,490489,Sahay; Rajeev,21,0,30,9
1713305072655,ECE 65,A50,490492,Staff,17,0,20,3
1713305072655,ECE 65,A51,490493,Staff,20,0,20,0
1713305073685,ECON 1,A01,489715,Famulari; Melissa,69,0,70,1
1713305074712,ECON 2,A01,489717,Levkoff; Steven B.,69,0,70,1
1713305075739,ECON 3,A01,489948,Staff,70,0,70,0
1713305077792,ECON 5,A01,490103,Staff,28,0,30,2
1713305077792,ECON 5,B01,626281,Dai; Yinlin,45,0,45,0
1713305078818,ECON 100A,A01,490127,Famulari; Melissa,70,0,70,0
1713305079848,ECON 100B,A01,490129,Staff,64,0,70,6
1713305080873,ECON 109,A01,490187,Shishkin; Denis,29,0,35,6
1713305081899,ECON 110A,A01,490190,Levkoff; Steven B.,64,0,70,6
1713305082923,ECON 120A,A01,490245,Dai; Yinlin,69,0,70,1
1713305083950,ECON 120B,A01,490247,Nieto-Barthaburu; Augusto,60,0,70,10
1713305084977,ECON 120C,A01,490253,Sun; Yixiao,32,0,35,3
1713305084977,ECON 120C,B01,490255,Sun; Yixiao,34,0,35,1
1713305086003,ECON 129,A00,490256,Eckert; Fabian Paul,28,0,35,7
1713305087028,ECON 131,A00,490257,Nieto-Barthaburu; Augusto,6,0,35,29
1713305088061,ECON 138,A00,490258,Bharadwaj; Prashant,24,0,35,11
1713305088061,ECON 138,B00,490259,Bharadwaj; Prashant,20,0,35,15
1713305089086,ECON 159,A00,490260,Hendrickson; Gerald M.,0,6,0,0
1713305090117,ECON 178,A01,553995,Zhu; Ying,28,0,35,7
1713305091145,EDS 40,A01,512576,Black; Alison Michelle,20,0,20,0
1713305092170,EDS 107,A01,515848,Staff,30,0,30,0
1713305093195,EDS 110R,A01,490262,Staff,26,0,30,4
1713305094222,EDS 112,A01,490264,Chapman; Thandeka K,45,0,50,5
1713305095251,EDS 113,A00,490266,Staff,28,0,30,2
1713305096277,EDS 118,A00,490267,Warstadt; Melissa Fawn,27,0,30,3
1713305097305,EDS 124BR,A00,490268,Eguchi; Emi,10,0,25,15
1713305097305,EDS 124BR,B00,490269,Eguchi; Emi,25,0,25,0
1713305098331,EDS 126,A01,490271,Jones; Makeba,47,0,50,3
1713305099360,EDS 135,A01,490316,Staff,19,0,20,1
1713305100385,ENVR 142GS,A00,519514,Chang; Edmond Yi-Teh,28,0,28,0
1713305101414,ETHN 103,A00,490504,Staff,33,0,36,3
1713305102441,ETHN 103A,A00,490505,Man; Simeon S,7,0,9,2
1713305103472,ETHN 109,A00,490506,Staff,30,0,30,0
1713305104504,ETHN 118,A00,490507,Staff,35,0,36,1
1713305105528,ETHN 119,A00,490508,Staff,36,0,36,0
1713305106554,ETHN 121R,A00,490518,Choi; Esther Min,30,0,36,6
1713305107579,ETHN 127,A00,490528,Staff,15,0,15,0
1713305108609,ETHN 139,A00,490573,Staff,10,0,10,0
1713305109634,ETHN 150,A00,490575,Staff,15,0,15,0
1713305110658,GLBH 20,A00,491705,Elwardani; Nile Regina,38,0,40,2
1713305111684,GLBH 101,A00,491706,Staff,20,0,20,0
1713305112712,GLBH 111,A01,491708,Burgos; Jose L.,15,0,15,0
1713305113737,GLBH 146,A00,491709,Staff,14,0,20,6
1713305114769,GLBH 148,A00,491710,Olivas Hernandez; Olga Lid,17,0,20,3
1713305115795,GLBH 150,A00,491711,Sloane; Julia Kathryn,20,0,20,0
1713305116819,HIEA 131,A00,491760,Staff,30,0,32,2
1713305117899,HIEA 153,A00,491762,Staff,29,0,30,1
1713305118926,HIEU 124,A00,491811,Staff,27,0,32,5
1713305119952,HIEU 124GS,A00,491812,Markman; Kristina,28,0,28,0
1713305120979,HIEU 147,A00,491813,Staff,30,0,32,2
1713305122005,HIEU 149GS,A00,491816,Caldwell; Michael Alan,28,0,28,0
1713305123030,HILD 2C,A01,491713,Hendrickson; Gerald M.,28,0,30,2
1713305124055,HILD 7B,A01,491715,Kwak; Nancy,17,0,30,13
1713305125080,HILD 10,A01,491717,Staff,15,0,20,5
1713305126108,HILD 30GS,A00,491719,Edington; Claire Ellen,24,0,28,4
1713305127133,HINE 109,A00,491818,Shafir; Nir,30,0,32,2
1713305128160,HINE 128,A00,491821,Shafir; Nir,32,0,32,0
1713305129188,HISC 117,A00,491830,Staff,29,0,32,3
1713305130212,HIUS 103,A00,491834,Man; Simeon S,17,0,23,6
1713305131241,HIUS 108B,A00,491835,Staff,30,0,30,0
1713305132270,HIUS 141,A00,491836,Hendrickson; Gerald M.,29,0,32,3
1713305133296,HIUS 149,A00,491839,Staff,27,0,32,5
1713305134321,HUM 3,A01,512617,Crum; Matthew Stephen,46,0,50,4
1713305134321,HUM 3,A02,512618,Crum; Matthew Stephen,48,0,50,2
1713305135346,HUM 3GS,A00,512663,Markman; Kristina,0,0,0,0
1713305135346,HUM 3GS,B00,512664,Staff,0,0,0,0
1713305136373,HUM 4,A01,512620,West; Geoffrey Scott,38,0,50,12
1713305137396,HUM 4GS,A00,512666,Lyon; Antony J.,0,0,0,3
1713305138420,HUM 4R,A01,512625,Watkins; Eric,49,0,50,1
1713305139450,HUM 5,A01,512649,Zavodny; Tatiana Sophia,34,0,50,16
1713305139450,HUM 5,B01,512661,Zroka; Ryan Edward,49,0,50,1
1713305140480,INTL 190,A00,490577,Segui; Alan S,0,0,0,5
1713305141506,JAPN 20AR,A01,491267,Ross; Kayoko F,12,0,20,8
1713305142536,JAPN 180,A00,491285,Berman; Michael David,34,0,40,6
1713305143563,LATI 50,A01,502536,Kokinis; Troy Andreas,19,0,22,3
1713305143563,LATI 50,A02,502551,Kokinis; Troy Andreas,22,0,22,0
1713305143563,LATI 50,A03,502650,Kokinis; Troy Andreas,22,0,22,0
1713305143563,LATI 50,A04,502909,Kokinis; Troy Andreas,22,0,22,0
1713305144591,LATI 160,A01,502920,Kokinis; Troy Andreas,30,0,30,0
1713305145621,LIFR 1A,A00,490494,Van Moer; Vinciane G,18,0,20,2
1713305146645,LIFR 1AX,A00,490495,Van Moer; Vinciane G,18,0,20,2
1713305147671,LIFR 1B,A00,490496,Van Moer; Vinciane G,20,0,20,0
1713305148700,LIFR 1BX,A00,490497,Van Moer; Vinciane G,20,0,20,0
1713305149725,LIGN 8,A00,505198,McIntosh; Justin Daniel,143,0,150,7
1713305150750,LIGN 9GS,A00,491239,Lott; Margaret S.,18,0,20,2
1713305151775,LIGN 101,A01,505200,McIntosh; Justin Daniel,26,0,30,4
1713305152805,LIGN 120,A01,491244,Staff,26,0,30,4
1713305153829,LIGN 149GS,A00,491245,Lott; Margaret S.,18,0,20,2
1713305154854,LIGN 170,A00,491247,Staff,25,0,30,5
1713305155883,LISP 1D,A00,490498,Munoz Sanchez; Alicia,11,0,14,3
1713305155883,LISP 1D,B00,490499,Munoz Sanchez; Alicia,7,0,14,7
1713305155883,LISP 1D,C00,490500,Munoz Sanchez; Alicia,10,0,14,4
1713305155883,LISP 1D,D00,490501,Munoz Sanchez; Alicia,11,0,14,3
1713305156914,LISP 1DX,A00,490502,Munoz Sanchez; Alicia,19,0,28,9
1713305156914,LISP 1DX,B00,490503,Munoz Sanchez; Alicia,19,0,28,9
1713305158968,LTAM 110,A00,491847,Staff,23,0,25,2
1713305159993,LTCS 119,A00,491848,Staff,13,0,15,2
1713305161020,LTCS 130,A00,491849,Staff,24,0,25,1
1713305163070,LTEA 120C,A00,491852,Staff,35,0,40,5
1713305164095,LTEN 130GS,A00,491853,Lyon; Antony J.,25,0,28,3
1713305165121,LTEN 148,A00,491855,Staff,23,0,25,2
1713305166147,LTEN 159,A00,491856,Staff,21,0,25,4
1713305167173,LTEN 180,A00,491857,Staff,9,0,15,6
1713305169225,LTSP 123GS,A00,505928,Bessett; Ryan Matthew,25,0,28,3
1713305170254,LTSP 174GS,A00,506037,Bessett; Ryan Matthew,25,0,28,3
1713305172308,LTWR 102,A00,491861,Staff,12,0,15,3
1713305173336,LTWR 106,A00,491862,Staff,11,0,15,4
1713305174360,MAE 11,A00,490930,Bahadori; Mohammad Yousef,98,0,100,2
1713305175385,MAE 30A,A00,490931,Qi; Huihui,38,0,40,2
1713305176410,MAE 101A,A00,491036,Sadeghizadeh; Zahra,98,0,100,2
1713305177434,MAE 101C,A00,491037,Seshadri; Kalyanasundaram,78,0,100,22
1713305178462,MAE 113,A00,491040,Seshadri; Kalyanasundaram,67,0,80,13
1713305179490,MAE 131A,A00,491041,Ghazinejad; Maziar,39,0,40,1
1713305180518,MAE 142,A00,491053,Staff,39,0,40,1
1713305181549,MAE 143A,A00,491054,Staff,43,0,50,7
1713305182583,MAE 150,A00,491092,Truong; Phuong Thi Ngoc,25,0,35,10
1713305183608,MATH 3C,A01,494031,Pardo Guerra; Sebastian,30,0,30,0
1713305183608,MATH 3C,A02,494032,Pardo Guerra; Sebastian,29,0,30,1
1713305184635,MATH 10A,A01,494034,Staff,28,0,30,2
1713305184635,MATH 10A,A02,494035,Staff,29,0,30,1
1713305184635,MATH 10A,B01,494037,Staff,28,0,30,2
1713305184635,MATH 10A,B02,494038,Staff,29,0,30,1
1713305185660,MATH 10B,A01,494040,Habib; Yousaf,24,0,30,6
1713305185660,MATH 10B,A02,494041,Habib; Yousaf,28,0,30,2
1713305185660,MATH 10B,A03,494042,Habib; Yousaf,30,0,30,0
1713305185660,MATH 10B,A04,494043,Habib; Yousaf,30,0,30,0
1713305185660,MATH 10B,B01,494045,Habib; Yousaf,28,0,30,2
1713305185660,MATH 10B,B02,494046,Habib; Yousaf,30,0,30,0
1713305185660,MATH 10B,B03,494047,Habib; Yousaf,30,0,30,0
1713305185660,MATH 10B,B04,494048,Habib; Yousaf,30,0,30,0
1713305186687,MATH 18,A01,494050,Kemp; Todd Aahron,27,0,30,3
1713305186687,MATH 18,A02,494051,Kemp; Todd Aahron,29,0,30,1
1713305186687,MATH 18,B01,494054,Kemp; Todd Aahron,28,0,30,2
1713305186687,MATH 18,B02,494055,Kemp; Todd Aahron,29,0,30,1
1713305187715,MATH 20A,A01,494059,Suk; Andrew Hoon,30,0,30,0
1713305188745,MATH 20B,A01,494061,Briones; Jor-el Thomas Caparas,34,0,35,1
1713305188745,MATH 20B,B01,494063,Bach; Quang Tran,34,0,35,1
1713305189771,MATH 20C,A01,494065,Staff,29,0,30,1
1713305189771,MATH 20C,A02,494066,Staff,30,0,30,0
1713305189771,MATH 20C,A03,494067,Staff,30,0,30,0
1713305189771,MATH 20C,A04,494068,Staff,30,0,30,0
1713305189771,MATH 20C,B01,494070,Zhang; Ming,27,0,30,3
1713305189771,MATH 20C,B02,494071,Zhang; Ming,30,0,30,0
1713305189771,MATH 20C,B03,494072,Zhang; Ming,29,0,30,1
1713305189771,MATH 20C,B04,494073,Zhang; Ming,29,0,30,1
1713305190795,MATH 20D,A01,494075,Staff,26,0,30,4
1713305190795,MATH 20D,A02,494076,Staff,30,0,30,0
1713305191825,MATH 20E,A01,494079,Staff,25,0,30,5
1713305191825,MATH 20E,A02,494080,Staff,28,0,30,2
1713305191825,MATH 20E,B01,494082,Staff,28,0,30,2
1713305191825,MATH 20E,B02,494083,Staff,25,0,30,5
1713305192851,MATH 103A,A01,494085,Aliabadi Sr.; Mohsen,22,0,30,8
1713305192851,MATH 103A,A02,494086,Aliabadi Sr.; Mohsen,29,0,30,1
1713305192851,MATH 103A,B01,494088,Aliabadi Sr.; Mohsen,22,0,30,8
1713305192851,MATH 103A,B02,494089,Aliabadi Sr.; Mohsen,28,0,30,2
1713305193880,MATH 109,A01,494091,Staff,30,0,30,0
1713305193880,MATH 109,A02,494092,Staff,30,0,30,0
1713305193880,MATH 109,B01,494094,Staff,28,0,30,2
1713305193880,MATH 109,B02,494095,Staff,29,0,30,1
1713305194907,MATH 142A,A01,494097,Chow; Bennett,16,0,30,14
1713305194907,MATH 142A,A02,494098,Chow; Bennett,25,0,30,5
1713305194907,MATH 142A,B01,494100,Chow; Bennett,23,0,30,7
1713305194907,MATH 142A,B02,494101,Chow; Bennett,29,0,30,1
1713305196963,MATH 168A,A01,516677,Dumitriu; Ioana,17,0,35,18
1713305197992,MATH 170A,A01,516679,Dumitriu; Ioana,21,0,30,9
1713305197992,MATH 170A,A02,516680,Dumitriu; Ioana,28,0,30,2
1713305199022,MATH 193A,A01,494107,Staff,17,0,30,13
1713305199022,MATH 193A,A02,494108,Staff,25,0,30,5
1713305199022,MATH 193A,A03,494109,Staff,29,0,30,1
1713305199022,MATH 193A,A04,494110,Staff,26,0,30,4
1713305202101,MGT 16,A00,491930,McKay; Michael J,94,0,98,4
1713305203132,MGT 18,A00,491992,McKay; Michael J,97,0,98,1
1713305204162,MGT 71,A00,492003,Staff,79,0,98,19
1713305205185,MGT 103,A00,505209,Eberhard; Craig A,87,0,98,11
1713305206217,MGT 131A,A00,505210,Anderson; John Charles,91,0,98,7
1713305208271,MGT 153,A00,492077,Perols; Johan Lars,51,0,90,39
1713305211349,MGT 164,A00,492222,McKay; Mary A,94,0,98,4
1713305212375,MGT 172,A00,492245,Staff,59,0,60,1
1713305212375,MGT 172,B00,505526,Hedges; Kathleen,79,0,98,19
1713305213405,MGT 181,A00,505669,Dunn; Louis Jean,88,0,98,10
1713305214431,MMW 14,A01,494399,Staff,23,0,28,5
1713305214431,MMW 14,A02,494400,Staff,26,0,28,2
1713305214431,MMW 14,A03,494401,Staff,28,0,28,0
1713305214431,MMW 14,A04,494402,Staff,28,0,28,0
1713305214431,MMW 14,B01,494404,Carreras; Maria Victoria,18,0,28,10
1713305214431,MMW 14,B02,494405,Carreras; Maria Victoria,27,0,28,1
1713305214431,MMW 14,B03,494406,Carreras; Maria Victoria,28,0,28,0
1713305214431,MMW 14,B04,494407,Carreras; Maria Victoria,28,0,28,0
1713305215462,MMW 14GS,A00,506250,Chang; Edmond Yi-Teh,0,0,0,0
1713305216491,MMW 121R,A01,494415,Adamiak; Patrick John,16,0,28,12
1713305216491,MMW 121R,A02,494416,Adamiak; Patrick John,25,0,28,3
1713305217516,MUS 1A,A01,494113,Staff,14,0,25,11
1713305217516,MUS 1A,A02,494114,Staff,25,0,25,0
1713305218546,MUS 4,A01,494116,Staff,24,0,25,1
1713305218546,MUS 4,A02,494117,Staff,22,0,25,3
1713305219577,MUS 5R,A01,494236,Dubnov; Shlomo,12,0,25,13
1713305219577,MUS 5R,A02,494237,Dubnov; Shlomo,25,0,25,0
1713305220606,MUS 6,A01,494122,Staff,16,0,25,9
1713305220606,MUS 6,A02,494123,Staff,24,0,25,1
1713305221703,MUS 7,A01,494125,Staff,17,0,25,8
1713305221703,MUS 7,A02,494126,Staff,24,0,25,1
1713305222729,MUS 11,A01,494128,Staff,23,0,25,2
1713305222729,MUS 11,A02,494129,Staff,25,0,25,0
1713305223755,MUS 13,A01,494131,Staff,25,0,25,0
1713305223755,MUS 13,A02,494132,Staff,25,0,25,0
1713305224783,MUS 15,A01,494134,Staff,20,0,25,5
1713305224783,MUS 15,A02,494135,Staff,25,0,25,0
1713305224783,MUS 15,B01,494137,Staff,25,0,25,0
1713305225809,MUS 80,A00,494232,Staff,25,0,25,0
1713305225809,MUS 80,B00,494233,Staff,25,0,25,0
1713305225809,MUS 80,C00,494234,Staff,23,0,25,2
1713305226838,MUS 95C,A00,494141,Staff,73,0,75,2
1713305227864,MUS 114,A00,494142,Staff,42,0,50,8
1713305228891,NANO 15,A01,490636,Drews; Aaron,7,0,7,0
1713305229921,PHIL 1,A00,490578,Grush; Rick Scott,50,0,50,0
1713305230951,PHIL 10,A01,490580,Grush; Rick Scott,34,0,35,1
1713305230951,PHIL 10,A02,490586,Grush; Rick Scott,33,0,35,2
1713305231978,PHIL 27,A01,490591,Staff,24,0,25,1
1713305231978,PHIL 27,A02,490592,Staff,25,0,25,0
1713305231978,PHIL 27,A03,490593,Staff,25,0,25,0
1713305231978,PHIL 27,A04,490598,Staff,25,0,25,0
1713305233005,PHIL 32,A01,490611,Staff,20,0,20,0
1713305233005,PHIL 32,A02,490618,Staff,20,0,20,0
1713305234031,PHIL 90,A00,490624,Staff,40,0,40,0
1713305235057,PHIL 136,A00,490627,Cohen; Jonathan David,38,0,40,2
1713305236085,PHIL 155,A00,490634,Staff,67,0,70,3
1713305237112,PHYS 1A,A00,491610,Staff,246,0,250,4
1713305238138,PHYS 1AL,001,491616,Tsai; Philbert S,28,0,30,2
1713305238138,PHYS 1AL,002,491618,Tsai; Philbert S,30,0,30,0
1713305239164,PHYS 1B,A00,491623,Staff,245,0,250,5
1713305240192,PHYS 1BL,001,491626,Tsai; Philbert S,27,0,30,3
1713305240192,PHYS 1BL,002,491628,Tsai; Philbert S,28,0,30,2
1713305241220,PHYS 1C,A00,491632,Staff,227,0,245,18
1713305242246,PHYS 1CL,001,491635,Tsai; Philbert S,12,0,30,18
1713305242246,PHYS 1CL,002,491643,Tsai; Philbert S,25,0,30,5
1713305243273,PHYS 2AR,A01,491651,Meyertholen; Andrew D.,46,0,50,4
1713305244297,PHYS 2B,A01,491659,Staff,107,0,115,8
1713305245322,PHYS 2BL,A01,491685,Staff,24,0,24,0
1713305245322,PHYS 2BL,A02,491700,Staff,23,0,24,1
1713305246351,PHYS 2C,A01,505161,Staff,108,0,115,7
1713305247377,PHYS 4A,A01,491704,Grinstein; Benjamin,100,0,100,0
1713305248402,POLI 5D,A01,494144,Staff,3,0,5,2
1713305248402,POLI 5D,B01,626283,Dai; Yinlin,5,0,5,0
1713305249427,POLI 12,A00,494145,Staff,44,0,45,1
1713305250451,POLI 13R,A00,494146,Forman; Fonna,47,0,50,3
1713305251476,POLI 27,A01,494148,Staff,59,0,60,1
1713305252502,POLI 30,A00,494149,Staff,49,0,50,1
1713305253525,POLI 100DA,A00,494150,Staff,23,0,25,2
1713305255576,POLI 100I,A00,494152,Staff,29,0,30,1
1713305256811,POLI 104B,A00,494153,Smith; Glenn Chatmas,54,0,55,1
1713305257836,POLI 104F,A00,494154,Staff,29,0,30,1
1713305258865,POLI 104I,A00,494155,Smith; Glenn Chatmas,30,0,30,0
1713305259892,POLI 110C,A00,494156,Ingham; Sean,23,0,25,2
1713305260917,POLI 117R,A00,494157,Forman; Fonna,16,0,20,4
1713305261945,POLI 118,A00,494158,Ingham; Sean,23,0,25,2
1713305262975,POLI 120H,A00,494159,Fisk; David Lee,41,0,45,4
1713305263999,POLI 131CR,A00,494160,Hoston; Germaine,41,0,45,4
1713305265024,POLI 133J,A00,494161,Staff,33,0,35,2
1713305266048,POLI 135,A00,494162,Fisk; David Lee,34,0,35,1
1713305267074,POLI 140A,A00,494164,Staff,22,0,30,8
1713305268098,POLI 142I,A00,494165,Staff,30,0,30,0
1713305269120,POLI 144D,A00,494166,Staff,23,0,25,2
1713305270146,POLI 151,A00,494167,Staff,30,0,30,0
1713305271173,POLI 153,A00,494168,Staff,34,0,35,1
1713305272197,POLI 160AA,A00,494169,Staff,36,0,40,4
1713305273225,POLI 162,A00,494170,Mignozzetti; Umberto,21,0,25,4
1713305274251,POLI 171,A00,494171,Mignozzetti; Umberto,23,0,25,2
1713305275276,PSYC 1,A00,494172,Staff,97,0,100,3
1713305276303,PSYC 2,A00,494173,Moranton; Nirelia Melbina-,48,0,50,2
1713305277328,PSYC 3,A00,494174,Staff,30,0,30,0
1713305278356,PSYC 6,A00,494175,Staff,17,0,20,3
1713305279381,PSYC 60,A01,494177,Staff,42,0,45,3
1713305280409,PSYC 70,A01,505724,Geller; Emma Harlan,42,0,45,3
1713305281436,PSYC 101,A00,494180,Heyman; Gail D.,93,0,100,7
1713305282461,PSYC 105,A00,494181,Geller; Emma Harlan,67,0,90,23
1713305283487,PSYC 106,A00,494182,Dobkins; Karen R.,34,0,45,11
1713305284512,PSYC 108,A00,494183,Adrian; Julia Anna,94,0,100,6
1713305285538,PSYC 114,A01,494185,Winkielman; Piotr,7,0,30,23
1713305286566,PSYC 122,A00,494186,Moranton; Nirelia Melbina-,41,0,50,9
1713305287591,PSYC 124,A00,494187,Chapman; Eddie Nathaniel,74,0,80,6
1713305288617,PSYC 131,A00,494188,Anagnostaras; Stephan,60,0,80,20
1713305301164,PSYC 144,A00,494189,Staff,22,0,50,28
1713305302190,PSYC 154,A00,494190,Lacefield; Katharine I,141,0,180,39
1713305303215,PSYC 162,A00,494191,Wixted; John T,90,0,100,10
1713305304242,PSYC 172,A00,494192,Gorman; Michael R.,38,0,45,7
1713305305268,PSYC 178,A00,494193,Glaser; Dale,41,0,45,4
1713305306295,PSYC 193,A00,505725,Chapman; Eddie Nathaniel,20,0,20,0
1713305307320,RELI 145GS,A00,519817,Rahimi; Babak,19,0,20,1
1713305308346,SE 101A,A01,490862,Chadha; Mayank,24,0,25,1
1713305309378,SE 101C,A01,490924,Krysl; Petr,18,0,20,2
1713305310406,SE 110A,A01,490928,Staff,20,0,20,0
1713305311433,SE 130A,A00,490929,Morrison; Machel Leigh,66,0,70,4
1713305312460,SIO 1,A01,519325,Staff,39,0,40,1
1713305313486,SIO 30,A01,519327,Staff,40,0,40,0
1713305314514,SIO 40,A00,519328,Staff,40,0,40,0
1713305315541,SIO 46GS,A00,519819,Cook; Geoffrey W,19,0,25,6
1713305316571,SIO 109R,A00,494197,Forman; Fonna,8,0,20,12
1713305317594,SIO 121GS,A00,519827,Cook; Geoffrey W,19,0,25,6
1713305318624,SIO 132,A01,519330,Staff,38,0,40,2
1713305319649,SIO 133,A01,519397,Staff,38,0,40,2
1713305320674,SIO 139,A00,519396,Kacev; David,33,0,40,7
1713305321702,SOCI 1,A01,494199,Thorpe; Charles Robert,24,0,30,6
1713305321702,SOCI 1,A02,494200,Thorpe; Charles Robert,30,0,30,0
1713305321702,SOCI 1,A03,494201,Thorpe; Charles Robert,29,0,30,1
1713305321702,SOCI 1,A04,494202,Thorpe; Charles Robert,29,0,30,1
1713305321702,SOCI 1,A05,494203,Thorpe; Charles Robert,29,0,30,1
1713305321702,SOCI 1,A06,494204,Thorpe; Charles Robert,30,0,30,0
1713305321702,SOCI 1,A07,494205,Thorpe; Charles Robert,29,0,30,1
1713305322728,SOCI 60,A01,494207,Staff,36,0,40,4
1713305322728,SOCI 60,A02,494208,Staff,39,0,40,1
1713305323754,SOCI 100,A01,494210,Payne; Christine Anna,28,0,30,2
1713305323754,SOCI 100,A02,494211,Payne; Christine Anna,28,0,30,2
1713305324779,SOCI 109M,A00,494212,Staff,20,0,20,0
1713305325806,SOCI 110,A00,494213,Staff,35,0,40,5
1713305327863,SOCI 118E,A00,494215,Ng; Kwai,38,0,40,2
1713305328889,SOCI 125,A00,494216,Calderon-Zaks; Michael Aar,42,0,45,3
1713305329915,SOCI 126,A01,494218,Jones; Makeba,4,0,5,1
1713305330942,SOCI 131,A00,494219,Thorpe; Charles Robert,30,0,30,0
1713305332993,SOCI 135,A00,494221,Payne; Christine Anna,44,0,50,6
1713305334019,SOCI 136E,A00,626690,Ruiz; Jonathan Joseph,25,0,25,0
1713305335047,SOCI 138GS,A00,494222,Navon; Daniel,24,0,28,4
1713305337154,SOCI 145,A00,494224,Staff,44,0,45,1
1713305338182,SOCI 153,A00,494225,Staff,28,0,30,2
1713305339206,SOCI 160E,A00,494226,Ng; Kwai,34,0,40,6
1713305340237,SOCI 180,A00,494227,Staff,29,0,30,1
1713305341265,SOCI 189GS,A00,494228,Ribas Norris; Janet Vanesa,11,0,11,0
1713305342291,SOCI 190GS,A00,553232,Ribas Norris; Janet Vanesa,11,0,11,0
1713305343317,SOMI 220,A00,627178,Staff,30,0,30,0
1713305344349,SYN 2,001,490768,Staff,14,0,15,1
1713305344349,SYN 2,002,490769,Staff,15,0,15,0
1713305344349,SYN 2,004,490775,Staff,0,0,0,0
1713305344349,SYN 2,003,490774,Staff,0,0,0,0
1713305344349,SYN 2,005,490776,Staff,0,0,0,0
1713305345380,SYN 2R,001,490779,Staff,14,0,15,1
1713305345380,SYN 2R,002,514635,Staff,14,0,15,1
1713305346408,SYN 100,A01,490783,Staff,17,0,20,3
1713305346408,SYN 100,B01,490787,Staff,12,0,20,8
1713305346408,SYN 100,C01,490789,Staff,15,0,20,5
1713305347431,SYN 150,A00,490817,Staff,14,0,15,1
1713305347431,SYN 150,B00,514610,Staff,15,0,15,0
1713305348459,TDAC 1,A00,492753,Walsh; Kim C.,19,0,20,1
1713305348459,TDAC 1,B00,492754,Harting; Carla Kelso,19,0,20,1
1713305348459,TDAC 1,C00,513995,Salovey; Todd,18,0,20,2
1713305349484,TDAC 101,A00,492766,Harting; Carla Kelso,19,0,20,1
1713305350511,TDAC 102,A00,492768,Basso; Beatrice,20,0,20,0
1713305351537,TDDE 111,A00,492769,Staff,25,0,25,0
1713305352561,TDDE 131,A00,492770,Staff,15,0,15,0
1713305352561,TDDE 131,B00,492771,Staff,15,0,15,0
1713305353588,TDDE 131GS,A00,523716,Guirguis; Mark C,25,0,28,3
1713305354621,TDGE 1,A01,492756,Salovey; Todd,57,0,60,3
1713305355647,TDGE 5,A01,492758,Staff,24,0,25,1
1713305356670,TDGE 10,A00,492759,Fulton; Julia,215,0,220,5
1713305357695,TDGE 11,A00,492760,Castro; Robert Jess,200,0,200,0
1713305358724,TDGE 50,A00,492761,Blair; Kyle Adam,0,0,0,0
1713305359751,TDGE 124,A00,492772,Fulton; Julia,199,0,220,21
1713305360777,TDGE 125,A00,492773,Meyer; Ursula,43,0,50,7
1713305360777,TDGE 125,B00,492774,Staff,50,0,50,0
1713305360777,TDGE 125,C00,523565,Staff,50,0,50,0
1713305361803,TDGE 125GS,A00,523580,Guirguis; Mark C,25,0,28,3
1713305362832,TDGE 127,A00,492775,Havis; Allan,43,0,50,7
1713305363857,TDHT 101,A00,492776,Staff,35,0,35,0
1713305364884,TDMV 1,A00,492762,Caligagan; Maria T.,30,0,30,0
1713305364884,TDMV 1,B00,492763,Arcidiacono; Kristin,26,0,30,4
1713305365909,TDMV 2,A00,492764,Weinberg; Sadie,29,0,30,1
1713305366936,TDMV 3,A00,492765,Mack; Kara Shanai',40,0,40,0
1713305367962,TDMV 138,A00,492777,Mack; Kara Shanai',37,0,40,3
1713305368990,TDMV 140,A00,492778,Lima; Paulo Henrique,40,0,40,0
1713305370016,TDMV 142,A00,492779,Caligagan; Maria T.,37,0,40,3
1713305370016,TDMV 142,B00,492780,Caligagan; Tony,38,0,40,2
1713305371041,TDMV 143,A00,492781,Fyall; Daunte Edward,40,0,40,0
1713305372074,USP 1,A01,492401,Kwak; Nancy,29,0,35,6
1713305373103,USP 2,A01,492453,Hinds; Juli Beth,35,0,35,0
1713305374127,USP 3,A01,492516,Staff,32,0,35,3
1713305375156,USP 4,A00,492522,McTague; Sarah,20,0,25,5
1713305376181,USP 100,A00,492523,Staff,33,0,35,2
1713305377205,USP 101,A00,492524,Staff,13,0,15,2
1713305378230,USP 105,A00,492525,Staff,22,0,25,3
1713305379255,USP 151,A00,492526,Shenkman; Michael Thomas,33,0,35,2
1713305380283,USP 170,A00,492545,Hinds; Juli Beth,33,0,35,2
1713305381310,USP 171GS,A00,492608,Bussell; Mirle Rabinowitz,26,0,28,2
1713305382338,USP 183GS,A00,492613,Peerson; Susan,26,0,28,2
1713305383369,VIS 30,A01,490693,Yoldas; Pinar,21,0,22,1
1713305383369,VIS 30,A02,490694,Yoldas; Pinar,19,0,22,3
1713305384395,VIS 83,A00,490695,Kester; Grant,68,0,75,7
1713305385425,VIS 105D,A00,490696,Staff,22,0,25,3
1713305386451,VIS 124CN,A00,490699,Rose; Jordan M,68,0,75,7
1713305387478,VIS 125GS,A00,511221,Williams; Alena J,21,0,22,1
1713305388507,VIS 128D,A00,490700,Staff,74,0,75,1
1713305389533,VIS 151,A01,490717,Staff,34,0,34,0
1713305389533,VIS 151,A02,490766,Staff,33,0,34,1
1713305390558,VIS 154GS,A00,511972,Williams; Alena J,21,0,22,1
1713305391581,VIS 160A,A00,490767,Stone; Patricia,7,0,10,3
1713305392609,WCWP 10A,A00,490638,Staff,15,0,15,0
1713305392609,WCWP 10A,B00,490640,Staff,15,0,15,0
1713305393634,WCWP 10B,A00,490641,Staff,0,0,0,0
1713305393634,WCWP 10B,B00,490642,Staff,14,0,15,1
1713305393634,WCWP 10B,C00,490644,Staff,14,0,15,1
1713305393634,WCWP 10B,D00,490647,Staff,0,0,0,0
1713305394658,WCWP 100,A00,490655,Staff,0,0,0,0
1713305394658,WCWP 100,B00,490687,Staff,12,0,15,3
1713305396777,ANAR 153,A00,487222,Braswell; Geoffrey E.,55,0,60,5
1713305397806,ANBI 134,A00,487223,Staff,14,0,20,6
1713305398834,ANBI 143GS,A00,487224,Noel; Geoffroy Pierre Jean,20,0,24,4
1713305399860,ANBI 144GS,A00,519548,Noel; Geoffroy Pierre Jean,20,0,24,4
1713305400884,ANSC 101,A00,487225,Staff,19,0,20,1
1713305401910,ANSC 125,A00,487227,Brenner; Suzanne A,40,0,40,0
1713305403960,ANSC 146,A00,487229,Staff,37,0,40,3
1713305404986,ANSC 148,A00,487230,Olivas Hernandez; Olga Lid,39,0,40,1
1713305406015,ANSC 150,A00,504165,Sloane; Julia Kathryn,19,0,20,1
1713305407040,ANSC 180,A00,487232,Staff,13,0,15,2
1713305408066,ANSC 188,A00,627155,Staff,40,0,40,0
1713305409094,ANTH 5,A00,519529,Semendeferi; Ekaterini,15,0,15,0
1713305410122,ANTH 10,A00,487219,Staff,58,0,60,2
1713305411149,ANTH 23,A01,487221,Staff,18,0,20,2
1713305412176,ANTH 102,A00,487233,Wilder; Linnea Lorene,53,0,60,7
1713305413208,ANTH 103,A00,487234,Varma; Saiba,57,0,60,3
1713305414239,ANTH 105,A00,487235,Stewart; Alexander B,57,0,60,3
1713305415264,BENG 100,A01,516685,Taylor Amos; Alyssa C,28,0,30,2
1713305416301,BIBC 102,A01,491316,Flagg; Matthew Paul,58,0,88,30
1713305416301,BIBC 102,A02,491366,Flagg; Matthew Paul,84,0,88,4
1713305417328,BIBC 103,A01,491486,Boumechache; Miyyada,16,0,24,8
1713305417328,BIBC 103,A02,491487,Boumechache; Miyyada,24,0,24,0
1713305418355,BICD 100,A01,516882,Staff,75,0,75,0
1713305418355,BICD 100,A02,516890,Staff,71,0,75,4
1713305419384,BICD 102GS,A00,491488,Lo; Stanley M.,27,0,28,1
1713305420409,BIEB 136GS,A00,516940,Holway; David A. & Shurin; Jonathan,20,0,24,4
1713305421439,BIEB 137GS,A01,517034,Holway; David A. & Shurin; Jonathan,20,0,24,4
1713305422464,BIEB 138GS,A01,491492,Pirino; Giorgia,22,0,28,6
1713305423492,BILD 1,A01,491296,Staff,62,0,63,1
1713305423492,BILD 1,A02,491297,Staff,63,0,63,0
1713305424520,BILD 4,A01,517099,Gonzalez Gamboa; Ivonne,23,0,24,1
1713305424520,BILD 4,A02,517100,Gonzalez Gamboa; Ivonne,24,0,24,0
1713305425546,BILD 60GS,A00,491309,Lo; Stanley M.,27,0,28,1
1713305426580,BIMM 100,A01,517136,Staff,92,0,100,8
1713305427605,BIMM 110,A01,517182,Staff,78,0,100,22
1713305428634,BIMM 120,A01,517228,Pickett; Brooke Elizabeth,40,0,63,23
1713305428634,BIMM 120,A02,517240,Pickett; Brooke Elizabeth,49,0,63,14
1713305429661,BIMM 132GS,A01,491498,Pirino; Giorgia,22,0,28,6
1713305430693,BIMM 143,A01,491589,Bozinovic; Goran,21,0,40,19
1713305431720,BIPN 100,A01,491594,Armour; Jon Christopher,93,0,100,7
1713305432752,BIPN 140,A01,491602,Marino; Marc J,32,0,50,18
1713305434806,CAT 125,A00,515973,Staff,20,0,20,0
1713305435834,CAT 125GS,A00,515974,Rahimi; Babak,19,0,20,1
1713305436863,CAT 125R,A00,515980,Staff,15,0,20,5
1713305436863,CAT 125R,B00,515981,Tosun; Adriana,19,0,20,1
1713305436863,CAT 125R,C00,515987,Hyland; Tina Mae,6,0,20,14
1713305436863,CAT 125R,D00,515988,Bronstein; Phoebe Malan,19,0,20,1
1713305437889,CENG 15,A01,488699,Drews; Aaron,25,0,25,0
1713305438919,CENG 100,A00,505196,Opatkiewicz; Justin Paul,25,0,25,0
1713305439951,CGS 2A,A01,489598,Staff,33,0,35,2
1713305441052,CGS 112,A00,489599,Staff,15,0,15,0
1713305442076,CGS 119,A00,489603,Staff,10,0,10,0
1713305443101,CGS 120,A00,489604,Staff,14,0,15,1
1713305444123,CGS 150,A00,489607,Staff,15,0,15,0
1713305445151,CHEM 6A,A01,488715,Staff,98,0,100,2
1713305446182,CHEM 6B,A01,488719,Piercy; Marc Anthony,100,0,100,0
1713305447213,CHEM 6C,A01,488723,Albizati; Kim F.,94,0,100,6
1713305448246,CHEM 7L,A01,488728,Schurmeier; Kimberly,18,0,24,6
1713305448246,CHEM 7L,A02,488730,Schurmeier; Kimberly,23,0,24,1
1713305448246,CHEM 7L,A03,488734,Schurmeier; Kimberly,24,0,24,0
1713305448246,CHEM 7L,A04,488763,Schurmeier; Kimberly,23,0,24,1
1713305448246,CHEM 7L,B01,488798,Schurmeier; Kimberly,18,0,24,6
1713305448246,CHEM 7L,B02,488801,Schurmeier; Kimberly,24,0,24,0
1713305448246,CHEM 7L,B03,488808,Schurmeier; Kimberly,24,0,24,0
1713305448246,CHEM 7L,B04,488811,Schurmeier; Kimberly,24,0,24,0
1713305449276,CHEM 11,A01,488897,Stallings; Dontarie M,98,0,100,2
1713305450306,CHEM 40A,A01,488913,Albizati; Kim F.,92,0,100,8
1713305451335,CHEM 40B,A01,488920,Weizman; Haim,48,0,50,2
1713305451335,CHEM 40B,A02,488938,Weizman; Haim,47,0,50,3
1713305452361,CHEM 41A,A01,489029,Klosterman; Jeremy K,58,0,60,2
1713305453387,CHEM 41C,A01,500436,Tor; Yitzhak,56,0,60,4
1713305454412,CHEM 43A,A01,500426,Weizman; Haim,6,0,24,18
1713305454412,CHEM 43A,A02,500430,Weizman; Haim,15,0,24,9
1713305454412,CHEM 43A,B01,514041,Klosterman; Jeremy K,18,0,24,6
1713305454412,CHEM 43A,B02,514047,Klosterman; Jeremy K,23,0,24,1
1713305455442,CHEM 108,A01,489140,Jennings; Patricia A.,14,0,24,10
1713305455442,CHEM 108,A02,489142,Jennings; Patricia A.,15,0,24,9
1713305456466,CHEM 114A,A01,489147,Stallings; Dontarie M,81,0,100,19
1713305457490,CHIN 169A,A00,489171,Wang; Xiao,19,0,20,1
1713305459551,COGS 3,A01,518827,Boyle; Mary E. T.,30,0,40,10
1713305460581,COGS 11,A01,489175,Staff,28,0,30,2
1713305461605,COGS 14A,A01,518829,Staff,53,0,60,7
1713305462630,COGS 14B,A01,489177,Hoffman; Drew Ellen,69,0,75,6
1713305463660,COGS 100,A01,489181,Allen; Michael Gordon,66,0,75,9
1713305464686,COGS 101A,A01,489183,Staff,51,0,60,9
1713305465714,COGS 101B,A01,489185,Allen; Michael Gordon,13,0,30,17
1713305466742,COGS 101C,A01,526786,Staff,25,0,30,5
1713305468794,COGS 107A,A01,489189,Boyle; Mary E. T.,24,0,35,11
1713305469819,COGS 107B,A01,627144,Mooshagian; Eric Frederick,60,0,60,0
1713305470849,COGS 118A,A01,489191,Staff,0,23,40,40
1713305472902,COGS 171GS,A01,489194,Pineda; Jaime A,22,0,28,6
1713305473929,COGS 172,A01,489196,Staff,9,0,30,21
1713305474953,COGS 174GS,A01,489264,Pineda; Jaime A,22,0,28,6
1713305475982,COGS 180,A01,627150,Staff,29,0,30,1
1713305477008,COGS 186,A01,489274,Staff,4,0,30,26
1713305478033,COMM 10,A01,489276,Staff,25,0,25,0
1713305478033,COMM 10,A02,489303,Staff,23,0,25,2
1713305479059,COMM 100A,A01,489312,Staff,21,0,25,4
1713305479059,COMM 100A,A02,489313,Staff,24,0,25,1
1713305480084,COMM 106T,A00,512540,Staff,34,0,35,1
1713305481109,COMM 107,A00,489347,Staff,31,0,35,4
1713305482139,COMM 109P,A00,489358,Staff,31,0,35,4
1713305483169,COMM 132,A00,489361,McKenna; Denise,29,0,30,1
1713305484196,COMM 146,A00,489362,Halm; Gavin Patrick,27,0,30,3
1713305485222,COMM 190,A00,489363,Abuelhiga; Soraya Jill,21,0,23,2
1713305486251,CSE 8A,A50,489366,Staff,23,0,25,2
1713305486251,CSE 8A,A51,489367,Staff,24,0,25,1
1713305487275,CSE 11,A01,489398,Cao; Yingjun,85,0,100,15
1713305488306,CSE 12,A01,489487,Staff,43,0,50,7
1713305489331,CSE 20,A01,489497,Staff,49,0,50,1
1713305490361,CSE 21,A01,489517,Braun; Oliver,44,0,50,6
1713305491386,CSE 101,A01,489524,Braun; Oliver,0,3,50,50
1713305492414,CSE 105,A01,512594,Jones; Miles E,84,0,100,16
1713305492414,CSE 105,B01,512598,Jones; Miles E,71,0,100,29
1713305493441,CSE 140,A01,489538,Staff,44,0,50,6
1713305494466,CSE 141,A01,489550,Eldon; John,76,0,100,24
1713305495491,CSE 141L,A01,489571,Eldon; John,75,0,100,25
1713305496520,CSE 151A,A01,489583,Solares; Edwin A,153,0,200,47
1713305497546,CSE 175,A01,510886,Kumar; Rakesh,30,0,30,0
1713305498634,CSE 190,A00,516828,Dubnov; Shlomo,41,0,49,8
1713305499661,DOC 100D,A00,489667,Pass; Natalye Joann,23,0,25,2
1713305500688,DSC 10,A01,624268,Staff,72,0,75,3
1713305501713,DSC 20,A01,624476,Staff,50,0,50,0
1713305502742,DSC 40A,A01,624608,Staff,40,0,40,0
1713305503773,DSGN 1,A01,489179,Rill; Bryan,37,0,50,13
1713305504799,ECE 17,A01,490489,Sahay; Rajeev,19,0,30,11
1713305505823,ECE 65,A50,490492,Staff,17,0,20,3
1713305505823,ECE 65,A51,490493,Staff,20,0,20,0
1713305506853,ECON 1,A01,489715,Famulari; Melissa,69,0,70,1
1713305507883,ECON 2,A01,489717,Levkoff; Steven B.,69,0,70,1
1713305508913,ECON 3,A01,489948,Staff,70,0,70,0
1713305510969,ECON 5,A01,490103,Staff,28,0,30,2
1713305510969,ECON 5,B01,626281,Dai; Yinlin,45,0,45,0
1713305511998,ECON 100A,A01,490127,Famulari; Melissa,70,0,70,0
1713305513021,ECON 100B,A01,490129,Staff,64,0,70,6
1713305514053,ECON 109,A01,490187,Shishkin; Denis,29,0,35,6
1713305515077,ECON 110A,A01,490190,Levkoff; Steven B.,64,0,70,6
1713305516101,ECON 120A,A01,490245,Dai; Yinlin,69,0,70,1
1713305517131,ECON 120B,A01,490247,Nieto-Barthaburu; Augusto,60,0,70,10
1713305518164,ECON 120C,A01,490253,Sun; Yixiao,32,0,35,3
1713305518164,ECON 120C,B01,490255,Sun; Yixiao,34,0,35,1
1713305519189,ECON 129,A00,490256,Eckert; Fabian Paul,28,0,35,7
1713305520223,ECON 131,A00,490257,Nieto-Barthaburu; Augusto,6,0,35,29
1713305521249,ECON 138,A00,490258,Bharadwaj; Prashant,24,0,35,11
1713305521249,ECON 138,B00,490259,Bharadwaj; Prashant,20,0,35,15
1713305522310,ECON 159,A00,490260,Hendrickson; Gerald M.,0,6,0,0
1713305523335,ECON 178,A01,553995,Zhu; Ying,28,0,35,7
1713305524366,EDS 40,A01,512576,Black; Alison Michelle,20,0,20,0
1713305525394,EDS 107,A01,515848,Staff,30,0,30,0
1713305526423,EDS 110R,A01,490262,Staff,26,0,30,4
1713305527453,EDS 112,A01,490264,Chapman; Thandeka K,45,0,50,5
1713305528477,EDS 113,A00,490266,Staff,28,0,30,2
1713305529503,EDS 118,A00,490267,Warstadt; Melissa Fawn,27,0,30,3
1713305530528,EDS 124BR,A00,490268,Eguchi; Emi,10,0,25,15
1713305530528,EDS 124BR,B00,490269,Eguchi; Emi,25,0,25,0
1713305531558,EDS 126,A01,490271,Jones; Makeba,47,0,50,3
1713305532583,EDS 135,A01,490316,Staff,19,0,20,1
1713305533611,ENVR 142GS,A00,519514,Chang; Edmond Yi-Teh,28,0,28,0
1713305534640,ETHN 103,A00,490504,Staff,33,0,36,3
1713305535665,ETHN 103A,A00,490505,Man; Simeon S,7,0,9,2
1713305536690,ETHN 109,A00,490506,Staff,30,0,30,0
1713305537720,ETHN 118,A00,490507,Staff,35,0,36,1
1713305538745,ETHN 119,A00,490508,Staff,36,0,36,0
1713305539769,ETHN 121R,A00,490518,Choi; Esther Min,30,0,36,6
1713305540795,ETHN 127,A00,490528,Staff,15,0,15,0
1713305541820,ETHN 139,A00,490573,Staff,10,0,10,0
1713305542849,ETHN 150,A00,490575,Staff,15,0,15,0
1713305543892,GLBH 20,A00,491705,Elwardani; Nile Regina,38,0,40,2
1713305544970,GLBH 101,A00,491706,Staff,20,0,20,0
1713305545999,GLBH 111,A01,491708,Burgos; Jose L.,15,0,15,0
1713305547022,GLBH 146,A00,491709,Staff,13,0,20,7
1713305548053,GLBH 148,A00,491710,Olivas Hernandez; Olga Lid,17,0,20,3
1713305549083,GLBH 150,A00,491711,Sloane; Julia Kathryn,20,0,20,0
1713305550114,HIEA 131,A00,491760,Staff,30,0,32,2
1713305551143,HIEA 153,A00,491762,Staff,29,0,30,1
1713305552169,HIEU 124,A00,491811,Staff,27,0,32,5
1713305553199,HIEU 124GS,A00,491812,Markman; Kristina,28,0,28,0
1713305554225,HIEU 147,A00,491813,Staff,30,0,32,2
1713305555251,HIEU 149GS,A00,491816,Caldwell; Michael Alan,28,0,28,0
1713305556277,HILD 2C,A01,491713,Hendrickson; Gerald M.,28,0,30,2
1713305557305,HILD 7B,A01,491715,Kwak; Nancy,17,0,30,13
1713305558333,HILD 10,A01,491717,Staff,15,0,20,5
1713305559358,HILD 30GS,A00,491719,Edington; Claire Ellen,24,0,28,4
1713305560383,HINE 109,A00,491818,Shafir; Nir,30,0,32,2
1713305561407,HINE 128,A00,491821,Shafir; Nir,32,0,32,0
1713305562434,HISC 117,A00,491830,Staff,29,0,32,3
1713305563459,HIUS 103,A00,491834,Man; Simeon S,17,0,23,6
1713305564488,HIUS 108B,A00,491835,Staff,30,0,30,0
1713305565512,HIUS 141,A00,491836,Hendrickson; Gerald M.,29,0,32,3
1713305566536,HIUS 149,A00,491839,Staff,27,0,32,5
1713305567562,HUM 3,A01,512617,Crum; Matthew Stephen,46,0,50,4
1713305567562,HUM 3,A02,512618,Crum; Matthew Stephen,48,0,50,2
1713305568587,HUM 3GS,A00,512663,Markman; Kristina,0,0,0,0
1713305568587,HUM 3GS,B00,512664,Staff,0,0,0,0
1713305569615,HUM 4,A01,512620,West; Geoffrey Scott,38,0,50,12
1713305570639,HUM 4GS,A00,512666,Lyon; Antony J.,0,0,0,3
1713305571666,HUM 4R,A01,512625,Watkins; Eric,49,0,50,1
1713305572703,HUM 5,A01,512649,Zavodny; Tatiana Sophia,34,0,50,16
1713305572703,HUM 5,B01,512661,Zroka; Ryan Edward,49,0,50,1
1713305573733,INTL 190,A00,490577,Segui; Alan S,0,0,0,5
1713305574765,JAPN 20AR,A01,491267,Ross; Kayoko F,12,0,20,8
1713305575790,JAPN 180,A00,491285,Berman; Michael David,34,0,40,6
1713305576819,LATI 50,A01,502536,Kokinis; Troy Andreas,19,0,22,3
1713305576819,LATI 50,A02,502551,Kokinis; Troy Andreas,22,0,22,0
1713305576819,LATI 50,A03,502650,Kokinis; Troy Andreas,22,0,22,0
1713305576819,LATI 50,A04,502909,Kokinis; Troy Andreas,22,0,22,0
1713305577845,LATI 160,A01,502920,Kokinis; Troy Andreas,30,0,30,0
1713305578870,LIFR 1A,A00,490494,Van Moer; Vinciane G,18,0,20,2
1713305579896,LIFR 1AX,A00,490495,Van Moer; Vinciane G,18,0,20,2
1713305580921,LIFR 1B,A00,490496,Van Moer; Vinciane G,20,0,20,0
1713305581951,LIFR 1BX,A00,490497,Van Moer; Vinciane G,20,0,20,0
1713305582978,LIGN 8,A00,505198,McIntosh; Justin Daniel,143,0,150,7
1713305584003,LIGN 9GS,A00,491239,Lott; Margaret S.,18,0,20,2
1713305585033,LIGN 101,A01,505200,McIntosh; Justin Daniel,26,0,30,4
1713305586058,LIGN 120,A01,491244,Staff,26,0,30,4
1713305587087,LIGN 149GS,A00,491245,Lott; Margaret S.,18,0,20,2
1713305588115,LIGN 170,A00,491247,Staff,25,0,30,5
1713305589142,LISP 1D,A00,490498,Munoz Sanchez; Alicia,11,0,14,3
1713305589142,LISP 1D,B00,490499,Munoz Sanchez; Alicia,7,0,14,7
1713305589142,LISP 1D,C00,490500,Munoz Sanchez; Alicia,10,0,14,4
1713305589142,LISP 1D,D00,490501,Munoz Sanchez; Alicia,11,0,14,3
1713305590167,LISP 1DX,A00,490502,Munoz Sanchez; Alicia,19,0,28,9
1713305590167,LISP 1DX,B00,490503,Munoz Sanchez; Alicia,19,0,28,9
1713305592226,LTAM 110,A00,491847,Staff,23,0,25,2
1713305593257,LTCS 119,A00,491848,Staff,13,0,15,2
1713305594288,LTCS 130,A00,491849,Staff,24,0,25,1
1713305596342,LTEA 120C,A00,491852,Staff,35,0,40,5
1713305597367,LTEN 130GS,A00,491853,Lyon; Antony J.,25,0,28,3
1713305598391,LTEN 148,A00,491855,Staff,23,0,25,2
1713305599416,LTEN 159,A00,491856,Staff,21,0,25,4
1713305600445,LTEN 180,A00,491857,Staff,9,0,15,6
1713305602498,LTSP 123GS,A00,505928,Bessett; Ryan Matthew,25,0,28,3
1713305603523,LTSP 174GS,A00,506037,Bessett; Ryan Matthew,25,0,28,3
1713305605573,LTWR 102,A00,491861,Staff,12,0,15,3
1713305606599,LTWR 106,A00,491862,Staff,11,0,15,4
1713305607624,MAE 11,A00,490930,Bahadori; Mohammad Yousef,98,0,100,2
1713305608653,MAE 30A,A00,490931,Qi; Huihui,38,0,40,2
1713305609677,MAE 101A,A00,491036,Sadeghizadeh; Zahra,98,0,100,2
1713305610701,MAE 101C,A00,491037,Seshadri; Kalyanasundaram,78,0,100,22
1713305611732,MAE 113,A00,491040,Seshadri; Kalyanasundaram,67,0,80,13
1713305612757,MAE 131A,A00,491041,Ghazinejad; Maziar,39,0,40,1
1713305613781,MAE 142,A00,491053,Staff,39,0,40,1
1713305614807,MAE 143A,A00,491054,Staff,42,0,50,8
1713305615837,MAE 150,A00,491092,Truong; Phuong Thi Ngoc,24,0,35,11
1713305616868,MATH 3C,A01,494031,Pardo Guerra; Sebastian,30,0,30,0
1713305616868,MATH 3C,A02,494032,Pardo Guerra; Sebastian,29,0,30,1
1713305617893,MATH 10A,A01,494034,Staff,28,0,30,2
1713305617893,MATH 10A,A02,494035,Staff,29,0,30,1
1713305617893,MATH 10A,B01,494037,Staff,28,0,30,2
1713305617893,MATH 10A,B02,494038,Staff,29,0,30,1
1713305618922,MATH 10B,A01,494040,Habib; Yousaf,24,0,30,6
1713305618922,MATH 10B,A02,494041,Habib; Yousaf,28,0,30,2
1713305618922,MATH 10B,A03,494042,Habib; Yousaf,30,0,30,0
1713305618922,MATH 10B,A04,494043,Habib; Yousaf,30,0,30,0
1713305618922,MATH 10B,B01,494045,Habib; Yousaf,28,0,30,2
1713305618922,MATH 10B,B02,494046,Habib; Yousaf,30,0,30,0
1713305618922,MATH 10B,B03,494047,Habib; Yousaf,30,0,30,0
1713305618922,MATH 10B,B04,494048,Habib; Yousaf,30,0,30,0
1713305619950,MATH 18,A01,494050,Kemp; Todd Aahron,27,0,30,3
1713305619950,MATH 18,A02,494051,Kemp; Todd Aahron,29,0,30,1
1713305619950,MATH 18,B01,494054,Kemp; Todd Aahron,28,0,30,2
1713305619950,MATH 18,B02,494055,Kemp; Todd Aahron,29,0,30,1
1713305620976,MATH 20A,A01,494059,Suk; Andrew Hoon,30,0,30,0
1713305622004,MATH 20B,A01,494061,Briones; Jor-el Thomas Caparas,34,0,35,1
1713305622004,MATH 20B,B01,494063,Bach; Quang Tran,34,0,35,1
1713305623035,MATH 20C,A01,494065,Staff,29,0,30,1
1713305623035,MATH 20C,A02,494066,Staff,30,0,30,0
1713305623035,MATH 20C,A03,494067,Staff,30,0,30,0
1713305623035,MATH 20C,A04,494068,Staff,30,0,30,0
1713305623035,MATH 20C,B01,494070,Zhang; Ming,27,0,30,3
1713305623035,MATH 20C,B02,494071,Zhang; Ming,30,0,30,0
1713305623035,MATH 20C,B03,494072,Zhang; Ming,29,0,30,1
1713305623035,MATH 20C,B04,494073,Zhang; Ming,29,0,30,1
1713305624062,MATH 20D,A01,494075,Staff,26,0,30,4
1713305624062,MATH 20D,A02,494076,Staff,30,0,30,0
1713305625092,MATH 20E,A01,494079,Staff,25,0,30,5
1713305625092,MATH 20E,A02,494080,Staff,28,0,30,2
1713305625092,MATH 20E,B01,494082,Staff,28,0,30,2
1713305625092,MATH 20E,B02,494083,Staff,25,0,30,5
1713305626120,MATH 103A,A01,494085,Aliabadi Sr.; Mohsen,22,0,30,8
1713305626120,MATH 103A,A02,494086,Aliabadi Sr.; Mohsen,29,0,30,1
1713305626120,MATH 103A,B01,494088,Aliabadi Sr.; Mohsen,22,0,30,8
1713305626120,MATH 103A,B02,494089,Aliabadi Sr.; Mohsen,28,0,30,2
1713305627147,MATH 109,A01,494091,Staff,30,0,30,0
1713305627147,MATH 109,A02,494092,Staff,30,0,30,0
1713305627147,MATH 109,B01,494094,Staff,28,0,30,2
1713305627147,MATH 109,B02,494095,Staff,29,0,30,1
1713305628172,MATH 142A,A01,494097,Chow; Bennett,16,0,30,14
1713305628172,MATH 142A,A02,494098,Chow; Bennett,24,0,30,6
1713305628172,MATH 142A,B01,494100,Chow; Bennett,22,0,30,8
1713305628172,MATH 142A,B02,494101,Chow; Bennett,29,0,30,1
1713305630234,MATH 168A,A01,516677,Dumitriu; Ioana,17,0,35,18
1713305631265,MATH 170A,A01,516679,Dumitriu; Ioana,21,0,30,9
1713305631265,MATH 170A,A02,516680,Dumitriu; Ioana,28,0,30,2
1713305632290,MATH 193A,A01,494107,Staff,17,0,30,13
1713305632290,MATH 193A,A02,494108,Staff,25,0,30,5
1713305632290,MATH 193A,A03,494109,Staff,29,0,30,1
1713305632290,MATH 193A,A04,494110,Staff,26,0,30,4
1713305635372,MGT 16,A00,491930,McKay; Michael J,94,0,98,4
1713305636399,MGT 18,A00,491992,McKay; Michael J,97,0,98,1
1713305637428,MGT 71,A00,492003,Staff,79,0,98,19
1713305638456,MGT 103,A00,505209,Eberhard; Craig A,87,0,98,11
1713305639486,MGT 131A,A00,505210,Anderson; John Charles,91,0,98,7
1713305641538,MGT 153,A00,492077,Perols; Johan Lars,51,0,90,39
1713305644614,MGT 164,A00,492222,McKay; Mary A,94,0,98,4
1713305645639,MGT 172,A00,492245,Staff,59,0,60,1
1713305645639,MGT 172,B00,505526,Hedges; Kathleen,78,0,98,20
1713305646665,MGT 181,A00,505669,Dunn; Louis Jean,88,0,98,10
1713305647704,MMW 14,A01,494399,Staff,23,0,28,5
1713305647704,MMW 14,A02,494400,Staff,26,0,28,2
1713305647704,MMW 14,A03,494401,Staff,28,0,28,0
1713305647704,MMW 14,A04,494402,Staff,28,0,28,0
1713305647704,MMW 14,B01,494404,Carreras; Maria Victoria,18,0,28,10
1713305647704,MMW 14,B02,494405,Carreras; Maria Victoria,27,0,28,1
1713305647704,MMW 14,B03,494406,Carreras; Maria Victoria,28,0,28,0
1713305647704,MMW 14,B04,494407,Carreras; Maria Victoria,28,0,28,0
1713305648788,MMW 14GS,A00,506250,Chang; Edmond Yi-Teh,0,0,0,0
1713305649813,MMW 121R,A01,494415,Adamiak; Patrick John,16,0,28,12
1713305649813,MMW 121R,A02,494416,Adamiak; Patrick John,25,0,28,3
1713305650840,MUS 1A,A01,494113,Staff,14,0,25,11
1713305650840,MUS 1A,A02,494114,Staff,25,0,25,0
1713305651870,MUS 4,A01,494116,Staff,24,0,25,1
1713305651870,MUS 4,A02,494117,Staff,22,0,25,3
1713305652896,MUS 5R,A01,494236,Dubnov; Shlomo,12,0,25,13
1713305652896,MUS 5R,A02,494237,Dubnov; Shlomo,25,0,25,0
1713305653923,MUS 6,A01,494122,Staff,16,0,25,9
1713305653923,MUS 6,A02,494123,Staff,24,0,25,1
1713305654949,MUS 7,A01,494125,Staff,17,0,25,8
1713305654949,MUS 7,A02,494126,Staff,24,0,25,1
1713305655975,MUS 11,A01,494128,Staff,23,0,25,2
1713305655975,MUS 11,A02,494129,Staff,25,0,25,0
1713305657005,MUS 13,A01,494131,Staff,25,0,25,0
1713305657005,MUS 13,A02,494132,Staff,25,0,25,0
1713305658032,MUS 15,A01,494134,Staff,20,0,25,5
1713305658032,MUS 15,A02,494135,Staff,25,0,25,0
1713305658032,MUS 15,B01,494137,Staff,25,0,25,0
1713305659057,MUS 80,A00,494232,Staff,25,0,25,0
1713305659057,MUS 80,B00,494233,Staff,25,0,25,0
1713305659057,MUS 80,C00,494234,Staff,23,0,25,2
1713305660081,MUS 95C,A00,494141,Staff,73,0,75,2
1713305661106,MUS 114,A00,494142,Staff,42,0,50,8
1713305662138,NANO 15,A01,490636,Drews; Aaron,7,0,7,0
1713305663164,PHIL 1,A00,490578,Grush; Rick Scott,50,0,50,0
1713305664194,PHIL 10,A01,490580,Grush; Rick Scott,34,0,35,1
1713305664194,PHIL 10,A02,490586,Grush; Rick Scott,33,0,35,2
1713305665222,PHIL 27,A01,490591,Staff,24,0,25,1
1713305665222,PHIL 27,A02,490592,Staff,25,0,25,0
1713305665222,PHIL 27,A03,490593,Staff,25,0,25,0
1713305665222,PHIL 27,A04,490598,Staff,25,0,25,0
1713305666249,PHIL 32,A01,490611,Staff,20,0,20,0
1713305666249,PHIL 32,A02,490618,Staff,20,0,20,0
1713305667276,PHIL 90,A00,490624,Staff,40,0,40,0
1713305668303,PHIL 136,A00,490627,Cohen; Jonathan David,38,0,40,2
1713305669329,PHIL 155,A00,490634,Staff,67,0,70,3
1713305670354,PHYS 1A,A00,491610,Staff,246,0,250,4
1713305671383,PHYS 1AL,001,491616,Tsai; Philbert S,28,0,30,2
1713305671383,PHYS 1AL,002,491618,Tsai; Philbert S,30,0,30,0
1713305672414,PHYS 1B,A00,491623,Staff,245,0,250,5
1713305673441,PHYS 1BL,001,491626,Tsai; Philbert S,27,0,30,3
1713305673441,PHYS 1BL,002,491628,Tsai; Philbert S,28,0,30,2
1713305674468,PHYS 1C,A00,491632,Staff,227,0,245,18
1713305675494,PHYS 1CL,001,491635,Tsai; Philbert S,13,0,30,17
1713305675494,PHYS 1CL,002,491643,Tsai; Philbert S,24,0,30,6
1713305676522,PHYS 2AR,A01,491651,Meyertholen; Andrew D.,46,0,50,4
1713305677589,PHYS 2B,A01,491659,Staff,107,0,115,8
1713305678615,PHYS 2BL,A01,491685,Staff,24,0,24,0
1713305678615,PHYS 2BL,A02,491700,Staff,23,0,24,1
1713305679645,PHYS 2C,A01,505161,Staff,108,0,115,7
1713305680674,PHYS 4A,A01,491704,Grinstein; Benjamin,100,0,100,0
1713305681699,POLI 5D,A01,494144,Staff,3,0,5,2
1713305681699,POLI 5D,B01,626283,Dai; Yinlin,5,0,5,0
1713305682729,POLI 12,A00,494145,Staff,44,0,45,1
1713305683755,POLI 13R,A00,494146,Forman; Fonna,47,0,50,3
1713305684782,POLI 27,A01,494148,Staff,59,0,60,1
1713305685808,POLI 30,A00,494149,Staff,49,0,50,1
1713305686846,POLI 100DA,A00,494150,Staff,23,0,25,2
1713305688902,POLI 100I,A00,494152,Staff,29,0,30,1
1713305689938,POLI 104B,A00,494153,Smith; Glenn Chatmas,54,0,55,1
1713305690965,POLI 104F,A00,494154,Staff,29,0,30,1
1713305691994,POLI 104I,A00,494155,Smith; Glenn Chatmas,30,0,30,0
1713305693018,POLI 110C,A00,494156,Ingham; Sean,23,0,25,2
1713305694044,POLI 117R,A00,494157,Forman; Fonna,16,0,20,4
1713305695072,POLI 118,A00,494158,Ingham; Sean,23,0,25,2
1713305696098,POLI 120H,A00,494159,Fisk; David Lee,41,0,45,4
1713305697127,POLI 131CR,A00,494160,Hoston; Germaine,41,0,45,4
1713305698155,POLI 133J,A00,494161,Staff,33,0,35,2
1713305699185,POLI 135,A00,494162,Fisk; David Lee,34,0,35,1
1713305700210,POLI 140A,A00,494164,Staff,22,0,30,8
1713305701238,POLI 142I,A00,494165,Staff,30,0,30,0
1713305702263,POLI 144D,A00,494166,Staff,23,0,25,2
1713305703287,POLI 151,A00,494167,Staff,30,0,30,0
1713305704311,POLI 153,A00,494168,Staff,34,0,35,1
1713305705337,POLI 160AA,A00,494169,Staff,36,0,40,4
1713305706360,POLI 162,A00,494170,Mignozzetti; Umberto,21,0,25,4
1713305707384,POLI 171,A00,494171,Mignozzetti; Umberto,23,0,25,2
1713305708410,PSYC 1,A00,494172,Staff,97,0,100,3
1713305709432,PSYC 2,A00,494173,Moranton; Nirelia Melbina-,47,0,50,3
1713305710457,PSYC 3,A00,494174,Staff,30,0,30,0
1713305711485,PSYC 6,A00,494175,Staff,17,0,20,3
1713305712512,PSYC 60,A01,494177,Staff,42,0,45,3
1713305713537,PSYC 70,A01,505724,Geller; Emma Harlan,42,0,45,3
1713305714567,PSYC 101,A00,494180,Heyman; Gail D.,93,0,100,7
1713305715600,PSYC 105,A00,494181,Geller; Emma Harlan,66,0,90,24
1713305716628,PSYC 106,A00,494182,Dobkins; Karen R.,34,0,45,11
1713305717661,PSYC 108,A00,494183,Adrian; Julia Anna,94,0,100,6
1713305718688,PSYC 114,A01,494185,Winkielman; Piotr,7,0,30,23
1713305719718,PSYC 122,A00,494186,Moranton; Nirelia Melbina-,41,0,50,9
1713305720747,PSYC 124,A00,494187,Chapman; Eddie Nathaniel,73,0,80,7
1713305721770,PSYC 131,A00,494188,Anagnostaras; Stephan,60,0,80,20
1713305722801,PSYC 144,A00,494189,Staff,22,0,50,28
1713305723829,PSYC 154,A00,494190,Lacefield; Katharine I,141,0,180,39
1713305724855,PSYC 162,A00,494191,Wixted; John T,89,0,100,11
1713305725880,PSYC 172,A00,494192,Gorman; Michael R.,38,0,45,7
1713305726908,PSYC 178,A00,494193,Glaser; Dale,41,0,45,4
1713305727933,PSYC 193,A00,505725,Chapman; Eddie Nathaniel,20,0,20,0
1713305728963,RELI 145GS,A00,519817,Rahimi; Babak,19,0,20,1
1713305729988,SE 101A,A01,490862,Chadha; Mayank,24,0,25,1
1713305731015,SE 101C,A01,490924,Krysl; Petr,18,0,20,2
1713305732043,SE 110A,A01,490928,Staff,20,0,20,0
1713305733074,SE 130A,A00,490929,Morrison; Machel Leigh,66,0,70,4
1713305734100,SIO 1,A01,519325,Staff,39,0,40,1
1713305735125,SIO 30,A01,519327,Staff,40,0,40,0
1713305736153,SIO 40,A00,519328,Staff,40,0,40,0
1713305737178,SIO 46GS,A00,519819,Cook; Geoffrey W,19,0,25,6
1713305738203,SIO 109R,A00,494197,Forman; Fonna,8,0,20,12
1713305739228,SIO 121GS,A00,519827,Cook; Geoffrey W,19,0,25,6
1713305740253,SIO 132,A01,519330,Staff,38,0,40,2
1713305741279,SIO 133,A01,519397,Staff,38,0,40,2
1713305742307,SIO 139,A00,519396,Kacev; David,33,0,40,7
1713305743340,SOCI 1,A01,494199,Thorpe; Charles Robert,24,0,30,6
1713305743340,SOCI 1,A02,494200,Thorpe; Charles Robert,30,0,30,0
1713305743340,SOCI 1,A03,494201,Thorpe; Charles Robert,29,0,30,1
1713305743340,SOCI 1,A04,494202,Thorpe; Charles Robert,29,0,30,1
1713305743340,SOCI 1,A05,494203,Thorpe; Charles Robert,29,0,30,1
1713305743340,SOCI 1,A06,494204,Thorpe; Charles Robert,30,0,30,0
1713305743340,SOCI 1,A07,494205,Thorpe; Charles Robert,29,0,30,1
1713305744368,SOCI 60,A01,494207,Staff,36,0,40,4
1713305744368,SOCI 60,A02,494208,Staff,39,0,40,1
1713305745393,SOCI 100,A01,494210,Payne; Christine Anna,28,0,30,2
1713305745393,SOCI 100,A02,494211,Payne; Christine Anna,28,0,30,2
1713305746417,SOCI 109M,A00,494212,Staff,20,0,20,0
1713305747446,SOCI 110,A00,494213,Staff,35,0,40,5
1713305749499,SOCI 118E,A00,494215,Ng; Kwai,38,0,40,2
1713305750528,SOCI 125,A00,494216,Calderon-Zaks; Michael Aar,42,0,45,3
1713305751554,SOCI 126,A01,494218,Jones; Makeba,4,0,5,1
1713305752634,SOCI 131,A00,494219,Thorpe; Charles Robert,30,0,30,0
1713305754688,SOCI 135,A00,494221,Payne; Christine Anna,44,0,50,6
1713305755716,SOCI 136E,A00,626690,Ruiz; Jonathan Joseph,25,0,25,0
1713305756742,SOCI 138GS,A00,494222,Navon; Daniel,24,0,28,4
1713305758798,SOCI 145,A00,494224,Staff,43,0,45,2
1713305759825,SOCI 153,A00,494225,Staff,28,0,30,2
1713305760850,SOCI 160E,A00,494226,Ng; Kwai,34,0,40,6
1713305761874,SOCI 180,A00,494227,Staff,29,0,30,1
1713305762898,SOCI 189GS,A00,494228,Ribas Norris; Janet Vanesa,11,0,11,0
1713305763924,SOCI 190GS,A00,553232,Ribas Norris; Janet Vanesa,11,0,11,0
1713305764954,SOMI 220,A00,627178,Schneid; Stephen David,30,0,30,0
1713305765986,SYN 2,001,490768,Staff,14,0,15,1
1713305765986,SYN 2,002,490769,Staff,15,0,15,0
1713305765986,SYN 2,004,490775,Staff,0,0,0,0
1713305765986,SYN 2,003,490774,Staff,0,0,0,0
1713305765986,SYN 2,005,490776,Staff,0,0,0,0
1713305767012,SYN 2R,001,490779,Staff,14,0,15,1
1713305767012,SYN 2R,002,514635,Staff,14,0,15,1
1713305768042,SYN 100,A01,490783,Staff,17,0,20,3
1713305768042,SYN 100,B01,490787,Staff,12,0,20,8
1713305768042,SYN 100,C01,490789,Staff,15,0,20,5
1713305769066,SYN 150,A00,490817,Staff,14,0,15,1
1713305769066,SYN 150,B00,514610,Staff,15,0,15,0
1713305770099,TDAC 1,A00,492753,Walsh; Kim C.,19,0,20,1
1713305770099,TDAC 1,B00,492754,Harting; Carla Kelso,19,0,20,1
1713305770099,TDAC 1,C00,513995,Salovey; Todd,18,0,20,2
1713305771125,TDAC 101,A00,492766,Harting; Carla Kelso,19,0,20,1
1713305772151,TDAC 102,A00,492768,Basso; Beatrice,20,0,20,0
1713305773179,TDDE 111,A00,492769,Staff,25,0,25,0
1713305774207,TDDE 131,A00,492770,Staff,15,0,15,0
1713305774207,TDDE 131,B00,492771,Staff,15,0,15,0
1713305775244,TDDE 131GS,A00,523716,Guirguis; Mark C,25,0,28,3
1713305776269,TDGE 1,A01,492756,Salovey; Todd,57,0,60,3
1713305777295,TDGE 5,A01,492758,Staff,24,0,25,1
1713305778318,TDGE 10,A00,492759,Fulton; Julia,215,0,220,5
1713305779342,TDGE 11,A00,492760,Castro; Robert Jess,200,0,200,0
1713305780370,TDGE 50,A00,492761,Blair; Kyle Adam,0,0,0,0
1713305781396,TDGE 124,A00,492772,Fulton; Julia,199,0,220,21
1713305782427,TDGE 125,A00,492773,Meyer; Ursula,43,0,50,7
1713305782427,TDGE 125,B00,492774,Staff,50,0,50,0
1713305782427,TDGE 125,C00,523565,Staff,50,0,50,0
1713305783451,TDGE 125GS,A00,523580,Guirguis; Mark C,25,0,28,3
1713305784480,TDGE 127,A00,492775,Havis; Allan,43,0,50,7
1713305785505,TDHT 101,A00,492776,Staff,35,0,35,0
1713305786532,TDMV 1,A00,492762,Caligagan; Maria T.,30,0,30,0
1713305786532,TDMV 1,B00,492763,Arcidiacono; Kristin,26,0,30,4
1713305787559,TDMV 2,A00,492764,Weinberg; Sadie,29,0,30,1
1713305788585,TDMV 3,A00,492765,Mack; Kara Shanai',39,0,40,1
1713305789609,TDMV 138,A00,492777,Mack; Kara Shanai',37,0,40,3
1713305790637,TDMV 140,A00,492778,Lima; Paulo Henrique,40,0,40,0
1713305791666,TDMV 142,A00,492779,Caligagan; Maria T.,37,0,40,3
1713305791666,TDMV 142,B00,492780,Caligagan; Tony,38,0,40,2
1713305792690,TDMV 143,A00,492781,Fyall; Daunte Edward,40,0,40,0
1713305793717,USP 1,A01,492401,Kwak; Nancy,29,0,35,6
1713305794750,USP 2,A01,492453,Hinds; Juli Beth,35,0,35,0
1713305795774,USP 3,A01,492516,Staff,32,0,35,3
1713305796798,USP 4,A00,492522,McTague; Sarah,20,0,25,5
1713305797823,USP 100,A00,492523,Staff,33,0,35,2
1713305798849,USP 101,A00,492524,Staff,13,0,15,2
1713305799874,USP 105,A00,492525,Staff,22,0,25,3
1713305800900,USP 151,A00,492526,Shenkman; Michael Thomas,33,0,35,2
1713305801925,USP 170,A00,492545,Hinds; Juli Beth,33,0,35,2
1713305802954,USP 171GS,A00,492608,Bussell; Mirle Rabinowitz,26,0,28,2
1713305803981,USP 183GS,A00,492613,Peerson; Susan,26,0,28,2
1713305805011,VIS 30,A01,490693,Yoldas; Pinar,21,0,22,1
1713305805011,VIS 30,A02,490694,Yoldas; Pinar,19,0,22,3
1713305806038,VIS 83,A00,490695,Kester; Grant,68,0,75,7
1713305807069,VIS 105D,A00,490696,Staff,22,0,25,3
1713305808099,VIS 124CN,A00,490699,Rose; Jordan M,68,0,75,7
1713305809139,VIS 125GS,A00,511221,Williams; Alena J,21,0,22,1
1713305810169,VIS 128D,A00,490700,Staff,74,0,75,1
1713305811208,VIS 151,A01,490717,Staff,34,0,34,0
1713305811208,VIS 151,A02,490766,Staff,33,0,34,1
1713305812236,VIS 154GS,A00,511972,Williams; Alena J,21,0,22,1
1713305813261,VIS 160A,A00,490767,Stone; Patricia,7,0,10,3
1713305814292,WCWP 10A,A00,490638,Staff,15,0,15,0
1713305814292,WCWP 10A,B00,490640,Staff,15,0,15,0
1713305815318,WCWP 10B,A00,490641,Staff,0,0,0,0
1713305815318,WCWP 10B,B00,490642,Staff,14,0,15,1
1713305815318,WCWP 10B,C00,490644,Staff,14,0,15,1
1713305815318,WCWP 10B,D00,490647,Staff,0,0,0,0
1713305816343,WCWP 100,A00,490655,Staff,0,0,0,0
1713305816343,WCWP 100,B00,490687,Staff,12,0,15,3
1713305818426,ANAR 153,A00,487222,Braswell; Geoffrey E.,55,0,60,5
1713305819453,ANBI 134,A00,487223,Staff,14,0,20,6
1713305820475,ANBI 143GS,A00,487224,Noel; Geoffroy Pierre Jean,20,0,24,4
1713305821504,ANBI 144GS,A00,519548,Noel; Geoffroy Pierre Jean,20,0,24,4
1713305822531,ANSC 101,A00,487225,Staff,19,0,20,1
1713305823564,ANSC 125,A00,487227,Brenner; Suzanne A,39,0,40,1
1713305825620,ANSC 146,A00,487229,Staff,37,0,40,3
1713305826646,ANSC 148,A00,487230,Olivas Hernandez; Olga Lid,39,0,40,1
1713305827674,ANSC 150,A00,504165,Sloane; Julia Kathryn,19,0,20,1
1713305828699,ANSC 180,A00,487232,Staff,13,0,15,2
1713305829730,ANSC 188,A00,627155,Staff,40,0,40,0
1713305830762,ANTH 5,A00,519529,Semendeferi; Ekaterini,15,0,15,0
1713305831786,ANTH 10,A00,487219,Staff,58,0,60,2
1713305832813,ANTH 23,A01,487221,Staff,17,0,20,3
1713305833843,ANTH 102,A00,487233,Wilder; Linnea Lorene,53,0,60,7
1713305834868,ANTH 103,A00,487234,Varma; Saiba,57,0,60,3
1713305835896,ANTH 105,A00,487235,Stewart; Alexander B,57,0,60,3
1713305836922,BENG 100,A01,516685,Taylor Amos; Alyssa C,28,0,30,2
1713305837954,BIBC 102,A01,491316,Flagg; Matthew Paul,58,0,88,30
1713305837954,BIBC 102,A02,491366,Flagg; Matthew Paul,84,0,88,4
1713305838983,BIBC 103,A01,491486,Boumechache; Miyyada,16,0,24,8
1713305838983,BIBC 103,A02,491487,Boumechache; Miyyada,24,0,24,0
1713305840018,BICD 100,A01,516882,Staff,75,0,75,0
1713305840018,BICD 100,A02,516890,Staff,71,0,75,4
1713305841042,BICD 102GS,A00,491488,Lo; Stanley M.,27,0,28,1
1713305842072,BIEB 136GS,A00,516940,Holway; David A. & Shurin; Jonathan,20,0,24,4
1713305843098,BIEB 137GS,A01,517034,Holway; David A. & Shurin; Jonathan,20,0,24,4
1713305844124,BIEB 138GS,A01,491492,Pirino; Giorgia,22,0,28,6
1713305845153,BILD 1,A01,491296,Staff,62,0,63,1
1713305845153,BILD 1,A02,491297,Staff,63,0,63,0
1713305846183,BILD 4,A01,517099,Gonzalez Gamboa; Ivonne,23,0,24,1
1713305846183,BILD 4,A02,517100,Gonzalez Gamboa; Ivonne,24,0,24,0
1713305847207,BILD 60GS,A00,491309,Lo; Stanley M.,27,0,28,1
1713305848234,BIMM 100,A01,517136,Staff,92,0,100,8
1713305849262,BIMM 110,A01,517182,Staff,78,0,100,22
1713305850289,BIMM 120,A01,517228,Pickett; Brooke Elizabeth,40,0,63,23
1713305850289,BIMM 120,A02,517240,Pickett; Brooke Elizabeth,49,0,63,14
1713305851314,BIMM 132GS,A01,491498,Pirino; Giorgia,22,0,28,6
1713305852344,BIMM 143,A01,491589,Bozinovic; Goran,21,0,40,19
1713305853374,BIPN 100,A01,491594,Armour; Jon Christopher,93,0,100,7
1713305854445,BIPN 140,A01,491602,Marino; Marc J,32,0,50,18
1713305856551,CAT 125,A00,515973,Staff,20,0,20,0
1713305857581,CAT 125GS,A00,515974,Rahimi; Babak,19,0,20,1
1713305858606,CAT 125R,A00,515980,Staff,15,0,20,5
1713305858606,CAT 125R,B00,515981,Tosun; Adriana,19,0,20,1
1713305858606,CAT 125R,C00,515987,Hyland; Tina Mae,6,0,20,14
1713305858606,CAT 125R,D00,515988,Bronstein; Phoebe Malan,18,0,20,2
1713305859632,CENG 15,A01,488699,Drews; Aaron,25,0,25,0
1713305860658,CENG 100,A00,505196,Opatkiewicz; Justin Paul,25,0,25,0
1713305861687,CGS 2A,A01,489598,Staff,33,0,35,2
1713305862717,CGS 112,A00,489599,Staff,15,0,15,0
1713305863746,CGS 119,A00,489603,Staff,10,0,10,0
1713305864770,CGS 120,A00,489604,Staff,14,0,15,1
1713305865793,CGS 150,A00,489607,Staff,15,0,15,0
1713305866818,CHEM 6A,A01,488715,Staff,98,0,100,2
1713305867844,CHEM 6B,A01,488719,Piercy; Marc Anthony,100,0,100,0
1713305868870,CHEM 6C,A01,488723,Albizati; Kim F.,94,0,100,6
1713305869898,CHEM 7L,A01,488728,Schurmeier; Kimberly,18,0,24,6
1713305869898,CHEM 7L,A02,488730,Schurmeier; Kimberly,23,0,24,1
1713305869898,CHEM 7L,A03,488734,Schurmeier; Kimberly,24,0,24,0
1713305869898,CHEM 7L,A04,488763,Schurmeier; Kimberly,23,0,24,1
1713305869898,CHEM 7L,B01,488798,Schurmeier; Kimberly,18,0,24,6
1713305869898,CHEM 7L,B02,488801,Schurmeier; Kimberly,24,0,24,0
1713305869898,CHEM 7L,B03,488808,Schurmeier; Kimberly,24,0,24,0
1713305869898,CHEM 7L,B04,488811,Schurmeier; Kimberly,24,0,24,0
1713305870924,CHEM 11,A01,488897,Stallings; Dontarie M,98,0,100,2
1713305871952,CHEM 40A,A01,488913,Albizati; Kim F.,92,0,100,8
1713305872981,CHEM 40B,A01,488920,Weizman; Haim,48,0,50,2
1713305872981,CHEM 40B,A02,488938,Weizman; Haim,47,0,50,3
1713305874006,CHEM 41A,A01,489029,Klosterman; Jeremy K,58,0,60,2
1713305875033,CHEM 41C,A01,500436,Tor; Yitzhak,55,0,60,5
1713305876062,CHEM 43A,A01,500426,Weizman; Haim,6,0,24,18
1713305876062,CHEM 43A,A02,500430,Weizman; Haim,14,0,24,10
1713305876062,CHEM 43A,B01,514041,Klosterman; Jeremy K,18,0,24,6
1713305876062,CHEM 43A,B02,514047,Klosterman; Jeremy K,23,0,24,1
1713305877088,CHEM 108,A01,489140,Jennings; Patricia A.,14,0,24,10
1713305877088,CHEM 108,A02,489142,Jennings; Patricia A.,15,0,24,9
1713305878118,CHEM 114A,A01,489147,Stallings; Dontarie M,81,0,100,19
1713305879144,CHIN 169A,A00,489171,Wang; Xiao,19,0,20,1
1713305881199,COGS 3,A01,518827,Boyle; Mary E. T.,30,0,40,10
1713305882227,COGS 11,A01,489175,Staff,28,0,30,2
1713305883255,COGS 14A,A01,518829,Staff,53,0,60,7
1713305884281,COGS 14B,A01,489177,Hoffman; Drew Ellen,69,0,75,6
1713305885306,COGS 100,A01,489181,Allen; Michael Gordon,66,0,75,9
1713305886330,COGS 101A,A01,489183,Staff,51,0,60,9
1713305887357,COGS 101B,A01,489185,Allen; Michael Gordon,13,0,30,17
1713305888389,COGS 101C,A01,526786,Staff,25,0,30,5
1713305890437,COGS 107A,A01,489189,Boyle; Mary E. T.,24,0,35,11
1713305891464,COGS 107B,A01,627144,Mooshagian; Eric Frederick,60,0,60,0
1713305892488,COGS 118A,A01,489191,Staff,0,24,40,40
1713305894545,COGS 171GS,A01,489194,Pineda; Jaime A,22,0,28,6
1713305895571,COGS 172,A01,489196,Staff,7,0,30,23
1713305896595,COGS 174GS,A01,489264,Pineda; Jaime A,22,0,28,6
1713305897621,COGS 180,A01,627150,Staff,29,0,30,1
1713305898646,COGS 186,A01,489274,Staff,4,0,30,26
1713305899669,COMM 10,A01,489276,Staff,25,0,25,0
1713305899669,COMM 10,A02,489303,Staff,23,0,25,2
1713305900696,COMM 100A,A01,489312,Staff,21,0,25,4
1713305900696,COMM 100A,A02,489313,Staff,24,0,25,1
1713305901721,COMM 106T,A00,512540,Staff,34,0,35,1
1713305902863,COMM 107,A00,489347,Staff,31,0,35,4
1713305903889,COMM 109P,A00,489358,Staff,31,0,35,4
1713305904915,COMM 132,A00,489361,McKenna; Denise,29,0,30,1
1713305905942,COMM 146,A00,489362,Halm; Gavin Patrick,27,0,30,3
1713305906970,COMM 190,A00,489363,Abuelhiga; Soraya Jill,21,0,23,2
1713305908002,CSE 8A,A50,489366,Staff,23,0,25,2
1713305908002,CSE 8A,A51,489367,Staff,24,0,25,1
1713305909029,CSE 11,A01,489398,Cao; Yingjun,84,0,100,16
1713305910057,CSE 12,A01,489487,Staff,43,0,50,7
1713305911086,CSE 20,A01,489497,Staff,49,0,50,1
1713305912113,CSE 21,A01,489517,Braun; Oliver,44,0,50,6
1713305913143,CSE 101,A01,489524,Braun; Oliver,0,3,50,50
1713305914174,CSE 105,A01,512594,Jones; Miles E,83,0,100,17
1713305914174,CSE 105,B01,512598,Jones; Miles E,71,0,100,29
1713305915205,CSE 140,A01,489538,Staff,44,0,50,6
1713305916232,CSE 141,A01,489550,Eldon; John,76,0,100,24
1713305917264,CSE 141L,A01,489571,Eldon; John,75,0,100,25
1713305918290,CSE 151A,A01,489583,Solares; Edwin A,153,0,200,47
1713305919313,CSE 175,A01,510886,Kumar; Rakesh,30,0,30,0
1713305920342,CSE 190,A00,516828,Dubnov; Shlomo,41,0,49,8
1713305921368,DOC 100D,A00,489667,Pass; Natalye Joann,23,0,25,2
1713305922394,DSC 10,A01,624268,Staff,72,0,75,3
1713305923421,DSC 20,A01,624476,Staff,50,0,50,0
1713305924447,DSC 40A,A01,624608,Staff,40,0,40,0
1713305925471,DSGN 1,A01,489179,Rill; Bryan,37,0,50,13
1713305926502,ECE 17,A01,490489,Sahay; Rajeev,19,0,30,11
1713305927532,ECE 65,A50,490492,Staff,17,0,20,3
1713305927532,ECE 65,A51,490493,Staff,20,0,20,0
1713305928563,ECON 1,A01,489715,Famulari; Melissa,69,0,70,1
1713305929591,ECON 2,A01,489717,Levkoff; Steven B.,68,0,70,2
1713305930623,ECON 3,A01,489948,Staff,70,0,70,0
1713305932685,ECON 5,A01,490103,Staff,28,0,30,2
1713305932685,ECON 5,B01,626281,Dai; Yinlin,45,0,45,0
1713305933710,ECON 100A,A01,490127,Famulari; Melissa,70,0,70,0
1713305934738,ECON 100B,A01,490129,Staff,64,0,70,6
1713305935766,ECON 109,A01,490187,Shishkin; Denis,29,0,35,6
1713305936790,ECON 110A,A01,490190,Levkoff; Steven B.,64,0,70,6
1713305937816,ECON 120A,A01,490245,Dai; Yinlin,69,0,70,1
1713305938848,ECON 120B,A01,490247,Nieto-Barthaburu; Augusto,60,0,70,10
1713305939875,ECON 120C,A01,490253,Sun; Yixiao,32,0,35,3
1713305939875,ECON 120C,B01,490255,Sun; Yixiao,34,0,35,1
1713305940901,ECON 129,A00,490256,Eckert; Fabian Paul,28,0,35,7
1713305941926,ECON 131,A00,490257,Nieto-Barthaburu; Augusto,6,0,35,29
1713305942952,ECON 138,A00,490258,Bharadwaj; Prashant,24,0,35,11
1713305942952,ECON 138,B00,490259,Bharadwaj; Prashant,20,0,35,15
1713305943978,ECON 159,A00,490260,Hendrickson; Gerald M.,0,6,0,0
1713305945013,ECON 178,A01,553995,Zhu; Ying,28,0,35,7
1713305946042,EDS 40,A01,512576,Black; Alison Michelle,20,0,20,0
1713305947067,EDS 107,A01,515848,Staff,30,0,30,0
1713305948091,EDS 110R,A01,490262,Staff,26,0,30,4
1713305949119,EDS 112,A01,490264,Chapman; Thandeka K,45,0,50,5
1713305950144,EDS 113,A00,490266,Staff,28,0,30,2
1713305951170,EDS 118,A00,490267,Warstadt; Melissa Fawn,27,0,30,3
1713305952199,EDS 124BR,A00,490268,Eguchi; Emi,10,0,25,15
1713305952199,EDS 124BR,B00,490269,Eguchi; Emi,25,0,25,0
1713305953225,EDS 126,A01,490271,Jones; Makeba,47,0,50,3
1713305954250,EDS 135,A01,490316,Staff,19,0,20,1
1713305955274,ENVR 142GS,A00,519514,Chang; Edmond Yi-Teh,28,0,28,0
1713305956301,ETHN 103,A00,490504,Staff,33,0,36,3
1713305957326,ETHN 103A,A00,490505,Man; Simeon S,7,0,9,2
1713305958355,ETHN 109,A00,490506,Staff,30,0,30,0
1713305959383,ETHN 118,A00,490507,Staff,35,0,36,1
1713305960465,ETHN 119,A00,490508,Staff,36,0,36,0
1713305961496,ETHN 121R,A00,490518,Choi; Esther Min,30,0,36,6
1713305962520,ETHN 127,A00,490528,Staff,15,0,15,0
1713305963545,ETHN 139,A00,490573,Staff,10,0,10,0
1713305964569,ETHN 150,A00,490575,Staff,15,0,15,0
1713305965600,GLBH 20,A00,491705,Elwardani; Nile Regina,38,0,40,2
1713305966625,GLBH 101,A00,491706,Staff,20,0,20,0
1713305967648,GLBH 111,A01,491708,Burgos; Jose L.,15,0,15,0
1713305968675,GLBH 146,A00,491709,Staff,13,0,20,7
1713305969706,GLBH 148,A00,491710,Olivas Hernandez; Olga Lid,17,0,20,3
1713305970732,GLBH 150,A00,491711,Sloane; Julia Kathryn,20,0,20,0
1713305971757,HIEA 131,A00,491760,Staff,30,0,32,2
1713305972804,HIEA 153,A00,491762,Staff,29,0,30,1
1713305973831,HIEU 124,A00,491811,Staff,27,0,32,5
1713305974857,HIEU 124GS,A00,491812,Markman; Kristina,28,0,28,0
1713305975886,HIEU 147,A00,491813,Staff,30,0,32,2
1713305976911,HIEU 149GS,A00,491816,Caldwell; Michael Alan,28,0,28,0
1713305977943,HILD 2C,A01,491713,Hendrickson; Gerald M.,28,0,30,2
1713305980806,HILD 7B,A01,491715,Kwak; Nancy,17,0,30,13
1713305981831,HILD 10,A01,491717,Staff,15,0,20,5
1713305982860,HILD 30GS,A00,491719,Edington; Claire Ellen,24,0,28,4
1713305983895,HINE 109,A00,491818,Shafir; Nir,30,0,32,2
1713305984919,HINE 128,A00,491821,Shafir; Nir,32,0,32,0
1713305985946,HISC 117,A00,491830,Staff,29,0,32,3
1713305987068,HIUS 103,A00,491834,Man; Simeon S,17,0,23,6
1713305988095,HIUS 108B,A00,491835,Staff,30,0,30,0
1713305989121,HIUS 141,A00,491836,Hendrickson; Gerald M.,29,0,32,3
1713305990147,HIUS 149,A00,491839,Staff,27,0,32,5
1713305991173,HUM 3,A01,512617,Crum; Matthew Stephen,46,0,50,4
1713305991173,HUM 3,A02,512618,Crum; Matthew Stephen,48,0,50,2
1713305992196,HUM 3GS,A00,512663,Markman; Kristina,0,0,0,0
1713305992196,HUM 3GS,B00,512664,Staff,0,0,0,0
1713305993223,HUM 4,A01,512620,West; Geoffrey Scott,38,0,50,12
1713305994254,HUM 4GS,A00,512666,Lyon; Antony J.,0,0,0,3
1713305995281,HUM 4R,A01,512625,Watkins; Eric,49,0,50,1
1713305996307,HUM 5,A01,512649,Zavodny; Tatiana Sophia,34,0,50,16
1713305996307,HUM 5,B01,512661,Zroka; Ryan Edward,49,0,50,1
1713305997334,INTL 190,A00,490577,Segui; Alan S,0,0,0,5
1713305998362,JAPN 20AR,A01,491267,Ross; Kayoko F,12,0,20,8
1713305999387,JAPN 180,A00,491285,Berman; Michael David,34,0,40,6
1713306000419,LATI 50,A01,502536,Kokinis; Troy Andreas,19,0,22,3
1713306000419,LATI 50,A02,502551,Kokinis; Troy Andreas,22,0,22,0
1713306000419,LATI 50,A03,502650,Kokinis; Troy Andreas,22,0,22,0
1713306000419,LATI 50,A04,502909,Kokinis; Troy Andreas,22,0,22,0
1713306001445,LATI 160,A01,502920,Kokinis; Troy Andreas,30,0,30,0
1713306002471,LIFR 1A,A00,490494,Van Moer; Vinciane G,18,0,20,2
1713306003498,LIFR 1AX,A00,490495,Van Moer; Vinciane G,18,0,20,2
1713306004524,LIFR 1B,A00,490496,Van Moer; Vinciane G,20,0,20,0
1713306005556,LIFR 1BX,A00,490497,Van Moer; Vinciane G,20,0,20,0
1713306006583,LIGN 8,A00,505198,McIntosh; Justin Daniel,143,0,150,7
1713306007614,LIGN 9GS,A00,491239,Lott; Margaret S.,18,0,20,2
1713306008640,LIGN 101,A01,505200,McIntosh; Justin Daniel,26,0,30,4
1713306009666,LIGN 120,A01,491244,Staff,26,0,30,4
1713306010691,LIGN 149GS,A00,491245,Lott; Margaret S.,18,0,20,2
1713306011717,LIGN 170,A00,491247,Staff,25,0,30,5
1713306012745,LISP 1D,A00,490498,Munoz Sanchez; Alicia,11,0,14,3
1713306012745,LISP 1D,B00,490499,Munoz Sanchez; Alicia,7,0,14,7
1713306012745,LISP 1D,C00,490500,Munoz Sanchez; Alicia,10,0,14,4
1713306012745,LISP 1D,D00,490501,Munoz Sanchez; Alicia,11,0,14,3
1713306013774,LISP 1DX,A00,490502,Munoz Sanchez; Alicia,19,0,28,9
1713306013774,LISP 1DX,B00,490503,Munoz Sanchez; Alicia,19,0,28,9
1713306015831,LTAM 110,A00,491847,Staff,23,0,25,2
1713306016857,LTCS 119,A00,491848,Staff,13,0,15,2
1713306017888,LTCS 130,A00,491849,Staff,24,0,25,1
1713306019952,LTEA 120C,A00,491852,Staff,35,0,40,5
1713306020982,LTEN 130GS,A00,491853,Lyon; Antony J.,25,0,28,3
1713306022011,LTEN 148,A00,491855,Staff,23,0,25,2
1713306023037,LTEN 159,A00,491856,Staff,21,0,25,4
1713306024065,LTEN 180,A00,491857,Staff,9,0,15,6
1713306026116,LTSP 123GS,A00,505928,Bessett; Ryan Matthew,25,0,28,3
1713306027140,LTSP 174GS,A00,506037,Bessett; Ryan Matthew,25,0,28,3
1713306029191,LTWR 102,A00,491861,Staff,12,0,15,3
1713306030216,LTWR 106,A00,491862,Staff,11,0,15,4
1713306031241,MAE 11,A00,490930,Bahadori; Mohammad Yousef,98,0,100,2
1713306032267,MAE 30A,A00,490931,Qi; Huihui,38,0,40,2
1713306033291,MAE 101A,A00,491036,Sadeghizadeh; Zahra,98,0,100,2
1713306034318,MAE 101C,A00,491037,Seshadri; Kalyanasundaram,78,0,100,22
1713306035343,MAE 113,A00,491040,Seshadri; Kalyanasundaram,67,0,80,13
1713306036368,MAE 131A,A00,491041,Ghazinejad; Maziar,39,0,40,1
1713306037392,MAE 142,A00,491053,Staff,39,0,40,1
1713306038422,MAE 143A,A00,491054,Staff,42,0,50,8
1713306039447,MAE 150,A00,491092,Truong; Phuong Thi Ngoc,24,0,35,11
1713306040472,MATH 3C,A01,494031,Pardo Guerra; Sebastian,30,0,30,0
1713306040472,MATH 3C,A02,494032,Pardo Guerra; Sebastian,29,0,30,1
1713306041503,MATH 10A,A01,494034,Staff,28,0,30,2
1713306041503,MATH 10A,A02,494035,Staff,29,0,30,1
1713306041503,MATH 10A,B01,494037,Staff,28,0,30,2
1713306041503,MATH 10A,B02,494038,Staff,29,0,30,1
1713306042541,MATH 10B,A01,494040,Habib; Yousaf,24,0,30,6
1713306042541,MATH 10B,A02,494041,Habib; Yousaf,28,0,30,2
1713306042541,MATH 10B,A03,494042,Habib; Yousaf,30,0,30,0
1713306042541,MATH 10B,A04,494043,Habib; Yousaf,30,0,30,0
1713306042541,MATH 10B,B01,494045,Habib; Yousaf,28,0,30,2
1713306042541,MATH 10B,B02,494046,Habib; Yousaf,30,0,30,0
1713306042541,MATH 10B,B03,494047,Habib; Yousaf,30,0,30,0
1713306042541,MATH 10B,B04,494048,Habib; Yousaf,30,0,30,0
1713306043573,MATH 18,A01,494050,Kemp; Todd Aahron,27,0,30,3
1713306043573,MATH 18,A02,494051,Kemp; Todd Aahron,29,0,30,1
1713306043573,MATH 18,B01,494054,Kemp; Todd Aahron,28,0,30,2
1713306043573,MATH 18,B02,494055,Kemp; Todd Aahron,29,0,30,1
1713306044599,MATH 20A,A01,494059,Suk; Andrew Hoon,30,0,30,0
1713306045625,MATH 20B,A01,494061,Briones; Jor-el Thomas Caparas,34,0,35,1
1713306045625,MATH 20B,B01,494063,Bach; Quang Tran,34,0,35,1
1713306046660,MATH 20C,A01,494065,Staff,29,0,30,1
1713306046660,MATH 20C,A02,494066,Staff,30,0,30,0
1713306046660,MATH 20C,A03,494067,Staff,30,0,30,0
1713306046660,MATH 20C,A04,494068,Staff,30,0,30,0
1713306046660,MATH 20C,B01,494070,Zhang; Ming,27,0,30,3
1713306046660,MATH 20C,B02,494071,Zhang; Ming,30,0,30,0
1713306046660,MATH 20C,B03,494072,Zhang; Ming,29,0,30,1
1713306046660,MATH 20C,B04,494073,Zhang; Ming,29,0,30,1
1713306047688,MATH 20D,A01,494075,Staff,26,0,30,4
1713306047688,MATH 20D,A02,494076,Staff,30,0,30,0
1713306048721,MATH 20E,A01,494079,Staff,25,0,30,5
1713306048721,MATH 20E,A02,494080,Staff,28,0,30,2
1713306048721,MATH 20E,B01,494082,Staff,28,0,30,2
1713306048721,MATH 20E,B02,494083,Staff,25,0,30,5
1713306049747,MATH 103A,A01,494085,Aliabadi Sr.; Mohsen,20,0,30,10
1713306049747,MATH 103A,A02,494086,Aliabadi Sr.; Mohsen,29,0,30,1
1713306049747,MATH 103A,B01,494088,Aliabadi Sr.; Mohsen,22,0,30,8
1713306049747,MATH 103A,B02,494089,Aliabadi Sr.; Mohsen,28,0,30,2
1713306050773,MATH 109,A01,494091,Staff,30,0,30,0
1713306050773,MATH 109,A02,494092,Staff,30,0,30,0
1713306050773,MATH 109,B01,494094,Staff,28,0,30,2
1713306050773,MATH 109,B02,494095,Staff,29,0,30,1
1713306051800,MATH 142A,A01,494097,Chow; Bennett,16,0,30,14
1713306051800,MATH 142A,A02,494098,Chow; Bennett,24,0,30,6
1713306051800,MATH 142A,B01,494100,Chow; Bennett,21,0,30,9
1713306051800,MATH 142A,B02,494101,Chow; Bennett,29,0,30,1
1713306053857,MATH 168A,A01,516677,Dumitriu; Ioana,17,0,35,18
1713306054887,MATH 170A,A01,516679,Dumitriu; Ioana,21,0,30,9
1713306054887,MATH 170A,A02,516680,Dumitriu; Ioana,28,0,30,2
1713306055915,MATH 193A,A01,494107,Staff,17,0,30,13
1713306055915,MATH 193A,A02,494108,Staff,25,0,30,5
1713306055915,MATH 193A,A03,494109,Staff,29,0,30,1
1713306055915,MATH 193A,A04,494110,Staff,26,0,30,4
1713306058997,MGT 16,A00,491930,McKay; Michael J,94,0,98,4
1713306060028,MGT 18,A00,491992,McKay; Michael J,97,0,98,1
1713306061055,MGT 71,A00,492003,Staff,79,0,98,19
1713306062081,MGT 103,A00,505209,Eberhard; Craig A,87,0,98,11
1713306063106,MGT 131A,A00,505210,Anderson; John Charles,91,0,98,7
1713306065167,MGT 153,A00,492077,Perols; Johan Lars,51,0,90,39
1713306068304,MGT 164,A00,492222,McKay; Mary A,94,0,98,4
1713306069333,MGT 172,A00,492245,Staff,59,0,60,1
1713306069333,MGT 172,B00,505526,Hedges; Kathleen,78,0,98,20
1713306070359,MGT 181,A00,505669,Dunn; Louis Jean,88,0,98,10
1713306071385,MMW 14,A01,494399,Staff,23,0,28,5
1713306071385,MMW 14,A02,494400,Staff,26,0,28,2
1713306071385,MMW 14,A03,494401,Staff,28,0,28,0
1713306071385,MMW 14,A04,494402,Staff,28,0,28,0
1713306071385,MMW 14,B01,494404,Carreras; Maria Victoria,18,0,28,10
1713306071385,MMW 14,B02,494405,Carreras; Maria Victoria,27,0,28,1
1713306071385,MMW 14,B03,494406,Carreras; Maria Victoria,28,0,28,0
1713306071385,MMW 14,B04,494407,Carreras; Maria Victoria,28,0,28,0
1713306072411,MMW 14GS,A00,506250,Chang; Edmond Yi-Teh,0,0,0,0
1713306073437,MMW 121R,A01,494415,Adamiak; Patrick John,16,0,28,12
1713306073437,MMW 121R,A02,494416,Adamiak; Patrick John,25,0,28,3
1713306074469,MUS 1A,A01,494113,Staff,14,0,25,11
1713306074469,MUS 1A,A02,494114,Staff,25,0,25,0
1713306075496,MUS 4,A01,494116,Staff,24,0,25,1
1713306075496,MUS 4,A02,494117,Staff,22,0,25,3
1713306076521,MUS 5R,A01,494236,Dubnov; Shlomo,12,0,25,13
1713306076521,MUS 5R,A02,494237,Dubnov; Shlomo,25,0,25,0
1713306077554,MUS 6,A01,494122,Staff,16,0,25,9
1713306077554,MUS 6,A02,494123,Staff,24,0,25,1
1713306078579,MUS 7,A01,494125,Staff,17,0,25,8
1713306078579,MUS 7,A02,494126,Staff,24,0,25,1
1713306079604,MUS 11,A01,494128,Staff,23,0,25,2
1713306079604,MUS 11,A02,494129,Staff,25,0,25,0
1713306080629,MUS 13,A01,494131,Staff,25,0,25,0
1713306080629,MUS 13,A02,494132,Staff,25,0,25,0
1713306081655,MUS 15,A01,494134,Staff,20,0,25,5
1713306081655,MUS 15,A02,494135,Staff,25,0,25,0
1713306081655,MUS 15,B01,494137,Staff,25,0,25,0
1713306082684,MUS 80,A00,494232,Staff,25,0,25,0
1713306082684,MUS 80,B00,494233,Staff,25,0,25,0
1713306082684,MUS 80,C00,494234,Staff,23,0,25,2
1713306083711,MUS 95C,A00,494141,Staff,73,0,75,2
1713306084735,MUS 114,A00,494142,Staff,42,0,50,8
1713306085765,NANO 15,A01,490636,Drews; Aaron,7,0,7,0
1713306086798,PHIL 1,A00,490578,Grush; Rick Scott,50,0,50,0
1713306087825,PHIL 10,A01,490580,Grush; Rick Scott,34,0,35,1
1713306087825,PHIL 10,A02,490586,Grush; Rick Scott,33,0,35,2
1713306088851,PHIL 27,A01,490591,Staff,24,0,25,1
1713306088851,PHIL 27,A02,490592,Staff,25,0,25,0
1713306088851,PHIL 27,A03,490593,Staff,25,0,25,0
1713306088851,PHIL 27,A04,490598,Staff,25,0,25,0
1713306089911,PHIL 32,A01,490611,Staff,20,0,20,0
1713306089911,PHIL 32,A02,490618,Staff,20,0,20,0
1713306090935,PHIL 90,A00,490624,Staff,40,0,40,0
1713306091961,PHIL 136,A00,490627,Cohen; Jonathan David,38,0,40,2
1713306092986,PHIL 155,A00,490634,Staff,67,0,70,3
1713306094012,PHYS 1A,A00,491610,Staff,246,0,250,4
1713306095037,PHYS 1AL,001,491616,Tsai; Philbert S,28,0,30,2
1713306095037,PHYS 1AL,002,491618,Tsai; Philbert S,30,0,30,0
1713306096066,PHYS 1B,A00,491623,Staff,245,0,250,5
1713306097096,PHYS 1BL,001,491626,Tsai; Philbert S,27,0,30,3
1713306097096,PHYS 1BL,002,491628,Tsai; Philbert S,28,0,30,2
1713306098126,PHYS 1C,A00,491632,Staff,227,0,245,18
1713306099154,PHYS 1CL,001,491635,Tsai; Philbert S,13,0,30,17
1713306099154,PHYS 1CL,002,491643,Tsai; Philbert S,24,0,30,6
1713306100180,PHYS 2AR,A01,491651,Meyertholen; Andrew D.,46,0,50,4
1713306101211,PHYS 2B,A01,491659,Staff,107,0,115,8
1713306102235,PHYS 2BL,A01,491685,Staff,24,0,24,0
1713306102235,PHYS 2BL,A02,491700,Staff,23,0,24,1
1713306103264,PHYS 2C,A01,505161,Staff,108,0,115,7
1713306104291,PHYS 4A,A01,491704,Grinstein; Benjamin,99,0,100,1
1713306105317,POLI 5D,A01,494144,Staff,3,0,5,2
1713306105317,POLI 5D,B01,626283,Dai; Yinlin,5,0,5,0
1713306106342,POLI 12,A00,494145,Staff,44,0,45,1
1713306107367,POLI 13R,A00,494146,Forman; Fonna,47,0,50,3
1713306108396,POLI 27,A01,494148,Staff,59,0,60,1
1713306109425,POLI 30,A00,494149,Staff,49,0,50,1
1713306110454,POLI 100DA,A00,494150,Staff,23,0,25,2
1713306112502,POLI 100I,A00,494152,Staff,29,0,30,1
1713306113528,POLI 104B,A00,494153,Smith; Glenn Chatmas,54,0,55,1
1713306114555,POLI 104F,A00,494154,Staff,29,0,30,1
1713306115582,POLI 104I,A00,494155,Smith; Glenn Chatmas,30,0,30,0
1713306116606,POLI 110C,A00,494156,Ingham; Sean,23,0,25,2
1713306117633,POLI 117R,A00,494157,Forman; Fonna,16,0,20,4
1713306118661,POLI 118,A00,494158,Ingham; Sean,23,0,25,2
1713306119687,POLI 120H,A00,494159,Fisk; David Lee,41,0,45,4
1713306120712,POLI 131CR,A00,494160,Hoston; Germaine,41,0,45,4
1713306121737,POLI 133J,A00,494161,Staff,33,0,35,2
1713306122762,POLI 135,A00,494162,Fisk; David Lee,34,0,35,1
1713306123786,POLI 140A,A00,494164,Staff,22,0,30,8
1713306124810,POLI 142I,A00,494165,Staff,30,0,30,0
1713306125846,POLI 144D,A00,494166,Staff,23,0,25,2
1713306126870,POLI 151,A00,494167,Staff,30,0,30,0
1713306127896,POLI 153,A00,494168,Staff,34,0,35,1
1713306128922,POLI 160AA,A00,494169,Staff,36,0,40,4
1713306129947,POLI 162,A00,494170,Mignozzetti; Umberto,21,0,25,4
1713306130974,POLI 171,A00,494171,Mignozzetti; Umberto,23,0,25,2
1713306131999,PSYC 1,A00,494172,Staff,97,0,100,3
1713306133025,PSYC 2,A00,494173,Moranton; Nirelia Melbina-,45,0,50,5
1713306134053,PSYC 3,A00,494174,Staff,30,0,30,0
1713306135078,PSYC 6,A00,494175,Staff,17,0,20,3
1713306136107,PSYC 60,A01,494177,Staff,42,0,45,3
1713306137131,PSYC 70,A01,505724,Geller; Emma Harlan,42,0,45,3
1713306138157,PSYC 101,A00,494180,Heyman; Gail D.,91,0,100,9
1713306139182,PSYC 105,A00,494181,Geller; Emma Harlan,66,0,90,24
1713306140214,PSYC 106,A00,494182,Dobkins; Karen R.,34,0,45,11
1713306141243,PSYC 108,A00,494183,Adrian; Julia Anna,94,0,100,6
1713306142275,PSYC 114,A01,494185,Winkielman; Piotr,7,0,30,23
1713306143304,PSYC 122,A00,494186,Moranton; Nirelia Melbina-,41,0,50,9
1713306144329,PSYC 124,A00,494187,Chapman; Eddie Nathaniel,73,0,80,7
1713306145354,PSYC 131,A00,494188,Anagnostaras; Stephan,60,0,80,20
1713306146379,PSYC 144,A00,494189,Staff,22,0,50,28
1713306147406,PSYC 154,A00,494190,Lacefield; Katharine I,139,0,180,41
1713306148429,PSYC 162,A00,494191,Wixted; John T,87,0,100,13
1713306149455,PSYC 172,A00,494192,Gorman; Michael R.,38,0,45,7
1713306150532,PSYC 178,A00,494193,Glaser; Dale,41,0,45,4
1713306151558,PSYC 193,A00,505725,Chapman; Eddie Nathaniel,20,0,20,0
1713306152582,RELI 145GS,A00,519817,Rahimi; Babak,19,0,20,1
1713306153608,SE 101A,A01,490862,Chadha; Mayank,24,0,25,1
1713306154638,SE 101C,A01,490924,Krysl; Petr,18,0,20,2
1713306155666,SE 110A,A01,490928,Staff,20,0,20,0
1713306156692,SE 130A,A00,490929,Morrison; Machel Leigh,66,0,70,4
1713306157722,SIO 1,A01,519325,Staff,39,0,40,1
1713306158749,SIO 30,A01,519327,Staff,40,0,40,0
1713306159781,SIO 40,A00,519328,Staff,40,0,40,0
1713306160807,SIO 46GS,A00,519819,Cook; Geoffrey W,19,0,25,6
1713306161832,SIO 109R,A00,494197,Forman; Fonna,8,0,20,12
1713306162863,SIO 121GS,A00,519827,Cook; Geoffrey W,19,0,25,6
1713306163890,SIO 132,A01,519330,Staff,38,0,40,2
1713306164915,SIO 133,A01,519397,Staff,38,0,40,2
1713306165948,SIO 139,A00,519396,Kacev; David,33,0,40,7
1713306166976,SOCI 1,A01,494199,Thorpe; Charles Robert,24,0,30,6
1713306166976,SOCI 1,A02,494200,Thorpe; Charles Robert,30,0,30,0
1713306166976,SOCI 1,A03,494201,Thorpe; Charles Robert,29,0,30,1
1713306166976,SOCI 1,A04,494202,Thorpe; Charles Robert,29,0,30,1
1713306166976,SOCI 1,A05,494203,Thorpe; Charles Robert,29,0,30,1
1713306166976,SOCI 1,A06,494204,Thorpe; Charles Robert,30,0,30,0
1713306166976,SOCI 1,A07,494205,Thorpe; Charles Robert,29,0,30,1
1713306168002,SOCI 60,A01,494207,Staff,36,0,40,4
1713306168002,SOCI 60,A02,494208,Staff,39,0,40,1
1713306169034,SOCI 100,A01,494210,Payne; Christine Anna,28,0,30,2
1713306169034,SOCI 100,A02,494211,Payne; Christine Anna,28,0,30,2
1713306170122,SOCI 109M,A00,494212,Staff,20,0,20,0
1713306171148,SOCI 110,A00,494213,Staff,35,0,40,5
1713306173204,SOCI 118E,A00,494215,Ng; Kwai,38,0,40,2
1713306174233,SOCI 125,A00,494216,Calderon-Zaks; Michael Aar,42,0,45,3
1713306175257,SOCI 126,A01,494218,Jones; Makeba,4,0,5,1
1713306176285,SOCI 131,A00,494219,Thorpe; Charles Robert,30,0,30,0
1713306178338,SOCI 135,A00,494221,Payne; Christine Anna,43,0,50,7
1713306179368,SOCI 136E,A00,626690,Ruiz; Jonathan Joseph,25,0,25,0
1713306180418,SOCI 138GS,A00,494222,Navon; Daniel,24,0,28,4
1713306182470,SOCI 145,A00,494224,Staff,43,0,45,2
1713306183496,SOCI 153,A00,494225,Staff,28,0,30,2
1713306184521,SOCI 160E,A00,494226,Ng; Kwai,34,0,40,6
1713306185550,SOCI 180,A00,494227,Staff,29,0,30,1
1713306186574,SOCI 189GS,A00,494228,Ribas Norris; Janet Vanesa,11,0,11,0
1713306187604,SOCI 190GS,A00,553232,Ribas Norris; Janet Vanesa,11,0,11,0
1713306188633,SOMI 220,A00,627178,Schneid; Stephen David,30,0,30,0
1713306189661,SYN 2,001,490768,Staff,14,0,15,1
1713306189661,SYN 2,002,490769,Staff,15,0,15,0
1713306189661,SYN 2,004,490775,Staff,0,0,0,0
1713306189661,SYN 2,003,490774,Staff,0,0,0,0
1713306189661,SYN 2,005,490776,Staff,0,0,0,0
1713306190691,SYN 2R,001,490779,Staff,14,0,15,1
1713306190691,SYN 2R,002,514635,Staff,14,0,15,1
1713306191716,SYN 100,A01,490783,Staff,17,0,20,3
1713306191716,SYN 100,B01,490787,Staff,12,0,20,8
1713306191716,SYN 100,C01,490789,Staff,15,0,20,5
1713306192743,SYN 150,A00,490817,Staff,14,0,15,1
1713306192743,SYN 150,B00,514610,Staff,15,0,15,0
1713306193771,TDAC 1,A00,492753,Walsh; Kim C.,19,0,20,1
1713306193771,TDAC 1,B00,492754,Harting; Carla Kelso,19,0,20,1
1713306193771,TDAC 1,C00,513995,Salovey; Todd,18,0,20,2
1713306194800,TDAC 101,A00,492766,Harting; Carla Kelso,19,0,20,1
1713306195826,TDAC 102,A00,492768,Basso; Beatrice,20,0,20,0
1713306196855,TDDE 111,A00,492769,Staff,25,0,25,0
1713306197882,TDDE 131,A00,492770,Staff,15,0,15,0
1713306197882,TDDE 131,B00,492771,Staff,15,0,15,0
1713306198908,TDDE 131GS,A00,523716,Guirguis; Mark C,25,0,28,3
1713306199938,TDGE 1,A01,492756,Salovey; Todd,57,0,60,3
1713306200967,TDGE 5,A01,492758,Staff,24,0,25,1
1713306201993,TDGE 10,A00,492759,Fulton; Julia,215,0,220,5
1713306203024,TDGE 11,A00,492760,Castro; Robert Jess,200,0,200,0
1713306204049,TDGE 50,A00,492761,Blair; Kyle Adam,0,0,0,0
1713306205077,TDGE 124,A00,492772,Fulton; Julia,199,0,220,21
1713306206107,TDGE 125,A00,492773,Meyer; Ursula,42,0,50,8
1713306206107,TDGE 125,B00,492774,Staff,50,0,50,0
1713306206107,TDGE 125,C00,523565,Staff,50,0,50,0
1713306207131,TDGE 125GS,A00,523580,Guirguis; Mark C,25,0,28,3
1713306208161,TDGE 127,A00,492775,Havis; Allan,43,0,50,7
1713306209186,TDHT 101,A00,492776,Staff,35,0,35,0
1713306210211,TDMV 1,A00,492762,Caligagan; Maria T.,30,0,30,0
1713306210211,TDMV 1,B00,492763,Arcidiacono; Kristin,26,0,30,4
1713306211241,TDMV 2,A00,492764,Weinberg; Sadie,29,0,30,1
1713306212270,TDMV 3,A00,492765,Mack; Kara Shanai',39,0,40,1
1713306213295,TDMV 138,A00,492777,Mack; Kara Shanai',37,0,40,3
1713306214321,TDMV 140,A00,492778,Lima; Paulo Henrique,40,0,40,0
1713306215350,TDMV 142,A00,492779,Caligagan; Maria T.,37,0,40,3
1713306215350,TDMV 142,B00,492780,Caligagan; Tony,38,0,40,2
1713306216377,TDMV 143,A00,492781,Fyall; Daunte Edward,40,0,40,0
1713306217407,USP 1,A01,492401,Kwak; Nancy,29,0,35,6
1713306218432,USP 2,A01,492453,Hinds; Juli Beth,35,0,35,0
1713306219460,USP 3,A01,492516,Staff,32,0,35,3
1713306220487,USP 4,A00,492522,McTague; Sarah,20,0,25,5
1713306221513,USP 100,A00,492523,Staff,33,0,35,2
1713306222540,USP 101,A00,492524,Staff,13,0,15,2
1713306223565,USP 105,A00,492525,Staff,22,0,25,3
1713306224593,USP 151,A00,492526,Shenkman; Michael Thomas,33,0,35,2
1713306225624,USP 170,A00,492545,Hinds; Juli Beth,33,0,35,2
1713306226649,USP 171GS,A00,492608,Bussell; Mirle Rabinowitz,26,0,28,2
1713306227677,USP 183GS,A00,492613,Peerson; Susan,26,0,28,2
1713306228708,VIS 30,A01,490693,Yoldas; Pinar,21,0,22,1
1713306228708,VIS 30,A02,490694,Yoldas; Pinar,19,0,22,3
1713306229740,VIS 83,A00,490695,Kester; Grant,68,0,75,7
1713306230763,VIS 105D,A00,490696,Staff,22,0,25,3
1713306231789,VIS 124CN,A00,490699,Rose; Jordan M,68,0,75,7
1713306232819,VIS 125GS,A00,511221,Williams; Alena J,21,0,22,1
1713306233843,VIS 128D,A00,490700,Staff,74,0,75,1
1713306234868,VIS 151,A01,490717,Staff,34,0,34,0
1713306234868,VIS 151,A02,490766,Staff,33,0,34,1
1713306235893,VIS 154GS,A00,511972,Williams; Alena J,21,0,22,1
1713306236919,VIS 160A,A00,490767,Stone; Patricia,7,0,10,3
1713306237943,WCWP 10A,A00,490638,Staff,15,0,15,0
1713306237943,WCWP 10A,B00,490640,Staff,15,0,15,0
1713306238968,WCWP 10B,A00,490641,Staff,0,0,0,0
1713306238968,WCWP 10B,B00,490642,Staff,14,0,15,1
1713306238968,WCWP 10B,C00,490644,Staff,14,0,15,1
1713306238968,WCWP 10B,D00,490647,Staff,0,0,0,0
1713306239994,WCWP 100,A00,490655,Staff,0,0,0,0
1713306239994,WCWP 100,B00,490687,Staff,12,0,15,3
1713306242131,ANAR 153,A00,487222,Braswell; Geoffrey E.,55,0,60,5
1713306243159,ANBI 134,A00,487223,Staff,14,0,20,6
1713306244185,ANBI 143GS,A00,487224,Noel; Geoffroy Pierre Jean,20,0,24,4
1713306245214,ANBI 144GS,A00,519548,Noel; Geoffroy Pierre Jean,20,0,24,4
1713306246238,ANSC 101,A00,487225,Staff,19,0,20,1
1713306247263,ANSC 125,A00,487227,Brenner; Suzanne A,39,0,40,1
1713306249314,ANSC 146,A00,487229,Staff,36,0,40,4
1713306250344,ANSC 148,A00,487230,Olivas Hernandez; Olga Lid,39,0,40,1
1713306251371,ANSC 150,A00,504165,Sloane; Julia Kathryn,19,0,20,1
1713306252395,ANSC 180,A00,487232,Staff,13,0,15,2
1713306253422,ANSC 188,A00,627155,Staff,40,0,40,0
1713306254452,ANTH 5,A00,519529,Semendeferi; Ekaterini,15,0,15,0
1713306255477,ANTH 10,A00,487219,Staff,58,0,60,2
1713306256505,ANTH 23,A01,487221,Staff,17,0,20,3
1713306257532,ANTH 102,A00,487233,Wilder; Linnea Lorene,53,0,60,7
1713306258560,ANTH 103,A00,487234,Varma; Saiba,57,0,60,3
1713306259588,ANTH 105,A00,487235,Stewart; Alexander B,57,0,60,3
1713306260614,BENG 100,A01,516685,Taylor Amos; Alyssa C,28,0,30,2
1713306261641,BIBC 102,A01,491316,Flagg; Matthew Paul,58,0,88,30
1713306261641,BIBC 102,A02,491366,Flagg; Matthew Paul,84,0,88,4
1713306262665,BIBC 103,A01,491486,Boumechache; Miyyada,16,0,24,8
1713306262665,BIBC 103,A02,491487,Boumechache; Miyyada,24,0,24,0
1713306263689,BICD 100,A01,516882,Staff,75,0,75,0
1713306263689,BICD 100,A02,516890,Staff,71,0,75,4
1713306264715,BICD 102GS,A00,491488,Lo; Stanley M.,27,0,28,1
1713306265744,BIEB 136GS,A00,516940,Holway; David A. & Shurin; Jonathan,20,0,24,4
1713306266769,BIEB 137GS,A01,517034,Holway; David A. & Shurin; Jonathan,20,0,24,4
1713306267800,BIEB 138GS,A01,491492,Pirino; Giorgia,22,0,28,6
1713306268825,BILD 1,A01,491296,Staff,62,0,63,1
1713306268825,BILD 1,A02,491297,Staff,63,0,63,0
1713306269856,BILD 4,A01,517099,Gonzalez Gamboa; Ivonne,22,0,24,2
1713306269856,BILD 4,A02,517100,Gonzalez Gamboa; Ivonne,24,0,24,0
1713306270885,BILD 60GS,A00,491309,Lo; Stanley M.,27,0,28,1
1713306271910,BIMM 100,A01,517136,Staff,92,0,100,8
1713306272935,BIMM 110,A01,517182,Staff,78,0,100,22
1713306274016,BIMM 120,A01,517228,Pickett; Brooke Elizabeth,40,0,63,23
1713306274016,BIMM 120,A02,517240,Pickett; Brooke Elizabeth,49,0,63,14
1713306275043,BIMM 132GS,A01,491498,Pirino; Giorgia,22,0,28,6
1713306276070,BIMM 143,A01,491589,Bozinovic; Goran,21,0,40,19
1713306277097,BIPN 100,A01,491594,Armour; Jon Christopher,92,0,100,8
1713306278125,BIPN 140,A01,491602,Marino; Marc J,32,0,50,18
1713306280186,CAT 125,A00,515973,Staff,20,0,20,0
1713306281215,CAT 125GS,A00,515974,Rahimi; Babak,19,0,20,1
1713306282243,CAT 125R,A00,515980,Staff,15,0,20,5
1713306282243,CAT 125R,B00,515981,Tosun; Adriana,19,0,20,1
1713306282243,CAT 125R,C00,515987,Hyland; Tina Mae,4,0,20,16
1713306282243,CAT 125R,D00,515988,Bronstein; Phoebe Malan,18,0,20,2
1713306283268,CENG 15,A01,488699,Drews; Aaron,25,0,25,0
1713306284294,CENG 100,A00,505196,Opatkiewicz; Justin Paul,25,0,25,0
1713306285326,CGS 2A,A01,489598,Staff,33,0,35,2
1713306286354,CGS 112,A00,489599,Staff,15,0,15,0
1713306287380,CGS 119,A00,489603,Staff,10,0,10,0
1713306288404,CGS 120,A00,489604,Staff,14,0,15,1
1713306289433,CGS 150,A00,489607,Staff,15,0,15,0
1713306290455,CHEM 6A,A01,488715,Staff,98,0,100,2
1713306291480,CHEM 6B,A01,488719,Piercy; Marc Anthony,100,0,100,0
1713306292514,CHEM 6C,A01,488723,Albizati; Kim F.,94,0,100,6
1713306293551,CHEM 7L,A01,488728,Schurmeier; Kimberly,18,0,24,6
1713306293551,CHEM 7L,A02,488730,Schurmeier; Kimberly,23,0,24,1
1713306293551,CHEM 7L,A03,488734,Schurmeier; Kimberly,24,0,24,0
1713306293551,CHEM 7L,A04,488763,Schurmeier; Kimberly,23,0,24,1
1713306293551,CHEM 7L,B01,488798,Schurmeier; Kimberly,18,0,24,6
1713306293551,CHEM 7L,B02,488801,Schurmeier; Kimberly,24,0,24,0
1713306293551,CHEM 7L,B03,488808,Schurmeier; Kimberly,24,0,24,0
1713306293551,CHEM 7L,B04,488811,Schurmeier; Kimberly,24,0,24,0
1713306294578,CHEM 11,A01,488897,Stallings; Dontarie M,98,0,100,2
1713306295606,CHEM 40A,A01,488913,Albizati; Kim F.,91,0,100,9
1713306296632,CHEM 40B,A01,488920,Weizman; Haim,48,0,50,2
1713306296632,CHEM 40B,A02,488938,Weizman; Haim,47,0,50,3
1713306297660,CHEM 41A,A01,489029,Klosterman; Jeremy K,58,0,60,2
1713306298688,CHEM 41C,A01,500436,Tor; Yitzhak,55,0,60,5
1713306299716,CHEM 43A,A01,500426,Weizman; Haim,6,0,24,18
1713306299716,CHEM 43A,A02,500430,Weizman; Haim,14,0,24,10
1713306299716,CHEM 43A,B01,514041,Klosterman; Jeremy K,18,0,24,6
1713306299716,CHEM 43A,B02,514047,Klosterman; Jeremy K,23,0,24,1
1713306300740,CHEM 108,A01,489140,Jennings; Patricia A.,14,0,24,10
1713306300740,CHEM 108,A02,489142,Jennings; Patricia A.,15,0,24,9
1713306301770,CHEM 114A,A01,489147,Stallings; Dontarie M,81,0,100,19
1713306302804,CHIN 169A,A00,489171,Wang; Xiao,19,0,20,1
1713306304867,COGS 3,A01,518827,Boyle; Mary E. T.,30,0,40,10
1713306305894,COGS 11,A01,489175,Staff,28,0,30,2
1713306306920,COGS 14A,A01,518829,Staff,53,0,60,7
1713306307947,COGS 14B,A01,489177,Hoffman; Drew Ellen,69,0,75,6
1713306308976,COGS 100,A01,489181,Allen; Michael Gordon,66,0,75,9
1713306310003,COGS 101A,A01,489183,Staff,50,0,60,10
1713306311028,COGS 101B,A01,489185,Allen; Michael Gordon,13,0,30,17
1713306312055,COGS 101C,A01,526786,Staff,25,0,30,5
1713306314104,COGS 107A,A01,489189,Boyle; Mary E. T.,24,0,35,11
1713306315135,COGS 107B,A01,627144,Mooshagian; Eric Frederick,60,0,60,0
1713306316163,COGS 118A,A01,489191,Staff,0,26,40,40
1713306318215,COGS 171GS,A01,489194,Pineda; Jaime A,22,0,28,6
1713306319244,COGS 172,A01,489196,Staff,6,0,30,24
1713306320274,COGS 174GS,A01,489264,Pineda; Jaime A,22,0,28,6
1713306321299,COGS 180,A01,627150,Staff,29,0,30,1
1713306322323,COGS 186,A01,489274,Staff,4,0,30,26
1713306323347,COMM 10,A01,489276,Staff,25,0,25,0
1713306323347,COMM 10,A02,489303,Staff,23,0,25,2
1713306324373,COMM 100A,A01,489312,Staff,21,0,25,4
1713306324373,COMM 100A,A02,489313,Staff,24,0,25,1
1713306325402,COMM 106T,A00,512540,Staff,34,0,35,1
1713306326426,COMM 107,A00,489347,Staff,31,0,35,4
1713306327451,COMM 109P,A00,489358,Staff,31,0,35,4
1713306328482,COMM 132,A00,489361,McKenna; Denise,29,0,30,1
1713306329506,COMM 146,A00,489362,Halm; Gavin Patrick,27,0,30,3
1713306330530,COMM 190,A00,489363,Abuelhiga; Soraya Jill,21,0,23,2
1713306331556,CSE 8A,A50,489366,Staff,23,0,25,2
1713306331556,CSE 8A,A51,489367,Staff,24,0,25,1
1713306332587,CSE 11,A01,489398,Cao; Yingjun,84,0,100,16
1713306333619,CSE 12,A01,489487,Staff,43,0,50,7
1713306334645,CSE 20,A01,489497,Staff,49,0,50,1
1713306335676,CSE 21,A01,489517,Braun; Oliver,44,0,50,6
1713306336704,CSE 101,A01,489524,Braun; Oliver,0,3,50,50
1713306337730,CSE 105,A01,512594,Jones; Miles E,82,0,100,18
1713306337730,CSE 105,B01,512598,Jones; Miles E,71,0,100,29
1713306338757,CSE 140,A01,489538,Staff,44,0,50,6
1713306339783,CSE 141,A01,489550,Eldon; John,76,0,100,24
1713306340812,CSE 141L,A01,489571,Eldon; John,75,0,100,25
1713306341839,CSE 151A,A01,489583,Solares; Edwin A,153,0,200,47
1713306342866,CSE 175,A01,510886,Kumar; Rakesh,30,0,30,0
1713306343892,CSE 190,A00,516828,Dubnov; Shlomo,41,0,49,8
1713306344917,DOC 100D,A00,489667,Pass; Natalye Joann,23,0,25,2
1713306345946,DSC 10,A01,624268,Staff,72,0,75,3
1713306346971,DSC 20,A01,624476,Staff,50,0,50,0
1713306347999,DSC 40A,A01,624608,Staff,40,0,40,0
1713306349024,DSGN 1,A01,489179,Rill; Bryan,37,0,50,13
1713306350050,ECE 17,A01,490489,Sahay; Rajeev,19,0,30,11
1713306351078,ECE 65,A50,490492,Staff,17,0,20,3
1713306351078,ECE 65,A51,490493,Staff,20,0,20,0
1713306352104,ECON 1,A01,489715,Famulari; Melissa,69,0,70,1
1713306353133,ECON 2,A01,489717,Levkoff; Steven B.,68,0,70,2
1713306354162,ECON 3,A01,489948,Staff,70,0,70,0
1713306356216,ECON 5,A01,490103,Staff,28,0,30,2
1713306356216,ECON 5,B01,626281,Dai; Yinlin,45,0,45,0
1713306357241,ECON 100A,A01,490127,Famulari; Melissa,70,0,70,0
1713306358270,ECON 100B,A01,490129,Staff,64,0,70,6
1713306359296,ECON 109,A01,490187,Shishkin; Denis,28,0,35,7
1713306360325,ECON 110A,A01,490190,Levkoff; Steven B.,64,0,70,6
1713306361351,ECON 120A,A01,490245,Dai; Yinlin,69,0,70,1
1713306362382,ECON 120B,A01,490247,Nieto-Barthaburu; Augusto,60,0,70,10
1713306363413,ECON 120C,A01,490253,Sun; Yixiao,32,0,35,3
1713306363413,ECON 120C,B01,490255,Sun; Yixiao,34,0,35,1
1713306364437,ECON 129,A00,490256,Eckert; Fabian Paul,28,0,35,7
1713306365467,ECON 131,A00,490257,Nieto-Barthaburu; Augusto,6,0,35,29
1713306366496,ECON 138,A00,490258,Bharadwaj; Prashant,24,0,35,11
1713306366496,ECON 138,B00,490259,Bharadwaj; Prashant,20,0,35,15
1713306367523,ECON 159,A00,490260,Hendrickson; Gerald M.,0,6,0,0
1713306368547,ECON 178,A01,553995,Zhu; Ying,27,0,35,8
1713306369575,EDS 40,A01,512576,Black; Alison Michelle,20,0,20,0
1713306370601,EDS 107,A01,515848,Staff,30,0,30,0
1713306371631,EDS 110R,A01,490262,Staff,26,0,30,4
1713306372655,EDS 112,A01,490264,Chapman; Thandeka K,45,0,50,5
1713306373682,EDS 113,A00,490266,Staff,28,0,30,2
1713306374707,EDS 118,A00,490267,Warstadt; Melissa Fawn,27,0,30,3
1713306375737,EDS 124BR,A00,490268,Eguchi; Emi,10,0,25,15
1713306375737,EDS 124BR,B00,490269,Eguchi; Emi,25,0,25,0
1713306376762,EDS 126,A01,490271,Jones; Makeba,46,0,50,4
1713306377841,EDS 135,A01,490316,Staff,19,0,20,1
1713306378870,ENVR 142GS,A00,519514,Chang; Edmond Yi-Teh,28,0,28,0
1713306379894,ETHN 103,A00,490504,Staff,33,0,36,3
1713306380926,ETHN 103A,A00,490505,Man; Simeon S,7,0,9,2
1713306381957,ETHN 109,A00,490506,Staff,30,0,30,0
1713306382981,ETHN 118,A00,490507,Staff,35,0,36,1
1713306384006,ETHN 119,A00,490508,Staff,36,0,36,0
1713306385031,ETHN 121R,A00,490518,Choi; Esther Min,30,0,36,6
1713306386059,ETHN 127,A00,490528,Staff,15,0,15,0
1713306387085,ETHN 139,A00,490573,Staff,10,0,10,0
1713306388110,ETHN 150,A00,490575,Staff,15,0,15,0
1713306389136,GLBH 20,A00,491705,Elwardani; Nile Regina,38,0,40,2
1713306390161,GLBH 101,A00,491706,Staff,20,0,20,0
1713306391187,GLBH 111,A01,491708,Burgos; Jose L.,15,0,15,0
1713306392212,GLBH 146,A00,491709,Staff,13,0,20,7
1713306393240,GLBH 148,A00,491710,Olivas Hernandez; Olga Lid,17,0,20,3
1713306394268,GLBH 150,A00,491711,Sloane; Julia Kathryn,20,0,20,0
1713306395293,HIEA 131,A00,491760,Staff,30,0,32,2
1713306396320,HIEA 153,A00,491762,Staff,29,0,30,1
1713306397343,HIEU 124,A00,491811,Staff,26,0,32,6
1713306398372,HIEU 124GS,A00,491812,Markman; Kristina,28,0,28,0
1713306399400,HIEU 147,A00,491813,Staff,30,0,32,2
1713306400426,HIEU 149GS,A00,491816,Caldwell; Michael Alan,28,0,28,0
1713306401452,HILD 2C,A01,491713,Hendrickson; Gerald M.,28,0,30,2
1713306402476,HILD 7B,A01,491715,Kwak; Nancy,17,0,30,13
1713306403503,HILD 10,A01,491717,Staff,14,0,20,6
1713306404530,HILD 30GS,A00,491719,Edington; Claire Ellen,24,0,28,4
1713306405556,HINE 109,A00,491818,Shafir; Nir,30,0,32,2
1713306406581,HINE 128,A00,491821,Shafir; Nir,32,0,32,0
1713306407605,HISC 117,A00,491830,Staff,29,0,32,3
1713306408634,HIUS 103,A00,491834,Man; Simeon S,17,0,23,6
1713306409662,HIUS 108B,A00,491835,Staff,30,0,30,0
1713306410693,HIUS 141,A00,491836,Hendrickson; Gerald M.,29,0,32,3
1713306411722,HIUS 149,A00,491839,Staff,27,0,32,5
1713306412757,HUM 3,A01,512617,Crum; Matthew Stephen,46,0,50,4
1713306412757,HUM 3,A02,512618,Crum; Matthew Stephen,48,0,50,2
1713306413792,HUM 3GS,A00,512663,Markman; Kristina,0,0,0,0
1713306413792,HUM 3GS,B00,512664,Staff,0,0,0,0
1713306414822,HUM 4,A01,512620,West; Geoffrey Scott,38,0,50,12
1713306415848,HUM 4GS,A00,512666,Lyon; Antony J.,0,0,0,3
1713306416871,HUM 4R,A01,512625,Watkins; Eric,49,0,50,1
1713306417897,HUM 5,A01,512649,Zavodny; Tatiana Sophia,34,0,50,16
1713306417897,HUM 5,B01,512661,Zroka; Ryan Edward,49,0,50,1
1713306418925,INTL 190,A00,490577,Segui; Alan S,0,0,0,5
1713306419952,JAPN 20AR,A01,491267,Ross; Kayoko F,12,0,20,8
1713306420980,JAPN 180,A00,491285,Berman; Michael David,34,0,40,6
1713306422013,LATI 50,A01,502536,Kokinis; Troy Andreas,19,0,22,3
1713306422013,LATI 50,A02,502551,Kokinis; Troy Andreas,22,0,22,0
1713306422013,LATI 50,A03,502650,Kokinis; Troy Andreas,22,0,22,0
1713306422013,LATI 50,A04,502909,Kokinis; Troy Andreas,22,0,22,0
1713306423042,LATI 160,A01,502920,Kokinis; Troy Andreas,30,0,30,0
1713306424071,LIFR 1A,A00,490494,Van Moer; Vinciane G,18,0,20,2
1713306425094,LIFR 1AX,A00,490495,Van Moer; Vinciane G,18,0,20,2
1713306426120,LIFR 1B,A00,490496,Van Moer; Vinciane G,20,0,20,0
1713306427149,LIFR 1BX,A00,490497,Van Moer; Vinciane G,20,0,20,0
1713306428177,LIGN 8,A00,505198,McIntosh; Justin Daniel,143,0,150,7
1713306429206,LIGN 9GS,A00,491239,Lott; Margaret S.,18,0,20,2
1713306430235,LIGN 101,A01,505200,McIntosh; Justin Daniel,26,0,30,4
1713306431260,LIGN 120,A01,491244,Staff,26,0,30,4
1713306432286,LIGN 149GS,A00,491245,Lott; Margaret S.,18,0,20,2
1713306433312,LIGN 170,A00,491247,Staff,25,0,30,5
1713306434337,LISP 1D,A00,490498,Munoz Sanchez; Alicia,11,0,14,3
1713306434337,LISP 1D,B00,490499,Munoz Sanchez; Alicia,6,0,14,8
1713306434337,LISP 1D,C00,490500,Munoz Sanchez; Alicia,10,0,14,4
1713306434337,LISP 1D,D00,490501,Munoz Sanchez; Alicia,11,0,14,3
1713306435366,LISP 1DX,A00,490502,Munoz Sanchez; Alicia,18,0,28,10
1713306435366,LISP 1DX,B00,490503,Munoz Sanchez; Alicia,19,0,28,9
1713306437428,LTAM 110,A00,491847,Staff,23,0,25,2
1713306438452,LTCS 119,A00,491848,Staff,13,0,15,2
1713306439479,LTCS 130,A00,491849,Staff,24,0,25,1
1713306441532,LTEA 120C,A00,491852,Staff,35,0,40,5
1713306442557,LTEN 130GS,A00,491853,Lyon; Antony J.,25,0,28,3
1713306443585,LTEN 148,A00,491855,Staff,23,0,25,2
1713306444609,LTEN 159,A00,491856,Staff,21,0,25,4
1713306445632,LTEN 180,A00,491857,Staff,9,0,15,6
1713306447684,LTSP 123GS,A00,505928,Bessett; Ryan Matthew,25,0,28,3
1713306448711,LTSP 174GS,A00,506037,Bessett; Ryan Matthew,25,0,28,3
1713306450760,LTWR 102,A00,491861,Staff,12,0,15,3
1713306451789,LTWR 106,A00,491862,Staff,10,0,15,5
1713306452820,MAE 11,A00,490930,Bahadori; Mohammad Yousef,98,0,100,2
1713306453845,MAE 30A,A00,490931,Qi; Huihui,38,0,40,2
1713306454871,MAE 101A,A00,491036,Sadeghizadeh; Zahra,98,0,100,2
1713306455900,MAE 101C,A00,491037,Seshadri; Kalyanasundaram,78,0,100,22
1713306456925,MAE 113,A00,491040,Seshadri; Kalyanasundaram,67,0,80,13
1713306457950,MAE 131A,A00,491041,Ghazinejad; Maziar,39,0,40,1
1713306458975,MAE 142,A00,491053,Staff,39,0,40,1
1713306460002,MAE 143A,A00,491054,Staff,42,0,50,8
1713306461028,MAE 150,A00,491092,Truong; Phuong Thi Ngoc,24,0,35,11
1713306462058,MATH 3C,A01,494031,Pardo Guerra; Sebastian,30,0,30,0
1713306462058,MATH 3C,A02,494032,Pardo Guerra; Sebastian,29,0,30,1
1713306463085,MATH 10A,A01,494034,Staff,28,0,30,2
1713306463085,MATH 10A,A02,494035,Staff,29,0,30,1
1713306463085,MATH 10A,B01,494037,Staff,28,0,30,2
1713306463085,MATH 10A,B02,494038,Staff,29,0,30,1
1713306464113,MATH 10B,A01,494040,Habib; Yousaf,24,0,30,6
1713306464113,MATH 10B,A02,494041,Habib; Yousaf,28,0,30,2
1713306464113,MATH 10B,A03,494042,Habib; Yousaf,30,0,30,0
1713306464113,MATH 10B,A04,494043,Habib; Yousaf,30,0,30,0
1713306464113,MATH 10B,B01,494045,Habib; Yousaf,28,0,30,2
1713306464113,MATH 10B,B02,494046,Habib; Yousaf,30,0,30,0
1713306464113,MATH 10B,B03,494047,Habib; Yousaf,30,0,30,0
1713306464113,MATH 10B,B04,494048,Habib; Yousaf,30,0,30,0
1713306465139,MATH 18,A01,494050,Kemp; Todd Aahron,27,0,30,3
1713306465139,MATH 18,A02,494051,Kemp; Todd Aahron,29,0,30,1
1713306465139,MATH 18,B01,494054,Kemp; Todd Aahron,28,0,30,2
1713306465139,MATH 18,B02,494055,Kemp; Todd Aahron,29,0,30,1
1713306466166,MATH 20A,A01,494059,Suk; Andrew Hoon,30,0,30,0
1713306467193,MATH 20B,A01,494061,Briones; Jor-el Thomas Caparas,34,0,35,1
1713306467193,MATH 20B,B01,494063,Bach; Quang Tran,34,0,35,1
1713306468230,MATH 20C,A01,494065,Staff,29,0,30,1
1713306468230,MATH 20C,A02,494066,Staff,30,0,30,0
1713306468230,MATH 20C,A03,494067,Staff,30,0,30,0
1713306468230,MATH 20C,A04,494068,Staff,30,0,30,0
1713306468230,MATH 20C,B01,494070,Zhang; Ming,27,0,30,3
1713306468230,MATH 20C,B02,494071,Zhang; Ming,30,0,30,0
1713306468230,MATH 20C,B03,494072,Zhang; Ming,29,0,30,1
1713306468230,MATH 20C,B04,494073,Zhang; Ming,28,0,30,2
1713306469255,MATH 20D,A01,494075,Staff,26,0,30,4
1713306469255,MATH 20D,A02,494076,Staff,30,0,30,0
1713306470283,MATH 20E,A01,494079,Staff,25,0,30,5
1713306470283,MATH 20E,A02,494080,Staff,28,0,30,2
1713306470283,MATH 20E,B01,494082,Staff,28,0,30,2
1713306470283,MATH 20E,B02,494083,Staff,25,0,30,5
1713306471309,MATH 103A,A01,494085,Aliabadi Sr.; Mohsen,20,0,30,10
1713306471309,MATH 103A,A02,494086,Aliabadi Sr.; Mohsen,29,0,30,1
1713306471309,MATH 103A,B01,494088,Aliabadi Sr.; Mohsen,22,0,30,8
1713306471309,MATH 103A,B02,494089,Aliabadi Sr.; Mohsen,28,0,30,2
1713306472335,MATH 109,A01,494091,Staff,30,0,30,0
1713306472335,MATH 109,A02,494092,Staff,30,0,30,0
1713306472335,MATH 109,B01,494094,Staff,28,0,30,2
1713306472335,MATH 109,B02,494095,Staff,29,0,30,1
1713306473363,MATH 142A,A01,494097,Chow; Bennett,16,0,30,14
1713306473363,MATH 142A,A02,494098,Chow; Bennett,24,0,30,6
1713306473363,MATH 142A,B01,494100,Chow; Bennett,21,0,30,9
1713306473363,MATH 142A,B02,494101,Chow; Bennett,29,0,30,1
1713306475414,MATH 168A,A01,516677,Dumitriu; Ioana,17,0,35,18
1713306476443,MATH 170A,A01,516679,Dumitriu; Ioana,21,0,30,9
1713306476443,MATH 170A,A02,516680,Dumitriu; Ioana,28,0,30,2
1713306477468,MATH 193A,A01,494107,Staff,17,0,30,13
1713306477468,MATH 193A,A02,494108,Staff,25,0,30,5
1713306477468,MATH 193A,A03,494109,Staff,29,0,30,1
1713306477468,MATH 193A,A04,494110,Staff,26,0,30,4
1713306480549,MGT 16,A00,491930,McKay; Michael J,94,0,98,4
1713306481632,MGT 18,A00,491992,McKay; Michael J,97,0,98,1
1713306482660,MGT 71,A00,492003,Staff,79,0,98,19
1713306483685,MGT 103,A00,505209,Eberhard; Craig A,87,0,98,11
1713306484709,MGT 131A,A00,505210,Anderson; John Charles,91,0,98,7
1713306486763,MGT 153,A00,492077,Perols; Johan Lars,50,0,90,40
1713306489842,MGT 164,A00,492222,McKay; Mary A,94,0,98,4
1713306490874,MGT 172,A00,492245,Staff,59,0,60,1
1713306490874,MGT 172,B00,505526,Hedges; Kathleen,78,0,98,20
1713306491899,MGT 181,A00,505669,Dunn; Louis Jean,88,0,98,10
1713306492940,MMW 14,A01,494399,Staff,23,0,28,5
1713306492940,MMW 14,A02,494400,Staff,26,0,28,2
1713306492940,MMW 14,A03,494401,Staff,28,0,28,0
1713306492940,MMW 14,A04,494402,Staff,28,0,28,0
1713306492940,MMW 14,B01,494404,Carreras; Maria Victoria,18,0,28,10
1713306492940,MMW 14,B02,494405,Carreras; Maria Victoria,27,0,28,1
1713306492940,MMW 14,B03,494406,Carreras; Maria Victoria,28,0,28,0
1713306492940,MMW 14,B04,494407,Carreras; Maria Victoria,28,0,28,0
1713306493980,MMW 14GS,A00,506250,Chang; Edmond Yi-Teh,0,0,0,0
1713306495005,MMW 121R,A01,494415,Adamiak; Patrick John,15,0,28,13
1713306495005,MMW 121R,A02,494416,Adamiak; Patrick John,25,0,28,3
1713306496040,MUS 1A,A01,494113,Staff,13,0,25,12
1713306496040,MUS 1A,A02,494114,Staff,25,0,25,0
1713306497067,MUS 4,A01,494116,Staff,24,0,25,1
1713306497067,MUS 4,A02,494117,Staff,22,0,25,3
1713306498097,MUS 5R,A01,494236,Dubnov; Shlomo,12,0,25,13
1713306498097,MUS 5R,A02,494237,Dubnov; Shlomo,25,0,25,0
1713306499123,MUS 6,A01,494122,Staff,16,0,25,9
1713306499123,MUS 6,A02,494123,Staff,24,0,25,1
1713306500150,MUS 7,A01,494125,Staff,17,0,25,8
1713306500150,MUS 7,A02,494126,Staff,24,0,25,1
1713306501177,MUS 11,A01,494128,Staff,23,0,25,2
1713306501177,MUS 11,A02,494129,Staff,25,0,25,0
1713306502247,MUS 13,A01,494131,Staff,25,0,25,0
1713306502247,MUS 13,A02,494132,Staff,25,0,25,0
1713306503274,MUS 15,A01,494134,Staff,20,0,25,5
1713306503274,MUS 15,A02,494135,Staff,25,0,25,0
1713306503274,MUS 15,B01,494137,Staff,25,0,25,0
1713306504304,MUS 80,A00,494232,Staff,25,0,25,0
1713306504304,MUS 80,B00,494233,Staff,25,0,25,0
1713306504304,MUS 80,C00,494234,Staff,23,0,25,2
1713306505328,MUS 95C,A00,494141,Staff,73,0,75,2
1713306506355,MUS 114,A00,494142,Staff,42,0,50,8
1713306507385,NANO 15,A01,490636,Drews; Aaron,7,0,7,0
1713306508412,PHIL 1,A00,490578,Grush; Rick Scott,50,0,50,0
1713306509438,PHIL 10,A01,490580,Grush; Rick Scott,34,0,35,1
1713306509438,PHIL 10,A02,490586,Grush; Rick Scott,33,0,35,2
1713306510465,PHIL 27,A01,490591,Staff,24,0,25,1
1713306510465,PHIL 27,A02,490592,Staff,25,0,25,0
1713306510465,PHIL 27,A03,490593,Staff,25,0,25,0
1713306510465,PHIL 27,A04,490598,Staff,25,0,25,0
1713306511494,PHIL 32,A01,490611,Staff,20,0,20,0
1713306511494,PHIL 32,A02,490618,Staff,20,0,20,0
1713306512518,PHIL 90,A00,490624,Staff,40,0,40,0
1713306513544,PHIL 136,A00,490627,Cohen; Jonathan David,38,0,40,2
1713306514572,PHIL 155,A00,490634,Staff,67,0,70,3
1713306515596,PHYS 1A,A00,491610,Staff,246,0,250,4
1713306516620,PHYS 1AL,001,491616,Tsai; Philbert S,28,0,30,2
1713306516620,PHYS 1AL,002,491618,Tsai; Philbert S,30,0,30,0
1713306517650,PHYS 1B,A00,491623,Staff,244,0,250,6
1713306518676,PHYS 1BL,001,491626,Tsai; Philbert S,26,0,30,4
1713306518676,PHYS 1BL,002,491628,Tsai; Philbert S,28,0,30,2
1713306519701,PHYS 1C,A00,491632,Staff,227,0,245,18
1713306520732,PHYS 1CL,001,491635,Tsai; Philbert S,13,0,30,17
1713306520732,PHYS 1CL,002,491643,Tsai; Philbert S,24,0,30,6
1713306521755,PHYS 2AR,A01,491651,Meyertholen; Andrew D.,46,0,50,4
1713306522780,PHYS 2B,A01,491659,Staff,107,0,115,8
1713306523809,PHYS 2BL,A01,491685,Staff,24,0,24,0
1713306523809,PHYS 2BL,A02,491700,Staff,23,0,24,1
1713306524836,PHYS 2C,A01,505161,Staff,107,0,115,8
1713306525862,PHYS 4A,A01,491704,Grinstein; Benjamin,99,0,100,1
1713306526891,POLI 5D,A01,494144,Staff,3,0,5,2
1713306526891,POLI 5D,B01,626283,Dai; Yinlin,5,0,5,0
1713306527921,POLI 12,A00,494145,Staff,44,0,45,1
1713306528951,POLI 13R,A00,494146,Forman; Fonna,47,0,50,3
1713306529976,POLI 27,A01,494148,Staff,59,0,60,1
1713306531002,POLI 30,A00,494149,Staff,49,0,50,1
1713306532027,POLI 100DA,A00,494150,Staff,22,0,25,3
1713306534079,POLI 100I,A00,494152,Staff,29,0,30,1
1713306535111,POLI 104B,A00,494153,Smith; Glenn Chatmas,54,0,55,1
1713306536135,POLI 104F,A00,494154,Staff,28,0,30,2
1713306537164,POLI 104I,A00,494155,Smith; Glenn Chatmas,30,0,30,0
1713306538191,POLI 110C,A00,494156,Ingham; Sean,23,0,25,2
1713306539216,POLI 117R,A00,494157,Forman; Fonna,16,0,20,4
1713306540243,POLI 118,A00,494158,Ingham; Sean,23,0,25,2
1713306541270,POLI 120H,A00,494159,Fisk; David Lee,41,0,45,4
1713306542295,POLI 131CR,A00,494160,Hoston; Germaine,40,0,45,5
1713306543320,POLI 133J,A00,494161,Staff,33,0,35,2
1713306544346,POLI 135,A00,494162,Fisk; David Lee,34,0,35,1
1713306545374,POLI 140A,A00,494164,Staff,22,0,30,8
1713306546399,POLI 142I,A00,494165,Staff,30,0,30,0
1713306547424,POLI 144D,A00,494166,Staff,23,0,25,2
1713306548450,POLI 151,A00,494167,Staff,30,0,30,0
1713306549475,POLI 153,A00,494168,Staff,33,0,35,2
1713306550503,POLI 160AA,A00,494169,Staff,36,0,40,4
1713306551529,POLI 162,A00,494170,Mignozzetti; Umberto,21,0,25,4
1713306552556,POLI 171,A00,494171,Mignozzetti; Umberto,23,0,25,2
1713306553581,PSYC 1,A00,494172,Staff,97,0,100,3
1713306554607,PSYC 2,A00,494173,Moranton; Nirelia Melbina-,45,0,50,5
1713306555633,PSYC 3,A00,494174,Staff,30,0,30,0
1713306556659,PSYC 6,A00,494175,Staff,17,0,20,3
1713306557685,PSYC 60,A01,494177,Staff,42,0,45,3
1713306558713,PSYC 70,A01,505724,Geller; Emma Harlan,42,0,45,3
1713306559738,PSYC 101,A00,494180,Heyman; Gail D.,90,0,100,10
1713306560765,PSYC 105,A00,494181,Geller; Emma Harlan,66,0,90,24
1713306561793,PSYC 106,A00,494182,Dobkins; Karen R.,34,0,45,11
1713306562818,PSYC 108,A00,494183,Adrian; Julia Anna,94,0,100,6
1713306563848,PSYC 114,A01,494185,Winkielman; Piotr,7,0,30,23
1713306564873,PSYC 122,A00,494186,Moranton; Nirelia Melbina-,40,0,50,10
1713306566047,PSYC 124,A00,494187,Chapman; Eddie Nathaniel,73,0,80,7
1713306567074,PSYC 131,A00,494188,Anagnostaras; Stephan,59,0,80,21
1713306568101,PSYC 144,A00,494189,Staff,22,0,50,28
1713306569128,PSYC 154,A00,494190,Lacefield; Katharine I,138,0,180,42
1713306570158,PSYC 162,A00,494191,Wixted; John T,87,0,100,13
1713306571185,PSYC 172,A00,494192,Gorman; Michael R.,38,0,45,7
1713306572216,PSYC 178,A00,494193,Glaser; Dale,41,0,45,4
1713306573240,PSYC 193,A00,505725,Chapman; Eddie Nathaniel,20,0,20,0
1713306574265,RELI 145GS,A00,519817,Rahimi; Babak,19,0,20,1
1713306575292,SE 101A,A01,490862,Chadha; Mayank,24,0,25,1
1713306576321,SE 101C,A01,490924,Krysl; Petr,18,0,20,2
1713306577345,SE 110A,A01,490928,Staff,20,0,20,0
1713306578372,SE 130A,A00,490929,Morrison; Machel Leigh,65,0,70,5
1713306579396,SIO 1,A01,519325,Staff,39,0,40,1
1713306580421,SIO 30,A01,519327,Staff,40,0,40,0
1713306581447,SIO 40,A00,519328,Staff,40,0,40,0
1713306582474,SIO 46GS,A00,519819,Cook; Geoffrey W,18,0,25,7
1713306583500,SIO 109R,A00,494197,Forman; Fonna,8,0,20,12
1713306584528,SIO 121GS,A00,519827,Cook; Geoffrey W,18,0,25,7
1713306585609,SIO 132,A01,519330,Staff,38,0,40,2
1713306586635,SIO 133,A01,519397,Staff,38,0,40,2
1713306587666,SIO 139,A00,519396,Kacev; David,33,0,40,7
1713306588693,SOCI 1,A01,494199,Thorpe; Charles Robert,24,0,30,6
1713306588693,SOCI 1,A02,494200,Thorpe; Charles Robert,30,0,30,0
1713306588693,SOCI 1,A03,494201,Thorpe; Charles Robert,29,0,30,1
1713306588693,SOCI 1,A04,494202,Thorpe; Charles Robert,29,0,30,1
1713306588693,SOCI 1,A05,494203,Thorpe; Charles Robert,29,0,30,1
1713306588693,SOCI 1,A06,494204,Thorpe; Charles Robert,30,0,30,0
1713306588693,SOCI 1,A07,494205,Thorpe; Charles Robert,29,0,30,1
1713306589764,SOCI 60,A01,494207,Staff,36,0,40,4
1713306589764,SOCI 60,A02,494208,Staff,39,0,40,1
1713306590799,SOCI 100,A01,494210,Payne; Christine Anna,28,0,30,2
1713306590799,SOCI 100,A02,494211,Payne; Christine Anna,28,0,30,2
1713306591825,SOCI 109M,A00,494212,Staff,20,0,20,0
1713306592853,SOCI 110,A00,494213,Staff,35,0,40,5
1713306594909,SOCI 118E,A00,494215,Ng; Kwai,38,0,40,2
1713306595935,SOCI 125,A00,494216,Calderon-Zaks; Michael Aar,42,0,45,3
1713306596961,SOCI 126,A01,494218,Jones; Makeba,4,0,5,1
1713306597987,SOCI 131,A00,494219,Thorpe; Charles Robert,30,0,30,0
1713306600041,SOCI 135,A00,494221,Payne; Christine Anna,43,0,50,7
1713306601072,SOCI 136E,A00,626690,Ruiz; Jonathan Joseph,25,0,25,0
1713306602095,SOCI 138GS,A00,494222,Navon; Daniel,24,0,28,4
1713306604150,SOCI 145,A00,494224,Staff,43,0,45,2
1713306605176,SOCI 153,A00,494225,Staff,28,0,30,2
1713306606203,SOCI 160E,A00,494226,Ng; Kwai,34,0,40,6
1713306607429,SOCI 180,A00,494227,Staff,29,0,30,1
1713306608457,SOCI 189GS,A00,494228,Ribas Norris; Janet Vanesa,11,0,11,0
1713306609485,SOCI 190GS,A00,553232,Ribas Norris; Janet Vanesa,11,0,11,0
1713306610510,SOMI 220,A00,627178,Schneid; Stephen David,30,0,30,0
1713306611537,SYN 2,001,490768,Staff,14,0,15,1
1713306611537,SYN 2,002,490769,Staff,15,0,15,0
1713306611537,SYN 2,004,490775,Staff,0,0,0,0
1713306611537,SYN 2,003,490774,Staff,0,0,0,0
1713306611537,SYN 2,005,490776,Staff,0,0,0,0
1713306612568,SYN 2R,001,490779,Staff,14,0,15,1
1713306612568,SYN 2R,002,514635,Staff,14,0,15,1
1713306613595,SYN 100,A01,490783,Staff,17,0,20,3
1713306613595,SYN 100,B01,490787,Staff,12,0,20,8
1713306613595,SYN 100,C01,490789,Staff,15,0,20,5
1713306614619,SYN 150,A00,490817,Staff,14,0,15,1
1713306614619,SYN 150,B00,514610,Staff,15,0,15,0
1713306615652,TDAC 1,A00,492753,Walsh; Kim C.,19,0,20,1
1713306615652,TDAC 1,B00,492754,Harting; Carla Kelso,19,0,20,1
1713306615652,TDAC 1,C00,513995,Salovey; Todd,18,0,20,2
1713306616675,TDAC 101,A00,492766,Harting; Carla Kelso,19,0,20,1
1713306617700,TDAC 102,A00,492768,Basso; Beatrice,20,0,20,0
1713306618724,TDDE 111,A00,492769,Staff,25,0,25,0
1713306619754,TDDE 131,A00,492770,Staff,15,0,15,0
1713306619754,TDDE 131,B00,492771,Staff,15,0,15,0
1713306620780,TDDE 131GS,A00,523716,Guirguis; Mark C,25,0,28,3
1713306621805,TDGE 1,A01,492756,Salovey; Todd,57,0,60,3
1713306622833,TDGE 5,A01,492758,Staff,24,0,25,1
1713306623867,TDGE 10,A00,492759,Fulton; Julia,215,0,220,5
1713306624894,TDGE 11,A00,492760,Castro; Robert Jess,200,0,200,0
1713306625919,TDGE 50,A00,492761,Blair; Kyle Adam,0,0,0,0
1713306626944,TDGE 124,A00,492772,Fulton; Julia,198,0,220,22
1713306627974,TDGE 125,A00,492773,Meyer; Ursula,42,0,50,8
1713306627974,TDGE 125,B00,492774,Staff,50,0,50,0
1713306627974,TDGE 125,C00,523565,Staff,50,0,50,0
1713306628999,TDGE 125GS,A00,523580,Guirguis; Mark C,25,0,28,3
1713306630024,TDGE 127,A00,492775,Havis; Allan,43,0,50,7
1713306631053,TDHT 101,A00,492776,Staff,35,0,35,0
1713306632081,TDMV 1,A00,492762,Caligagan; Maria T.,30,0,30,0
1713306632081,TDMV 1,B00,492763,Arcidiacono; Kristin,26,0,30,4
1713306633110,TDMV 2,A00,492764,Weinberg; Sadie,29,0,30,1
1713306634136,TDMV 3,A00,492765,Mack; Kara Shanai',39,0,40,1
1713306635160,TDMV 138,A00,492777,Mack; Kara Shanai',37,0,40,3
1713306636186,TDMV 140,A00,492778,Lima; Paulo Henrique,40,0,40,0
1713306637209,TDMV 142,A00,492779,Caligagan; Maria T.,37,0,40,3
1713306637209,TDMV 142,B00,492780,Caligagan; Tony,38,0,40,2
1713306638236,TDMV 143,A00,492781,Fyall; Daunte Edward,40,0,40,0
1713306639263,USP 1,A01,492401,Kwak; Nancy,28,0,35,7
1713306640289,USP 2,A01,492453,Hinds; Juli Beth,35,0,35,0
1713306641314,USP 3,A01,492516,Staff,32,0,35,3
1713306642343,USP 4,A00,492522,McTague; Sarah,20,0,25,5
1713306643370,USP 100,A00,492523,Staff,33,0,35,2
1713306644395,USP 101,A00,492524,Staff,13,0,15,2
1713306645420,USP 105,A00,492525,Staff,22,0,25,3
1713306646445,USP 151,A00,492526,Shenkman; Michael Thomas,33,0,35,2
1713306647475,USP 170,A00,492545,Hinds; Juli Beth,33,0,35,2
1713306648500,USP 171GS,A00,492608,Bussell; Mirle Rabinowitz,26,0,28,2
1713306649528,USP 183GS,A00,492613,Peerson; Susan,26,0,28,2
1713306650554,VIS 30,A01,490693,Yoldas; Pinar,21,0,22,1
1713306650554,VIS 30,A02,490694,Yoldas; Pinar,19,0,22,3
1713306651583,VIS 83,A00,490695,Kester; Grant,68,0,75,7
1713306652608,VIS 105D,A00,490696,Staff,22,0,25,3
1713306653636,VIS 124CN,A00,490699,Rose; Jordan M,68,0,75,7
1713306654667,VIS 125GS,A00,511221,Williams; Alena J,21,0,22,1
1713306655698,VIS 128D,A00,490700,Staff,74,0,75,1
1713306656722,VIS 151,A01,490717,Staff,34,0,34,0
1713306656722,VIS 151,A02,490766,Staff,33,0,34,1
1713306657752,VIS 154GS,A00,511972,Williams; Alena J,21,0,22,1
1713306658782,VIS 160A,A00,490767,Stone; Patricia,7,0,10,3
1713306659811,WCWP 10A,A00,490638,Staff,15,0,15,0
1713306659811,WCWP 10A,B00,490640,Staff,15,0,15,0
1713306660838,WCWP 10B,A00,490641,Staff,0,0,0,0
1713306660838,WCWP 10B,B00,490642,Staff,14,0,15,1
1713306660838,WCWP 10B,C00,490644,Staff,14,0,15,1
1713306660838,WCWP 10B,D00,490647,Staff,0,0,0,0
1713306661865,WCWP 100,A00,490655,Staff,0,0,0,0
1713306661865,WCWP 100,B00,490687,Staff,12,0,15,3
1713306663999,ANAR 153,A00,487222,Braswell; Geoffrey E.,55,0,60,5
1713306665025,ANBI 134,A00,487223,Staff,14,0,20,6
1713306666049,ANBI 143GS,A00,487224,Noel; Geoffroy Pierre Jean,20,0,24,4
1713306667073,ANBI 144GS,A00,519548,Noel; Geoffroy Pierre Jean,20,0,24,4
1713306668098,ANSC 101,A00,487225,Staff,19,0,20,1
1713306669124,ANSC 125,A00,487227,Brenner; Suzanne A,39,0,40,1
1713306671173,ANSC 146,A00,487229,Staff,36,0,40,4
1713306672204,ANSC 148,A00,487230,Olivas Hernandez; Olga Lid,39,0,40,1
1713306673230,ANSC 150,A00,504165,Sloane; Julia Kathryn,19,0,20,1
1713306674253,ANSC 180,A00,487232,Staff,13,0,15,2
1713306675277,ANSC 188,A00,627155,Staff,40,0,40,0
1713306676302,ANTH 5,A00,519529,Semendeferi; Ekaterini,15,0,15,0
1713306677329,ANTH 10,A00,487219,Staff,58,0,60,2
1713306678357,ANTH 23,A01,487221,Staff,17,0,20,3
1713306679384,ANTH 102,A00,487233,Wilder; Linnea Lorene,53,0,60,7
1713306680408,ANTH 103,A00,487234,Varma; Saiba,57,0,60,3
1713306681435,ANTH 105,A00,487235,Stewart; Alexander B,57,0,60,3
1713306682461,BENG 100,A01,516685,Taylor Amos; Alyssa C,28,0,30,2
1713306683487,BIBC 102,A01,491316,Flagg; Matthew Paul,58,0,88,30
1713306683487,BIBC 102,A02,491366,Flagg; Matthew Paul,84,0,88,4
1713306684515,BIBC 103,A01,491486,Boumechache; Miyyada,16,0,24,8
1713306684515,BIBC 103,A02,491487,Boumechache; Miyyada,24,0,24,0
1713306685542,BICD 100,A01,516882,Staff,75,0,75,0
1713306685542,BICD 100,A02,516890,Staff,71,0,75,4
1713306686567,BICD 102GS,A00,491488,Lo; Stanley M.,27,0,28,1
1713306687596,BIEB 136GS,A00,516940,Holway; David A. & Shurin; Jonathan,20,0,24,4
1713306688621,BIEB 137GS,A01,517034,Holway; David A. & Shurin; Jonathan,20,0,24,4
1713306689703,BIEB 138GS,A01,491492,Pirino; Giorgia,22,0,28,6
1713306690727,BILD 1,A01,491296,Staff,62,0,63,1
1713306690727,BILD 1,A02,491297,Staff,63,0,63,0
1713306691758,BILD 4,A01,517099,Gonzalez Gamboa; Ivonne,22,0,24,2
1713306691758,BILD 4,A02,517100,Gonzalez Gamboa; Ivonne,24,0,24,0
1713306692784,BILD 60GS,A00,491309,Lo; Stanley M.,27,0,28,1
1713306693812,BIMM 100,A01,517136,Staff,92,0,100,8
1713306694837,BIMM 110,A01,517182,Staff,78,0,100,22
1713306695864,BIMM 120,A01,517228,Pickett; Brooke Elizabeth,40,0,63,23
1713306695864,BIMM 120,A02,517240,Pickett; Brooke Elizabeth,49,0,63,14
1713306696892,BIMM 132GS,A01,491498,Pirino; Giorgia,22,0,28,6
1713306697920,BIMM 143,A01,491589,Bozinovic; Goran,21,0,40,19
1713306698946,BIPN 100,A01,491594,Armour; Jon Christopher,92,0,100,8
1713306699975,BIPN 140,A01,491602,Marino; Marc J,32,0,50,18
1713306702029,CAT 125,A00,515973,Staff,20,0,20,0
1713306703059,CAT 125GS,A00,515974,Rahimi; Babak,19,0,20,1
1713306704084,CAT 125R,A00,515980,Staff,15,0,20,5
1713306704084,CAT 125R,B00,515981,Tosun; Adriana,19,0,20,1
1713306704084,CAT 125R,C00,515987,Hyland; Tina Mae,4,0,20,16
1713306704084,CAT 125R,D00,515988,Bronstein; Phoebe Malan,18,0,20,2
1713306705113,CENG 15,A01,488699,Drews; Aaron,25,0,25,0
1713306706155,CENG 100,A00,505196,Opatkiewicz; Justin Paul,25,0,25,0
1713306707184,CGS 2A,A01,489598,Staff,33,0,35,2
1713306708210,CGS 112,A00,489599,Staff,15,0,15,0
1713306709235,CGS 119,A00,489603,Staff,10,0,10,0
1713306710261,CGS 120,A00,489604,Staff,14,0,15,1
1713306711287,CGS 150,A00,489607,Staff,15,0,15,0
1713306712311,CHEM 6A,A01,488715,Staff,98,0,100,2
1713306713336,CHEM 6B,A01,488719,Piercy; Marc Anthony,100,0,100,0
1713306714361,CHEM 6C,A01,488723,Albizati; Kim F.,94,0,100,6
1713306715390,CHEM 7L,A01,488728,Schurmeier; Kimberly,18,0,24,6
1713306715390,CHEM 7L,A02,488730,Schurmeier; Kimberly,23,0,24,1
1713306715390,CHEM 7L,A03,488734,Schurmeier; Kimberly,24,0,24,0
1713306715390,CHEM 7L,A04,488763,Schurmeier; Kimberly,23,0,24,1
1713306715390,CHEM 7L,B01,488798,Schurmeier; Kimberly,18,0,24,6
1713306715390,CHEM 7L,B02,488801,Schurmeier; Kimberly,24,0,24,0
1713306715390,CHEM 7L,B03,488808,Schurmeier; Kimberly,24,0,24,0
1713306715390,CHEM 7L,B04,488811,Schurmeier; Kimberly,24,0,24,0
1713306716419,CHEM 11,A01,488897,Stallings; Dontarie M,98,0,100,2
1713306717443,CHEM 40A,A01,488913,Albizati; Kim F.,91,0,100,9
1713306718471,CHEM 40B,A01,488920,Weizman; Haim,48,0,50,2
1713306718471,CHEM 40B,A02,488938,Weizman; Haim,47,0,50,3
1713306719503,CHEM 41A,A01,489029,Klosterman; Jeremy K,58,0,60,2
1713306720529,CHEM 41C,A01,500436,Tor; Yitzhak,55,0,60,5
1713306721564,CHEM 43A,A01,500426,Weizman; Haim,6,0,24,18
1713306721564,CHEM 43A,A02,500430,Weizman; Haim,14,0,24,10
1713306721564,CHEM 43A,B01,514041,Klosterman; Jeremy K,17,0,24,7
1713306721564,CHEM 43A,B02,514047,Klosterman; Jeremy K,23,0,24,1
1713306722590,CHEM 108,A01,489140,Jennings; Patricia A.,14,0,24,10
1713306722590,CHEM 108,A02,489142,Jennings; Patricia A.,15,0,24,9
1713306723619,CHEM 114A,A01,489147,Stallings; Dontarie M,81,0,100,19
1713306724652,CHIN 169A,A00,489171,Wang; Xiao,19,0,20,1
1713306726708,COGS 3,A01,518827,Boyle; Mary E. T.,30,0,40,10
1713306727733,COGS 11,A01,489175,Staff,28,0,30,2
1713306728760,COGS 14A,A01,518829,Staff,53,0,60,7
1713306729791,COGS 14B,A01,489177,Hoffman; Drew Ellen,69,0,75,6
1713306730816,COGS 100,A01,489181,Allen; Michael Gordon,66,0,75,9
1713306731844,COGS 101A,A01,489183,Staff,51,0,60,9
1713306732874,COGS 101B,A01,489185,Allen; Michael Gordon,13,0,30,17
1713306733903,COGS 101C,A01,526786,Staff,25,0,30,5
1713306735960,COGS 107A,A01,489189,Boyle; Mary E. T.,24,0,35,11
1713306736988,COGS 107B,A01,627144,Mooshagian; Eric Frederick,60,0,60,0
1713306738015,COGS 118A,A01,489191,Staff,0,25,40,40
1713306740070,COGS 171GS,A01,489194,Pineda; Jaime A,22,0,28,6
1713306741095,COGS 172,A01,489196,Staff,6,0,30,24
1713306742122,COGS 174GS,A01,489264,Pineda; Jaime A,22,0,28,6
1713306743147,COGS 180,A01,627150,Staff,29,0,30,1
1713306744171,COGS 186,A01,489274,Staff,4,0,30,26
1713306745196,COMM 10,A01,489276,Staff,25,0,25,0
1713306745196,COMM 10,A02,489303,Staff,23,0,25,2
1713306746223,COMM 100A,A01,489312,Staff,21,0,25,4
1713306746223,COMM 100A,A02,489313,Staff,24,0,25,1
1713306747247,COMM 106T,A00,512540,Staff,34,0,35,1
1713306748276,COMM 107,A00,489347,Staff,31,0,35,4
1713306749304,COMM 109P,A00,489358,Staff,31,0,35,4
1713306750330,COMM 132,A00,489361,McKenna; Denise,29,0,30,1
1713306751354,COMM 146,A00,489362,Halm; Gavin Patrick,27,0,30,3
1713306752379,COMM 190,A00,489363,Abuelhiga; Soraya Jill,21,0,23,2
1713306753407,CSE 8A,A50,489366,Staff,23,0,25,2
1713306753407,CSE 8A,A51,489367,Staff,24,0,25,1
1713306754436,CSE 11,A01,489398,Cao; Yingjun,84,0,100,16
1713306755461,CSE 12,A01,489487,Staff,43,0,50,7
1713306756486,CSE 20,A01,489497,Staff,49,0,50,1
1713306757515,CSE 21,A01,489517,Braun; Oliver,44,0,50,6
1713306758581,CSE 101,A01,489524,Braun; Oliver,0,4,50,50
1713306759607,CSE 105,A01,512594,Jones; Miles E,82,0,100,18
1713306759607,CSE 105,B01,512598,Jones; Miles E,70,0,100,30
1713306760632,CSE 140,A01,489538,Staff,44,0,50,6
1713306761658,CSE 141,A01,489550,Eldon; John,76,0,100,24
1713306762687,CSE 141L,A01,489571,Eldon; John,75,0,100,25
1713306763713,CSE 151A,A01,489583,Solares; Edwin A,153,0,200,47
1713306764738,CSE 175,A01,510886,Kumar; Rakesh,30,0,30,0
1713306765763,CSE 190,A00,516828,Dubnov; Shlomo,41,0,49,8
1713306766791,DOC 100D,A00,489667,Pass; Natalye Joann,23,0,25,2
1713306767820,DSC 10,A01,624268,Staff,72,0,75,3
1713306768843,DSC 20,A01,624476,Staff,50,0,50,0
1713306769871,DSC 40A,A01,624608,Staff,40,0,40,0
1713306770897,DSGN 1,A01,489179,Rill; Bryan,37,0,50,13
1713306771923,ECE 17,A01,490489,Sahay; Rajeev,19,0,30,11
1713306772954,ECE 65,A50,490492,Staff,17,0,20,3
1713306772954,ECE 65,A51,490493,Staff,20,0,20,0
1713306773984,ECON 1,A01,489715,Famulari; Melissa,69,0,70,1
1713306775010,ECON 2,A01,489717,Levkoff; Steven B.,68,0,70,2
1713306776038,ECON 3,A01,489948,Staff,70,0,70,0
1713306778100,ECON 5,A01,490103,Staff,28,0,30,2
1713306778100,ECON 5,B01,626281,Dai; Yinlin,45,0,45,0
1713306779126,ECON 100A,A01,490127,Famulari; Melissa,70,0,70,0
1713306780157,ECON 100B,A01,490129,Staff,64,0,70,6
1713306781190,ECON 109,A01,490187,Shishkin; Denis,27,0,35,8
1713306782219,ECON 110A,A01,490190,Levkoff; Steven B.,64,0,70,6
1713306783246,ECON 120A,A01,490245,Dai; Yinlin,68,0,70,2
1713306784276,ECON 120B,A01,490247,Nieto-Barthaburu; Augusto,60,0,70,10
1713306785313,ECON 120C,A01,490253,Sun; Yixiao,32,0,35,3
1713306785313,ECON 120C,B01,490255,Sun; Yixiao,34,0,35,1
1713306786343,ECON 129,A00,490256,Eckert; Fabian Paul,27,0,35,8
1713306787368,ECON 131,A00,490257,Nieto-Barthaburu; Augusto,6,0,35,29
1713306788399,ECON 138,A00,490258,Bharadwaj; Prashant,24,0,35,11
1713306788399,ECON 138,B00,490259,Bharadwaj; Prashant,20,0,35,15
1713306789426,ECON 159,A00,490260,Hendrickson; Gerald M.,0,6,0,0
1713306790457,ECON 178,A01,553995,Zhu; Ying,27,0,35,8
1713306791480,EDS 40,A01,512576,Black; Alison Michelle,20,0,20,0
1713306792506,EDS 107,A01,515848,Staff,30,0,30,0
1713306793585,EDS 110R,A01,490262,Staff,26,0,30,4
1713306794613,EDS 112,A01,490264,Chapman; Thandeka K,44,0,50,6
1713306795638,EDS 113,A00,490266,Staff,27,0,30,3
1713306796661,EDS 118,A00,490267,Warstadt; Melissa Fawn,27,0,30,3
1713306797687,EDS 124BR,A00,490268,Eguchi; Emi,10,0,25,15
1713306797687,EDS 124BR,B00,490269,Eguchi; Emi,25,0,25,0
1713306798712,EDS 126,A01,490271,Jones; Makeba,46,0,50,4
1713306799735,EDS 135,A01,490316,Staff,19,0,20,1
1713306800760,ENVR 142GS,A00,519514,Chang; Edmond Yi-Teh,28,0,28,0
1713306801784,ETHN 103,A00,490504,Staff,33,0,36,3
1713306802812,ETHN 103A,A00,490505,Man; Simeon S,7,0,9,2
1713306803837,ETHN 109,A00,490506,Staff,30,0,30,0
1713306804866,ETHN 118,A00,490507,Staff,35,0,36,1
1713306805893,ETHN 119,A00,490508,Staff,36,0,36,0
1713306806921,ETHN 121R,A00,490518,Choi; Esther Min,30,0,36,6
1713306807945,ETHN 127,A00,490528,Staff,15,0,15,0
1713306808973,ETHN 139,A00,490573,Staff,10,0,10,0
1713306810001,ETHN 150,A00,490575,Staff,15,0,15,0
1713306811031,GLBH 20,A00,491705,Elwardani; Nile Regina,38,0,40,2
1713306812059,GLBH 101,A00,491706,Staff,20,0,20,0
1713306813085,GLBH 111,A01,491708,Burgos; Jose L.,15,0,15,0
1713306814109,GLBH 146,A00,491709,Staff,12,0,20,8
1713306815135,GLBH 148,A00,491710,Olivas Hernandez; Olga Lid,17,0,20,3
1713306816161,GLBH 150,A00,491711,Sloane; Julia Kathryn,20,0,20,0
1713306817189,HIEA 131,A00,491760,Staff,30,0,32,2
1713306818213,HIEA 153,A00,491762,Staff,29,0,30,1
1713306819238,HIEU 124,A00,491811,Staff,26,0,32,6
1713306820266,HIEU 124GS,A00,491812,Markman; Kristina,28,0,28,0
1713306821290,HIEU 147,A00,491813,Staff,30,0,32,2
1713306822315,HIEU 149GS,A00,491816,Caldwell; Michael Alan,28,0,28,0
1713306823344,HILD 2C,A01,491713,Hendrickson; Gerald M.,28,0,30,2
1713306824369,HILD 7B,A01,491715,Kwak; Nancy,17,0,30,13
1713306825397,HILD 10,A01,491717,Staff,14,0,20,6
1713306826425,HILD 30GS,A00,491719,Edington; Claire Ellen,24,0,28,4
1713306827450,HINE 109,A00,491818,Shafir; Nir,30,0,32,2
1713306828475,HINE 128,A00,491821,Shafir; Nir,32,0,32,0
1713306829500,HISC 117,A00,491830,Staff,29,0,32,3
1713306830524,HIUS 103,A00,491834,Man; Simeon S,16,0,23,7
1713306831550,HIUS 108B,A00,491835,Staff,30,0,30,0
1713306832579,HIUS 141,A00,491836,Hendrickson; Gerald M.,29,0,32,3
1713306833609,HIUS 149,A00,491839,Staff,27,0,32,5
1713306834636,HUM 3,A01,512617,Crum; Matthew Stephen,46,0,50,4
1713306834636,HUM 3,A02,512618,Crum; Matthew Stephen,48,0,50,2
1713306835659,HUM 3GS,A00,512663,Markman; Kristina,0,0,0,0
1713306835659,HUM 3GS,B00,512664,Staff,0,0,0,0
1713306836684,HUM 4,A01,512620,West; Geoffrey Scott,38,0,50,12
1713306837712,HUM 4GS,A00,512666,Lyon; Antony J.,0,0,0,3
1713306838740,HUM 4R,A01,512625,Watkins; Eric,49,0,50,1
1713306839771,HUM 5,A01,512649,Zavodny; Tatiana Sophia,34,0,50,16
1713306839771,HUM 5,B01,512661,Zroka; Ryan Edward,49,0,50,1
1713306840796,INTL 190,A00,490577,Segui; Alan S,0,0,0,5
1713306841822,JAPN 20AR,A01,491267,Ross; Kayoko F,12,0,20,8
1713306842847,JAPN 180,A00,491285,Berman; Michael David,34,0,40,6
1713306843871,LATI 50,A01,502536,Kokinis; Troy Andreas,19,0,22,3
1713306843871,LATI 50,A02,502551,Kokinis; Troy Andreas,22,0,22,0
1713306843871,LATI 50,A03,502650,Kokinis; Troy Andreas,22,0,22,0
1713306843871,LATI 50,A04,502909,Kokinis; Troy Andreas,22,0,22,0
1713306844901,LATI 160,A01,502920,Kokinis; Troy Andreas,30,0,30,0
1713306845932,LIFR 1A,A00,490494,Van Moer; Vinciane G,18,0,20,2
1713306846961,LIFR 1AX,A00,490495,Van Moer; Vinciane G,18,0,20,2
1713306847986,LIFR 1B,A00,490496,Van Moer; Vinciane G,20,0,20,0
1713306849020,LIFR 1BX,A00,490497,Van Moer; Vinciane G,20,0,20,0
1713306850052,LIGN 8,A00,505198,McIntosh; Justin Daniel,143,0,150,7
1713306851085,LIGN 9GS,A00,491239,Lott; Margaret S.,18,0,20,2
1713306852114,LIGN 101,A01,505200,McIntosh; Justin Daniel,26,0,30,4
1713306853141,LIGN 120,A01,491244,Staff,25,0,30,5
1713306854167,LIGN 149GS,A00,491245,Lott; Margaret S.,18,0,20,2
1713306855192,LIGN 170,A00,491247,Staff,24,0,30,6
1713306856217,LISP 1D,A00,490498,Munoz Sanchez; Alicia,11,0,14,3
1713306856217,LISP 1D,B00,490499,Munoz Sanchez; Alicia,6,0,14,8
1713306856217,LISP 1D,C00,490500,Munoz Sanchez; Alicia,10,0,14,4
1713306856217,LISP 1D,D00,490501,Munoz Sanchez; Alicia,11,0,14,3
1713306857245,LISP 1DX,A00,490502,Munoz Sanchez; Alicia,18,0,28,10
1713306857245,LISP 1DX,B00,490503,Munoz Sanchez; Alicia,19,0,28,9
1713306859297,LTAM 110,A00,491847,Staff,23,0,25,2
1713306860325,LTCS 119,A00,491848,Staff,13,0,15,2
1713306861351,LTCS 130,A00,491849,Staff,24,0,25,1
1713306863402,LTEA 120C,A00,491852,Staff,35,0,40,5
1713306864425,LTEN 130GS,A00,491853,Lyon; Antony J.,25,0,28,3
1713306865451,LTEN 148,A00,491855,Staff,23,0,25,2
1713306866476,LTEN 159,A00,491856,Staff,21,0,25,4
1713306867503,LTEN 180,A00,491857,Staff,9,0,15,6
1713306869554,LTSP 123GS,A00,505928,Bessett; Ryan Matthew,25,0,28,3
1713306870583,LTSP 174GS,A00,506037,Bessett; Ryan Matthew,25,0,28,3
1713306872640,LTWR 102,A00,491861,Staff,12,0,15,3
1713306873665,LTWR 106,A00,491862,Staff,10,0,15,5
1713306874695,MAE 11,A00,490930,Bahadori; Mohammad Yousef,98,0,100,2
1713306875725,MAE 30A,A00,490931,Qi; Huihui,38,0,40,2
1713306876751,MAE 101A,A00,491036,Sadeghizadeh; Zahra,98,0,100,2
1713306877780,MAE 101C,A00,491037,Seshadri; Kalyanasundaram,78,0,100,22
1713306878808,MAE 113,A00,491040,Seshadri; Kalyanasundaram,67,0,80,13
1713306879834,MAE 131A,A00,491041,Ghazinejad; Maziar,39,0,40,1
1713306880866,MAE 142,A00,491053,Staff,39,0,40,1
1713306881891,MAE 143A,A00,491054,Staff,41,0,50,9
1713306882917,MAE 150,A00,491092,Truong; Phuong Thi Ngoc,24,0,35,11
1713306883949,MATH 3C,A01,494031,Pardo Guerra; Sebastian,30,0,30,0
1713306883949,MATH 3C,A02,494032,Pardo Guerra; Sebastian,29,0,30,1
1713306884979,MATH 10A,A01,494034,Staff,28,0,30,2
1713306884979,MATH 10A,A02,494035,Staff,29,0,30,1
1713306884979,MATH 10A,B01,494037,Staff,28,0,30,2
1713306884979,MATH 10A,B02,494038,Staff,29,0,30,1
1713306886009,MATH 10B,A01,494040,Habib; Yousaf,24,0,30,6
1713306886009,MATH 10B,A02,494041,Habib; Yousaf,28,0,30,2
1713306886009,MATH 10B,A03,494042,Habib; Yousaf,30,0,30,0
1713306886009,MATH 10B,A04,494043,Habib; Yousaf,30,0,30,0
1713306886009,MATH 10B,B01,494045,Habib; Yousaf,28,0,30,2
1713306886009,MATH 10B,B02,494046,Habib; Yousaf,30,0,30,0
1713306886009,MATH 10B,B03,494047,Habib; Yousaf,30,0,30,0
1713306886009,MATH 10B,B04,494048,Habib; Yousaf,30,0,30,0
1713306887036,MATH 18,A01,494050,Kemp; Todd Aahron,27,0,30,3
1713306887036,MATH 18,A02,494051,Kemp; Todd Aahron,29,0,30,1
1713306887036,MATH 18,B01,494054,Kemp; Todd Aahron,28,0,30,2
1713306887036,MATH 18,B02,494055,Kemp; Todd Aahron,29,0,30,1
1713306888064,MATH 20A,A01,494059,Suk; Andrew Hoon,30,0,30,0
1713306889096,MATH 20B,A01,494061,Briones; Jor-el Thomas Caparas,34,0,35,1
1713306889096,MATH 20B,B01,494063,Bach; Quang Tran,34,0,35,1
1713306890132,MATH 20C,A01,494065,Staff,28,0,30,2
1713306890132,MATH 20C,A02,494066,Staff,30,0,30,0
1713306890132,MATH 20C,A03,494067,Staff,30,0,30,0
1713306890132,MATH 20C,A04,494068,Staff,30,0,30,0
1713306890132,MATH 20C,B01,494070,Zhang; Ming,26,0,30,4
1713306890132,MATH 20C,B02,494071,Zhang; Ming,30,0,30,0
1713306890132,MATH 20C,B03,494072,Zhang; Ming,29,0,30,1
1713306890132,MATH 20C,B04,494073,Zhang; Ming,28,0,30,2
1713306891157,MATH 20D,A01,494075,Staff,26,0,30,4
1713306891157,MATH 20D,A02,494076,Staff,30,0,30,0
1713306892188,MATH 20E,A01,494079,Staff,25,0,30,5
1713306892188,MATH 20E,A02,494080,Staff,27,0,30,3
1713306892188,MATH 20E,B01,494082,Staff,28,0,30,2
1713306892188,MATH 20E,B02,494083,Staff,25,0,30,5
1713306893217,MATH 103A,A01,494085,Aliabadi Sr.; Mohsen,20,0,30,10
1713306893217,MATH 103A,A02,494086,Aliabadi Sr.; Mohsen,29,0,30,1
1713306893217,MATH 103A,B01,494088,Aliabadi Sr.; Mohsen,22,0,30,8
1713306893217,MATH 103A,B02,494089,Aliabadi Sr.; Mohsen,28,0,30,2
1713306894243,MATH 109,A01,494091,Staff,30,0,30,0
1713306894243,MATH 109,A02,494092,Staff,30,0,30,0
1713306894243,MATH 109,B01,494094,Staff,28,0,30,2
1713306894243,MATH 109,B02,494095,Staff,29,0,30,1
1713306895270,MATH 142A,A01,494097,Chow; Bennett,16,0,30,14
1713306895270,MATH 142A,A02,494098,Chow; Bennett,24,0,30,6
1713306895270,MATH 142A,B01,494100,Chow; Bennett,20,0,30,10
1713306895270,MATH 142A,B02,494101,Chow; Bennett,29,0,30,1
1713306897377,MATH 168A,A01,516677,Dumitriu; Ioana,17,0,35,18
1713306898407,MATH 170A,A01,516679,Dumitriu; Ioana,21,0,30,9
1713306898407,MATH 170A,A02,516680,Dumitriu; Ioana,28,0,30,2
1713306899434,MATH 193A,A01,494107,Staff,17,0,30,13
1713306899434,MATH 193A,A02,494108,Staff,25,0,30,5
1713306899434,MATH 193A,A03,494109,Staff,29,0,30,1
1713306899434,MATH 193A,A04,494110,Staff,26,0,30,4
1713306902517,MGT 16,A00,491930,McKay; Michael J,94,0,98,4
1713306903548,MGT 18,A00,491992,McKay; Michael J,97,0,98,1
1713306904573,MGT 71,A00,492003,Staff,78,0,98,20
1713306905598,MGT 103,A00,505209,Eberhard; Craig A,87,0,98,11
1713306906623,MGT 131A,A00,505210,Anderson; John Charles,91,0,98,7
1713306908691,MGT 153,A00,492077,Perols; Johan Lars,49,0,90,41
1713306911769,MGT 164,A00,492222,McKay; Mary A,94,0,98,4
1713306912798,MGT 172,A00,492245,Staff,59,0,60,1
1713306912798,MGT 172,B00,505526,Hedges; Kathleen,78,0,98,20
1713306913827,MGT 181,A00,505669,Dunn; Louis Jean,88,0,98,10
1713306914852,MMW 14,A01,494399,Staff,23,0,28,5
1713306914852,MMW 14,A02,494400,Staff,26,0,28,2
1713306914852,MMW 14,A03,494401,Staff,28,0,28,0
1713306914852,MMW 14,A04,494402,Staff,28,0,28,0
1713306914852,MMW 14,B01,494404,Carreras; Maria Victoria,18,0,28,10
1713306914852,MMW 14,B02,494405,Carreras; Maria Victoria,27,0,28,1
1713306914852,MMW 14,B03,494406,Carreras; Maria Victoria,28,0,28,0
1713306914852,MMW 14,B04,494407,Carreras; Maria Victoria,28,0,28,0
1713306915877,MMW 14GS,A00,506250,Chang; Edmond Yi-Teh,0,0,0,0
1713306916901,MMW 121R,A01,494415,Adamiak; Patrick John,15,0,28,13
1713306916901,MMW 121R,A02,494416,Adamiak; Patrick John,25,0,28,3
1713306917928,MUS 1A,A01,494113,Staff,13,0,25,12
1713306917928,MUS 1A,A02,494114,Staff,25,0,25,0
1713306918953,MUS 4,A01,494116,Staff,24,0,25,1
1713306918953,MUS 4,A02,494117,Staff,22,0,25,3
1713306919978,MUS 5R,A01,494236,Dubnov; Shlomo,12,0,25,13
1713306919978,MUS 5R,A02,494237,Dubnov; Shlomo,25,0,25,0
1713306921007,MUS 6,A01,494122,Staff,16,0,25,9
1713306921007,MUS 6,A02,494123,Staff,24,0,25,1
1713306922036,MUS 7,A01,494125,Staff,17,0,25,8
1713306922036,MUS 7,A02,494126,Staff,24,0,25,1
1713306923066,MUS 11,A01,494128,Staff,23,0,25,2
1713306923066,MUS 11,A02,494129,Staff,25,0,25,0
1713306924092,MUS 13,A01,494131,Staff,25,0,25,0
1713306924092,MUS 13,A02,494132,Staff,25,0,25,0
1713306925118,MUS 15,A01,494134,Staff,20,0,25,5
1713306925118,MUS 15,A02,494135,Staff,25,0,25,0
1713306925118,MUS 15,B01,494137,Staff,25,0,25,0
1713306926149,MUS 80,A00,494232,Staff,25,0,25,0
1713306926149,MUS 80,B00,494233,Staff,25,0,25,0
1713306926149,MUS 80,C00,494234,Staff,23,0,25,2
1713306927175,MUS 95C,A00,494141,Staff,73,0,75,2
1713306928199,MUS 114,A00,494142,Staff,42,0,50,8
1713306929227,NANO 15,A01,490636,Drews; Aaron,7,0,7,0
1713306930252,PHIL 1,A00,490578,Grush; Rick Scott,50,0,50,0
1713306931281,PHIL 10,A01,490580,Grush; Rick Scott,34,0,35,1
1713306931281,PHIL 10,A02,490586,Grush; Rick Scott,33,0,35,2
1713306932305,PHIL 27,A01,490591,Staff,24,0,25,1
1713306932305,PHIL 27,A02,490592,Staff,25,0,25,0
1713306932305,PHIL 27,A03,490593,Staff,25,0,25,0
1713306932305,PHIL 27,A04,490598,Staff,25,0,25,0
1713306933331,PHIL 32,A01,490611,Staff,20,0,20,0
1713306933331,PHIL 32,A02,490618,Staff,20,0,20,0
1713306934360,PHIL 90,A00,490624,Staff,40,0,40,0
1713306935391,PHIL 136,A00,490627,Cohen; Jonathan David,38,0,40,2
1713306936420,PHIL 155,A00,490634,Staff,67,0,70,3
1713306937448,PHYS 1A,A00,491610,Staff,246,0,250,4
1713306938474,PHYS 1AL,001,491616,Tsai; Philbert S,28,0,30,2
1713306938474,PHYS 1AL,002,491618,Tsai; Philbert S,30,0,30,0
1713306939503,PHYS 1B,A00,491623,Staff,244,0,250,6
1713306940527,PHYS 1BL,001,491626,Tsai; Philbert S,26,0,30,4
1713306940527,PHYS 1BL,002,491628,Tsai; Philbert S,28,0,30,2
1713306941555,PHYS 1C,A00,491632,Staff,227,0,245,18
1713306942584,PHYS 1CL,001,491635,Tsai; Philbert S,13,0,30,17
1713306942584,PHYS 1CL,002,491643,Tsai; Philbert S,24,0,30,6
1713306943614,PHYS 2AR,A01,491651,Meyertholen; Andrew D.,46,0,50,4
1713306944640,PHYS 2B,A01,491659,Staff,107,0,115,8
1713306945668,PHYS 2BL,A01,491685,Staff,24,0,24,0
1713306945668,PHYS 2BL,A02,491700,Staff,23,0,24,1
1713306946693,PHYS 2C,A01,505161,Staff,107,0,115,8
1713306947724,PHYS 4A,A01,491704,Grinstein; Benjamin,99,0,100,1
1713306948751,POLI 5D,A01,494144,Staff,3,0,5,2
1713306948751,POLI 5D,B01,626283,Dai; Yinlin,5,0,5,0
1713306949777,POLI 12,A00,494145,Staff,44,0,45,1
1713306950813,POLI 13R,A00,494146,Forman; Fonna,47,0,50,3
1713306951853,POLI 27,A01,494148,Staff,59,0,60,1
1713306952878,POLI 30,A00,494149,Staff,49,0,50,1
1713306953907,POLI 100DA,A00,494150,Staff,23,0,25,2
1713306955960,POLI 100I,A00,494152,Staff,28,0,30,2
1713306956987,POLI 104B,A00,494153,Smith; Glenn Chatmas,54,0,55,1
1713306958014,POLI 104F,A00,494154,Staff,28,0,30,2
1713306959041,POLI 104I,A00,494155,Smith; Glenn Chatmas,30,0,30,0
1713306960068,POLI 110C,A00,494156,Ingham; Sean,23,0,25,2
1713306961096,POLI 117R,A00,494157,Forman; Fonna,15,0,20,5
1713306962127,POLI 118,A00,494158,Ingham; Sean,23,0,25,2
1713306963159,POLI 120H,A00,494159,Fisk; David Lee,41,0,45,4
1713306964185,POLI 131CR,A00,494160,Hoston; Germaine,40,0,45,5
1713306965209,POLI 133J,A00,494161,Staff,33,0,35,2
1713306966235,POLI 135,A00,494162,Fisk; David Lee,33,0,35,2
1713306967262,POLI 140A,A00,494164,Staff,22,0,30,8
1713306968291,POLI 142I,A00,494165,Staff,30,0,30,0
1713306969318,POLI 144D,A00,494166,Staff,23,0,25,2
1713306970344,POLI 151,A00,494167,Staff,30,0,30,0
1713306971377,POLI 153,A00,494168,Staff,33,0,35,2
1713306972406,POLI 160AA,A00,494169,Staff,36,0,40,4
1713306973434,POLI 162,A00,494170,Mignozzetti; Umberto,21,0,25,4
1713306974459,POLI 171,A00,494171,Mignozzetti; Umberto,23,0,25,2
1713306975493,PSYC 1,A00,494172,Staff,97,0,100,3
1713306976519,PSYC 2,A00,494173,Moranton; Nirelia Melbina-,45,0,50,5
1713306977556,PSYC 3,A00,494174,Staff,30,0,30,0
1713306978586,PSYC 6,A00,494175,Staff,17,0,20,3
1713306979612,PSYC 60,A01,494177,Staff,42,0,45,3
1713306980639,PSYC 70,A01,505724,Geller; Emma Harlan,42,0,45,3
1713306981674,PSYC 101,A00,494180,Heyman; Gail D.,88,0,100,12
1713306982699,PSYC 105,A00,494181,Geller; Emma Harlan,66,0,90,24
1713306983722,PSYC 106,A00,494182,Dobkins; Karen R.,34,0,45,11
1713306984754,PSYC 108,A00,494183,Adrian; Julia Anna,94,0,100,6
1713306985784,PSYC 114,A01,494185,Winkielman; Piotr,6,0,30,24
1713306986809,PSYC 122,A00,494186,Moranton; Nirelia Melbina-,40,0,50,10
1713306987835,PSYC 124,A00,494187,Chapman; Eddie Nathaniel,72,0,80,8
1713306988861,PSYC 131,A00,494188,Anagnostaras; Stephan,59,0,80,21
1713306989888,PSYC 144,A00,494189,Staff,22,0,50,28
1713306990913,PSYC 154,A00,494190,Lacefield; Katharine I,138,0,180,42
1713306991943,PSYC 162,A00,494191,Wixted; John T,87,0,100,13
1713306992982,PSYC 172,A00,494192,Gorman; Michael R.,38,0,45,7
1713306994008,PSYC 178,A00,494193,Glaser; Dale,41,0,45,4
1713306995033,PSYC 193,A00,505725,Chapman; Eddie Nathaniel,20,0,20,0
1713306996058,RELI 145GS,A00,519817,Rahimi; Babak,19,0,20,1
1713306997084,SE 101A,A01,490862,Chadha; Mayank,24,0,25,1
1713306998116,SE 101C,A01,490924,Krysl; Petr,18,0,20,2
1713306999141,SE 110A,A01,490928,Staff,20,0,20,0
1713307000173,SE 130A,A00,490929,Morrison; Machel Leigh,65,0,70,5
1713307001258,SIO 1,A01,519325,Staff,39,0,40,1
1713307002283,SIO 30,A01,519327,Staff,40,0,40,0
1713307003310,SIO 40,A00,519328,Staff,40,0,40,0
1713307004335,SIO 46GS,A00,519819,Cook; Geoffrey W,18,0,25,7
1713307005361,SIO 109R,A00,494197,Forman; Fonna,8,0,20,12
1713307006389,SIO 121GS,A00,519827,Cook; Geoffrey W,18,0,25,7
1713307007418,SIO 132,A01,519330,Staff,38,0,40,2
1713307008447,SIO 133,A01,519397,Staff,38,0,40,2
1713307009472,SIO 139,A00,519396,Kacev; David,33,0,40,7
1713307010499,SOCI 1,A01,494199,Thorpe; Charles Robert,24,0,30,6
1713307010499,SOCI 1,A02,494200,Thorpe; Charles Robert,30,0,30,0
1713307010499,SOCI 1,A03,494201,Thorpe; Charles Robert,29,0,30,1
1713307010499,SOCI 1,A04,494202,Thorpe; Charles Robert,29,0,30,1
1713307010499,SOCI 1,A05,494203,Thorpe; Charles Robert,29,0,30,1
1713307010499,SOCI 1,A06,494204,Thorpe; Charles Robert,30,0,30,0
1713307010499,SOCI 1,A07,494205,Thorpe; Charles Robert,29,0,30,1
1713307011522,SOCI 60,A01,494207,Staff,36,0,40,4
1713307011522,SOCI 60,A02,494208,Staff,39,0,40,1
1713307012548,SOCI 100,A01,494210,Payne; Christine Anna,28,0,30,2
1713307012548,SOCI 100,A02,494211,Payne; Christine Anna,28,0,30,2
1713307013571,SOCI 109M,A00,494212,Staff,20,0,20,0
1713307014596,SOCI 110,A00,494213,Staff,35,0,40,5
1713307016645,SOCI 118E,A00,494215,Ng; Kwai,38,0,40,2
1713307017674,SOCI 125,A00,494216,Calderon-Zaks; Michael Aar,42,0,45,3
1713307018700,SOCI 126,A01,494218,Jones; Makeba,4,0,5,1
1713307019724,SOCI 131,A00,494219,Thorpe; Charles Robert,30,0,30,0
1713307021782,SOCI 135,A00,494221,Payne; Christine Anna,43,0,50,7
1713307022813,SOCI 136E,A00,626690,Ruiz; Jonathan Joseph,25,0,25,0
1713307023836,SOCI 138GS,A00,494222,Navon; Daniel,24,0,28,4
1713307025889,SOCI 145,A00,494224,Staff,43,0,45,2
1713307026916,SOCI 153,A00,494225,Staff,28,0,30,2
1713307027947,SOCI 160E,A00,494226,Ng; Kwai,34,0,40,6
1713307028972,SOCI 180,A00,494227,Staff,29,0,30,1
1713307029997,SOCI 189GS,A00,494228,Ribas Norris; Janet Vanesa,11,0,11,0
1713307031022,SOCI 190GS,A00,553232,Ribas Norris; Janet Vanesa,11,0,11,0
1713307032047,SOMI 220,A00,627178,Schneid; Stephen David,30,0,30,0
1713307033078,SYN 2,001,490768,Staff,14,0,15,1
1713307033078,SYN 2,002,490769,Staff,15,0,15,0
1713307033078,SYN 2,004,490775,Staff,0,0,0,0
1713307033078,SYN 2,003,490774,Staff,0,0,0,0
1713307033078,SYN 2,005,490776,Staff,0,0,0,0
1713307034103,SYN 2R,001,490779,Staff,14,0,15,1
1713307034103,SYN 2R,002,514635,Staff,14,0,15,1
1713307035132,SYN 100,A01,490783,Staff,17,0,20,3
1713307035132,SYN 100,B01,490787,Staff,12,0,20,8
1713307035132,SYN 100,C01,490789,Staff,14,0,20,6
1713307036159,SYN 150,A00,490817,Staff,14,0,15,1
1713307036159,SYN 150,B00,514610,Staff,15,0,15,0
1713307037187,TDAC 1,A00,492753,Walsh; Kim C.,19,0,20,1
1713307037187,TDAC 1,B00,492754,Harting; Carla Kelso,19,0,20,1
1713307037187,TDAC 1,C00,513995,Salovey; Todd,18,0,20,2
1713307038213,TDAC 101,A00,492766,Harting; Carla Kelso,19,0,20,1
1713307039239,TDAC 102,A00,492768,Basso; Beatrice,20,0,20,0
1713307040264,TDDE 111,A00,492769,Staff,25,0,25,0
1713307041288,TDDE 131,A00,492770,Staff,15,0,15,0
1713307041288,TDDE 131,B00,492771,Staff,15,0,15,0
1713307042314,TDDE 131GS,A00,523716,Guirguis; Mark C,25,0,28,3
1713307043344,TDGE 1,A01,492756,Salovey; Todd,57,0,60,3
1713307044367,TDGE 5,A01,492758,Staff,24,0,25,1
1713307045397,TDGE 10,A00,492759,Fulton; Julia,215,0,220,5
1713307046426,TDGE 11,A00,492760,Castro; Robert Jess,200,0,200,0
1713307047448,TDGE 50,A00,492761,Blair; Kyle Adam,0,0,0,0
1713307048476,TDGE 124,A00,492772,Fulton; Julia,197,0,220,23
1713307049507,TDGE 125,A00,492773,Meyer; Ursula,41,0,50,9
1713307049507,TDGE 125,B00,492774,Staff,50,0,50,0
1713307049507,TDGE 125,C00,523565,Staff,49,0,50,1
1713307050536,TDGE 125GS,A00,523580,Guirguis; Mark C,25,0,28,3
1713307051565,TDGE 127,A00,492775,Havis; Allan,43,0,50,7
1713307052593,TDHT 101,A00,492776,Staff,35,0,35,0
1713307053625,TDMV 1,A00,492762,Caligagan; Maria T.,30,0,30,0
1713307053625,TDMV 1,B00,492763,Arcidiacono; Kristin,26,0,30,4
1713307054649,TDMV 2,A00,492764,Weinberg; Sadie,29,0,30,1
1713307055676,TDMV 3,A00,492765,Mack; Kara Shanai',39,0,40,1
1713307056699,TDMV 138,A00,492777,Mack; Kara Shanai',37,0,40,3
1713307057729,TDMV 140,A00,492778,Lima; Paulo Henrique,40,0,40,0
1713307058759,TDMV 142,A00,492779,Caligagan; Maria T.,37,0,40,3
1713307058759,TDMV 142,B00,492780,Caligagan; Tony,38,0,40,2
1713307059790,TDMV 143,A00,492781,Fyall; Daunte Edward,40,0,40,0
1713307060816,USP 1,A01,492401,Kwak; Nancy,26,0,35,9
1713307061842,USP 2,A01,492453,Hinds; Juli Beth,35,0,35,0
1713307062867,USP 3,A01,492516,Staff,31,0,35,4
1713307063901,USP 4,A00,492522,McTague; Sarah,20,0,25,5
1713307064927,USP 100,A00,492523,Staff,32,0,35,3
1713307065953,USP 101,A00,492524,Staff,12,0,15,3
1713307066981,USP 105,A00,492525,Staff,22,0,25,3
1713307068012,USP 151,A00,492526,Shenkman; Michael Thomas,33,0,35,2
1713307069042,USP 170,A00,492545,Hinds; Juli Beth,33,0,35,2
1713307070068,USP 171GS,A00,492608,Bussell; Mirle Rabinowitz,26,0,28,2
1713307071097,USP 183GS,A00,492613,Peerson; Susan,26,0,28,2
1713307072126,VIS 30,A01,490693,Yoldas; Pinar,21,0,22,1
1713307072126,VIS 30,A02,490694,Yoldas; Pinar,19,0,22,3
1713307073156,VIS 83,A00,490695,Kester; Grant,68,0,75,7
1713307074181,VIS 105D,A00,490696,Staff,22,0,25,3
1713307075206,VIS 124CN,A00,490699,Rose; Jordan M,68,0,75,7
1713307076241,VIS 125GS,A00,511221,Williams; Alena J,21,0,22,1
1713307077270,VIS 128D,A00,490700,Staff,74,0,75,1
1713307078300,VIS 151,A01,490717,Staff,34,0,34,0
1713307078300,VIS 151,A02,490766,Staff,33,0,34,1
1713307079325,VIS 154GS,A00,511972,Williams; Alena J,21,0,22,1
1713307080351,VIS 160A,A00,490767,Stone; Patricia,7,0,10,3
1713307081380,WCWP 10A,A00,490638,Staff,15,0,15,0
1713307081380,WCWP 10A,B00,490640,Staff,15,0,15,0
1713307082405,WCWP 10B,A00,490641,Staff,0,0,0,0
1713307082405,WCWP 10B,B00,490642,Staff,14,0,15,1
1713307082405,WCWP 10B,C00,490644,Staff,13,0,15,2
1713307082405,WCWP 10B,D00,490647,Staff,0,0,0,0
1713307083430,WCWP 100,A00,490655,Staff,0,0,0,0
1713307083430,WCWP 100,B00,490687,Staff,12,0,15,3
1713307085521,ANAR 153,A00,487222,Braswell; Geoffrey E.,55,0,60,5
1713307086547,ANBI 134,A00,487223,Staff,14,0,20,6
1713307087577,ANBI 143GS,A00,487224,Noel; Geoffroy Pierre Jean,20,0,24,4
1713307088602,ANBI 144GS,A00,519548,Noel; Geoffroy Pierre Jean,20,0,24,4
1713307089629,ANSC 101,A00,487225,Staff,19,0,20,1
1713307090658,ANSC 125,A00,487227,Brenner; Suzanne A,39,0,40,1
1713307092711,ANSC 146,A00,487229,Staff,36,0,40,4
1713307093737,ANSC 148,A00,487230,Olivas Hernandez; Olga Lid,39,0,40,1
1713307094769,ANSC 150,A00,504165,Sloane; Julia Kathryn,19,0,20,1
1713307095792,ANSC 180,A00,487232,Staff,13,0,15,2
1713307096823,ANSC 188,A00,627155,Staff,40,0,40,0
1713307097852,ANTH 5,A00,519529,Semendeferi; Ekaterini,15,0,15,0
1713307098877,ANTH 10,A00,487219,Staff,58,0,60,2
1713307099905,ANTH 23,A01,487221,Staff,17,0,20,3
1713307100937,ANTH 102,A00,487233,Wilder; Linnea Lorene,53,0,60,7
1713307101973,ANTH 103,A00,487234,Varma; Saiba,57,0,60,3
1713307102998,ANTH 105,A00,487235,Stewart; Alexander B,57,0,60,3
1713307104027,BENG 100,A01,516685,Taylor Amos; Alyssa C,28,0,30,2
1713307105116,BIBC 102,A01,491316,Flagg; Matthew Paul,56,0,88,32
1713307105116,BIBC 102,A02,491366,Flagg; Matthew Paul,84,0,88,4
1713307106141,BIBC 103,A01,491486,Boumechache; Miyyada,16,0,24,8
1713307106141,BIBC 103,A02,491487,Boumechache; Miyyada,24,0,24,0
1713307107167,BICD 100,A01,516882,Staff,75,0,75,0
1713307107167,BICD 100,A02,516890,Staff,71,0,75,4
1713307108193,BICD 102GS,A00,491488,Lo; Stanley M.,27,0,28,1
1713307109217,BIEB 136GS,A00,516940,Holway; David A. & Shurin; Jonathan,20,0,24,4
1713307110248,BIEB 137GS,A01,517034,Holway; David A. & Shurin; Jonathan,20,0,24,4
1713307111274,BIEB 138GS,A01,491492,Pirino; Giorgia,22,0,28,6
1713307112299,BILD 1,A01,491296,Staff,62,0,63,1
1713307112299,BILD 1,A02,491297,Staff,63,0,63,0
1713307113328,BILD 4,A01,517099,Gonzalez Gamboa; Ivonne,22,0,24,2
1713307113328,BILD 4,A02,517100,Gonzalez Gamboa; Ivonne,24,0,24,0
1713307114354,BILD 60GS,A00,491309,Lo; Stanley M.,27,0,28,1
1713307115379,BIMM 100,A01,517136,Staff,92,0,100,8
1713307116405,BIMM 110,A01,517182,Staff,77,0,100,23
1713307117432,BIMM 120,A01,517228,Pickett; Brooke Elizabeth,40,0,63,23
1713307117432,BIMM 120,A02,517240,Pickett; Brooke Elizabeth,49,0,63,14
1713307118461,BIMM 132GS,A01,491498,Pirino; Giorgia,22,0,28,6
1713307119486,BIMM 143,A01,491589,Bozinovic; Goran,21,0,40,19
1713307120514,BIPN 100,A01,491594,Armour; Jon Christopher,92,0,100,8
1713307121540,BIPN 140,A01,491602,Marino; Marc J,32,0,50,18
1713307123594,CAT 125,A00,515973,Staff,20,0,20,0
1713307124620,CAT 125GS,A00,515974,Rahimi; Babak,19,0,20,1
1713307125645,CAT 125R,A00,515980,Staff,15,0,20,5
1713307125645,CAT 125R,B00,515981,Tosun; Adriana,19,0,20,1
1713307125645,CAT 125R,C00,515987,Hyland; Tina Mae,4,0,20,16
1713307125645,CAT 125R,D00,515988,Bronstein; Phoebe Malan,18,0,20,2
1713307126670,CENG 15,A01,488699,Drews; Aaron,25,0,25,0
1713307127696,CENG 100,A00,505196,Opatkiewicz; Justin Paul,25,0,25,0
1713307128721,CGS 2A,A01,489598,Staff,33,0,35,2
1713307129749,CGS 112,A00,489599,Staff,15,0,15,0
1713307130774,CGS 119,A00,489603,Staff,10,0,10,0
1713307131805,CGS 120,A00,489604,Staff,14,0,15,1
1713307132832,CGS 150,A00,489607,Staff,15,0,15,0
1713307133871,CHEM 6A,A01,488715,Staff,98,0,100,2
1713307134897,CHEM 6B,A01,488719,Piercy; Marc Anthony,100,0,100,0
1713307135928,CHEM 6C,A01,488723,Albizati; Kim F.,94,0,100,6
1713307136964,CHEM 7L,A01,488728,Schurmeier; Kimberly,18,0,24,6
1713307136964,CHEM 7L,A02,488730,Schurmeier; Kimberly,23,0,24,1
1713307136964,CHEM 7L,A03,488734,Schurmeier; Kimberly,24,0,24,0
1713307136964,CHEM 7L,A04,488763,Schurmeier; Kimberly,23,0,24,1
1713307136964,CHEM 7L,B01,488798,Schurmeier; Kimberly,18,0,24,6
1713307136964,CHEM 7L,B02,488801,Schurmeier; Kimberly,24,0,24,0
1713307136964,CHEM 7L,B03,488808,Schurmeier; Kimberly,24,0,24,0
1713307136964,CHEM 7L,B04,488811,Schurmeier; Kimberly,24,0,24,0
1713307137991,CHEM 11,A01,488897,Stallings; Dontarie M,98,0,100,2
1713307139022,CHEM 40A,A01,488913,Albizati; Kim F.,91,0,100,9
1713307140051,CHEM 40B,A01,488920,Weizman; Haim,48,0,50,2
1713307140051,CHEM 40B,A02,488938,Weizman; Haim,47,0,50,3
1713307141076,CHEM 41A,A01,489029,Klosterman; Jeremy K,58,0,60,2
1713307142101,CHEM 41C,A01,500436,Tor; Yitzhak,55,0,60,5
1713307143136,CHEM 43A,A01,500426,Weizman; Haim,6,0,24,18
1713307143136,CHEM 43A,A02,500430,Weizman; Haim,14,0,24,10
1713307143136,CHEM 43A,B01,514041,Klosterman; Jeremy K,16,0,24,8
1713307143136,CHEM 43A,B02,514047,Klosterman; Jeremy K,23,0,24,1
1713307144162,CHEM 108,A01,489140,Jennings; Patricia A.,14,0,24,10
1713307144162,CHEM 108,A02,489142,Jennings; Patricia A.,15,0,24,9
1713307145187,CHEM 114A,A01,489147,Stallings; Dontarie M,81,0,100,19
1713307146211,CHIN 169A,A00,489171,Wang; Xiao,19,0,20,1
1713307148262,COGS 3,A01,518827,Boyle; Mary E. T.,30,0,40,10
1713307149287,COGS 11,A01,489175,Staff,28,0,30,2
1713307150313,COGS 14A,A01,518829,Staff,53,0,60,7
1713307151340,COGS 14B,A01,489177,Hoffman; Drew Ellen,69,0,75,6
1713307152370,COGS 100,A01,489181,Allen; Michael Gordon,66,0,75,9
1713307153396,COGS 101A,A01,489183,Staff,51,0,60,9
1713307154425,COGS 101B,A01,489185,Allen; Michael Gordon,13,0,30,17
1713307155457,COGS 101C,A01,526786,Staff,25,0,30,5
1713307157513,COGS 107A,A01,489189,Boyle; Mary E. T.,24,0,35,11
1713307158538,COGS 107B,A01,627144,Mooshagian; Eric Frederick,60,0,60,0
1713307159563,COGS 118A,A01,489191,Staff,0,26,40,40
1713307161616,COGS 171GS,A01,489194,Pineda; Jaime A,22,0,28,6
1713307162642,COGS 172,A01,489196,Staff,6,0,30,24
1713307163667,COGS 174GS,A01,489264,Pineda; Jaime A,22,0,28,6
1713307164693,COGS 180,A01,627150,Staff,29,0,30,1
1713307165722,COGS 186,A01,489274,Staff,4,0,30,26
1713307166752,COMM 10,A01,489276,Staff,25,0,25,0
1713307166752,COMM 10,A02,489303,Staff,23,0,25,2
1713307167777,COMM 100A,A01,489312,Staff,21,0,25,4
1713307167777,COMM 100A,A02,489313,Staff,24,0,25,1
1713307168805,COMM 106T,A00,512540,Staff,34,0,35,1
1713307169834,COMM 107,A00,489347,Staff,31,0,35,4
1713307170862,COMM 109P,A00,489358,Staff,31,0,35,4
1713307171887,COMM 132,A00,489361,McKenna; Denise,29,0,30,1
1713307172913,COMM 146,A00,489362,Halm; Gavin Patrick,27,0,30,3
1713307173943,COMM 190,A00,489363,Abuelhiga; Soraya Jill,21,0,23,2
1713307174978,CSE 8A,A50,489366,Staff,23,0,25,2
1713307174978,CSE 8A,A51,489367,Staff,24,0,25,1
1713307176008,CSE 11,A01,489398,Cao; Yingjun,83,0,100,17
1713307177036,CSE 12,A01,489487,Staff,43,0,50,7
1713307178060,CSE 20,A01,489497,Staff,49,0,50,1
1713307179087,CSE 21,A01,489517,Braun; Oliver,44,0,50,6
1713307180112,CSE 101,A01,489524,Braun; Oliver,0,3,50,50
1713307181140,CSE 105,A01,512594,Jones; Miles E,82,0,100,18
1713307181140,CSE 105,B01,512598,Jones; Miles E,70,0,100,30
1713307182171,CSE 140,A01,489538,Staff,44,0,50,6
1713307183202,CSE 141,A01,489550,Eldon; John,76,0,100,24
1713307184229,CSE 141L,A01,489571,Eldon; John,75,0,100,25
1713307185252,CSE 151A,A01,489583,Solares; Edwin A,153,0,200,47
1713307186278,CSE 175,A01,510886,Kumar; Rakesh,30,0,30,0
1713307187307,CSE 190,A00,516828,Dubnov; Shlomo,41,0,49,8
1713307188334,DOC 100D,A00,489667,Pass; Natalye Joann,23,0,25,2
1713307189360,DSC 10,A01,624268,Staff,72,0,75,3
1713307190386,DSC 20,A01,624476,Staff,50,0,50,0
1713307191412,DSC 40A,A01,624608,Staff,40,0,40,0
1713307192438,DSGN 1,A01,489179,Rill; Bryan,37,0,50,13
1713307193466,ECE 17,A01,490489,Sahay; Rajeev,19,0,30,11
1713307194494,ECE 65,A50,490492,Staff,17,0,20,3
1713307194494,ECE 65,A51,490493,Staff,20,0,20,0
1713307195520,ECON 1,A01,489715,Famulari; Melissa,69,0,70,1
1713307196551,ECON 2,A01,489717,Levkoff; Steven B.,68,0,70,2
1713307197576,ECON 3,A01,489948,Staff,70,0,70,0
1713307199630,ECON 5,A01,490103,Staff,28,0,30,2
1713307199630,ECON 5,B01,626281,Dai; Yinlin,45,0,45,0
1713307200654,ECON 100A,A01,490127,Famulari; Melissa,70,0,70,0
1713307201680,ECON 100B,A01,490129,Staff,64,0,70,6
1713307202711,ECON 109,A01,490187,Shishkin; Denis,27,0,35,8
1713307203739,ECON 110A,A01,490190,Levkoff; Steven B.,64,0,70,6
1713307204767,ECON 120A,A01,490245,Dai; Yinlin,68,0,70,2
1713307205802,ECON 120B,A01,490247,Nieto-Barthaburu; Augusto,60,0,70,10
1713307206839,ECON 120C,A01,490253,Sun; Yixiao,32,0,35,3
1713307206839,ECON 120C,B01,490255,Sun; Yixiao,34,0,35,1
1713307207864,ECON 129,A00,490256,Eckert; Fabian Paul,27,0,35,8
1713307208947,ECON 131,A00,490257,Nieto-Barthaburu; Augusto,5,0,35,30
1713307209975,ECON 138,A00,490258,Bharadwaj; Prashant,24,0,35,11
1713307209975,ECON 138,B00,490259,Bharadwaj; Prashant,20,0,35,15
1713307211000,ECON 159,A00,490260,Hendrickson; Gerald M.,0,6,0,0
1713307212036,ECON 178,A01,553995,Zhu; Ying,27,0,35,8
1713307213062,EDS 40,A01,512576,Black; Alison Michelle,20,0,20,0
1713307214091,EDS 107,A01,515848,Staff,30,0,30,0
1713307215115,EDS 110R,A01,490262,Staff,26,0,30,4
1713307216146,EDS 112,A01,490264,Chapman; Thandeka K,44,0,50,6
1713307217175,EDS 113,A00,490266,Staff,27,0,30,3
1713307218201,EDS 118,A00,490267,Warstadt; Melissa Fawn,27,0,30,3
1713307219230,EDS 124BR,A00,490268,Eguchi; Emi,10,0,25,15
1713307219230,EDS 124BR,B00,490269,Eguchi; Emi,25,0,25,0
1713307220259,EDS 126,A01,490271,Jones; Makeba,46,0,50,4
1713307221285,EDS 135,A01,490316,Staff,19,0,20,1
1713307222310,ENVR 142GS,A00,519514,Chang; Edmond Yi-Teh,28,0,28,0
1713307223336,ETHN 103,A00,490504,Staff,33,0,36,3
1713307224360,ETHN 103A,A00,490505,Man; Simeon S,7,0,9,2
1713307225384,ETHN 109,A00,490506,Staff,30,0,30,0
1713307226413,ETHN 118,A00,490507,Staff,35,0,36,1
1713307227438,ETHN 119,A00,490508,Staff,36,0,36,0
1713307228463,ETHN 121R,A00,490518,Choi; Esther Min,30,0,36,6
1713307229490,ETHN 127,A00,490528,Staff,15,0,15,0
1713307230519,ETHN 139,A00,490573,Staff,10,0,10,0
1713307231550,ETHN 150,A00,490575,Staff,15,0,15,0
1713307232577,GLBH 20,A00,491705,Elwardani; Nile Regina,38,0,40,2
1713307233605,GLBH 101,A00,491706,Staff,20,0,20,0
1713307234633,GLBH 111,A01,491708,Burgos; Jose L.,15,0,15,0
1713307235658,GLBH 146,A00,491709,Staff,12,0,20,8
1713307236692,GLBH 148,A00,491710,Olivas Hernandez; Olga Lid,17,0,20,3
1713307237722,GLBH 150,A00,491711,Sloane; Julia Kathryn,20,0,20,0
1713307238748,HIEA 131,A00,491760,Staff,30,0,32,2
1713307239778,HIEA 153,A00,491762,Staff,29,0,30,1
1713307240808,HIEU 124,A00,491811,Staff,26,0,32,6
1713307241836,HIEU 124GS,A00,491812,Markman; Kristina,28,0,28,0
1713307242864,HIEU 147,A00,491813,Staff,30,0,32,2
1713307243901,HIEU 149GS,A00,491816,Caldwell; Michael Alan,28,0,28,0
1713307244936,HILD 2C,A01,491713,Hendrickson; Gerald M.,28,0,30,2
1713307245966,HILD 7B,A01,491715,Kwak; Nancy,17,0,30,13
1713307246991,HILD 10,A01,491717,Staff,14,0,20,6
1713307248018,HILD 30GS,A00,491719,Edington; Claire Ellen,24,0,28,4
1713307249046,HINE 109,A00,491818,Shafir; Nir,30,0,32,2
1713307250091,HINE 128,A00,491821,Shafir; Nir,32,0,32,0
1713307251116,HISC 117,A00,491830,Staff,29,0,32,3
1713307252142,HIUS 103,A00,491834,Man; Simeon S,16,0,23,7
1713307253170,HIUS 108B,A00,491835,Staff,30,0,30,0
1713307254194,HIUS 141,A00,491836,Hendrickson; Gerald M.,29,0,32,3
1713307255220,HIUS 149,A00,491839,Staff,27,0,32,5
1713307256247,HUM 3,A01,512617,Crum; Matthew Stephen,46,0,50,4
1713307256247,HUM 3,A02,512618,Crum; Matthew Stephen,48,0,50,2
1713307257272,HUM 3GS,A00,512663,Markman; Kristina,0,0,0,0
1713307257272,HUM 3GS,B00,512664,Staff,0,0,0,0
1713307258298,HUM 4,A01,512620,West; Geoffrey Scott,37,0,50,13
1713307259326,HUM 4GS,A00,512666,Lyon; Antony J.,0,0,0,3
1713307260367,HUM 4R,A01,512625,Watkins; Eric,49,0,50,1
1713307261400,HUM 5,A01,512649,Zavodny; Tatiana Sophia,34,0,50,16
1713307261400,HUM 5,B01,512661,Zroka; Ryan Edward,49,0,50,1
1713307262427,INTL 190,A00,490577,Segui; Alan S,0,0,0,5
1713307263460,JAPN 20AR,A01,491267,Ross; Kayoko F,12,0,20,8
1713307264492,JAPN 180,A00,491285,Berman; Michael David,34,0,40,6
1713307265520,LATI 50,A01,502536,Kokinis; Troy Andreas,19,0,22,3
1713307265520,LATI 50,A02,502551,Kokinis; Troy Andreas,22,0,22,0
1713307265520,LATI 50,A03,502650,Kokinis; Troy Andreas,22,0,22,0
1713307265520,LATI 50,A04,502909,Kokinis; Troy Andreas,22,0,22,0
1713307266549,LATI 160,A01,502920,Kokinis; Troy Andreas,30,0,30,0
1713307267575,LIFR 1A,A00,490494,Van Moer; Vinciane G,18,0,20,2
1713307268601,LIFR 1AX,A00,490495,Van Moer; Vinciane G,18,0,20,2
1713307269625,LIFR 1B,A00,490496,Van Moer; Vinciane G,20,0,20,0
1713307270650,LIFR 1BX,A00,490497,Van Moer; Vinciane G,20,0,20,0
1713307271676,LIGN 8,A00,505198,McIntosh; Justin Daniel,143,0,150,7
1713307272700,LIGN 9GS,A00,491239,Lott; Margaret S.,18,0,20,2
1713307273725,LIGN 101,A01,505200,McIntosh; Justin Daniel,26,0,30,4
1713307274751,LIGN 120,A01,491244,Staff,25,0,30,5
1713307275779,LIGN 149GS,A00,491245,Lott; Margaret S.,18,0,20,2
1713307276804,LIGN 170,A00,491247,Staff,24,0,30,6
1713307277835,LISP 1D,A00,490498,Munoz Sanchez; Alicia,11,0,14,3
1713307277835,LISP 1D,B00,490499,Munoz Sanchez; Alicia,6,0,14,8
1713307277835,LISP 1D,C00,490500,Munoz Sanchez; Alicia,10,0,14,4
1713307277835,LISP 1D,D00,490501,Munoz Sanchez; Alicia,11,0,14,3
1713307278861,LISP 1DX,A00,490502,Munoz Sanchez; Alicia,18,0,28,10
1713307278861,LISP 1DX,B00,490503,Munoz Sanchez; Alicia,19,0,28,9
1713307280915,LTAM 110,A00,491847,Staff,23,0,25,2
1713307281939,LTCS 119,A00,491848,Staff,13,0,15,2
1713307282965,LTCS 130,A00,491849,Staff,24,0,25,1
1713307285020,LTEA 120C,A00,491852,Staff,35,0,40,5
1713307286049,LTEN 130GS,A00,491853,Lyon; Antony J.,25,0,28,3
1713307287073,LTEN 148,A00,491855,Staff,23,0,25,2
1713307288100,LTEN 159,A00,491856,Staff,21,0,25,4
1713307289125,LTEN 180,A00,491857,Staff,9,0,15,6
1713307291177,LTSP 123GS,A00,505928,Bessett; Ryan Matthew,25,0,28,3
1713307292203,LTSP 174GS,A00,506037,Bessett; Ryan Matthew,25,0,28,3
1713307294255,LTWR 102,A00,491861,Staff,12,0,15,3
1713307295282,LTWR 106,A00,491862,Staff,10,0,15,5
1713307296308,MAE 11,A00,490930,Bahadori; Mohammad Yousef,98,0,100,2
1713307297333,MAE 30A,A00,490931,Qi; Huihui,38,0,40,2
1713307298366,MAE 101A,A00,491036,Sadeghizadeh; Zahra,98,0,100,2
1713307299390,MAE 101C,A00,491037,Seshadri; Kalyanasundaram,78,0,100,22
1713307300418,MAE 113,A00,491040,Seshadri; Kalyanasundaram,67,0,80,13
1713307301444,MAE 131A,A00,491041,Ghazinejad; Maziar,39,0,40,1
1713307302471,MAE 142,A00,491053,Staff,39,0,40,1
1713307303496,MAE 143A,A00,491054,Staff,41,0,50,9
1713307304525,MAE 150,A00,491092,Truong; Phuong Thi Ngoc,24,0,35,11
1713307305555,MATH 3C,A01,494031,Pardo Guerra; Sebastian,30,0,30,0
1713307305555,MATH 3C,A02,494032,Pardo Guerra; Sebastian,29,0,30,1
1713307306581,MATH 10A,A01,494034,Staff,28,0,30,2
1713307306581,MATH 10A,A02,494035,Staff,29,0,30,1
1713307306581,MATH 10A,B01,494037,Staff,28,0,30,2
1713307306581,MATH 10A,B02,494038,Staff,29,0,30,1
1713307307617,MATH 10B,A01,494040,Habib; Yousaf,24,0,30,6
1713307307617,MATH 10B,A02,494041,Habib; Yousaf,28,0,30,2
1713307307617,MATH 10B,A03,494042,Habib; Yousaf,30,0,30,0
1713307307617,MATH 10B,A04,494043,Habib; Yousaf,30,0,30,0
1713307307617,MATH 10B,B01,494045,Habib; Yousaf,28,0,30,2
1713307307617,MATH 10B,B02,494046,Habib; Yousaf,30,0,30,0
1713307307617,MATH 10B,B03,494047,Habib; Yousaf,30,0,30,0
1713307307617,MATH 10B,B04,494048,Habib; Yousaf,30,0,30,0
1713307308646,MATH 18,A01,494050,Kemp; Todd Aahron,27,0,30,3
1713307308646,MATH 18,A02,494051,Kemp; Todd Aahron,29,0,30,1
1713307308646,MATH 18,B01,494054,Kemp; Todd Aahron,28,0,30,2
1713307308646,MATH 18,B02,494055,Kemp; Todd Aahron,29,0,30,1
1713307309672,MATH 20A,A01,494059,Suk; Andrew Hoon,30,0,30,0
1713307310700,MATH 20B,A01,494061,Briones; Jor-el Thomas Caparas,34,0,35,1
1713307310700,MATH 20B,B01,494063,Bach; Quang Tran,34,0,35,1
1713307311727,MATH 20C,A01,494065,Staff,28,0,30,2
1713307311727,MATH 20C,A02,494066,Staff,30,0,30,0
1713307311727,MATH 20C,A03,494067,Staff,30,0,30,0
1713307311727,MATH 20C,A04,494068,Staff,30,0,30,0
1713307311727,MATH 20C,B01,494070,Zhang; Ming,26,0,30,4
1713307311727,MATH 20C,B02,494071,Zhang; Ming,30,0,30,0
1713307311727,MATH 20C,B03,494072,Zhang; Ming,29,0,30,1
1713307311727,MATH 20C,B04,494073,Zhang; Ming,28,0,30,2
1713307312808,MATH 20D,A01,494075,Staff,26,0,30,4
1713307312808,MATH 20D,A02,494076,Staff,30,0,30,0
1713307313840,MATH 20E,A01,494079,Staff,25,0,30,5
1713307313840,MATH 20E,A02,494080,Staff,27,0,30,3
1713307313840,MATH 20E,B01,494082,Staff,28,0,30,2
1713307313840,MATH 20E,B02,494083,Staff,25,0,30,5
1713307314873,MATH 103A,A01,494085,Aliabadi Sr.; Mohsen,19,0,30,11
1713307314873,MATH 103A,A02,494086,Aliabadi Sr.; Mohsen,29,0,30,1
1713307314873,MATH 103A,B01,494088,Aliabadi Sr.; Mohsen,22,0,30,8
1713307314873,MATH 103A,B02,494089,Aliabadi Sr.; Mohsen,28,0,30,2
1713307315898,MATH 109,A01,494091,Staff,30,0,30,0
1713307315898,MATH 109,A02,494092,Staff,30,0,30,0
1713307315898,MATH 109,B01,494094,Staff,28,0,30,2
1713307315898,MATH 109,B02,494095,Staff,29,0,30,1
1713307316925,MATH 142A,A01,494097,Chow; Bennett,16,0,30,14
1713307316925,MATH 142A,A02,494098,Chow; Bennett,24,0,30,6
1713307316925,MATH 142A,B01,494100,Chow; Bennett,20,0,30,10
1713307316925,MATH 142A,B02,494101,Chow; Bennett,29,0,30,1
1713307318986,MATH 168A,A01,516677,Dumitriu; Ioana,17,0,35,18
1713307320012,MATH 170A,A01,516679,Dumitriu; Ioana,21,0,30,9
1713307320012,MATH 170A,A02,516680,Dumitriu; Ioana,28,0,30,2
1713307321037,MATH 193A,A01,494107,Staff,17,0,30,13
1713307321037,MATH 193A,A02,494108,Staff,25,0,30,5
1713307321037,MATH 193A,A03,494109,Staff,29,0,30,1
1713307321037,MATH 193A,A04,494110,Staff,25,0,30,5
1713307324115,MGT 16,A00,491930,McKay; Michael J,94,0,98,4
1713307325140,MGT 18,A00,491992,McKay; Michael J,97,0,98,1
1713307326163,MGT 71,A00,492003,Staff,78,0,98,20
1713307327193,MGT 103,A00,505209,Eberhard; Craig A,87,0,98,11
1713307328217,MGT 131A,A00,505210,Anderson; John Charles,91,0,98,7
1713307330267,MGT 153,A00,492077,Perols; Johan Lars,49,0,90,41
1713307333344,MGT 164,A00,492222,McKay; Mary A,94,0,98,4
1713307334375,MGT 172,A00,492245,Staff,59,0,60,1
1713307334375,MGT 172,B00,505526,Hedges; Kathleen,78,0,98,20
1713307335400,MGT 181,A00,505669,Dunn; Louis Jean,88,0,98,10
1713307336427,MMW 14,A01,494399,Staff,23,0,28,5
1713307336427,MMW 14,A02,494400,Staff,26,0,28,2
1713307336427,MMW 14,A03,494401,Staff,28,0,28,0
1713307336427,MMW 14,A04,494402,Staff,28,0,28,0
1713307336427,MMW 14,B01,494404,Carreras; Maria Victoria,18,0,28,10
1713307336427,MMW 14,B02,494405,Carreras; Maria Victoria,27,0,28,1
1713307336427,MMW 14,B03,494406,Carreras; Maria Victoria,28,0,28,0
1713307336427,MMW 14,B04,494407,Carreras; Maria Victoria,28,0,28,0
1713307337453,MMW 14GS,A00,506250,Chang; Edmond Yi-Teh,0,0,0,0
1713307338477,MMW 121R,A01,494415,Adamiak; Patrick John,15,0,28,13
1713307338477,MMW 121R,A02,494416,Adamiak; Patrick John,25,0,28,3
1713307339503,MUS 1A,A01,494113,Staff,12,0,25,13
1713307339503,MUS 1A,A02,494114,Staff,25,0,25,0
1713307340529,MUS 4,A01,494116,Staff,24,0,25,1
1713307340529,MUS 4,A02,494117,Staff,22,0,25,3
1713307341554,MUS 5R,A01,494236,Dubnov; Shlomo,12,0,25,13
1713307341554,MUS 5R,A02,494237,Dubnov; Shlomo,25,0,25,0
1713307342704,MUS 6,A01,494122,Staff,16,0,25,9
1713307342704,MUS 6,A02,494123,Staff,24,0,25,1
1713307343731,MUS 7,A01,494125,Staff,17,0,25,8
1713307343731,MUS 7,A02,494126,Staff,24,0,25,1
1713307344757,MUS 11,A01,494128,Staff,23,0,25,2
1713307344757,MUS 11,A02,494129,Staff,25,0,25,0
1713307345783,MUS 13,A01,494131,Staff,25,0,25,0
1713307345783,MUS 13,A02,494132,Staff,25,0,25,0
1713307346810,MUS 15,A01,494134,Staff,20,0,25,5
1713307346810,MUS 15,A02,494135,Staff,25,0,25,0
1713307346810,MUS 15,B01,494137,Staff,24,0,25,1
1713307347840,MUS 80,A00,494232,Staff,25,0,25,0
1713307347840,MUS 80,B00,494233,Staff,25,0,25,0
1713307347840,MUS 80,C00,494234,Staff,23,0,25,2
1713307348864,MUS 95C,A00,494141,Staff,73,0,75,2
1713307349887,MUS 114,A00,494142,Staff,42,0,50,8
1713307350921,NANO 15,A01,490636,Drews; Aaron,7,0,7,0
1713307351949,PHIL 1,A00,490578,Grush; Rick Scott,50,0,50,0
1713307352982,PHIL 10,A01,490580,Grush; Rick Scott,34,0,35,1
1713307352982,PHIL 10,A02,490586,Grush; Rick Scott,33,0,35,2
1713307354006,PHIL 27,A01,490591,Staff,24,0,25,1
1713307354006,PHIL 27,A02,490592,Staff,25,0,25,0
1713307354006,PHIL 27,A03,490593,Staff,25,0,25,0
1713307354006,PHIL 27,A04,490598,Staff,25,0,25,0
1713307355031,PHIL 32,A01,490611,Staff,20,0,20,0
1713307355031,PHIL 32,A02,490618,Staff,20,0,20,0
1713307356062,PHIL 90,A00,490624,Staff,40,0,40,0
1713307357088,PHIL 136,A00,490627,Cohen; Jonathan David,38,0,40,2
1713307358115,PHIL 155,A00,490634,Staff,67,0,70,3
1713307359146,PHYS 1A,A00,491610,Staff,246,0,250,4
1713307360172,PHYS 1AL,001,491616,Tsai; Philbert S,28,0,30,2
1713307360172,PHYS 1AL,002,491618,Tsai; Philbert S,30,0,30,0
1713307361200,PHYS 1B,A00,491623,Staff,244,0,250,6
1713307362230,PHYS 1BL,001,491626,Tsai; Philbert S,26,0,30,4
1713307362230,PHYS 1BL,002,491628,Tsai; Philbert S,28,0,30,2
1713307363256,PHYS 1C,A00,491632,Staff,227,0,245,18
1713307364287,PHYS 1CL,001,491635,Tsai; Philbert S,13,0,30,17
1713307364287,PHYS 1CL,002,491643,Tsai; Philbert S,24,0,30,6
1713307365317,PHYS 2AR,A01,491651,Meyertholen; Andrew D.,46,0,50,4
1713307366343,PHYS 2B,A01,491659,Staff,107,0,115,8
1713307367368,PHYS 2BL,A01,491685,Staff,23,0,24,1
1713307367368,PHYS 2BL,A02,491700,Staff,23,0,24,1
1713307368390,PHYS 2C,A01,505161,Staff,107,0,115,8
1713307369419,PHYS 4A,A01,491704,Grinstein; Benjamin,99,0,100,1
1713307370449,POLI 5D,A01,494144,Staff,3,0,5,2
1713307370449,POLI 5D,B01,626283,Dai; Yinlin,5,0,5,0
1713307371475,POLI 12,A00,494145,Staff,44,0,45,1
1713307372501,POLI 13R,A00,494146,Forman; Fonna,47,0,50,3
1713307373526,POLI 27,A01,494148,Staff,59,0,60,1
1713307374551,POLI 30,A00,494149,Staff,49,0,50,1
1713307375574,POLI 100DA,A00,494150,Staff,23,0,25,2
1713307377629,POLI 100I,A00,494152,Staff,28,0,30,2
1713307378654,POLI 104B,A00,494153,Smith; Glenn Chatmas,54,0,55,1
1713307379681,POLI 104F,A00,494154,Staff,28,0,30,2
1713307380708,POLI 104I,A00,494155,Smith; Glenn Chatmas,30,0,30,0
1713307381732,POLI 110C,A00,494156,Ingham; Sean,23,0,25,2
1713307382756,POLI 117R,A00,494157,Forman; Fonna,15,0,20,5
1713307383782,POLI 118,A00,494158,Ingham; Sean,23,0,25,2
1713307384809,POLI 120H,A00,494159,Fisk; David Lee,41,0,45,4
1713307385834,POLI 131CR,A00,494160,Hoston; Germaine,40,0,45,5
1713307386863,POLI 133J,A00,494161,Staff,33,0,35,2
1713307387890,POLI 135,A00,494162,Fisk; David Lee,33,0,35,2
1713307388918,POLI 140A,A00,494164,Staff,22,0,30,8
1713307389944,POLI 142I,A00,494165,Staff,30,0,30,0
1713307390970,POLI 144D,A00,494166,Staff,23,0,25,2
1713307391995,POLI 151,A00,494167,Staff,30,0,30,0
1713307393024,POLI 153,A00,494168,Staff,33,0,35,2
1713307394048,POLI 160AA,A00,494169,Staff,36,0,40,4
1713307395075,POLI 162,A00,494170,Mignozzetti; Umberto,21,0,25,4
1713307396103,POLI 171,A00,494171,Mignozzetti; Umberto,23,0,25,2
1713307397130,PSYC 1,A00,494172,Staff,97,0,100,3
1713307398157,PSYC 2,A00,494173,Moranton; Nirelia Melbina-,45,0,50,5
1713307399182,PSYC 3,A00,494174,Staff,30,0,30,0
1713307400210,PSYC 6,A00,494175,Staff,17,0,20,3
1713307401239,PSYC 60,A01,494177,Staff,42,0,45,3
1713307402266,PSYC 70,A01,505724,Geller; Emma Harlan,42,0,45,3
1713307403295,PSYC 101,A00,494180,Heyman; Gail D.,87,0,100,13
1713307404323,PSYC 105,A00,494181,Geller; Emma Harlan,66,0,90,24
1713307405353,PSYC 106,A00,494182,Dobkins; Karen R.,33,0,45,12
1713307406379,PSYC 108,A00,494183,Adrian; Julia Anna,94,0,100,6
1713307407403,PSYC 114,A01,494185,Winkielman; Piotr,5,0,30,25
1713307408431,PSYC 122,A00,494186,Moranton; Nirelia Melbina-,40,0,50,10
1713307409457,PSYC 124,A00,494187,Chapman; Eddie Nathaniel,72,0,80,8
1713307410482,PSYC 131,A00,494188,Anagnostaras; Stephan,59,0,80,21
1713307411509,PSYC 144,A00,494189,Staff,22,0,50,28
1713307412533,PSYC 154,A00,494190,Lacefield; Katharine I,137,0,180,43
1713307413559,PSYC 162,A00,494191,Wixted; John T,86,0,100,14
1713307414583,PSYC 172,A00,494192,Gorman; Michael R.,38,0,45,7
1713307415612,PSYC 178,A00,494193,Glaser; Dale,41,0,45,4
1713307416691,PSYC 193,A00,505725,Chapman; Eddie Nathaniel,20,0,20,0
1713307417721,RELI 145GS,A00,519817,Rahimi; Babak,19,0,20,1
1713307418749,SE 101A,A01,490862,Chadha; Mayank,24,0,25,1
1713307419779,SE 101C,A01,490924,Krysl; Petr,18,0,20,2
1713307420803,SE 110A,A01,490928,Staff,20,0,20,0
1713307421828,SE 130A,A00,490929,Morrison; Machel Leigh,64,0,70,6
1713307422854,SIO 1,A01,519325,Staff,39,0,40,1
1713307423879,SIO 30,A01,519327,Staff,40,0,40,0
1713307424904,SIO 40,A00,519328,Staff,40,0,40,0
1713307425936,SIO 46GS,A00,519819,Cook; Geoffrey W,18,0,25,7
1713307426960,SIO 109R,A00,494197,Forman; Fonna,8,0,20,12
1713307427988,SIO 121GS,A00,519827,Cook; Geoffrey W,18,0,25,7
1713307429012,SIO 132,A01,519330,Staff,38,0,40,2
1713307430042,SIO 133,A01,519397,Staff,38,0,40,2
1713307431066,SIO 139,A00,519396,Kacev; David,33,0,40,7
1713307432092,SOCI 1,A01,494199,Thorpe; Charles Robert,24,0,30,6
1713307432092,SOCI 1,A02,494200,Thorpe; Charles Robert,30,0,30,0
1713307432092,SOCI 1,A03,494201,Thorpe; Charles Robert,29,0,30,1
1713307432092,SOCI 1,A04,494202,Thorpe; Charles Robert,29,0,30,1
1713307432092,SOCI 1,A05,494203,Thorpe; Charles Robert,29,0,30,1
1713307432092,SOCI 1,A06,494204,Thorpe; Charles Robert,30,0,30,0
1713307432092,SOCI 1,A07,494205,Thorpe; Charles Robert,29,0,30,1
1713307433117,SOCI 60,A01,494207,Staff,36,0,40,4
1713307433117,SOCI 60,A02,494208,Staff,39,0,40,1
1713307434142,SOCI 100,A01,494210,Payne; Christine Anna,28,0,30,2
1713307434142,SOCI 100,A02,494211,Payne; Christine Anna,28,0,30,2
1713307435168,SOCI 109M,A00,494212,Staff,20,0,20,0
1713307436199,SOCI 110,A00,494213,Staff,35,0,40,5
1713307438269,SOCI 118E,A00,494215,Ng; Kwai,38,0,40,2
1713307439300,SOCI 125,A00,494216,Calderon-Zaks; Michael Aar,42,0,45,3
1713307440331,SOCI 126,A01,494218,Jones; Makeba,4,0,5,1
1713307441361,SOCI 131,A00,494219,Thorpe; Charles Robert,30,0,30,0
1713307443413,SOCI 135,A00,494221,Payne; Christine Anna,41,0,50,9
1713307444446,SOCI 136E,A00,626690,Ruiz; Jonathan Joseph,25,0,25,0
1713307445470,SOCI 138GS,A00,494222,Navon; Daniel,24,0,28,4
1713307447519,SOCI 145,A00,494224,Staff,42,0,45,3
1713307448543,SOCI 153,A00,494225,Staff,28,0,30,2
1713307449571,SOCI 160E,A00,494226,Ng; Kwai,33,0,40,7
1713307450600,SOCI 180,A00,494227,Staff,29,0,30,1
1713307451624,SOCI 189GS,A00,494228,Ribas Norris; Janet Vanesa,11,0,11,0
1713307452652,SOCI 190GS,A00,553232,Ribas Norris; Janet Vanesa,11,0,11,0
1713307453681,SOMI 220,A00,627178,Schneid; Stephen David,30,0,30,0
1713307454708,SYN 2,001,490768,Staff,14,0,15,1
1713307454708,SYN 2,002,490769,Staff,15,0,15,0
1713307454708,SYN 2,004,490775,Staff,0,0,0,0
1713307454708,SYN 2,003,490774,Staff,0,0,0,0
1713307454708,SYN 2,005,490776,Staff,0,0,0,0
1713307455733,SYN 2R,001,490779,Staff,14,0,15,1
1713307455733,SYN 2R,002,514635,Staff,14,0,15,1
1713307456908,SYN 100,A01,490783,Staff,17,0,20,3
1713307456908,SYN 100,B01,490787,Staff,12,0,20,8
1713307456908,SYN 100,C01,490789,Staff,13,0,20,7
1713307457936,SYN 150,A00,490817,Staff,14,0,15,1
1713307457936,SYN 150,B00,514610,Staff,15,0,15,0
1713307458963,TDAC 1,A00,492753,Walsh; Kim C.,19,0,20,1
1713307458963,TDAC 1,B00,492754,Harting; Carla Kelso,19,0,20,1
1713307458963,TDAC 1,C00,513995,Salovey; Todd,18,0,20,2
1713307459992,TDAC 101,A00,492766,Harting; Carla Kelso,19,0,20,1
1713307461018,TDAC 102,A00,492768,Basso; Beatrice,20,0,20,0
1713307462048,TDDE 111,A00,492769,Staff,25,0,25,0
1713307463072,TDDE 131,A00,492770,Staff,15,0,15,0
1713307463072,TDDE 131,B00,492771,Staff,15,0,15,0
1713307464100,TDDE 131GS,A00,523716,Guirguis; Mark C,25,0,28,3
1713307465135,TDGE 1,A01,492756,Salovey; Todd,57,0,60,3
1713307466164,TDGE 5,A01,492758,Staff,24,0,25,1
1713307467192,TDGE 10,A00,492759,Fulton; Julia,215,0,220,5
1713307468218,TDGE 11,A00,492760,Castro; Robert Jess,200,0,200,0
1713307469245,TDGE 50,A00,492761,Blair; Kyle Adam,0,0,0,0
1713307470270,TDGE 124,A00,492772,Fulton; Julia,197,0,220,23
1713307471302,TDGE 125,A00,492773,Meyer; Ursula,41,0,50,9
1713307471302,TDGE 125,B00,492774,Staff,50,0,50,0
1713307471302,TDGE 125,C00,523565,Staff,49,0,50,1
1713307472331,TDGE 125GS,A00,523580,Guirguis; Mark C,25,0,28,3
1713307473360,TDGE 127,A00,492775,Havis; Allan,43,0,50,7
1713307474385,TDHT 101,A00,492776,Staff,35,0,35,0
1713307475414,TDMV 1,A00,492762,Caligagan; Maria T.,30,0,30,0
1713307475414,TDMV 1,B00,492763,Arcidiacono; Kristin,26,0,30,4
1713307476444,TDMV 2,A00,492764,Weinberg; Sadie,29,0,30,1
1713307477475,TDMV 3,A00,492765,Mack; Kara Shanai',39,0,40,1
1713307478498,TDMV 138,A00,492777,Mack; Kara Shanai',37,0,40,3
1713307479524,TDMV 140,A00,492778,Lima; Paulo Henrique,40,0,40,0
1713307480548,TDMV 142,A00,492779,Caligagan; Maria T.,37,0,40,3
1713307480548,TDMV 142,B00,492780,Caligagan; Tony,38,0,40,2
1713307481574,TDMV 143,A00,492781,Fyall; Daunte Edward,40,0,40,0
1713307482612,USP 1,A01,492401,Kwak; Nancy,26,0,35,9
1713307483636,USP 2,A01,492453,Hinds; Juli Beth,35,0,35,0
1713307484662,USP 3,A01,492516,Staff,30,0,35,5
1713307485691,USP 4,A00,492522,McTague; Sarah,19,0,25,6
1713307486818,USP 100,A00,492523,Staff,33,0,35,2
1713307487846,USP 101,A00,492524,Staff,13,0,15,2
1713307488875,USP 105,A00,492525,Staff,22,0,25,3
1713307489905,USP 151,A00,492526,Shenkman; Michael Thomas,33,0,35,2
1713307490934,USP 170,A00,492545,Hinds; Juli Beth,33,0,35,2
1713307491959,USP 171GS,A00,492608,Bussell; Mirle Rabinowitz,26,0,28,2
1713307492989,USP 183GS,A00,492613,Peerson; Susan,26,0,28,2
1713307494013,VIS 30,A01,490693,Yoldas; Pinar,21,0,22,1
1713307494013,VIS 30,A02,490694,Yoldas; Pinar,19,0,22,3
1713307495040,VIS 83,A00,490695,Kester; Grant,68,0,75,7
1713307496065,VIS 105D,A00,490696,Staff,22,0,25,3
1713307497090,VIS 124CN,A00,490699,Rose; Jordan M,68,0,75,7
1713307498113,VIS 125GS,A00,511221,Williams; Alena J,21,0,22,1
1713307499143,VIS 128D,A00,490700,Staff,74,0,75,1
1713307500172,VIS 151,A01,490717,Staff,34,0,34,0
1713307500172,VIS 151,A02,490766,Staff,33,0,34,1
1713307501196,VIS 154GS,A00,511972,Williams; Alena J,21,0,22,1
1713307502221,VIS 160A,A00,490767,Stone; Patricia,7,0,10,3
1713307503253,WCWP 10A,A00,490638,Staff,15,0,15,0
1713307503253,WCWP 10A,B00,490640,Staff,15,0,15,0
1713307504278,WCWP 10B,A00,490641,Staff,0,0,0,0
1713307504278,WCWP 10B,B00,490642,Staff,14,0,15,1
1713307504278,WCWP 10B,C00,490644,Staff,13,0,15,2
1713307504278,WCWP 10B,D00,490647,Staff,0,0,0,0
1713307505306,WCWP 100,A00,490655,Staff,0,0,0,0
1713307505306,WCWP 100,B00,490687,Staff,12,0,15,3
1713307507452,ANAR 153,A00,487222,Braswell; Geoffrey E.,55,0,60,5
1713307508478,ANBI 134,A00,487223,Staff,14,0,20,6
1713307509505,ANBI 143GS,A00,487224,Noel; Geoffroy Pierre Jean,20,0,24,4
1713307510531,ANBI 144GS,A00,519548,Noel; Geoffroy Pierre Jean,20,0,24,4
1713307511557,ANSC 101,A00,487225,Staff,19,0,20,1
1713307512589,ANSC 125,A00,487227,Brenner; Suzanne A,39,0,40,1
1713307514642,ANSC 146,A00,487229,Staff,36,0,40,4
1713307515673,ANSC 148,A00,487230,Olivas Hernandez; Olga Lid,39,0,40,1
1713307516698,ANSC 150,A00,504165,Sloane; Julia Kathryn,19,0,20,1
1713307517724,ANSC 180,A00,487232,Staff,13,0,15,2
1713307518751,ANSC 188,A00,627155,Staff,40,0,40,0
1713307519780,ANTH 5,A00,519529,Semendeferi; Ekaterini,15,0,15,0
1713307520874,ANTH 10,A00,487219,Staff,58,0,60,2
1713307521900,ANTH 23,A01,487221,Staff,17,0,20,3
1713307522925,ANTH 102,A00,487233,Wilder; Linnea Lorene,53,0,60,7
1713307523954,ANTH 103,A00,487234,Varma; Saiba,57,0,60,3
1713307524982,ANTH 105,A00,487235,Stewart; Alexander B,57,0,60,3
1713307526011,BENG 100,A01,516685,Taylor Amos; Alyssa C,28,0,30,2
1713307527036,BIBC 102,A01,491316,Flagg; Matthew Paul,56,0,88,32
1713307527036,BIBC 102,A02,491366,Flagg; Matthew Paul,84,0,88,4
1713307528061,BIBC 103,A01,491486,Boumechache; Miyyada,16,0,24,8
1713307528061,BIBC 103,A02,491487,Boumechache; Miyyada,24,0,24,0
1713307529090,BICD 100,A01,516882,Staff,75,0,75,0
1713307529090,BICD 100,A02,516890,Staff,70,0,75,5
1713307530116,BICD 102GS,A00,491488,Lo; Stanley M.,27,0,28,1
1713307531146,BIEB 136GS,A00,516940,Holway; David A. & Shurin; Jonathan,20,0,24,4
1713307532175,BIEB 137GS,A01,517034,Holway; David A. & Shurin; Jonathan,20,0,24,4
1713307533200,BIEB 138GS,A01,491492,Pirino; Giorgia,22,0,28,6
1713307534225,BILD 1,A01,491296,Staff,62,0,63,1
1713307534225,BILD 1,A02,491297,Staff,63,0,63,0
1713307535256,BILD 4,A01,517099,Gonzalez Gamboa; Ivonne,22,0,24,2
1713307535256,BILD 4,A02,517100,Gonzalez Gamboa; Ivonne,24,0,24,0
1713307536281,BILD 60GS,A00,491309,Lo; Stanley M.,27,0,28,1
1713307537316,BIMM 100,A01,517136,Staff,92,0,100,8
1713307538359,BIMM 110,A01,517182,Staff,76,0,100,24
1713307539388,BIMM 120,A01,517228,Pickett; Brooke Elizabeth,40,0,63,23
1713307539388,BIMM 120,A02,517240,Pickett; Brooke Elizabeth,48,0,63,15
1713307540417,BIMM 132GS,A01,491498,Pirino; Giorgia,22,0,28,6
1713307541444,BIMM 143,A01,491589,Bozinovic; Goran,21,0,40,19
1713307542468,BIPN 100,A01,491594,Armour; Jon Christopher,92,0,100,8
1713307543492,BIPN 140,A01,491602,Marino; Marc J,32,0,50,18
1713307545545,CAT 125,A00,515973,Staff,20,0,20,0
1713307546573,CAT 125GS,A00,515974,Rahimi; Babak,19,0,20,1
1713307547600,CAT 125R,A00,515980,Staff,15,0,20,5
1713307547600,CAT 125R,B00,515981,Tosun; Adriana,19,0,20,1
1713307547600,CAT 125R,C00,515987,Hyland; Tina Mae,3,0,20,17
1713307547600,CAT 125R,D00,515988,Bronstein; Phoebe Malan,18,0,20,2
1713307548626,CENG 15,A01,488699,Drews; Aaron,25,0,25,0
1713307549656,CENG 100,A00,505196,Opatkiewicz; Justin Paul,25,0,25,0
1713307550682,CGS 2A,A01,489598,Staff,33,0,35,2
1713307551710,CGS 112,A00,489599,Staff,15,0,15,0
1713307552739,CGS 119,A00,489603,Staff,10,0,10,0
1713307553763,CGS 120,A00,489604,Staff,14,0,15,1
1713307554790,CGS 150,A00,489607,Staff,15,0,15,0
1713307555820,CHEM 6A,A01,488715,Staff,98,0,100,2
1713307556847,CHEM 6B,A01,488719,Piercy; Marc Anthony,100,0,100,0
1713307557873,CHEM 6C,A01,488723,Albizati; Kim F.,94,0,100,6
1713307558910,CHEM 7L,A01,488728,Schurmeier; Kimberly,18,0,24,6
1713307558910,CHEM 7L,A02,488730,Schurmeier; Kimberly,23,0,24,1
1713307558910,CHEM 7L,A03,488734,Schurmeier; Kimberly,24,0,24,0
1713307558910,CHEM 7L,A04,488763,Schurmeier; Kimberly,23,0,24,1
1713307558910,CHEM 7L,B01,488798,Schurmeier; Kimberly,18,0,24,6
1713307558910,CHEM 7L,B02,488801,Schurmeier; Kimberly,24,0,24,0
1713307558910,CHEM 7L,B03,488808,Schurmeier; Kimberly,24,0,24,0
1713307558910,CHEM 7L,B04,488811,Schurmeier; Kimberly,24,0,24,0
1713307559934,CHEM 11,A01,488897,Stallings; Dontarie M,98,0,100,2
1713307560958,CHEM 40A,A01,488913,Albizati; Kim F.,91,0,100,9
1713307561989,CHEM 40B,A01,488920,Weizman; Haim,48,0,50,2
1713307561989,CHEM 40B,A02,488938,Weizman; Haim,47,0,50,3
1713307563016,CHEM 41A,A01,489029,Klosterman; Jeremy K,58,0,60,2
1713307564047,CHEM 41C,A01,500436,Tor; Yitzhak,55,0,60,5
1713307565080,CHEM 43A,A01,500426,Weizman; Haim,6,0,24,18
1713307565080,CHEM 43A,A02,500430,Weizman; Haim,14,0,24,10
1713307565080,CHEM 43A,B01,514041,Klosterman; Jeremy K,16,0,24,8
1713307565080,CHEM 43A,B02,514047,Klosterman; Jeremy K,23,0,24,1
1713307566104,CHEM 108,A01,489140,Jennings; Patricia A.,14,0,24,10
1713307566104,CHEM 108,A02,489142,Jennings; Patricia A.,15,0,24,9
1713307567132,CHEM 114A,A01,489147,Stallings; Dontarie M,81,0,100,19
1713307568159,CHIN 169A,A00,489171,Wang; Xiao,19,0,20,1
1713307570218,COGS 3,A01,518827,Boyle; Mary E. T.,30,0,40,10
1713307571244,COGS 11,A01,489175,Staff,28,0,30,2
1713307572269,COGS 14A,A01,518829,Staff,53,0,60,7
1713307573296,COGS 14B,A01,489177,Hoffman; Drew Ellen,69,0,75,6
1713307574326,COGS 100,A01,489181,Allen; Michael Gordon,66,0,75,9
1713307575350,COGS 101A,A01,489183,Staff,51,0,60,9
1713307576376,COGS 101B,A01,489185,Allen; Michael Gordon,13,0,30,17
1713307577405,COGS 101C,A01,526786,Staff,25,0,30,5
1713307579457,COGS 107A,A01,489189,Boyle; Mary E. T.,24,0,35,11
1713307580484,COGS 107B,A01,627144,Mooshagian; Eric Frederick,60,0,60,0
1713307581508,COGS 118A,A01,489191,Staff,0,26,40,40
1713307583558,COGS 171GS,A01,489194,Pineda; Jaime A,22,0,28,6
1713307584584,COGS 172,A01,489196,Staff,6,0,30,24
1713307585612,COGS 174GS,A01,489264,Pineda; Jaime A,22,0,28,6
1713307586636,COGS 180,A01,627150,Staff,29,0,30,1
1713307587662,COGS 186,A01,489274,Staff,4,0,30,26
1713307588691,COMM 10,A01,489276,Staff,24,0,25,1
1713307588691,COMM 10,A02,489303,Staff,23,0,25,2
1713307589719,COMM 100A,A01,489312,Staff,21,0,25,4
1713307589719,COMM 100A,A02,489313,Staff,24,0,25,1
1713307590744,COMM 106T,A00,512540,Staff,34,0,35,1
1713307591867,COMM 107,A00,489347,Staff,31,0,35,4
1713307592897,COMM 109P,A00,489358,Staff,31,0,35,4
1713307593926,COMM 132,A00,489361,McKenna; Denise,29,0,30,1
1713307594952,COMM 146,A00,489362,Halm; Gavin Patrick,27,0,30,3
1713307595982,COMM 190,A00,489363,Abuelhiga; Soraya Jill,21,0,23,2
1713307597010,CSE 8A,A50,489366,Staff,23,0,25,2
1713307597010,CSE 8A,A51,489367,Staff,24,0,25,1
1713307598044,CSE 11,A01,489398,Cao; Yingjun,83,0,100,17
1713307599070,CSE 12,A01,489487,Staff,43,0,50,7
1713307600098,CSE 20,A01,489497,Staff,49,0,50,1
1713307601127,CSE 21,A01,489517,Braun; Oliver,44,0,50,6
1713307602156,CSE 101,A01,489524,Braun; Oliver,0,5,50,50
1713307603185,CSE 105,A01,512594,Jones; Miles E,82,0,100,18
1713307603185,CSE 105,B01,512598,Jones; Miles E,70,0,100,30
1713307604212,CSE 140,A01,489538,Staff,44,0,50,6
1713307605246,CSE 141,A01,489550,Eldon; John,76,0,100,24
1713307606272,CSE 141L,A01,489571,Eldon; John,75,0,100,25
1713307607297,CSE 151A,A01,489583,Solares; Edwin A,152,0,200,48
1713307608327,CSE 175,A01,510886,Kumar; Rakesh,30,0,30,0
1713307609351,CSE 190,A00,516828,Dubnov; Shlomo,41,0,49,8
1713307610381,DOC 100D,A00,489667,Pass; Natalye Joann,23,0,25,2
1713307611407,DSC 10,A01,624268,Staff,72,0,75,3
1713307612431,DSC 20,A01,624476,Staff,50,0,50,0
1713307613459,DSC 40A,A01,624608,Staff,40,0,40,0
1713307614487,DSGN 1,A01,489179,Rill; Bryan,37,0,50,13
1713307615513,ECE 17,A01,490489,Sahay; Rajeev,19,0,30,11
1713307616543,ECE 65,A50,490492,Staff,17,0,20,3
1713307616543,ECE 65,A51,490493,Staff,20,0,20,0
1713307617569,ECON 1,A01,489715,Famulari; Melissa,69,0,70,1
1713307618595,ECON 2,A01,489717,Levkoff; Steven B.,68,0,70,2
1713307619624,ECON 3,A01,489948,Staff,70,0,70,0
1713307621677,ECON 5,A01,490103,Staff,28,0,30,2
1713307621677,ECON 5,B01,626281,Dai; Yinlin,45,0,45,0
1713307622705,ECON 100A,A01,490127,Famulari; Melissa,69,0,70,1
1713307623734,ECON 100B,A01,490129,Staff,64,0,70,6
1713307624813,ECON 109,A01,490187,Shishkin; Denis,27,0,35,8
1713307625839,ECON 110A,A01,490190,Levkoff; Steven B.,64,0,70,6
1713307626864,ECON 120A,A01,490245,Dai; Yinlin,67,0,70,3
1713307627894,ECON 120B,A01,490247,Nieto-Barthaburu; Augusto,60,0,70,10
1713307628926,ECON 120C,A01,490253,Sun; Yixiao,32,0,35,3
1713307628926,ECON 120C,B01,490255,Sun; Yixiao,34,0,35,1
1713307629952,ECON 129,A00,490256,Eckert; Fabian Paul,26,0,35,9
1713307630978,ECON 131,A00,490257,Nieto-Barthaburu; Augusto,5,0,35,30
1713307632004,ECON 138,A00,490258,Bharadwaj; Prashant,24,0,35,11
1713307632004,ECON 138,B00,490259,Bharadwaj; Prashant,19,0,35,16
1713307633030,ECON 159,A00,490260,Hendrickson; Gerald M.,0,6,0,0
1713307634057,ECON 178,A01,553995,Zhu; Ying,27,0,35,8
1713307635087,EDS 40,A01,512576,Black; Alison Michelle,20,0,20,0
1713307636112,EDS 107,A01,515848,Staff,30,0,30,0
1713307637142,EDS 110R,A01,490262,Staff,26,0,30,4
1713307638174,EDS 112,A01,490264,Chapman; Thandeka K,44,0,50,6
1713307639200,EDS 113,A00,490266,Staff,27,0,30,3
1713307640228,EDS 118,A00,490267,Warstadt; Melissa Fawn,27,0,30,3
1713307641253,EDS 124BR,A00,490268,Eguchi; Emi,10,0,25,15
1713307641253,EDS 124BR,B00,490269,Eguchi; Emi,25,0,25,0
1713307642280,EDS 126,A01,490271,Jones; Makeba,46,0,50,4
1713307643305,EDS 135,A01,490316,Staff,19,0,20,1
1713307644337,ENVR 142GS,A00,519514,Chang; Edmond Yi-Teh,28,0,28,0
1713307645364,ETHN 103,A00,490504,Staff,33,0,36,3
1713307646393,ETHN 103A,A00,490505,Man; Simeon S,7,0,9,2
1713307647417,ETHN 109,A00,490506,Staff,30,0,30,0
1713307648446,ETHN 118,A00,490507,Staff,35,0,36,1
1713307649473,ETHN 119,A00,490508,Staff,36,0,36,0
1713307650497,ETHN 121R,A00,490518,Choi; Esther Min,30,0,36,6
1713307651523,ETHN 127,A00,490528,Staff,15,0,15,0
1713307652553,ETHN 139,A00,490573,Staff,10,0,10,0
1713307653580,ETHN 150,A00,490575,Staff,15,0,15,0
1713307654606,GLBH 20,A00,491705,Elwardani; Nile Regina,38,0,40,2
1713307655635,GLBH 101,A00,491706,Staff,20,0,20,0
1713307656659,GLBH 111,A01,491708,Burgos; Jose L.,15,0,15,0
1713307657685,GLBH 146,A00,491709,Staff,12,0,20,8
1713307658715,GLBH 148,A00,491710,Olivas Hernandez; Olga Lid,16,0,20,4
1713307659744,GLBH 150,A00,491711,Sloane; Julia Kathryn,20,0,20,0
1713307660771,HIEA 131,A00,491760,Staff,30,0,32,2
1713307661800,HIEA 153,A00,491762,Staff,29,0,30,1
1713307662828,HIEU 124,A00,491811,Staff,26,0,32,6
1713307663872,HIEU 124GS,A00,491812,Markman; Kristina,28,0,28,0
1713307664898,HIEU 147,A00,491813,Staff,30,0,32,2
1713307665923,HIEU 149GS,A00,491816,Caldwell; Michael Alan,28,0,28,0
1713307666951,HILD 2C,A01,491713,Hendrickson; Gerald M.,28,0,30,2
1713307667976,HILD 7B,A01,491715,Kwak; Nancy,17,0,30,13
1713307669000,HILD 10,A01,491717,Staff,14,0,20,6
1713307670026,HILD 30GS,A00,491719,Edington; Claire Ellen,24,0,28,4
1713307671053,HINE 109,A00,491818,Shafir; Nir,30,0,32,2
1713307672080,HINE 128,A00,491821,Shafir; Nir,32,0,32,0
1713307673108,HISC 117,A00,491830,Staff,29,0,32,3
1713307674134,HIUS 103,A00,491834,Man; Simeon S,16,0,23,7
1713307675163,HIUS 108B,A00,491835,Staff,30,0,30,0
1713307676194,HIUS 141,A00,491836,Hendrickson; Gerald M.,29,0,32,3
1713307677218,HIUS 149,A00,491839,Staff,27,0,32,5
1713307678244,HUM 3,A01,512617,Crum; Matthew Stephen,46,0,50,4
1713307678244,HUM 3,A02,512618,Crum; Matthew Stephen,48,0,50,2
1713307679270,HUM 3GS,A00,512663,Markman; Kristina,0,0,0,0
1713307679270,HUM 3GS,B00,512664,Staff,0,0,0,0
1713307680312,HUM 4,A01,512620,West; Geoffrey Scott,37,0,50,13
1713307681341,HUM 4GS,A00,512666,Lyon; Antony J.,0,0,0,3
1713307682367,HUM 4R,A01,512625,Watkins; Eric,49,0,50,1
1713307683395,HUM 5,A01,512649,Zavodny; Tatiana Sophia,34,0,50,16
1713307683395,HUM 5,B01,512661,Zroka; Ryan Edward,49,0,50,1
1713307684420,INTL 190,A00,490577,Segui; Alan S,0,0,0,5
1713307685447,JAPN 20AR,A01,491267,Ross; Kayoko F,12,0,20,8
1713307686477,JAPN 180,A00,491285,Berman; Michael David,34,0,40,6
1713307687512,LATI 50,A01,502536,Kokinis; Troy Andreas,19,0,22,3
1713307687512,LATI 50,A02,502551,Kokinis; Troy Andreas,22,0,22,0
1713307687512,LATI 50,A03,502650,Kokinis; Troy Andreas,22,0,22,0
1713307687512,LATI 50,A04,502909,Kokinis; Troy Andreas,22,0,22,0
1713307688544,LATI 160,A01,502920,Kokinis; Troy Andreas,30,0,30,0
1713307689571,LIFR 1A,A00,490494,Van Moer; Vinciane G,18,0,20,2
1713307690595,LIFR 1AX,A00,490495,Van Moer; Vinciane G,18,0,20,2
1713307691621,LIFR 1B,A00,490496,Van Moer; Vinciane G,20,0,20,0
1713307692647,LIFR 1BX,A00,490497,Van Moer; Vinciane G,20,0,20,0
1713307693673,LIGN 8,A00,505198,McIntosh; Justin Daniel,142,0,150,8
1713307694701,LIGN 9GS,A00,491239,Lott; Margaret S.,18,0,20,2
1713307695730,LIGN 101,A01,505200,McIntosh; Justin Daniel,26,0,30,4
1713307696762,LIGN 120,A01,491244,Staff,25,0,30,5
1713307697793,LIGN 149GS,A00,491245,Lott; Margaret S.,18,0,20,2
1713307698821,LIGN 170,A00,491247,Staff,24,0,30,6
1713307699847,LISP 1D,A00,490498,Munoz Sanchez; Alicia,11,0,14,3
1713307699847,LISP 1D,B00,490499,Munoz Sanchez; Alicia,6,0,14,8
1713307699847,LISP 1D,C00,490500,Munoz Sanchez; Alicia,10,0,14,4
1713307699847,LISP 1D,D00,490501,Munoz Sanchez; Alicia,11,0,14,3
1713307700877,LISP 1DX,A00,490502,Munoz Sanchez; Alicia,18,0,28,10
1713307700877,LISP 1DX,B00,490503,Munoz Sanchez; Alicia,19,0,28,9
1713307702938,LTAM 110,A00,491847,Staff,23,0,25,2
1713307703963,LTCS 119,A00,491848,Staff,13,0,15,2
1713307704992,LTCS 130,A00,491849,Staff,24,0,25,1
1713307707042,LTEA 120C,A00,491852,Staff,35,0,40,5
1713307708067,LTEN 130GS,A00,491853,Lyon; Antony J.,25,0,28,3
1713307709096,LTEN 148,A00,491855,Staff,23,0,25,2
1713307710127,LTEN 159,A00,491856,Staff,21,0,25,4
1713307711155,LTEN 180,A00,491857,Staff,9,0,15,6
1713307713206,LTSP 123GS,A00,505928,Bessett; Ryan Matthew,25,0,28,3
1713307714230,LTSP 174GS,A00,506037,Bessett; Ryan Matthew,25,0,28,3
1713307716279,LTWR 102,A00,491861,Staff,12,0,15,3
1713307717308,LTWR 106,A00,491862,Staff,10,0,15,5
1713307718338,MAE 11,A00,490930,Bahadori; Mohammad Yousef,97,0,100,3
1713307719370,MAE 30A,A00,490931,Qi; Huihui,38,0,40,2
1713307720395,MAE 101A,A00,491036,Sadeghizadeh; Zahra,98,0,100,2
1713307721420,MAE 101C,A00,491037,Seshadri; Kalyanasundaram,78,0,100,22
1713307722448,MAE 113,A00,491040,Seshadri; Kalyanasundaram,67,0,80,13
1713307723479,MAE 131A,A00,491041,Ghazinejad; Maziar,39,0,40,1
1713307724513,MAE 142,A00,491053,Staff,39,0,40,1
1713307725541,MAE 143A,A00,491054,Staff,40,0,50,10
1713307726570,MAE 150,A00,491092,Truong; Phuong Thi Ngoc,24,0,35,11
1713307727603,MATH 3C,A01,494031,Pardo Guerra; Sebastian,30,0,30,0
1713307727603,MATH 3C,A02,494032,Pardo Guerra; Sebastian,29,0,30,1
1713307728688,MATH 10A,A01,494034,Staff,28,0,30,2
1713307728688,MATH 10A,A02,494035,Staff,29,0,30,1
1713307728688,MATH 10A,B01,494037,Staff,28,0,30,2
1713307728688,MATH 10A,B02,494038,Staff,29,0,30,1
1713307729722,MATH 10B,A01,494040,Habib; Yousaf,24,0,30,6
1713307729722,MATH 10B,A02,494041,Habib; Yousaf,28,0,30,2
1713307729722,MATH 10B,A03,494042,Habib; Yousaf,30,0,30,0
1713307729722,MATH 10B,A04,494043,Habib; Yousaf,30,0,30,0
1713307729722,MATH 10B,B01,494045,Habib; Yousaf,28,0,30,2
1713307729722,MATH 10B,B02,494046,Habib; Yousaf,30,0,30,0
1713307729722,MATH 10B,B03,494047,Habib; Yousaf,30,0,30,0
1713307729722,MATH 10B,B04,494048,Habib; Yousaf,30,0,30,0
1713307730749,MATH 18,A01,494050,Kemp; Todd Aahron,27,0,30,3
1713307730749,MATH 18,A02,494051,Kemp; Todd Aahron,29,0,30,1
1713307730749,MATH 18,B01,494054,Kemp; Todd Aahron,28,0,30,2
1713307730749,MATH 18,B02,494055,Kemp; Todd Aahron,29,0,30,1
1713307731775,MATH 20A,A01,494059,Suk; Andrew Hoon,30,0,30,0
1713307732806,MATH 20B,A01,494061,Briones; Jor-el Thomas Caparas,34,0,35,1
1713307732806,MATH 20B,B01,494063,Bach; Quang Tran,34,0,35,1
1713307733839,MATH 20C,A01,494065,Staff,28,0,30,2
1713307733839,MATH 20C,A02,494066,Staff,30,0,30,0
1713307733839,MATH 20C,A03,494067,Staff,30,0,30,0
1713307733839,MATH 20C,A04,494068,Staff,30,0,30,0
1713307733839,MATH 20C,B01,494070,Zhang; Ming,26,0,30,4
1713307733839,MATH 20C,B02,494071,Zhang; Ming,30,0,30,0
1713307733839,MATH 20C,B03,494072,Zhang; Ming,29,0,30,1
1713307733839,MATH 20C,B04,494073,Zhang; Ming,28,0,30,2
1713307734865,MATH 20D,A01,494075,Staff,26,0,30,4
1713307734865,MATH 20D,A02,494076,Staff,30,0,30,0
1713307735892,MATH 20E,A01,494079,Staff,25,0,30,5
1713307735892,MATH 20E,A02,494080,Staff,27,0,30,3
1713307735892,MATH 20E,B01,494082,Staff,28,0,30,2
1713307735892,MATH 20E,B02,494083,Staff,25,0,30,5
1713307736923,MATH 103A,A01,494085,Aliabadi Sr.; Mohsen,19,0,30,11
1713307736923,MATH 103A,A02,494086,Aliabadi Sr.; Mohsen,28,0,30,2
1713307736923,MATH 103A,B01,494088,Aliabadi Sr.; Mohsen,22,0,30,8
1713307736923,MATH 103A,B02,494089,Aliabadi Sr.; Mohsen,28,0,30,2
1713307737953,MATH 109,A01,494091,Staff,30,0,30,0
1713307737953,MATH 109,A02,494092,Staff,30,0,30,0
1713307737953,MATH 109,B01,494094,Staff,28,0,30,2
1713307737953,MATH 109,B02,494095,Staff,29,0,30,1
1713307738979,MATH 142A,A01,494097,Chow; Bennett,16,0,30,14
1713307738979,MATH 142A,A02,494098,Chow; Bennett,24,0,30,6
1713307738979,MATH 142A,B01,494100,Chow; Bennett,20,0,30,10
1713307738979,MATH 142A,B02,494101,Chow; Bennett,29,0,30,1
1713307741029,MATH 168A,A01,516677,Dumitriu; Ioana,17,0,35,18
1713307742054,MATH 170A,A01,516679,Dumitriu; Ioana,21,0,30,9
1713307742054,MATH 170A,A02,516680,Dumitriu; Ioana,28,0,30,2
1713307743088,MATH 193A,A01,494107,Staff,17,0,30,13
1713307743088,MATH 193A,A02,494108,Staff,25,0,30,5
1713307743088,MATH 193A,A03,494109,Staff,29,0,30,1
1713307743088,MATH 193A,A04,494110,Staff,25,0,30,5
1713307746170,MGT 16,A00,491930,McKay; Michael J,94,0,98,4
1713307747196,MGT 18,A00,491992,McKay; Michael J,97,0,98,1
1713307748222,MGT 71,A00,492003,Staff,78,0,98,20
1713307749249,MGT 103,A00,505209,Eberhard; Craig A,86,0,98,12
1713307750280,MGT 131A,A00,505210,Anderson; John Charles,91,0,98,7
1713307752330,MGT 153,A00,492077,Perols; Johan Lars,49,0,90,41
1713307755416,MGT 164,A00,492222,McKay; Mary A,94,0,98,4
1713307756450,MGT 172,A00,492245,Staff,59,0,60,1
1713307756450,MGT 172,B00,505526,Hedges; Kathleen,78,0,98,20
1713307757480,MGT 181,A00,505669,Dunn; Louis Jean,88,0,98,10
1713307758509,MMW 14,A01,494399,Staff,23,0,28,5
1713307758509,MMW 14,A02,494400,Staff,26,0,28,2
1713307758509,MMW 14,A03,494401,Staff,28,0,28,0
1713307758509,MMW 14,A04,494402,Staff,28,0,28,0
1713307758509,MMW 14,B01,494404,Carreras; Maria Victoria,17,0,28,11
1713307758509,MMW 14,B02,494405,Carreras; Maria Victoria,27,0,28,1
1713307758509,MMW 14,B03,494406,Carreras; Maria Victoria,28,0,28,0
1713307758509,MMW 14,B04,494407,Carreras; Maria Victoria,28,0,28,0
1713307759536,MMW 14GS,A00,506250,Chang; Edmond Yi-Teh,0,0,0,0
1713307760560,MMW 121R,A01,494415,Adamiak; Patrick John,15,0,28,13
1713307760560,MMW 121R,A02,494416,Adamiak; Patrick John,25,0,28,3
1713307761585,MUS 1A,A01,494113,Staff,12,0,25,13
1713307761585,MUS 1A,A02,494114,Staff,25,0,25,0
1713307762610,MUS 4,A01,494116,Staff,24,0,25,1
1713307762610,MUS 4,A02,494117,Staff,22,0,25,3
1713307763636,MUS 5R,A01,494236,Dubnov; Shlomo,12,0,25,13
1713307763636,MUS 5R,A02,494237,Dubnov; Shlomo,25,0,25,0
1713307764660,MUS 6,A01,494122,Staff,16,0,25,9
1713307764660,MUS 6,A02,494123,Staff,24,0,25,1
1713307765691,MUS 7,A01,494125,Staff,17,0,25,8
1713307765691,MUS 7,A02,494126,Staff,24,0,25,1
1713307766721,MUS 11,A01,494128,Staff,23,0,25,2
1713307766721,MUS 11,A02,494129,Staff,25,0,25,0
1713307767749,MUS 13,A01,494131,Staff,25,0,25,0
1713307767749,MUS 13,A02,494132,Staff,25,0,25,0
1713307768778,MUS 15,A01,494134,Staff,20,0,25,5
1713307768778,MUS 15,A02,494135,Staff,25,0,25,0
1713307768778,MUS 15,B01,494137,Staff,24,0,25,1
1713307769803,MUS 80,A00,494232,Staff,25,0,25,0
1713307769803,MUS 80,B00,494233,Staff,25,0,25,0
1713307769803,MUS 80,C00,494234,Staff,23,0,25,2
1713307770832,MUS 95C,A00,494141,Staff,73,0,75,2
1713307771855,MUS 114,A00,494142,Staff,41,0,50,9
1713307772878,NANO 15,A01,490636,Drews; Aaron,7,0,7,0
1713307773908,PHIL 1,A00,490578,Grush; Rick Scott,50,0,50,0
1713307774933,PHIL 10,A01,490580,Grush; Rick Scott,34,0,35,1
1713307774933,PHIL 10,A02,490586,Grush; Rick Scott,33,0,35,2
1713307775962,PHIL 27,A01,490591,Staff,24,0,25,1
1713307775962,PHIL 27,A02,490592,Staff,25,0,25,0
1713307775962,PHIL 27,A03,490593,Staff,25,0,25,0
1713307775962,PHIL 27,A04,490598,Staff,25,0,25,0
1713307776988,PHIL 32,A01,490611,Staff,20,0,20,0
1713307776988,PHIL 32,A02,490618,Staff,20,0,20,0
1713307778012,PHIL 90,A00,490624,Staff,40,0,40,0
1713307779037,PHIL 136,A00,490627,Cohen; Jonathan David,38,0,40,2
1713307780062,PHIL 155,A00,490634,Staff,67,0,70,3
1713307781093,PHYS 1A,A00,491610,Staff,246,0,250,4
1713307782117,PHYS 1AL,001,491616,Tsai; Philbert S,28,0,30,2
1713307782117,PHYS 1AL,002,491618,Tsai; Philbert S,30,0,30,0
1713307783141,PHYS 1B,A00,491623,Staff,244,0,250,6
1713307784166,PHYS 1BL,001,491626,Tsai; Philbert S,26,0,30,4
1713307784166,PHYS 1BL,002,491628,Tsai; Philbert S,28,0,30,2
1713307785194,PHYS 1C,A00,491632,Staff,226,0,245,19
1713307786223,PHYS 1CL,001,491635,Tsai; Philbert S,13,0,30,17
1713307786223,PHYS 1CL,002,491643,Tsai; Philbert S,24,0,30,6
1713307787249,PHYS 2AR,A01,491651,Meyertholen; Andrew D.,46,0,50,4
1713307788274,PHYS 2B,A01,491659,Staff,107,0,115,8
1713307789299,PHYS 2BL,A01,491685,Staff,23,0,24,1
1713307789299,PHYS 2BL,A02,491700,Staff,23,0,24,1
1713307790331,PHYS 2C,A01,505161,Staff,107,0,115,8
1713307791355,PHYS 4A,A01,491704,Grinstein; Benjamin,99,0,100,1
1713307792381,POLI 5D,A01,494144,Staff,3,0,5,2
1713307792381,POLI 5D,B01,626283,Dai; Yinlin,5,0,5,0
1713307793409,POLI 12,A00,494145,Staff,44,0,45,1
1713307794435,POLI 13R,A00,494146,Forman; Fonna,47,0,50,3
1713307795461,POLI 27,A01,494148,Staff,58,0,60,2
1713307796488,POLI 30,A00,494149,Staff,49,0,50,1
1713307797514,POLI 100DA,A00,494150,Staff,23,0,25,2
1713307799567,POLI 100I,A00,494152,Staff,28,0,30,2
1713307800597,POLI 104B,A00,494153,Smith; Glenn Chatmas,54,0,55,1
1713307801624,POLI 104F,A00,494154,Staff,28,0,30,2
1713307802661,POLI 104I,A00,494155,Smith; Glenn Chatmas,30,0,30,0
1713307803686,POLI 110C,A00,494156,Ingham; Sean,23,0,25,2
1713307804712,POLI 117R,A00,494157,Forman; Fonna,14,0,20,6
1713307805741,POLI 118,A00,494158,Ingham; Sean,23,0,25,2
1713307806781,POLI 120H,A00,494159,Fisk; David Lee,41,0,45,4
1713307807806,POLI 131CR,A00,494160,Hoston; Germaine,40,0,45,5
1713307808832,POLI 133J,A00,494161,Staff,33,0,35,2
1713307809868,POLI 135,A00,494162,Fisk; David Lee,33,0,35,2
1713307810898,POLI 140A,A00,494164,Staff,22,0,30,8
1713307811924,POLI 142I,A00,494165,Staff,30,0,30,0
1713307812949,POLI 144D,A00,494166,Staff,23,0,25,2
1713307813981,POLI 151,A00,494167,Staff,30,0,30,0
1713307815006,POLI 153,A00,494168,Staff,33,0,35,2
1713307816035,POLI 160AA,A00,494169,Staff,36,0,40,4
1713307817061,POLI 162,A00,494170,Mignozzetti; Umberto,21,0,25,4
1713307818089,POLI 171,A00,494171,Mignozzetti; Umberto,23,0,25,2
1713307819118,PSYC 1,A00,494172,Staff,97,0,100,3
1713307820147,PSYC 2,A00,494173,Moranton; Nirelia Melbina-,44,0,50,6
1713307821175,PSYC 3,A00,494174,Staff,30,0,30,0
1713307822200,PSYC 6,A00,494175,Staff,17,0,20,3
1713307823246,PSYC 60,A01,494177,Staff,42,0,45,3
1713307824271,PSYC 70,A01,505724,Geller; Emma Harlan,42,0,45,3
1713307825296,PSYC 101,A00,494180,Heyman; Gail D.,87,0,100,13
1713307826326,PSYC 105,A00,494181,Geller; Emma Harlan,66,0,90,24
1713307827350,PSYC 106,A00,494182,Dobkins; Karen R.,33,0,45,12
1713307828376,PSYC 108,A00,494183,Adrian; Julia Anna,94,0,100,6
1713307829403,PSYC 114,A01,494185,Winkielman; Piotr,5,0,30,25
1713307830433,PSYC 122,A00,494186,Moranton; Nirelia Melbina-,40,0,50,10
1713307831461,PSYC 124,A00,494187,Chapman; Eddie Nathaniel,72,0,80,8
1713307832543,PSYC 131,A00,494188,Anagnostaras; Stephan,59,0,80,21
1713307833568,PSYC 144,A00,494189,Staff,22,0,50,28
1713307834594,PSYC 154,A00,494190,Lacefield; Katharine I,137,0,180,43
1713307835619,PSYC 162,A00,494191,Wixted; John T,86,0,100,14
1713307836644,PSYC 172,A00,494192,Gorman; Michael R.,38,0,45,7
1713307837671,PSYC 178,A00,494193,Glaser; Dale,41,0,45,4
1713307838696,PSYC 193,A00,505725,Chapman; Eddie Nathaniel,20,0,20,0
1713307839722,RELI 145GS,A00,519817,Rahimi; Babak,19,0,20,1
1713307840753,SE 101A,A01,490862,Chadha; Mayank,24,0,25,1
1713307841780,SE 101C,A01,490924,Krysl; Petr,18,0,20,2
1713307842806,SE 110A,A01,490928,Staff,20,0,20,0
1713307843832,SE 130A,A00,490929,Morrison; Machel Leigh,64,0,70,6
1713307844858,SIO 1,A01,519325,Staff,39,0,40,1
1713307845883,SIO 30,A01,519327,Staff,40,0,40,0
1713307846909,SIO 40,A00,519328,Staff,40,0,40,0
1713307847935,SIO 46GS,A00,519819,Cook; Geoffrey W,18,0,25,7
1713307848959,SIO 109R,A00,494197,Forman; Fonna,8,0,20,12
1713307849988,SIO 121GS,A00,519827,Cook; Geoffrey W,18,0,25,7
1713307851016,SIO 132,A01,519330,Staff,38,0,40,2
1713307852041,SIO 133,A01,519397,Staff,38,0,40,2
1713307853065,SIO 139,A00,519396,Kacev; David,33,0,40,7
1713307854091,SOCI 1,A01,494199,Thorpe; Charles Robert,24,0,30,6
1713307854091,SOCI 1,A02,494200,Thorpe; Charles Robert,30,0,30,0
1713307854091,SOCI 1,A03,494201,Thorpe; Charles Robert,29,0,30,1
1713307854091,SOCI 1,A04,494202,Thorpe; Charles Robert,29,0,30,1
1713307854091,SOCI 1,A05,494203,Thorpe; Charles Robert,29,0,30,1
1713307854091,SOCI 1,A06,494204,Thorpe; Charles Robert,30,0,30,0
1713307854091,SOCI 1,A07,494205,Thorpe; Charles Robert,29,0,30,1
1713307855120,SOCI 60,A01,494207,Staff,36,0,40,4
1713307855120,SOCI 60,A02,494208,Staff,39,0,40,1
1713307856146,SOCI 100,A01,494210,Payne; Christine Anna,28,0,30,2
1713307856146,SOCI 100,A02,494211,Payne; Christine Anna,28,0,30,2
1713307857172,SOCI 109M,A00,494212,Staff,20,0,20,0
1713307858201,SOCI 110,A00,494213,Staff,35,0,40,5
1713307860260,SOCI 118E,A00,494215,Ng; Kwai,38,0,40,2
1713307861286,SOCI 125,A00,494216,Calderon-Zaks; Michael Aar,42,0,45,3
1713307862318,SOCI 126,A01,494218,Jones; Makeba,4,0,5,1
1713307863364,SOCI 131,A00,494219,Thorpe; Charles Robert,30,0,30,0
1713307865420,SOCI 135,A00,494221,Payne; Christine Anna,40,0,50,10
1713307866446,SOCI 136E,A00,626690,Ruiz; Jonathan Joseph,25,0,25,0
1713307867472,SOCI 138GS,A00,494222,Navon; Daniel,24,0,28,4
1713307869530,SOCI 145,A00,494224,Staff,42,0,45,3
1713307870555,SOCI 153,A00,494225,Staff,28,0,30,2
1713307871581,SOCI 160E,A00,494226,Ng; Kwai,34,0,40,6
1713307872606,SOCI 180,A00,494227,Staff,29,0,30,1
1713307873633,SOCI 189GS,A00,494228,Ribas Norris; Janet Vanesa,11,0,11,0
1713307874657,SOCI 190GS,A00,553232,Ribas Norris; Janet Vanesa,11,0,11,0
1713307875690,SOMI 220,A00,627178,Schneid; Stephen David,30,0,30,0
1713307876717,SYN 2,001,490768,Staff,14,0,15,1
1713307876717,SYN 2,002,490769,Staff,15,0,15,0
1713307876717,SYN 2,004,490775,Staff,0,0,0,0
1713307876717,SYN 2,003,490774,Staff,0,0,0,0
1713307876717,SYN 2,005,490776,Staff,0,0,0,0
1713307877742,SYN 2R,001,490779,Staff,14,0,15,1
1713307877742,SYN 2R,002,514635,Staff,14,0,15,1
1713307878769,SYN 100,A01,490783,Staff,17,0,20,3
1713307878769,SYN 100,B01,490787,Staff,12,0,20,8
1713307878769,SYN 100,C01,490789,Staff,13,0,20,7
1713307879799,SYN 150,A00,490817,Staff,14,0,15,1
1713307879799,SYN 150,B00,514610,Staff,15,0,15,0
1713307880841,TDAC 1,A00,492753,Walsh; Kim C.,19,0,20,1
1713307880841,TDAC 1,B00,492754,Harting; Carla Kelso,19,0,20,1
1713307880841,TDAC 1,C00,513995,Salovey; Todd,18,0,20,2
1713307881867,TDAC 101,A00,492766,Harting; Carla Kelso,19,0,20,1
1713307882895,TDAC 102,A00,492768,Basso; Beatrice,20,0,20,0
1713307883924,TDDE 111,A00,492769,Staff,25,0,25,0
1713307884949,TDDE 131,A00,492770,Staff,15,0,15,0
1713307884949,TDDE 131,B00,492771,Staff,15,0,15,0
1713307885973,TDDE 131GS,A00,523716,Guirguis; Mark C,25,0,28,3
1713307887006,TDGE 1,A01,492756,Salovey; Todd,57,0,60,3
1713307888031,TDGE 5,A01,492758,Staff,24,0,25,1
1713307889059,TDGE 10,A00,492759,Fulton; Julia,215,0,220,5
1713307890088,TDGE 11,A00,492760,Castro; Robert Jess,200,0,200,0
1713307891113,TDGE 50,A00,492761,Blair; Kyle Adam,0,0,0,0
1713307892143,TDGE 124,A00,492772,Fulton; Julia,197,0,220,23
1713307893192,TDGE 125,A00,492773,Meyer; Ursula,41,0,50,9
1713307893192,TDGE 125,B00,492774,Staff,50,0,50,0
1713307893192,TDGE 125,C00,523565,Staff,49,0,50,1
1713307894216,TDGE 125GS,A00,523580,Guirguis; Mark C,25,0,28,3
1713307895243,TDGE 127,A00,492775,Havis; Allan,43,0,50,7
1713307896268,TDHT 101,A00,492776,Staff,35,0,35,0
1713307897293,TDMV 1,A00,492762,Caligagan; Maria T.,30,0,30,0
1713307897293,TDMV 1,B00,492763,Arcidiacono; Kristin,26,0,30,4
1713307898327,TDMV 2,A00,492764,Weinberg; Sadie,29,0,30,1
1713307899350,TDMV 3,A00,492765,Mack; Kara Shanai',39,0,40,1
1713307900378,TDMV 138,A00,492777,Mack; Kara Shanai',37,0,40,3
1713307901407,TDMV 140,A00,492778,Lima; Paulo Henrique,40,0,40,0
1713307902436,TDMV 142,A00,492779,Caligagan; Maria T.,37,0,40,3
1713307902436,TDMV 142,B00,492780,Caligagan; Tony,38,0,40,2
1713307903466,TDMV 143,A00,492781,Fyall; Daunte Edward,40,0,40,0
1713307904491,USP 1,A01,492401,Kwak; Nancy,26,0,35,9
1713307905519,USP 2,A01,492453,Hinds; Juli Beth,35,0,35,0
1713307906551,USP 3,A01,492516,Staff,30,0,35,5
1713307907581,USP 4,A00,492522,McTague; Sarah,19,0,25,6
1713307908613,USP 100,A00,492523,Staff,33,0,35,2
1713307909638,USP 101,A00,492524,Staff,13,0,15,2
1713307910667,USP 105,A00,492525,Staff,22,0,25,3
1713307911697,USP 151,A00,492526,Shenkman; Michael Thomas,33,0,35,2
1713307912724,USP 170,A00,492545,Hinds; Juli Beth,33,0,35,2
1713307913749,USP 171GS,A00,492608,Bussell; Mirle Rabinowitz,26,0,28,2
1713307914776,USP 183GS,A00,492613,Peerson; Susan,26,0,28,2
1713307915801,VIS 30,A01,490693,Yoldas; Pinar,21,0,22,1
1713307915801,VIS 30,A02,490694,Yoldas; Pinar,19,0,22,3
1713307916827,VIS 83,A00,490695,Kester; Grant,68,0,75,7
1713307918055,VIS 105D,A00,490696,Staff,22,0,25,3
1713307919081,VIS 124CN,A00,490699,Rose; Jordan M,68,0,75,7
1713307920107,VIS 125GS,A00,511221,Williams; Alena J,21,0,22,1
1713307921131,VIS 128D,A00,490700,Staff,74,0,75,1
1713307922157,VIS 151,A01,490717,Staff,34,0,34,0
1713307922157,VIS 151,A02,490766,Staff,33,0,34,1
1713307923181,VIS 154GS,A00,511972,Williams; Alena J,21,0,22,1
1713307924206,VIS 160A,A00,490767,Stone; Patricia,7,0,10,3
1713307925233,WCWP 10A,A00,490638,Staff,15,0,15,0
1713307925233,WCWP 10A,B00,490640,Staff,15,0,15,0
1713307926258,WCWP 10B,A00,490641,Staff,0,0,0,0
1713307926258,WCWP 10B,B00,490642,Staff,14,0,15,1
1713307926258,WCWP 10B,C00,490644,Staff,13,0,15,2
1713307926258,WCWP 10B,D00,490647,Staff,0,0,0,0
1713307927283,WCWP 100,A00,490655,Staff,0,0,0,0
1713307927283,WCWP 100,B00,490687,Staff,12,0,15,3
1713307929427,ANAR 153,A00,487222,Braswell; Geoffrey E.,55,0,60,5
1713307930455,ANBI 134,A00,487223,Staff,14,0,20,6
1713307931483,ANBI 143GS,A00,487224,Noel; Geoffroy Pierre Jean,20,0,24,4
1713307932508,ANBI 144GS,A00,519548,Noel; Geoffroy Pierre Jean,20,0,24,4
1713307933532,ANSC 101,A00,487225,Staff,19,0,20,1
1713307934559,ANSC 125,A00,487227,Brenner; Suzanne A,39,0,40,1
1713307936667,ANSC 146,A00,487229,Staff,36,0,40,4
1713307937692,ANSC 148,A00,487230,Olivas Hernandez; Olga Lid,39,0,40,1
1713307938721,ANSC 150,A00,504165,Sloane; Julia Kathryn,19,0,20,1
1713307939749,ANSC 180,A00,487232,Staff,13,0,15,2
1713307940774,ANSC 188,A00,627155,Staff,40,0,40,0
1713307941805,ANTH 5,A00,519529,Semendeferi; Ekaterini,15,0,15,0
1713307942831,ANTH 10,A00,487219,Staff,58,0,60,2
1713307943861,ANTH 23,A01,487221,Staff,17,0,20,3
1713307944890,ANTH 102,A00,487233,Wilder; Linnea Lorene,53,0,60,7
1713307945917,ANTH 103,A00,487234,Varma; Saiba,57,0,60,3
1713307946946,ANTH 105,A00,487235,Stewart; Alexander B,57,0,60,3
1713307947972,BENG 100,A01,516685,Taylor Amos; Alyssa C,28,0,30,2
1713307949000,BIBC 102,A01,491316,Flagg; Matthew Paul,55,0,88,33
1713307949000,BIBC 102,A02,491366,Flagg; Matthew Paul,84,0,88,4
1713307950029,BIBC 103,A01,491486,Boumechache; Miyyada,16,0,24,8
1713307950029,BIBC 103,A02,491487,Boumechache; Miyyada,24,0,24,0
1713307951056,BICD 100,A01,516882,Staff,75,0,75,0
1713307951056,BICD 100,A02,516890,Staff,70,0,75,5
1713307952080,BICD 102GS,A00,491488,Lo; Stanley M.,27,0,28,1
1713307953111,BIEB 136GS,A00,516940,Holway; David A. & Shurin; Jonathan,20,0,24,4
1713307954144,BIEB 137GS,A01,517034,Holway; David A. & Shurin; Jonathan,20,0,24,4
1713307955174,BIEB 138GS,A01,491492,Pirino; Giorgia,22,0,28,6
1713307956208,BILD 1,A01,491296,Staff,62,0,63,1
1713307956208,BILD 1,A02,491297,Staff,63,0,63,0
1713307957239,BILD 4,A01,517099,Gonzalez Gamboa; Ivonne,22,0,24,2
1713307957239,BILD 4,A02,517100,Gonzalez Gamboa; Ivonne,24,0,24,0
1713307958268,BILD 60GS,A00,491309,Lo; Stanley M.,27,0,28,1
1713307959294,BIMM 100,A01,517136,Staff,92,0,100,8
1713307960325,BIMM 110,A01,517182,Staff,76,0,100,24
1713307961353,BIMM 120,A01,517228,Pickett; Brooke Elizabeth,40,0,63,23
1713307961353,BIMM 120,A02,517240,Pickett; Brooke Elizabeth,48,0,63,15
1713307962379,BIMM 132GS,A01,491498,Pirino; Giorgia,22,0,28,6
1713307963405,BIMM 143,A01,491589,Bozinovic; Goran,21,0,40,19
1713307964432,BIPN 100,A01,491594,Armour; Jon Christopher,92,0,100,8
1713307965457,BIPN 140,A01,491602,Marino; Marc J,32,0,50,18
1713307967515,CAT 125,A00,515973,Staff,20,0,20,0
1713307968542,CAT 125GS,A00,515974,Rahimi; Babak,19,0,20,1
1713307969570,CAT 125R,A00,515980,Staff,15,0,20,5
1713307969570,CAT 125R,B00,515981,Tosun; Adriana,19,0,20,1
1713307969570,CAT 125R,C00,515987,Hyland; Tina Mae,2,0,20,18
1713307969570,CAT 125R,D00,515988,Bronstein; Phoebe Malan,18,0,20,2
1713307970596,CENG 15,A01,488699,Drews; Aaron,25,0,25,0
1713307971625,CENG 100,A00,505196,Opatkiewicz; Justin Paul,25,0,25,0
1713307972649,CGS 2A,A01,489598,Staff,33,0,35,2
1713307973679,CGS 112,A00,489599,Staff,15,0,15,0
1713307974709,CGS 119,A00,489603,Staff,10,0,10,0
1713307975735,CGS 120,A00,489604,Staff,14,0,15,1
1713307976760,CGS 150,A00,489607,Staff,15,0,15,0
1713307977790,CHEM 6A,A01,488715,Staff,98,0,100,2
1713307978822,CHEM 6B,A01,488719,Piercy; Marc Anthony,100,0,100,0
1713307979850,CHEM 6C,A01,488723,Albizati; Kim F.,94,0,100,6
1713307980878,CHEM 7L,A01,488728,Schurmeier; Kimberly,18,0,24,6
1713307980878,CHEM 7L,A02,488730,Schurmeier; Kimberly,23,0,24,1
1713307980878,CHEM 7L,A03,488734,Schurmeier; Kimberly,24,0,24,0
1713307980878,CHEM 7L,A04,488763,Schurmeier; Kimberly,23,0,24,1
1713307980878,CHEM 7L,B01,488798,Schurmeier; Kimberly,18,0,24,6
1713307980878,CHEM 7L,B02,488801,Schurmeier; Kimberly,24,0,24,0
1713307980878,CHEM 7L,B03,488808,Schurmeier; Kimberly,24,0,24,0
1713307980878,CHEM 7L,B04,488811,Schurmeier; Kimberly,24,0,24,0
1713307981908,CHEM 11,A01,488897,Stallings; Dontarie M,98,0,100,2
1713307982939,CHEM 40A,A01,488913,Albizati; Kim F.,91,0,100,9
1713307983965,CHEM 40B,A01,488920,Weizman; Haim,48,0,50,2
1713307983965,CHEM 40B,A02,488938,Weizman; Haim,47,0,50,3
1713307984993,CHEM 41A,A01,489029,Klosterman; Jeremy K,58,0,60,2
1713307986023,CHEM 41C,A01,500436,Tor; Yitzhak,55,0,60,5
1713307987049,CHEM 43A,A01,500426,Weizman; Haim,6,0,24,18
1713307987049,CHEM 43A,A02,500430,Weizman; Haim,13,0,24,11
1713307987049,CHEM 43A,B01,514041,Klosterman; Jeremy K,16,0,24,8
1713307987049,CHEM 43A,B02,514047,Klosterman; Jeremy K,23,0,24,1
1713307988074,CHEM 108,A01,489140,Jennings; Patricia A.,14,0,24,10
1713307988074,CHEM 108,A02,489142,Jennings; Patricia A.,15,0,24,9
1713307989104,CHEM 114A,A01,489147,Stallings; Dontarie M,81,0,100,19
1713307990132,CHIN 169A,A00,489171,Wang; Xiao,19,0,20,1
1713307992187,COGS 3,A01,518827,Boyle; Mary E. T.,30,0,40,10
1713307993212,COGS 11,A01,489175,Staff,28,0,30,2
1713307994240,COGS 14A,A01,518829,Staff,53,0,60,7
1713307995265,COGS 14B,A01,489177,Hoffman; Drew Ellen,69,0,75,6
1713307996291,COGS 100,A01,489181,Allen; Michael Gordon,65,0,75,10
1713307997317,COGS 101A,A01,489183,Staff,51,0,60,9
1713307998347,COGS 101B,A01,489185,Allen; Michael Gordon,13,0,30,17
1713307999374,COGS 101C,A01,526786,Staff,25,0,30,5
1713308001426,COGS 107A,A01,489189,Boyle; Mary E. T.,23,0,35,12
1713308002453,COGS 107B,A01,627144,Mooshagian; Eric Frederick,60,0,60,0
1713308003477,COGS 118A,A01,489191,Staff,0,26,40,40
1713308005529,COGS 171GS,A01,489194,Pineda; Jaime A,22,0,28,6
1713308006557,COGS 172,A01,489196,Staff,6,0,30,24
1713308007583,COGS 174GS,A01,489264,Pineda; Jaime A,22,0,28,6
1713308008609,COGS 180,A01,627150,Staff,29,0,30,1
1713308009634,COGS 186,A01,489274,Staff,4,0,30,26
1713308010663,COMM 10,A01,489276,Staff,24,0,25,1
1713308010663,COMM 10,A02,489303,Staff,23,0,25,2
1713308011686,COMM 100A,A01,489312,Staff,21,0,25,4
1713308011686,COMM 100A,A02,489313,Staff,24,0,25,1
1713308012713,COMM 106T,A00,512540,Staff,34,0,35,1
1713308013743,COMM 107,A00,489347,Staff,31,0,35,4
1713308014767,COMM 109P,A00,489358,Staff,31,0,35,4
1713308015792,COMM 132,A00,489361,McKenna; Denise,29,0,30,1
1713308016823,COMM 146,A00,489362,Halm; Gavin Patrick,27,0,30,3
1713308017848,COMM 190,A00,489363,Abuelhiga; Soraya Jill,21,0,23,2
1713308018874,CSE 8A,A50,489366,Staff,23,0,25,2
1713308018874,CSE 8A,A51,489367,Staff,24,0,25,1
1713308019900,CSE 11,A01,489398,Cao; Yingjun,83,0,100,17
1713308020933,CSE 12,A01,489487,Staff,43,0,50,7
1713308021957,CSE 20,A01,489497,Staff,49,0,50,1
1713308022987,CSE 21,A01,489517,Braun; Oliver,44,0,50,6
1713308024015,CSE 101,A01,489524,Braun; Oliver,0,7,50,50
1713308025044,CSE 105,A01,512594,Jones; Miles E,82,0,100,18
1713308025044,CSE 105,B01,512598,Jones; Miles E,69,0,100,31
1713308026070,CSE 140,A01,489538,Staff,44,0,50,6
1713308027094,CSE 141,A01,489550,Eldon; John,76,0,100,24
1713308028127,CSE 141L,A01,489571,Eldon; John,75,0,100,25
1713308029162,CSE 151A,A01,489583,Solares; Edwin A,152,0,200,48
1713308030188,CSE 175,A01,510886,Kumar; Rakesh,30,0,30,0
1713308031214,CSE 190,A00,516828,Dubnov; Shlomo,41,0,49,8
1713308032241,DOC 100D,A00,489667,Pass; Natalye Joann,23,0,25,2
1713308033287,DSC 10,A01,624268,Staff,72,0,75,3
1713308034313,DSC 20,A01,624476,Staff,50,0,50,0
1713308035340,DSC 40A,A01,624608,Staff,40,0,40,0
1713308036368,DSGN 1,A01,489179,Rill; Bryan,37,0,50,13
1713308037396,ECE 17,A01,490489,Sahay; Rajeev,19,0,30,11
1713308038422,ECE 65,A50,490492,Staff,17,0,20,3
1713308038422,ECE 65,A51,490493,Staff,20,0,20,0
1713308039451,ECON 1,A01,489715,Famulari; Melissa,69,0,70,1
1713308040530,ECON 2,A01,489717,Levkoff; Steven B.,68,0,70,2
1713308041557,ECON 3,A01,489948,Staff,70,0,70,0
1713308043614,ECON 5,A01,490103,Staff,28,0,30,2
1713308043614,ECON 5,B01,626281,Dai; Yinlin,45,0,45,0
1713308044645,ECON 100A,A01,490127,Famulari; Melissa,69,0,70,1
1713308045674,ECON 100B,A01,490129,Staff,64,0,70,6
1713308046701,ECON 109,A01,490187,Shishkin; Denis,27,0,35,8
1713308047727,ECON 110A,A01,490190,Levkoff; Steven B.,64,0,70,6
1713308048756,ECON 120A,A01,490245,Dai; Yinlin,67,0,70,3
1713308049782,ECON 120B,A01,490247,Nieto-Barthaburu; Augusto,60,0,70,10
1713308050808,ECON 120C,A01,490253,Sun; Yixiao,32,0,35,3
1713308050808,ECON 120C,B01,490255,Sun; Yixiao,34,0,35,1
1713308051834,ECON 129,A00,490256,Eckert; Fabian Paul,26,0,35,9
1713308052860,ECON 131,A00,490257,Nieto-Barthaburu; Augusto,4,0,35,31
1713308053893,ECON 138,A00,490258,Bharadwaj; Prashant,24,0,35,11
1713308053893,ECON 138,B00,490259,Bharadwaj; Prashant,18,0,35,17
1713308054923,ECON 159,A00,490260,Hendrickson; Gerald M.,0,6,0,0
1713308055953,ECON 178,A01,553995,Zhu; Ying,27,0,35,8
1713308056984,EDS 40,A01,512576,Black; Alison Michelle,20,0,20,0
1713308058014,EDS 107,A01,515848,Staff,30,0,30,0
1713308059042,EDS 110R,A01,490262,Staff,26,0,30,4
1713308060068,EDS 112,A01,490264,Chapman; Thandeka K,43,0,50,7
1713308061098,EDS 113,A00,490266,Staff,27,0,30,3
1713308062127,EDS 118,A00,490267,Warstadt; Melissa Fawn,27,0,30,3
1713308063153,EDS 124BR,A00,490268,Eguchi; Emi,10,0,25,15
1713308063153,EDS 124BR,B00,490269,Eguchi; Emi,25,0,25,0
1713308064178,EDS 126,A01,490271,Jones; Makeba,45,0,50,5
1713308065204,EDS 135,A01,490316,Staff,19,0,20,1
1713308066233,ENVR 142GS,A00,519514,Chang; Edmond Yi-Teh,28,0,28,0
1713308067257,ETHN 103,A00,490504,Staff,33,0,36,3
1713308068282,ETHN 103A,A00,490505,Man; Simeon S,7,0,9,2
1713308069307,ETHN 109,A00,490506,Staff,30,0,30,0
1713308070334,ETHN 118,A00,490507,Staff,35,0,36,1
1713308071362,ETHN 119,A00,490508,Staff,36,0,36,0
1713308072389,ETHN 121R,A00,490518,Choi; Esther Min,30,0,36,6
1713308073414,ETHN 127,A00,490528,Staff,15,0,15,0
1713308074439,ETHN 139,A00,490573,Staff,10,0,10,0
1713308075466,ETHN 150,A00,490575,Staff,15,0,15,0
1713308076494,GLBH 20,A00,491705,Elwardani; Nile Regina,38,0,40,2
1713308077523,GLBH 101,A00,491706,Staff,20,0,20,0
1713308078550,GLBH 111,A01,491708,Burgos; Jose L.,15,0,15,0
1713308079578,GLBH 146,A00,491709,Staff,12,0,20,8
1713308080603,GLBH 148,A00,491710,Olivas Hernandez; Olga Lid,16,0,20,4
1713308081630,GLBH 150,A00,491711,Sloane; Julia Kathryn,20,0,20,0
1713308082655,HIEA 131,A00,491760,Staff,30,0,32,2
1713308083685,HIEA 153,A00,491762,Staff,29,0,30,1
1713308084710,HIEU 124,A00,491811,Staff,26,0,32,6
1713308085739,HIEU 124GS,A00,491812,Markman; Kristina,28,0,28,0
1713308086764,HIEU 147,A00,491813,Staff,30,0,32,2
1713308087797,HIEU 149GS,A00,491816,Caldwell; Michael Alan,28,0,28,0
1713308088831,HILD 2C,A01,491713,Hendrickson; Gerald M.,28,0,30,2
1713308089862,HILD 7B,A01,491715,Kwak; Nancy,16,0,30,14
1713308090887,HILD 10,A01,491717,Staff,14,0,20,6
1713308091918,HILD 30GS,A00,491719,Edington; Claire Ellen,24,0,28,4
1713308092945,HINE 109,A00,491818,Shafir; Nir,29,0,32,3
1713308093970,HINE 128,A00,491821,Shafir; Nir,31,0,32,1
1713308094996,HISC 117,A00,491830,Staff,29,0,32,3
1713308096028,HIUS 103,A00,491834,Man; Simeon S,16,0,23,7
1713308097058,HIUS 108B,A00,491835,Staff,30,0,30,0
1713308098085,HIUS 141,A00,491836,Hendrickson; Gerald M.,29,0,32,3
1713308099113,HIUS 149,A00,491839,Staff,27,0,32,5
1713308100139,HUM 3,A01,512617,Crum; Matthew Stephen,46,0,50,4
1713308100139,HUM 3,A02,512618,Crum; Matthew Stephen,48,0,50,2
1713308101173,HUM 3GS,A00,512663,Markman; Kristina,0,0,0,0
1713308101173,HUM 3GS,B00,512664,Staff,0,0,0,0
1713308102198,HUM 4,A01,512620,West; Geoffrey Scott,36,0,50,14
1713308103222,HUM 4GS,A00,512666,Lyon; Antony J.,0,0,0,3
1713308104248,HUM 4R,A01,512625,Watkins; Eric,49,0,50,1
1713308105279,HUM 5,A01,512649,Zavodny; Tatiana Sophia,34,0,50,16
1713308105279,HUM 5,B01,512661,Zroka; Ryan Edward,49,0,50,1
1713308106307,INTL 190,A00,490577,Segui; Alan S,0,0,0,5
1713308107339,JAPN 20AR,A01,491267,Ross; Kayoko F,12,0,20,8
1713308108370,JAPN 180,A00,491285,Berman; Michael David,34,0,40,6
1713308109396,LATI 50,A01,502536,Kokinis; Troy Andreas,19,0,22,3
1713308109396,LATI 50,A02,502551,Kokinis; Troy Andreas,22,0,22,0
1713308109396,LATI 50,A03,502650,Kokinis; Troy Andreas,22,0,22,0
1713308109396,LATI 50,A04,502909,Kokinis; Troy Andreas,22,0,22,0
1713308110427,LATI 160,A01,502920,Kokinis; Troy Andreas,30,0,30,0
1713308111454,LIFR 1A,A00,490494,Van Moer; Vinciane G,18,0,20,2
1713308112481,LIFR 1AX,A00,490495,Van Moer; Vinciane G,18,0,20,2
1713308113514,LIFR 1B,A00,490496,Van Moer; Vinciane G,19,0,20,1
1713308114544,LIFR 1BX,A00,490497,Van Moer; Vinciane G,19,0,20,1
1713308115574,LIGN 8,A00,505198,McIntosh; Justin Daniel,141,0,150,9
1713308116600,LIGN 9GS,A00,491239,Lott; Margaret S.,18,0,20,2
1713308117626,LIGN 101,A01,505200,McIntosh; Justin Daniel,26,0,30,4
1713308118650,LIGN 120,A01,491244,Staff,24,0,30,6
1713308119675,LIGN 149GS,A00,491245,Lott; Margaret S.,18,0,20,2
1713308120700,LIGN 170,A00,491247,Staff,24,0,30,6
1713308121724,LISP 1D,A00,490498,Munoz Sanchez; Alicia,11,0,14,3
1713308121724,LISP 1D,B00,490499,Munoz Sanchez; Alicia,6,0,14,8
1713308121724,LISP 1D,C00,490500,Munoz Sanchez; Alicia,10,0,14,4
1713308121724,LISP 1D,D00,490501,Munoz Sanchez; Alicia,11,0,14,3
1713308122752,LISP 1DX,A00,490502,Munoz Sanchez; Alicia,18,0,28,10
1713308122752,LISP 1DX,B00,490503,Munoz Sanchez; Alicia,19,0,28,9
1713308124802,LTAM 110,A00,491847,Staff,23,0,25,2
1713308125830,LTCS 119,A00,491848,Staff,12,0,15,3
1713308126856,LTCS 130,A00,491849,Staff,24,0,25,1
1713308128909,LTEA 120C,A00,491852,Staff,35,0,40,5
1713308129933,LTEN 130GS,A00,491853,Lyon; Antony J.,25,0,28,3
1713308130960,LTEN 148,A00,491855,Staff,23,0,25,2
1713308131984,LTEN 159,A00,491856,Staff,21,0,25,4
1713308133007,LTEN 180,A00,491857,Staff,9,0,15,6
1713308135058,LTSP 123GS,A00,505928,Bessett; Ryan Matthew,25,0,28,3
1713308136085,LTSP 174GS,A00,506037,Bessett; Ryan Matthew,25,0,28,3
1713308138139,LTWR 102,A00,491861,Staff,12,0,15,3
1713308139171,LTWR 106,A00,491862,Staff,10,0,15,5
1713308140197,MAE 11,A00,490930,Bahadori; Mohammad Yousef,97,0,100,3
1713308141228,MAE 30A,A00,490931,Qi; Huihui,38,0,40,2
1713308142252,MAE 101A,A00,491036,Sadeghizadeh; Zahra,98,0,100,2
1713308143280,MAE 101C,A00,491037,Seshadri; Kalyanasundaram,78,0,100,22
1713308144365,MAE 113,A00,491040,Seshadri; Kalyanasundaram,67,0,80,13
1713308145394,MAE 131A,A00,491041,Ghazinejad; Maziar,39,0,40,1
1713308146423,MAE 142,A00,491053,Staff,39,0,40,1
1713308147449,MAE 143A,A00,491054,Staff,40,0,50,10
1713308148477,MAE 150,A00,491092,Truong; Phuong Thi Ngoc,24,0,35,11
1713308149504,MATH 3C,A01,494031,Pardo Guerra; Sebastian,30,0,30,0
1713308149504,MATH 3C,A02,494032,Pardo Guerra; Sebastian,29,0,30,1
1713308150535,MATH 10A,A01,494034,Staff,28,0,30,2
1713308150535,MATH 10A,A02,494035,Staff,29,0,30,1
1713308150535,MATH 10A,B01,494037,Staff,26,0,30,4
1713308150535,MATH 10A,B02,494038,Staff,29,0,30,1
1713308151564,MATH 10B,A01,494040,Habib; Yousaf,24,0,30,6
1713308151564,MATH 10B,A02,494041,Habib; Yousaf,28,0,30,2
1713308151564,MATH 10B,A03,494042,Habib; Yousaf,30,0,30,0
1713308151564,MATH 10B,A04,494043,Habib; Yousaf,30,0,30,0
1713308151564,MATH 10B,B01,494045,Habib; Yousaf,28,0,30,2
1713308151564,MATH 10B,B02,494046,Habib; Yousaf,30,0,30,0
1713308151564,MATH 10B,B03,494047,Habib; Yousaf,30,0,30,0
1713308151564,MATH 10B,B04,494048,Habib; Yousaf,30,0,30,0
1713308152590,MATH 18,A01,494050,Kemp; Todd Aahron,27,0,30,3
1713308152590,MATH 18,A02,494051,Kemp; Todd Aahron,29,0,30,1
1713308152590,MATH 18,B01,494054,Kemp; Todd Aahron,28,0,30,2
1713308152590,MATH 18,B02,494055,Kemp; Todd Aahron,29,0,30,1
1713308153616,MATH 20A,A01,494059,Suk; Andrew Hoon,30,0,30,0
1713308154647,MATH 20B,A01,494061,Briones; Jor-el Thomas Caparas,34,0,35,1
1713308154647,MATH 20B,B01,494063,Bach; Quang Tran,34,0,35,1
1713308155675,MATH 20C,A01,494065,Staff,28,0,30,2
1713308155675,MATH 20C,A02,494066,Staff,30,0,30,0
1713308155675,MATH 20C,A03,494067,Staff,30,0,30,0
1713308155675,MATH 20C,A04,494068,Staff,30,0,30,0
1713308155675,MATH 20C,B01,494070,Zhang; Ming,26,0,30,4
1713308155675,MATH 20C,B02,494071,Zhang; Ming,30,0,30,0
1713308155675,MATH 20C,B03,494072,Zhang; Ming,29,0,30,1
1713308155675,MATH 20C,B04,494073,Zhang; Ming,28,0,30,2
1713308156701,MATH 20D,A01,494075,Staff,26,0,30,4
1713308156701,MATH 20D,A02,494076,Staff,30,0,30,0
1713308157731,MATH 20E,A01,494079,Staff,25,0,30,5
1713308157731,MATH 20E,A02,494080,Staff,27,0,30,3
1713308157731,MATH 20E,B01,494082,Staff,28,0,30,2
1713308157731,MATH 20E,B02,494083,Staff,25,0,30,5
1713308158758,MATH 103A,A01,494085,Aliabadi Sr.; Mohsen,18,0,30,12
1713308158758,MATH 103A,A02,494086,Aliabadi Sr.; Mohsen,28,0,30,2
1713308158758,MATH 103A,B01,494088,Aliabadi Sr.; Mohsen,22,0,30,8
1713308158758,MATH 103A,B02,494089,Aliabadi Sr.; Mohsen,28,0,30,2
1713308159788,MATH 109,A01,494091,Staff,30,0,30,0
1713308159788,MATH 109,A02,494092,Staff,30,0,30,0
1713308159788,MATH 109,B01,494094,Staff,28,0,30,2
1713308159788,MATH 109,B02,494095,Staff,29,0,30,1
1713308160815,MATH 142A,A01,494097,Chow; Bennett,16,0,30,14
1713308160815,MATH 142A,A02,494098,Chow; Bennett,24,0,30,6
1713308160815,MATH 142A,B01,494100,Chow; Bennett,21,0,30,9
1713308160815,MATH 142A,B02,494101,Chow; Bennett,29,0,30,1
1713308162867,MATH 168A,A01,516677,Dumitriu; Ioana,16,0,35,19
1713308163900,MATH 170A,A01,516679,Dumitriu; Ioana,20,0,30,10
1713308163900,MATH 170A,A02,516680,Dumitriu; Ioana,28,0,30,2
1713308164925,MATH 193A,A01,494107,Staff,17,0,30,13
1713308164925,MATH 193A,A02,494108,Staff,24,0,30,6
1713308164925,MATH 193A,A03,494109,Staff,29,0,30,1
1713308164925,MATH 193A,A04,494110,Staff,24,0,30,6
1713308168001,MGT 16,A00,491930,McKay; Michael J,94,0,98,4
1713308169028,MGT 18,A00,491992,McKay; Michael J,97,0,98,1
1713308170054,MGT 71,A00,492003,Staff,78,0,98,20
1713308171079,MGT 103,A00,505209,Eberhard; Craig A,86,0,98,12
1713308172108,MGT 131A,A00,505210,Anderson; John Charles,91,0,98,7
1713308174165,MGT 153,A00,492077,Perols; Johan Lars,47,0,90,43
1713308177240,MGT 164,A00,492222,McKay; Mary A,94,0,98,4
1713308178265,MGT 172,A00,492245,Staff,59,0,60,1
1713308178265,MGT 172,B00,505526,Hedges; Kathleen,78,0,98,20
1713308179293,MGT 181,A00,505669,Dunn; Louis Jean,88,0,98,10
1713308180324,MMW 14,A01,494399,Staff,23,0,28,5
1713308180324,MMW 14,A02,494400,Staff,26,0,28,2
1713308180324,MMW 14,A03,494401,Staff,28,0,28,0
1713308180324,MMW 14,A04,494402,Staff,28,0,28,0
1713308180324,MMW 14,B01,494404,Carreras; Maria Victoria,16,0,28,12
1713308180324,MMW 14,B02,494405,Carreras; Maria Victoria,27,0,28,1
1713308180324,MMW 14,B03,494406,Carreras; Maria Victoria,28,0,28,0
1713308180324,MMW 14,B04,494407,Carreras; Maria Victoria,28,0,28,0
1713308181348,MMW 14GS,A00,506250,Chang; Edmond Yi-Teh,0,0,0,0
1713308182375,MMW 121R,A01,494415,Adamiak; Patrick John,15,0,28,13
1713308182375,MMW 121R,A02,494416,Adamiak; Patrick John,25,0,28,3
1713308183403,MUS 1A,A01,494113,Staff,12,0,25,13
1713308183403,MUS 1A,A02,494114,Staff,25,0,25,0
1713308184429,MUS 4,A01,494116,Staff,24,0,25,1
1713308184429,MUS 4,A02,494117,Staff,22,0,25,3
1713308185454,MUS 5R,A01,494236,Dubnov; Shlomo,12,0,25,13
1713308185454,MUS 5R,A02,494237,Dubnov; Shlomo,25,0,25,0
1713308186485,MUS 6,A01,494122,Staff,16,0,25,9
1713308186485,MUS 6,A02,494123,Staff,24,0,25,1
1713308187514,MUS 7,A01,494125,Staff,17,0,25,8
1713308187514,MUS 7,A02,494126,Staff,24,0,25,1
1713308188542,MUS 11,A01,494128,Staff,23,0,25,2
1713308188542,MUS 11,A02,494129,Staff,25,0,25,0
1713308189569,MUS 13,A01,494131,Staff,25,0,25,0
1713308189569,MUS 13,A02,494132,Staff,25,0,25,0
1713308190600,MUS 15,A01,494134,Staff,20,0,25,5
1713308190600,MUS 15,A02,494135,Staff,25,0,25,0
1713308190600,MUS 15,B01,494137,Staff,24,0,25,1
1713308191629,MUS 80,A00,494232,Staff,25,0,25,0
1713308191629,MUS 80,B00,494233,Staff,25,0,25,0
1713308191629,MUS 80,C00,494234,Staff,23,0,25,2
1713308192656,MUS 95C,A00,494141,Staff,73,0,75,2
1713308193684,MUS 114,A00,494142,Staff,41,0,50,9
1713308194714,NANO 15,A01,490636,Drews; Aaron,7,0,7,0
1713308195744,PHIL 1,A00,490578,Grush; Rick Scott,50,0,50,0
1713308196772,PHIL 10,A01,490580,Grush; Rick Scott,34,0,35,1
1713308196772,PHIL 10,A02,490586,Grush; Rick Scott,33,0,35,2
1713308197797,PHIL 27,A01,490591,Staff,24,0,25,1
1713308197797,PHIL 27,A02,490592,Staff,25,0,25,0
1713308197797,PHIL 27,A03,490593,Staff,25,0,25,0
1713308197797,PHIL 27,A04,490598,Staff,25,0,25,0
1713308198826,PHIL 32,A01,490611,Staff,20,0,20,0
1713308198826,PHIL 32,A02,490618,Staff,20,0,20,0
1713308199858,PHIL 90,A00,490624,Staff,40,0,40,0
1713308200883,PHIL 136,A00,490627,Cohen; Jonathan David,38,0,40,2
1713308201909,PHIL 155,A00,490634,Staff,66,0,70,4
1713308202933,PHYS 1A,A00,491610,Staff,246,0,250,4
1713308203958,PHYS 1AL,001,491616,Tsai; Philbert S,28,0,30,2
1713308203958,PHYS 1AL,002,491618,Tsai; Philbert S,30,0,30,0
1713308204982,PHYS 1B,A00,491623,Staff,244,0,250,6
1713308206012,PHYS 1BL,001,491626,Tsai; Philbert S,26,0,30,4
1713308206012,PHYS 1BL,002,491628,Tsai; Philbert S,28,0,30,2
1713308207037,PHYS 1C,A00,491632,Staff,225,0,245,20
1713308208065,PHYS 1CL,001,491635,Tsai; Philbert S,12,0,30,18
1713308208065,PHYS 1CL,002,491643,Tsai; Philbert S,24,0,30,6
1713308209092,PHYS 2AR,A01,491651,Meyertholen; Andrew D.,46,0,50,4
1713308210117,PHYS 2B,A01,491659,Staff,107,0,115,8
1713308211142,PHYS 2BL,A01,491685,Staff,23,0,24,1
1713308211142,PHYS 2BL,A02,491700,Staff,23,0,24,1
1713308212173,PHYS 2C,A01,505161,Staff,107,0,115,8
1713308213204,PHYS 4A,A01,491704,Grinstein; Benjamin,99,0,100,1
1713308214229,POLI 5D,A01,494144,Staff,3,0,5,2
1713308214229,POLI 5D,B01,626283,Dai; Yinlin,5,0,5,0
1713308215253,POLI 12,A00,494145,Staff,44,0,45,1
1713308216279,POLI 13R,A00,494146,Forman; Fonna,47,0,50,3
1713308217301,POLI 27,A01,494148,Staff,58,0,60,2
1713308218330,POLI 30,A00,494149,Staff,49,0,50,1
1713308219354,POLI 100DA,A00,494150,Staff,23,0,25,2
1713308221404,POLI 100I,A00,494152,Staff,28,0,30,2
1713308222436,POLI 104B,A00,494153,Smith; Glenn Chatmas,54,0,55,1
1713308223466,POLI 104F,A00,494154,Staff,28,0,30,2
1713308224492,POLI 104I,A00,494155,Smith; Glenn Chatmas,30,0,30,0
1713308225523,POLI 110C,A00,494156,Ingham; Sean,23,0,25,2
1713308226551,POLI 117R,A00,494157,Forman; Fonna,13,0,20,7
1713308227578,POLI 118,A00,494158,Ingham; Sean,23,0,25,2
1713308228607,POLI 120H,A00,494159,Fisk; David Lee,41,0,45,4
1713308229635,POLI 131CR,A00,494160,Hoston; Germaine,40,0,45,5
1713308230661,POLI 133J,A00,494161,Staff,33,0,35,2
1713308231686,POLI 135,A00,494162,Fisk; David Lee,33,0,35,2
1713308232710,POLI 140A,A00,494164,Staff,22,0,30,8
1713308233974,POLI 142I,A00,494165,Staff,30,0,30,0
1713308235003,POLI 144D,A00,494166,Staff,23,0,25,2
1713308236030,POLI 151,A00,494167,Staff,30,0,30,0
1713308237059,POLI 153,A00,494168,Staff,33,0,35,2
1713308238084,POLI 160AA,A00,494169,Staff,35,0,40,5
1713308239110,POLI 162,A00,494170,Mignozzetti; Umberto,21,0,25,4
1713308240137,POLI 171,A00,494171,Mignozzetti; Umberto,23,0,25,2
1713308241161,PSYC 1,A00,494172,Staff,97,0,100,3
1713308242188,PSYC 2,A00,494173,Moranton; Nirelia Melbina-,44,0,50,6
1713308243213,PSYC 3,A00,494174,Staff,30,0,30,0
1713308244242,PSYC 6,A00,494175,Staff,17,0,20,3
1713308245267,PSYC 60,A01,494177,Staff,41,0,45,4
1713308246293,PSYC 70,A01,505724,Geller; Emma Harlan,42,0,45,3
1713308247323,PSYC 101,A00,494180,Heyman; Gail D.,87,0,100,13
1713308248402,PSYC 105,A00,494181,Geller; Emma Harlan,66,0,90,24
1713308249429,PSYC 106,A00,494182,Dobkins; Karen R.,33,0,45,12
1713308250454,PSYC 108,A00,494183,Adrian; Julia Anna,94,0,100,6
1713308251481,PSYC 114,A01,494185,Winkielman; Piotr,5,0,30,25
1713308252505,PSYC 122,A00,494186,Moranton; Nirelia Melbina-,39,0,50,11
1713308253535,PSYC 124,A00,494187,Chapman; Eddie Nathaniel,72,0,80,8
1713308254561,PSYC 131,A00,494188,Anagnostaras; Stephan,59,0,80,21
1713308255590,PSYC 144,A00,494189,Staff,22,0,50,28
1713308256614,PSYC 154,A00,494190,Lacefield; Katharine I,136,0,180,44
1713308257644,PSYC 162,A00,494191,Wixted; John T,86,0,100,14
1713308258671,PSYC 172,A00,494192,Gorman; Michael R.,38,0,45,7
1713308259695,PSYC 178,A00,494193,Glaser; Dale,40,0,45,5
1713308260719,PSYC 193,A00,505725,Chapman; Eddie Nathaniel,20,0,20,0
1713308261749,RELI 145GS,A00,519817,Rahimi; Babak,19,0,20,1
1713308262778,SE 101A,A01,490862,Chadha; Mayank,24,0,25,1
1713308263808,SE 101C,A01,490924,Krysl; Petr,18,0,20,2
1713308264832,SE 110A,A01,490928,Staff,20,0,20,0
1713308265859,SE 130A,A00,490929,Morrison; Machel Leigh,64,0,70,6
1713308267001,SIO 1,A01,519325,Staff,39,0,40,1
1713308268025,SIO 30,A01,519327,Staff,40,0,40,0
1713308269067,SIO 40,A00,519328,Staff,40,0,40,0
1713308270098,SIO 46GS,A00,519819,Cook; Geoffrey W,18,0,25,7
1713308271123,SIO 109R,A00,494197,Forman; Fonna,8,0,20,12
1713308272151,SIO 121GS,A00,519827,Cook; Geoffrey W,18,0,25,7
1713308273180,SIO 132,A01,519330,Staff,38,0,40,2
1713308274209,SIO 133,A01,519397,Staff,38,0,40,2
1713308275234,SIO 139,A00,519396,Kacev; David,33,0,40,7
1713308276260,SOCI 1,A01,494199,Thorpe; Charles Robert,23,0,30,7
1713308276260,SOCI 1,A02,494200,Thorpe; Charles Robert,30,0,30,0
1713308276260,SOCI 1,A03,494201,Thorpe; Charles Robert,29,0,30,1
1713308276260,SOCI 1,A04,494202,Thorpe; Charles Robert,29,0,30,1
1713308276260,SOCI 1,A05,494203,Thorpe; Charles Robert,29,0,30,1
1713308276260,SOCI 1,A06,494204,Thorpe; Charles Robert,30,0,30,0
1713308276260,SOCI 1,A07,494205,Thorpe; Charles Robert,29,0,30,1
1713308277284,SOCI 60,A01,494207,Staff,36,0,40,4
1713308277284,SOCI 60,A02,494208,Staff,39,0,40,1
1713308278314,SOCI 100,A01,494210,Payne; Christine Anna,28,0,30,2
1713308278314,SOCI 100,A02,494211,Payne; Christine Anna,28,0,30,2
1713308279341,SOCI 109M,A00,494212,Staff,20,0,20,0
1713308280370,SOCI 110,A00,494213,Staff,35,0,40,5
1713308282427,SOCI 118E,A00,494215,Ng; Kwai,38,0,40,2
1713308283453,SOCI 125,A00,494216,Calderon-Zaks; Michael Aar,42,0,45,3
1713308284476,SOCI 126,A01,494218,Jones; Makeba,4,0,5,1
1713308285505,SOCI 131,A00,494219,Thorpe; Charles Robert,30,0,30,0
1713308287560,SOCI 135,A00,494221,Payne; Christine Anna,40,0,50,10
1713308288586,SOCI 136E,A00,626690,Ruiz; Jonathan Joseph,25,0,25,0
1713308289616,SOCI 138GS,A00,494222,Navon; Daniel,24,0,28,4
1713308291673,SOCI 145,A00,494224,Staff,42,0,45,3
1713308292698,SOCI 153,A00,494225,Staff,28,0,30,2
1713308293724,SOCI 160E,A00,494226,Ng; Kwai,34,0,40,6
1713308294749,SOCI 180,A00,494227,Staff,29,0,30,1
1713308295776,SOCI 189GS,A00,494228,Ribas Norris; Janet Vanesa,11,0,11,0
1713308296801,SOCI 190GS,A00,553232,Ribas Norris; Janet Vanesa,11,0,11,0
1713308297826,SOMI 220,A00,627178,Schneid; Stephen David,30,0,30,0
1713308298854,SYN 2,001,490768,Staff,14,0,15,1
1713308298854,SYN 2,002,490769,Staff,15,0,15,0
1713308298854,SYN 2,004,490775,Staff,0,0,0,0
1713308298854,SYN 2,003,490774,Staff,0,0,0,0
1713308298854,SYN 2,005,490776,Staff,0,0,0,0
1713308299882,SYN 2R,001,490779,Staff,14,0,15,1
1713308299882,SYN 2R,002,514635,Staff,14,0,15,1
1713308300907,SYN 100,A01,490783,Staff,17,0,20,3
1713308300907,SYN 100,B01,490787,Staff,12,0,20,8
1713308300907,SYN 100,C01,490789,Staff,13,0,20,7
1713308301936,SYN 150,A00,490817,Staff,14,0,15,1
1713308301936,SYN 150,B00,514610,Staff,15,0,15,0
1713308302962,TDAC 1,A00,492753,Walsh; Kim C.,19,0,20,1
1713308302962,TDAC 1,B00,492754,Harting; Carla Kelso,19,0,20,1
1713308302962,TDAC 1,C00,513995,Salovey; Todd,17,0,20,3
1713308303988,TDAC 101,A00,492766,Harting; Carla Kelso,18,0,20,2
1713308305015,TDAC 102,A00,492768,Basso; Beatrice,19,0,20,1
1713308306042,TDDE 111,A00,492769,Staff,25,0,25,0
1713308307071,TDDE 131,A00,492770,Staff,15,0,15,0
1713308307071,TDDE 131,B00,492771,Staff,15,0,15,0
1713308308098,TDDE 131GS,A00,523716,Guirguis; Mark C,25,0,28,3
1713308309125,TDGE 1,A01,492756,Salovey; Todd,57,0,60,3
1713308310151,TDGE 5,A01,492758,Staff,24,0,25,1
1713308311176,TDGE 10,A00,492759,Fulton; Julia,212,0,220,8
1713308312202,TDGE 11,A00,492760,Castro; Robert Jess,200,0,200,0
1713308313230,TDGE 50,A00,492761,Blair; Kyle Adam,0,0,0,0
1713308314265,TDGE 124,A00,492772,Fulton; Julia,197,0,220,23
1713308315300,TDGE 125,A00,492773,Meyer; Ursula,41,0,50,9
1713308315300,TDGE 125,B00,492774,Staff,50,0,50,0
1713308315300,TDGE 125,C00,523565,Staff,49,0,50,1
1713308316324,TDGE 125GS,A00,523580,Guirguis; Mark C,25,0,28,3
1713308317349,TDGE 127,A00,492775,Havis; Allan,43,0,50,7
1713308318375,TDHT 101,A00,492776,Staff,35,0,35,0
1713308319401,TDMV 1,A00,492762,Caligagan; Maria T.,30,0,30,0
1713308319401,TDMV 1,B00,492763,Arcidiacono; Kristin,25,0,30,5
1713308320431,TDMV 2,A00,492764,Weinberg; Sadie,29,0,30,1
1713308321458,TDMV 3,A00,492765,Mack; Kara Shanai',39,0,40,1
1713308322489,TDMV 138,A00,492777,Mack; Kara Shanai',37,0,40,3
1713308323515,TDMV 140,A00,492778,Lima; Paulo Henrique,40,0,40,0
1713308324547,TDMV 142,A00,492779,Caligagan; Maria T.,37,0,40,3
1713308324547,TDMV 142,B00,492780,Caligagan; Tony,38,0,40,2
1713308325575,TDMV 143,A00,492781,Fyall; Daunte Edward,39,0,40,1
1713308326606,USP 1,A01,492401,Kwak; Nancy,26,0,35,9
1713308327632,USP 2,A01,492453,Hinds; Juli Beth,35,0,35,0
1713308328657,USP 3,A01,492516,Staff,30,0,35,5
1713308329684,USP 4,A00,492522,McTague; Sarah,19,0,25,6
1713308330709,USP 100,A00,492523,Staff,33,0,35,2
1713308331733,USP 101,A00,492524,Staff,13,0,15,2
1713308332760,USP 105,A00,492525,Staff,22,0,25,3
1713308333790,USP 151,A00,492526,Shenkman; Michael Thomas,33,0,35,2
1713308334816,USP 170,A00,492545,Hinds; Juli Beth,33,0,35,2
1713308335843,USP 171GS,A00,492608,Bussell; Mirle Rabinowitz,26,0,28,2
1713308336867,USP 183GS,A00,492613,Peerson; Susan,26,0,28,2
1713308337893,VIS 30,A01,490693,Yoldas; Pinar,21,0,22,1
1713308337893,VIS 30,A02,490694,Yoldas; Pinar,19,0,22,3
1713308338918,VIS 83,A00,490695,Kester; Grant,68,0,75,7
1713308339946,VIS 105D,A00,490696,Staff,22,0,25,3
1713308340973,VIS 124CN,A00,490699,Rose; Jordan M,68,0,75,7
1713308341999,VIS 125GS,A00,511221,Williams; Alena J,21,0,22,1
1713308343160,VIS 128D,A00,490700,Staff,74,0,75,1
1713308344185,VIS 151,A01,490717,Staff,34,0,34,0
1713308344185,VIS 151,A02,490766,Staff,33,0,34,1
1713308345209,VIS 154GS,A00,511972,Williams; Alena J,21,0,22,1
1713308346236,VIS 160A,A00,490767,Stone; Patricia,7,0,10,3
1713308347261,WCWP 10A,A00,490638,Staff,15,0,15,0
1713308347261,WCWP 10A,B00,490640,Staff,15,0,15,0
1713308348286,WCWP 10B,A00,490641,Staff,0,0,0,0
1713308348286,WCWP 10B,B00,490642,Staff,14,0,15,1
1713308348286,WCWP 10B,C00,490644,Staff,13,0,15,2
1713308348286,WCWP 10B,D00,490647,Staff,0,0,0,0
1713308349315,WCWP 100,A00,490655,Staff,0,0,0,0
1713308349315,WCWP 100,B00,490687,Staff,12,0,15,3
1713308351447,ANAR 153,A00,487222,Braswell; Geoffrey E.,55,0,60,5
1713308352532,ANBI 134,A00,487223,Staff,14,0,20,6
1713308353560,ANBI 143GS,A00,487224,Noel; Geoffroy Pierre Jean,20,0,24,4
1713308354585,ANBI 144GS,A00,519548,Noel; Geoffroy Pierre Jean,20,0,24,4
1713308355611,ANSC 101,A00,487225,Staff,19,0,20,1
1713308356637,ANSC 125,A00,487227,Brenner; Suzanne A,39,0,40,1
1713308358688,ANSC 146,A00,487229,Staff,36,0,40,4
1713308359712,ANSC 148,A00,487230,Olivas Hernandez; Olga Lid,39,0,40,1
1713308360744,ANSC 150,A00,504165,Sloane; Julia Kathryn,19,0,20,1
1713308361769,ANSC 180,A00,487232,Staff,13,0,15,2
1713308362795,ANSC 188,A00,627155,Staff,40,0,40,0
1713308363821,ANTH 5,A00,519529,Semendeferi; Ekaterini,15,0,15,0
1713308364851,ANTH 10,A00,487219,Staff,58,0,60,2
1713308365876,ANTH 23,A01,487221,Staff,17,0,20,3
1713308366900,ANTH 102,A00,487233,Wilder; Linnea Lorene,53,0,60,7
1713308367931,ANTH 103,A00,487234,Varma; Saiba,57,0,60,3
1713308368957,ANTH 105,A00,487235,Stewart; Alexander B,57,0,60,3
1713308369982,BENG 100,A01,516685,Taylor Amos; Alyssa C,28,0,30,2
1713308371011,BIBC 102,A01,491316,Flagg; Matthew Paul,54,0,88,34
1713308371011,BIBC 102,A02,491366,Flagg; Matthew Paul,84,0,88,4
1713308372036,BIBC 103,A01,491486,Boumechache; Miyyada,16,0,24,8
1713308372036,BIBC 103,A02,491487,Boumechache; Miyyada,24,0,24,0
1713308373069,BICD 100,A01,516882,Staff,75,0,75,0
1713308373069,BICD 100,A02,516890,Staff,70,0,75,5
1713308374099,BICD 102GS,A00,491488,Lo; Stanley M.,27,0,28,1
1713308375124,BIEB 136GS,A00,516940,Holway; David A. & Shurin; Jonathan,20,0,24,4
1713308376151,BIEB 137GS,A01,517034,Holway; David A. & Shurin; Jonathan,20,0,24,4
1713308377176,BIEB 138GS,A01,491492,Pirino; Giorgia,22,0,28,6
1713308378202,BILD 1,A01,491296,Staff,62,0,63,1
1713308378202,BILD 1,A02,491297,Staff,63,0,63,0
1713308379226,BILD 4,A01,517099,Gonzalez Gamboa; Ivonne,22,0,24,2
1713308379226,BILD 4,A02,517100,Gonzalez Gamboa; Ivonne,24,0,24,0
1713308380252,BILD 60GS,A00,491309,Lo; Stanley M.,27,0,28,1
1713308381278,BIMM 100,A01,517136,Staff,92,0,100,8
1713308382306,BIMM 110,A01,517182,Staff,75,0,100,25
1713308383331,BIMM 120,A01,517228,Pickett; Brooke Elizabeth,40,0,63,23
1713308383331,BIMM 120,A02,517240,Pickett; Brooke Elizabeth,48,0,63,15
1713308384360,BIMM 132GS,A01,491498,Pirino; Giorgia,22,0,28,6
1713308385385,BIMM 143,A01,491589,Bozinovic; Goran,21,0,40,19
1713308386411,BIPN 100,A01,491594,Armour; Jon Christopher,92,0,100,8
1713308387435,BIPN 140,A01,491602,Marino; Marc J,32,0,50,18
1713308389482,CAT 125,A00,515973,Staff,20,0,20,0
1713308390507,CAT 125GS,A00,515974,Rahimi; Babak,19,0,20,1
1713308391531,CAT 125R,A00,515980,Staff,15,0,20,5
1713308391531,CAT 125R,B00,515981,Tosun; Adriana,19,0,20,1
1713308391531,CAT 125R,C00,515987,Hyland; Tina Mae,3,0,20,17
1713308391531,CAT 125R,D00,515988,Bronstein; Phoebe Malan,18,0,20,2
1713308392561,CENG 15,A01,488699,Drews; Aaron,25,0,25,0
1713308393587,CENG 100,A00,505196,Opatkiewicz; Justin Paul,25,0,25,0
1713308394612,CGS 2A,A01,489598,Staff,33,0,35,2
1713308395639,CGS 112,A00,489599,Staff,15,0,15,0
1713308396667,CGS 119,A00,489603,Staff,10,0,10,0
1713308397695,CGS 120,A00,489604,Staff,14,0,15,1
1713308398722,CGS 150,A00,489607,Staff,15,0,15,0
1713308399750,CHEM 6A,A01,488715,Staff,98,0,100,2
1713308400780,CHEM 6B,A01,488719,Piercy; Marc Anthony,100,0,100,0
1713308401805,CHEM 6C,A01,488723,Albizati; Kim F.,94,0,100,6
1713308402830,CHEM 7L,A01,488728,Schurmeier; Kimberly,18,0,24,6
1713308402830,CHEM 7L,A02,488730,Schurmeier; Kimberly,23,0,24,1
1713308402830,CHEM 7L,A03,488734,Schurmeier; Kimberly,24,0,24,0
1713308402830,CHEM 7L,A04,488763,Schurmeier; Kimberly,23,0,24,1
1713308402830,CHEM 7L,B01,488798,Schurmeier; Kimberly,18,0,24,6
1713308402830,CHEM 7L,B02,488801,Schurmeier; Kimberly,24,0,24,0
1713308402830,CHEM 7L,B03,488808,Schurmeier; Kimberly,24,0,24,0
1713308402830,CHEM 7L,B04,488811,Schurmeier; Kimberly,24,0,24,0
1713308403872,CHEM 11,A01,488897,Stallings; Dontarie M,98,0,100,2
1713308404902,CHEM 40A,A01,488913,Albizati; Kim F.,91,0,100,9
1713308405930,CHEM 40B,A01,488920,Weizman; Haim,48,0,50,2
1713308405930,CHEM 40B,A02,488938,Weizman; Haim,46,0,50,4
1713308406956,CHEM 41A,A01,489029,Klosterman; Jeremy K,58,0,60,2
1713308407983,CHEM 41C,A01,500436,Tor; Yitzhak,55,0,60,5
1713308409019,CHEM 43A,A01,500426,Weizman; Haim,6,0,24,18
1713308409019,CHEM 43A,A02,500430,Weizman; Haim,13,0,24,11
1713308409019,CHEM 43A,B01,514041,Klosterman; Jeremy K,16,0,24,8
1713308409019,CHEM 43A,B02,514047,Klosterman; Jeremy K,23,0,24,1
1713308410051,CHEM 108,A01,489140,Jennings; Patricia A.,14,0,24,10
1713308410051,CHEM 108,A02,489142,Jennings; Patricia A.,15,0,24,9
1713308411082,CHEM 114A,A01,489147,Stallings; Dontarie M,81,0,100,19
1713308412108,CHIN 169A,A00,489171,Wang; Xiao,19,0,20,1
1713308414164,COGS 3,A01,518827,Boyle; Mary E. T.,30,0,40,10
1713308415190,COGS 11,A01,489175,Staff,28,0,30,2
1713308416213,COGS 14A,A01,518829,Staff,53,0,60,7
1713308417239,COGS 14B,A01,489177,Hoffman; Drew Ellen,69,0,75,6
1713308418266,COGS 100,A01,489181,Allen; Michael Gordon,66,0,75,9
1713308419293,COGS 101A,A01,489183,Staff,51,0,60,9
1713308420326,COGS 101B,A01,489185,Allen; Michael Gordon,13,0,30,17
1713308421351,COGS 101C,A01,526786,Staff,25,0,30,5
1713308423408,COGS 107A,A01,489189,Boyle; Mary E. T.,23,0,35,12
1713308424435,COGS 107B,A01,627144,Mooshagian; Eric Frederick,60,0,60,0
1713308425461,COGS 118A,A01,489191,Staff,0,27,40,40
1713308427515,COGS 171GS,A01,489194,Pineda; Jaime A,22,0,28,6
1713308428540,COGS 172,A01,489196,Staff,6,0,30,24
1713308429568,COGS 174GS,A01,489264,Pineda; Jaime A,22,0,28,6
1713308430596,COGS 180,A01,627150,Staff,29,0,30,1
1713308431622,COGS 186,A01,489274,Staff,4,0,30,26
1713308432652,COMM 10,A01,489276,Staff,24,0,25,1
1713308432652,COMM 10,A02,489303,Staff,23,0,25,2
1713308433677,COMM 100A,A01,489312,Staff,21,0,25,4
1713308433677,COMM 100A,A02,489313,Staff,24,0,25,1
1713308434704,COMM 106T,A00,512540,Staff,34,0,35,1
1713308435731,COMM 107,A00,489347,Staff,31,0,35,4
1713308436758,COMM 109P,A00,489358,Staff,31,0,35,4
1713308437783,COMM 132,A00,489361,McKenna; Denise,29,0,30,1
1713308438812,COMM 146,A00,489362,Halm; Gavin Patrick,27,0,30,3
1713308439843,COMM 190,A00,489363,Abuelhiga; Soraya Jill,21,0,23,2
1713308440874,CSE 8A,A50,489366,Staff,23,0,25,2
1713308440874,CSE 8A,A51,489367,Staff,24,0,25,1
1713308441900,CSE 11,A01,489398,Cao; Yingjun,83,0,100,17
1713308442929,CSE 12,A01,489487,Staff,43,0,50,7
1713308443954,CSE 20,A01,489497,Staff,49,0,50,1
1713308444985,CSE 21,A01,489517,Braun; Oliver,44,0,50,6
1713308446013,CSE 101,A01,489524,Braun; Oliver,0,10,50,50
1713308447045,CSE 105,A01,512594,Jones; Miles E,82,0,100,18
1713308447045,CSE 105,B01,512598,Jones; Miles E,69,0,100,31
1713308448079,CSE 140,A01,489538,Staff,44,0,50,6
1713308449110,CSE 141,A01,489550,Eldon; John,76,0,100,24
1713308450138,CSE 141L,A01,489571,Eldon; John,75,0,100,25
1713308451163,CSE 151A,A01,489583,Solares; Edwin A,152,0,200,48
1713308452191,CSE 175,A01,510886,Kumar; Rakesh,30,0,30,0
1713308453221,CSE 190,A00,516828,Dubnov; Shlomo,41,0,49,8
1713308454247,DOC 100D,A00,489667,Pass; Natalye Joann,23,0,25,2
1713308455271,DSC 10,A01,624268,Staff,72,0,75,3
1713308456353,DSC 20,A01,624476,Staff,50,0,50,0
1713308457379,DSC 40A,A01,624608,Staff,40,0,40,0
1713308458406,DSGN 1,A01,489179,Rill; Bryan,37,0,50,13
1713308459437,ECE 17,A01,490489,Sahay; Rajeev,19,0,30,11
1713308460462,ECE 65,A50,490492,Staff,17,0,20,3
1713308460462,ECE 65,A51,490493,Staff,20,0,20,0
1713308461486,ECON 1,A01,489715,Famulari; Melissa,69,0,70,1
1713308462515,ECON 2,A01,489717,Levkoff; Steven B.,68,0,70,2
1713308463574,ECON 3,A01,489948,Staff,70,0,70,0
1713308465645,ECON 5,A01,490103,Staff,28,0,30,2
1713308465645,ECON 5,B01,626281,Dai; Yinlin,45,0,45,0
1713308466671,ECON 100A,A01,490127,Famulari; Melissa,69,0,70,1
1713308467697,ECON 100B,A01,490129,Staff,64,0,70,6
1713308468723,ECON 109,A01,490187,Shishkin; Denis,27,0,35,8
1713308469748,ECON 110A,A01,490190,Levkoff; Steven B.,64,0,70,6
1713308470777,ECON 120A,A01,490245,Dai; Yinlin,67,0,70,3
1713308471806,ECON 120B,A01,490247,Nieto-Barthaburu; Augusto,60,0,70,10
1713308472839,ECON 120C,A01,490253,Sun; Yixiao,32,0,35,3
1713308472839,ECON 120C,B01,490255,Sun; Yixiao,34,0,35,1
1713308473874,ECON 129,A00,490256,Eckert; Fabian Paul,26,0,35,9
1713308474899,ECON 131,A00,490257,Nieto-Barthaburu; Augusto,4,0,35,31
1713308475924,ECON 138,A00,490258,Bharadwaj; Prashant,24,0,35,11
1713308475924,ECON 138,B00,490259,Bharadwaj; Prashant,18,0,35,17
1713308476953,ECON 159,A00,490260,Hendrickson; Gerald M.,0,6,0,0
1713308477980,ECON 178,A01,553995,Zhu; Ying,27,0,35,8
1713308479011,EDS 40,A01,512576,Black; Alison Michelle,20,0,20,0
1713308480036,EDS 107,A01,515848,Staff,30,0,30,0
1713308481061,EDS 110R,A01,490262,Staff,26,0,30,4
1713308482087,EDS 112,A01,490264,Chapman; Thandeka K,44,0,50,6
1713308483112,EDS 113,A00,490266,Staff,27,0,30,3
1713308484138,EDS 118,A00,490267,Warstadt; Melissa Fawn,26,0,30,4
1713308485163,EDS 124BR,A00,490268,Eguchi; Emi,10,0,25,15
1713308485163,EDS 124BR,B00,490269,Eguchi; Emi,25,0,25,0
1713308486188,EDS 126,A01,490271,Jones; Makeba,45,0,50,5
1713308487216,EDS 135,A01,490316,Staff,19,0,20,1
1713308488241,ENVR 142GS,A00,519514,Chang; Edmond Yi-Teh,28,0,28,0
1713308489268,ETHN 103,A00,490504,Staff,33,0,36,3
1713308490296,ETHN 103A,A00,490505,Man; Simeon S,7,0,9,2
1713308491324,ETHN 109,A00,490506,Staff,30,0,30,0
1713308492351,ETHN 118,A00,490507,Staff,35,0,36,1
1713308493376,ETHN 119,A00,490508,Staff,36,0,36,0
1713308494404,ETHN 121R,A00,490518,Choi; Esther Min,30,0,36,6
1713308495428,ETHN 127,A00,490528,Staff,15,0,15,0
1713308496451,ETHN 139,A00,490573,Staff,10,0,10,0
1713308497476,ETHN 150,A00,490575,Staff,15,0,15,0
1713308498505,GLBH 20,A00,491705,Elwardani; Nile Regina,38,0,40,2
1713308499531,GLBH 101,A00,491706,Staff,20,0,20,0
1713308500555,GLBH 111,A01,491708,Burgos; Jose L.,15,0,15,0
1713308501579,GLBH 146,A00,491709,Staff,12,0,20,8
1713308502608,GLBH 148,A00,491710,Olivas Hernandez; Olga Lid,16,0,20,4
1713308503634,GLBH 150,A00,491711,Sloane; Julia Kathryn,20,0,20,0
1713308504660,HIEA 131,A00,491760,Staff,30,0,32,2
1713308505685,HIEA 153,A00,491762,Staff,29,0,30,1
1713308506715,HIEU 124,A00,491811,Staff,26,0,32,6
1713308507741,HIEU 124GS,A00,491812,Markman; Kristina,28,0,28,0
1713308508766,HIEU 147,A00,491813,Staff,30,0,32,2
1713308509793,HIEU 149GS,A00,491816,Caldwell; Michael Alan,28,0,28,0
1713308510820,HILD 2C,A01,491713,Hendrickson; Gerald M.,28,0,30,2
1713308511845,HILD 7B,A01,491715,Kwak; Nancy,15,0,30,15
1713308512873,HILD 10,A01,491717,Staff,14,0,20,6
1713308513902,HILD 30GS,A00,491719,Edington; Claire Ellen,24,0,28,4
1713308514929,HINE 109,A00,491818,Shafir; Nir,29,0,32,3
1713308515952,HINE 128,A00,491821,Shafir; Nir,31,0,32,1
1713308516982,HISC 117,A00,491830,Staff,29,0,32,3
1713308518011,HIUS 103,A00,491834,Man; Simeon S,16,0,23,7
1713308519037,HIUS 108B,A00,491835,Staff,29,0,30,1
1713308520063,HIUS 141,A00,491836,Hendrickson; Gerald M.,29,0,32,3
1713308521089,HIUS 149,A00,491839,Staff,27,0,32,5
1713308522115,HUM 3,A01,512617,Crum; Matthew Stephen,46,0,50,4
1713308522115,HUM 3,A02,512618,Crum; Matthew Stephen,48,0,50,2
1713308523139,HUM 3GS,A00,512663,Markman; Kristina,0,0,0,0
1713308523139,HUM 3GS,B00,512664,Staff,0,0,0,0
1713308524165,HUM 4,A01,512620,West; Geoffrey Scott,36,0,50,14
1713308525190,HUM 4GS,A00,512666,Lyon; Antony J.,0,0,0,3
1713308526220,HUM 4R,A01,512625,Watkins; Eric,49,0,50,1
1713308527247,HUM 5,A01,512649,Zavodny; Tatiana Sophia,34,0,50,16
1713308527247,HUM 5,B01,512661,Zroka; Ryan Edward,49,0,50,1
1713308528277,INTL 190,A00,490577,Segui; Alan S,0,0,0,5
1713308529304,JAPN 20AR,A01,491267,Ross; Kayoko F,12,0,20,8
1713308530335,JAPN 180,A00,491285,Berman; Michael David,34,0,40,6
1713308531366,LATI 50,A01,502536,Kokinis; Troy Andreas,19,0,22,3
1713308531366,LATI 50,A02,502551,Kokinis; Troy Andreas,22,0,22,0
1713308531366,LATI 50,A03,502650,Kokinis; Troy Andreas,22,0,22,0
1713308531366,LATI 50,A04,502909,Kokinis; Troy Andreas,22,0,22,0
1713308532391,LATI 160,A01,502920,Kokinis; Troy Andreas,30,0,30,0
1713308533422,LIFR 1A,A00,490494,Van Moer; Vinciane G,17,0,20,3
1713308534448,LIFR 1AX,A00,490495,Van Moer; Vinciane G,17,0,20,3
1713308535479,LIFR 1B,A00,490496,Van Moer; Vinciane G,19,0,20,1
1713308536506,LIFR 1BX,A00,490497,Van Moer; Vinciane G,19,0,20,1
1713308537535,LIGN 8,A00,505198,McIntosh; Justin Daniel,141,0,150,9
1713308538568,LIGN 9GS,A00,491239,Lott; Margaret S.,18,0,20,2
1713308539595,LIGN 101,A01,505200,McIntosh; Justin Daniel,26,0,30,4
1713308540620,LIGN 120,A01,491244,Staff,24,0,30,6
1713308541647,LIGN 149GS,A00,491245,Lott; Margaret S.,18,0,20,2
1713308542670,LIGN 170,A00,491247,Staff,24,0,30,6
1713308543694,LISP 1D,A00,490498,Munoz Sanchez; Alicia,11,0,14,3
1713308543694,LISP 1D,B00,490499,Munoz Sanchez; Alicia,6,0,14,8
1713308543694,LISP 1D,C00,490500,Munoz Sanchez; Alicia,10,0,14,4
1713308543694,LISP 1D,D00,490501,Munoz Sanchez; Alicia,11,0,14,3
1713308544726,LISP 1DX,A00,490502,Munoz Sanchez; Alicia,18,0,28,10
1713308544726,LISP 1DX,B00,490503,Munoz Sanchez; Alicia,19,0,28,9
1713308546787,LTAM 110,A00,491847,Staff,23,0,25,2
1713308547814,LTCS 119,A00,491848,Staff,12,0,15,3
1713308548842,LTCS 130,A00,491849,Staff,24,0,25,1
1713308550892,LTEA 120C,A00,491852,Staff,35,0,40,5
1713308551918,LTEN 130GS,A00,491853,Lyon; Antony J.,25,0,28,3
1713308552945,LTEN 148,A00,491855,Staff,23,0,25,2
1713308553974,LTEN 159,A00,491856,Staff,21,0,25,4
1713308555002,LTEN 180,A00,491857,Staff,9,0,15,6
1713308557057,LTSP 123GS,A00,505928,Bessett; Ryan Matthew,25,0,28,3
1713308558082,LTSP 174GS,A00,506037,Bessett; Ryan Matthew,25,0,28,3
1713308560194,LTWR 102,A00,491861,Staff,12,0,15,3
1713308561301,LTWR 106,A00,491862,Staff,10,0,15,5
1713308562330,MAE 11,A00,490930,Bahadori; Mohammad Yousef,97,0,100,3
1713308563360,MAE 30A,A00,490931,Qi; Huihui,38,0,40,2
1713308564390,MAE 101A,A00,491036,Sadeghizadeh; Zahra,98,0,100,2
1713308565415,MAE 101C,A00,491037,Seshadri; Kalyanasundaram,78,0,100,22
1713308566448,MAE 113,A00,491040,Seshadri; Kalyanasundaram,67,0,80,13
1713308567474,MAE 131A,A00,491041,Ghazinejad; Maziar,39,0,40,1
1713308568497,MAE 142,A00,491053,Staff,39,0,40,1
1713308569525,MAE 143A,A00,491054,Staff,40,0,50,10
1713308570552,MAE 150,A00,491092,Truong; Phuong Thi Ngoc,24,0,35,11
1713308571582,MATH 3C,A01,494031,Pardo Guerra; Sebastian,30,0,30,0
1713308571582,MATH 3C,A02,494032,Pardo Guerra; Sebastian,29,0,30,1
1713308572605,MATH 10A,A01,494034,Staff,27,0,30,3
1713308572605,MATH 10A,A02,494035,Staff,29,0,30,1
1713308572605,MATH 10A,B01,494037,Staff,27,0,30,3
1713308572605,MATH 10A,B02,494038,Staff,29,0,30,1
1713308573632,MATH 10B,A01,494040,Habib; Yousaf,24,0,30,6
1713308573632,MATH 10B,A02,494041,Habib; Yousaf,28,0,30,2
1713308573632,MATH 10B,A03,494042,Habib; Yousaf,30,0,30,0
1713308573632,MATH 10B,A04,494043,Habib; Yousaf,30,0,30,0
1713308573632,MATH 10B,B01,494045,Habib; Yousaf,28,0,30,2
1713308573632,MATH 10B,B02,494046,Habib; Yousaf,30,0,30,0
1713308573632,MATH 10B,B03,494047,Habib; Yousaf,30,0,30,0
1713308573632,MATH 10B,B04,494048,Habib; Yousaf,30,0,30,0
1713308574658,MATH 18,A01,494050,Kemp; Todd Aahron,27,0,30,3
1713308574658,MATH 18,A02,494051,Kemp; Todd Aahron,29,0,30,1
1713308574658,MATH 18,B01,494054,Kemp; Todd Aahron,28,0,30,2
1713308574658,MATH 18,B02,494055,Kemp; Todd Aahron,29,0,30,1
1713308575688,MATH 20A,A01,494059,Suk; Andrew Hoon,30,0,30,0
1713308576719,MATH 20B,A01,494061,Briones; Jor-el Thomas Caparas,34,0,35,1
1713308576719,MATH 20B,B01,494063,Bach; Quang Tran,34,0,35,1
1713308577746,MATH 20C,A01,494065,Staff,28,0,30,2
1713308577746,MATH 20C,A02,494066,Staff,30,0,30,0
1713308577746,MATH 20C,A03,494067,Staff,30,0,30,0
1713308577746,MATH 20C,A04,494068,Staff,30,0,30,0
1713308577746,MATH 20C,B01,494070,Zhang; Ming,26,0,30,4
1713308577746,MATH 20C,B02,494071,Zhang; Ming,30,0,30,0
1713308577746,MATH 20C,B03,494072,Zhang; Ming,29,0,30,1
1713308577746,MATH 20C,B04,494073,Zhang; Ming,28,0,30,2
1713308578775,MATH 20D,A01,494075,Staff,26,0,30,4
1713308578775,MATH 20D,A02,494076,Staff,30,0,30,0
1713308579800,MATH 20E,A01,494079,Staff,25,0,30,5
1713308579800,MATH 20E,A02,494080,Staff,27,0,30,3
1713308579800,MATH 20E,B01,494082,Staff,28,0,30,2
1713308579800,MATH 20E,B02,494083,Staff,25,0,30,5
1713308580833,MATH 103A,A01,494085,Aliabadi Sr.; Mohsen,17,0,30,13
1713308580833,MATH 103A,A02,494086,Aliabadi Sr.; Mohsen,28,0,30,2
1713308580833,MATH 103A,B01,494088,Aliabadi Sr.; Mohsen,22,0,30,8
1713308580833,MATH 103A,B02,494089,Aliabadi Sr.; Mohsen,28,0,30,2
1713308581858,MATH 109,A01,494091,Staff,30,0,30,0
1713308581858,MATH 109,A02,494092,Staff,30,0,30,0
1713308581858,MATH 109,B01,494094,Staff,28,0,30,2
1713308581858,MATH 109,B02,494095,Staff,29,0,30,1
1713308582886,MATH 142A,A01,494097,Chow; Bennett,16,0,30,14
1713308582886,MATH 142A,A02,494098,Chow; Bennett,24,0,30,6
1713308582886,MATH 142A,B01,494100,Chow; Bennett,21,0,30,9
1713308582886,MATH 142A,B02,494101,Chow; Bennett,29,0,30,1
1713308584944,MATH 168A,A01,516677,Dumitriu; Ioana,16,0,35,19
1713308585973,MATH 170A,A01,516679,Dumitriu; Ioana,20,0,30,10
1713308585973,MATH 170A,A02,516680,Dumitriu; Ioana,28,0,30,2
1713308587012,MATH 193A,A01,494107,Staff,17,0,30,13
1713308587012,MATH 193A,A02,494108,Staff,24,0,30,6
1713308587012,MATH 193A,A03,494109,Staff,29,0,30,1
1713308587012,MATH 193A,A04,494110,Staff,24,0,30,6
1713308590090,MGT 16,A00,491930,McKay; Michael J,94,0,98,4
1713308591117,MGT 18,A00,491992,McKay; Michael J,97,0,98,1
1713308592144,MGT 71,A00,492003,Staff,78,0,98,20
1713308593170,MGT 103,A00,505209,Eberhard; Craig A,86,0,98,12
1713308594203,MGT 131A,A00,505210,Anderson; John Charles,91,0,98,7
1713308596255,MGT 153,A00,492077,Perols; Johan Lars,46,0,90,44
1713308599330,MGT 164,A00,492222,McKay; Mary A,94,0,98,4
1713308600355,MGT 172,A00,492245,Staff,59,0,60,1
1713308600355,MGT 172,B00,505526,Hedges; Kathleen,78,0,98,20
1713308601380,MGT 181,A00,505669,Dunn; Louis Jean,88,0,98,10
1713308602414,MMW 14,A01,494399,Staff,23,0,28,5
1713308602414,MMW 14,A02,494400,Staff,26,0,28,2
1713308602414,MMW 14,A03,494401,Staff,28,0,28,0
1713308602414,MMW 14,A04,494402,Staff,28,0,28,0
1713308602414,MMW 14,B01,494404,Carreras; Maria Victoria,16,0,28,12
1713308602414,MMW 14,B02,494405,Carreras; Maria Victoria,27,0,28,1
1713308602414,MMW 14,B03,494406,Carreras; Maria Victoria,28,0,28,0
1713308602414,MMW 14,B04,494407,Carreras; Maria Victoria,28,0,28,0
1713308603443,MMW 14GS,A00,506250,Chang; Edmond Yi-Teh,0,0,0,0
1713308604468,MMW 121R,A01,494415,Adamiak; Patrick John,15,0,28,13
1713308604468,MMW 121R,A02,494416,Adamiak; Patrick John,25,0,28,3
1713308605492,MUS 1A,A01,494113,Staff,12,0,25,13
1713308605492,MUS 1A,A02,494114,Staff,25,0,25,0
1713308606519,MUS 4,A01,494116,Staff,24,0,25,1
1713308606519,MUS 4,A02,494117,Staff,22,0,25,3
1713308607546,MUS 5R,A01,494236,Dubnov; Shlomo,12,0,25,13
1713308607546,MUS 5R,A02,494237,Dubnov; Shlomo,25,0,25,0
1713308608572,MUS 6,A01,494122,Staff,16,0,25,9
1713308608572,MUS 6,A02,494123,Staff,24,0,25,1
1713308609598,MUS 7,A01,494125,Staff,17,0,25,8
1713308609598,MUS 7,A02,494126,Staff,24,0,25,1
1713308610623,MUS 11,A01,494128,Staff,23,0,25,2
1713308610623,MUS 11,A02,494129,Staff,25,0,25,0
1713308611654,MUS 13,A01,494131,Staff,25,0,25,0
1713308611654,MUS 13,A02,494132,Staff,25,0,25,0
1713308612681,MUS 15,A01,494134,Staff,20,0,25,5
1713308612681,MUS 15,A02,494135,Staff,25,0,25,0
1713308612681,MUS 15,B01,494137,Staff,24,0,25,1
1713308613706,MUS 80,A00,494232,Staff,25,0,25,0
1713308613706,MUS 80,B00,494233,Staff,25,0,25,0
1713308613706,MUS 80,C00,494234,Staff,23,0,25,2
1713308614734,MUS 95C,A00,494141,Staff,73,0,75,2
1713308615759,MUS 114,A00,494142,Staff,41,0,50,9
1713308616789,NANO 15,A01,490636,Drews; Aaron,7,0,7,0
1713308617814,PHIL 1,A00,490578,Grush; Rick Scott,50,0,50,0
1713308618839,PHIL 10,A01,490580,Grush; Rick Scott,34,0,35,1
1713308618839,PHIL 10,A02,490586,Grush; Rick Scott,33,0,35,2
1713308619866,PHIL 27,A01,490591,Staff,24,0,25,1
1713308619866,PHIL 27,A02,490592,Staff,25,0,25,0
1713308619866,PHIL 27,A03,490593,Staff,25,0,25,0
1713308619866,PHIL 27,A04,490598,Staff,25,0,25,0
1713308620890,PHIL 32,A01,490611,Staff,20,0,20,0
1713308620890,PHIL 32,A02,490618,Staff,20,0,20,0
1713308621916,PHIL 90,A00,490624,Staff,40,0,40,0
1713308622942,PHIL 136,A00,490627,Cohen; Jonathan David,38,0,40,2
1713308623966,PHIL 155,A00,490634,Staff,66,0,70,4
1713308624994,PHYS 1A,A00,491610,Staff,246,0,250,4
1713308626021,PHYS 1AL,001,491616,Tsai; Philbert S,28,0,30,2
1713308626021,PHYS 1AL,002,491618,Tsai; Philbert S,30,0,30,0
1713308627045,PHYS 1B,A00,491623,Staff,244,0,250,6
1713308628071,PHYS 1BL,001,491626,Tsai; Philbert S,26,0,30,4
1713308628071,PHYS 1BL,002,491628,Tsai; Philbert S,28,0,30,2
1713308629097,PHYS 1C,A00,491632,Staff,225,0,245,20
1713308630128,PHYS 1CL,001,491635,Tsai; Philbert S,12,0,30,18
1713308630128,PHYS 1CL,002,491643,Tsai; Philbert S,24,0,30,6
1713308631157,PHYS 2AR,A01,491651,Meyertholen; Andrew D.,46,0,50,4
1713308632182,PHYS 2B,A01,491659,Staff,107,0,115,8
1713308633208,PHYS 2BL,A01,491685,Staff,23,0,24,1
1713308633208,PHYS 2BL,A02,491700,Staff,23,0,24,1
1713308634232,PHYS 2C,A01,505161,Staff,107,0,115,8
1713308635258,PHYS 4A,A01,491704,Grinstein; Benjamin,99,0,100,1
1713308636289,POLI 5D,A01,494144,Staff,3,0,5,2
1713308636289,POLI 5D,B01,626283,Dai; Yinlin,5,0,5,0
1713308637317,POLI 12,A00,494145,Staff,44,0,45,1
1713308638346,POLI 13R,A00,494146,Forman; Fonna,46,0,50,4
1713308639371,POLI 27,A01,494148,Staff,58,0,60,2
1713308640397,POLI 30,A00,494149,Staff,49,0,50,1
1713308641426,POLI 100DA,A00,494150,Staff,23,0,25,2
1713308643476,POLI 100I,A00,494152,Staff,28,0,30,2
1713308644502,POLI 104B,A00,494153,Smith; Glenn Chatmas,54,0,55,1
1713308645528,POLI 104F,A00,494154,Staff,28,0,30,2
1713308646553,POLI 104I,A00,494155,Smith; Glenn Chatmas,30,0,30,0
1713308647584,POLI 110C,A00,494156,Ingham; Sean,23,0,25,2
1713308648612,POLI 117R,A00,494157,Forman; Fonna,13,0,20,7
1713308649637,POLI 118,A00,494158,Ingham; Sean,23,0,25,2
1713308650667,POLI 120H,A00,494159,Fisk; David Lee,41,0,45,4
1713308651694,POLI 131CR,A00,494160,Hoston; Germaine,40,0,45,5
1713308652720,POLI 133J,A00,494161,Staff,33,0,35,2
1713308653746,POLI 135,A00,494162,Fisk; David Lee,33,0,35,2
1713308654777,POLI 140A,A00,494164,Staff,22,0,30,8
1713308655807,POLI 142I,A00,494165,Staff,30,0,30,0
1713308656833,POLI 144D,A00,494166,Staff,23,0,25,2
1713308657861,POLI 151,A00,494167,Staff,30,0,30,0
1713308658887,POLI 153,A00,494168,Staff,33,0,35,2
1713308659911,POLI 160AA,A00,494169,Staff,35,0,40,5
1713308660940,POLI 162,A00,494170,Mignozzetti; Umberto,21,0,25,4
1713308661966,POLI 171,A00,494171,Mignozzetti; Umberto,23,0,25,2
1713308662992,PSYC 1,A00,494172,Staff,97,0,100,3
1713308664070,PSYC 2,A00,494173,Moranton; Nirelia Melbina-,44,0,50,6
1713308665096,PSYC 3,A00,494174,Staff,30,0,30,0
1713308666126,PSYC 6,A00,494175,Staff,17,0,20,3
1713308667154,PSYC 60,A01,494177,Staff,41,0,45,4
1713308668179,PSYC 70,A01,505724,Geller; Emma Harlan,42,0,45,3
1713308669209,PSYC 101,A00,494180,Heyman; Gail D.,87,0,100,13
1713308670240,PSYC 105,A00,494181,Geller; Emma Harlan,66,0,90,24
1713308671264,PSYC 106,A00,494182,Dobkins; Karen R.,33,0,45,12
1713308672290,PSYC 108,A00,494183,Adrian; Julia Anna,94,0,100,6
1713308673316,PSYC 114,A01,494185,Winkielman; Piotr,4,0,30,26
1713308674341,PSYC 122,A00,494186,Moranton; Nirelia Melbina-,38,0,50,12
1713308675366,PSYC 124,A00,494187,Chapman; Eddie Nathaniel,72,0,80,8
1713308676394,PSYC 131,A00,494188,Anagnostaras; Stephan,59,0,80,21
1713308677420,PSYC 144,A00,494189,Staff,21,0,50,29
1713308678445,PSYC 154,A00,494190,Lacefield; Katharine I,135,0,180,45
1713308679469,PSYC 162,A00,494191,Wixted; John T,85,0,100,15
1713308680494,PSYC 172,A00,494192,Gorman; Michael R.,38,0,45,7
1713308681520,PSYC 178,A00,494193,Glaser; Dale,40,0,45,5
1713308682549,PSYC 193,A00,505725,Chapman; Eddie Nathaniel,20,0,20,0
1713308683574,RELI 145GS,A00,519817,Rahimi; Babak,19,0,20,1
1713308684602,SE 101A,A01,490862,Chadha; Mayank,24,0,25,1
1713308685633,SE 101C,A01,490924,Krysl; Petr,18,0,20,2
1713308686657,SE 110A,A01,490928,Staff,20,0,20,0
1713308687692,SE 130A,A00,490929,Morrison; Machel Leigh,64,0,70,6
1713308688718,SIO 1,A01,519325,Staff,39,0,40,1
1713308689747,SIO 30,A01,519327,Staff,40,0,40,0
1713308690774,SIO 40,A00,519328,Staff,40,0,40,0
1713308691800,SIO 46GS,A00,519819,Cook; Geoffrey W,18,0,25,7
1713308692824,SIO 109R,A00,494197,Forman; Fonna,8,0,20,12
1713308693853,SIO 121GS,A00,519827,Cook; Geoffrey W,18,0,25,7
1713308694878,SIO 132,A01,519330,Staff,38,0,40,2
1713308695907,SIO 133,A01,519397,Staff,38,0,40,2
1713308696934,SIO 139,A00,519396,Kacev; David,33,0,40,7
1713308697963,SOCI 1,A01,494199,Thorpe; Charles Robert,23,0,30,7
1713308697963,SOCI 1,A02,494200,Thorpe; Charles Robert,30,0,30,0
1713308697963,SOCI 1,A03,494201,Thorpe; Charles Robert,29,0,30,1
1713308697963,SOCI 1,A04,494202,Thorpe; Charles Robert,29,0,30,1
1713308697963,SOCI 1,A05,494203,Thorpe; Charles Robert,29,0,30,1
1713308697963,SOCI 1,A06,494204,Thorpe; Charles Robert,30,0,30,0
1713308697963,SOCI 1,A07,494205,Thorpe; Charles Robert,29,0,30,1
1713308698988,SOCI 60,A01,494207,Staff,36,0,40,4
1713308698988,SOCI 60,A02,494208,Staff,39,0,40,1
1713308700013,SOCI 100,A01,494210,Payne; Christine Anna,28,0,30,2
1713308700013,SOCI 100,A02,494211,Payne; Christine Anna,27,0,30,3
1713308701039,SOCI 109M,A00,494212,Staff,20,0,20,0
1713308702064,SOCI 110,A00,494213,Staff,35,0,40,5
1713308704116,SOCI 118E,A00,494215,Ng; Kwai,38,0,40,2
1713308705145,SOCI 125,A00,494216,Calderon-Zaks; Michael Aar,42,0,45,3
1713308706177,SOCI 126,A01,494218,Jones; Makeba,4,0,5,1
1713308707205,SOCI 131,A00,494219,Thorpe; Charles Robert,30,0,30,0
1713308709261,SOCI 135,A00,494221,Payne; Christine Anna,38,0,50,12
1713308710290,SOCI 136E,A00,626690,Ruiz; Jonathan Joseph,25,0,25,0
1713308711317,SOCI 138GS,A00,494222,Navon; Daniel,24,0,28,4
1713308713368,SOCI 145,A00,494224,Staff,42,0,45,3
1713308714395,SOCI 153,A00,494225,Staff,28,0,30,2
1713308715422,SOCI 160E,A00,494226,Ng; Kwai,34,0,40,6
1713308716449,SOCI 180,A00,494227,Staff,29,0,30,1
1713308717478,SOCI 189GS,A00,494228,Ribas Norris; Janet Vanesa,11,0,11,0
1713308718507,SOCI 190GS,A00,553232,Ribas Norris; Janet Vanesa,11,0,11,0
1713308719532,SOMI 220,A00,627178,Schneid; Stephen David,30,0,30,0
1713308720558,SYN 2,001,490768,Staff,14,0,15,1
1713308720558,SYN 2,002,490769,Staff,15,0,15,0
1713308720558,SYN 2,004,490775,Staff,0,0,0,0
1713308720558,SYN 2,003,490774,Staff,0,0,0,0
1713308720558,SYN 2,005,490776,Staff,0,0,0,0
1713308721586,SYN 2R,001,490779,Staff,14,0,15,1
1713308721586,SYN 2R,002,514635,Staff,14,0,15,1
1713308722609,SYN 100,A01,490783,Staff,17,0,20,3
1713308722609,SYN 100,B01,490787,Staff,12,0,20,8
1713308722609,SYN 100,C01,490789,Staff,13,0,20,7
1713308723637,SYN 150,A00,490817,Staff,14,0,15,1
1713308723637,SYN 150,B00,514610,Staff,15,0,15,0
1713308724665,TDAC 1,A00,492753,Walsh; Kim C.,19,0,20,1
1713308724665,TDAC 1,B00,492754,Harting; Carla Kelso,19,0,20,1
1713308724665,TDAC 1,C00,513995,Salovey; Todd,17,0,20,3
1713308725690,TDAC 101,A00,492766,Harting; Carla Kelso,18,0,20,2
1713308726720,TDAC 102,A00,492768,Basso; Beatrice,19,0,20,1
1713308727748,TDDE 111,A00,492769,Staff,25,0,25,0
1713308728775,TDDE 131,A00,492770,Staff,15,0,15,0
1713308728775,TDDE 131,B00,492771,Staff,15,0,15,0
1713308729801,TDDE 131GS,A00,523716,Guirguis; Mark C,25,0,28,3
1713308730827,TDGE 1,A01,492756,Salovey; Todd,57,0,60,3
1713308731853,TDGE 5,A01,492758,Staff,24,0,25,1
1713308732879,TDGE 10,A00,492759,Fulton; Julia,212,0,220,8
1713308733907,TDGE 11,A00,492760,Castro; Robert Jess,200,0,200,0
1713308734932,TDGE 50,A00,492761,Blair; Kyle Adam,0,0,0,0
1713308735956,TDGE 124,A00,492772,Fulton; Julia,197,0,220,23
1713308736987,TDGE 125,A00,492773,Meyer; Ursula,41,0,50,9
1713308736987,TDGE 125,B00,492774,Staff,50,0,50,0
1713308736987,TDGE 125,C00,523565,Staff,49,0,50,1
1713308738012,TDGE 125GS,A00,523580,Guirguis; Mark C,25,0,28,3
1713308739045,TDGE 127,A00,492775,Havis; Allan,43,0,50,7
1713308740069,TDHT 101,A00,492776,Staff,35,0,35,0
1713308741100,TDMV 1,A00,492762,Caligagan; Maria T.,30,0,30,0
1713308741100,TDMV 1,B00,492763,Arcidiacono; Kristin,25,0,30,5
1713308742126,TDMV 2,A00,492764,Weinberg; Sadie,29,0,30,1
1713308743152,TDMV 3,A00,492765,Mack; Kara Shanai',39,0,40,1
1713308744181,TDMV 138,A00,492777,Mack; Kara Shanai',37,0,40,3
1713308745208,TDMV 140,A00,492778,Lima; Paulo Henrique,40,0,40,0
1713308746236,TDMV 142,A00,492779,Caligagan; Maria T.,37,0,40,3
1713308746236,TDMV 142,B00,492780,Caligagan; Tony,38,0,40,2
1713308747262,TDMV 143,A00,492781,Fyall; Daunte Edward,39,0,40,1
1713308748286,USP 1,A01,492401,Kwak; Nancy,26,0,35,9
1713308749311,USP 2,A01,492453,Hinds; Juli Beth,35,0,35,0
1713308750335,USP 3,A01,492516,Staff,30,0,35,5
1713308751360,USP 4,A00,492522,McTague; Sarah,19,0,25,6
1713308752392,USP 100,A00,492523,Staff,33,0,35,2
1713308753417,USP 101,A00,492524,Staff,13,0,15,2
1713308754442,USP 105,A00,492525,Staff,22,0,25,3
1713308755469,USP 151,A00,492526,Shenkman; Michael Thomas,33,0,35,2
1713308756497,USP 170,A00,492545,Hinds; Juli Beth,33,0,35,2
1713308757525,USP 171GS,A00,492608,Bussell; Mirle Rabinowitz,26,0,28,2
1713308758553,USP 183GS,A00,492613,Peerson; Susan,26,0,28,2
1713308759579,VIS 30,A01,490693,Yoldas; Pinar,21,0,22,1
1713308759579,VIS 30,A02,490694,Yoldas; Pinar,19,0,22,3
1713308760606,VIS 83,A00,490695,Kester; Grant,68,0,75,7
1713308761638,VIS 105D,A00,490696,Staff,22,0,25,3
1713308762668,VIS 124CN,A00,490699,Rose; Jordan M,68,0,75,7
1713308763692,VIS 125GS,A00,511221,Williams; Alena J,21,0,22,1
1713308764717,VIS 128D,A00,490700,Staff,74,0,75,1
1713308765744,VIS 151,A01,490717,Staff,34,0,34,0
1713308765744,VIS 151,A02,490766,Staff,33,0,34,1
1713308766771,VIS 154GS,A00,511972,Williams; Alena J,21,0,22,1
1713308767853,VIS 160A,A00,490767,Stone; Patricia,7,0,10,3
1713308768883,WCWP 10A,A00,490638,Staff,15,0,15,0
1713308768883,WCWP 10A,B00,490640,Staff,15,0,15,0
1713308769910,WCWP 10B,A00,490641,Staff,0,0,0,0
1713308769910,WCWP 10B,B00,490642,Staff,14,0,15,1
1713308769910,WCWP 10B,C00,490644,Staff,13,0,15,2
1713308769910,WCWP 10B,D00,490647,Staff,0,0,0,0
1713308770937,WCWP 100,A00,490655,Staff,0,0,0,0
1713308770937,WCWP 100,B00,490687,Staff,12,0,15,3
1713308773037,ANAR 153,A00,487222,Braswell; Geoffrey E.,55,0,60,5
1713308774062,ANBI 134,A00,487223,Staff,13,0,20,7
1713308775087,ANBI 143GS,A00,487224,Noel; Geoffroy Pierre Jean,20,0,24,4
1713308776111,ANBI 144GS,A00,519548,Noel; Geoffroy Pierre Jean,20,0,24,4
1713308777142,ANSC 101,A00,487225,Staff,19,0,20,1
1713308778169,ANSC 125,A00,487227,Brenner; Suzanne A,39,0,40,1
1713308780220,ANSC 146,A00,487229,Staff,36,0,40,4
1713308781251,ANSC 148,A00,487230,Olivas Hernandez; Olga Lid,39,0,40,1
1713308782279,ANSC 150,A00,504165,Sloane; Julia Kathryn,19,0,20,1
1713308783306,ANSC 180,A00,487232,Staff,13,0,15,2
1713308784331,ANSC 188,A00,627155,Staff,40,0,40,0
1713308785357,ANTH 5,A00,519529,Semendeferi; Ekaterini,15,0,15,0
1713308786384,ANTH 10,A00,487219,Staff,58,0,60,2
1713308787412,ANTH 23,A01,487221,Staff,17,0,20,3
1713308788441,ANTH 102,A00,487233,Wilder; Linnea Lorene,53,0,60,7
1713308789466,ANTH 103,A00,487234,Varma; Saiba,57,0,60,3
1713308790496,ANTH 105,A00,487235,Stewart; Alexander B,57,0,60,3
1713308791525,BENG 100,A01,516685,Taylor Amos; Alyssa C,28,0,30,2
1713308792551,BIBC 102,A01,491316,Flagg; Matthew Paul,53,0,88,35
1713308792551,BIBC 102,A02,491366,Flagg; Matthew Paul,84,0,88,4
1713308793578,BIBC 103,A01,491486,Boumechache; Miyyada,16,0,24,8
1713308793578,BIBC 103,A02,491487,Boumechache; Miyyada,24,0,24,0
1713308794606,BICD 100,A01,516882,Staff,75,0,75,0
1713308794606,BICD 100,A02,516890,Staff,70,0,75,5
1713308795631,BICD 102GS,A00,491488,Lo; Stanley M.,27,0,28,1
1713308796658,BIEB 136GS,A00,516940,Holway; David A. & Shurin; Jonathan,19,0,24,5
1713308797682,BIEB 137GS,A01,517034,Holway; David A. & Shurin; Jonathan,19,0,24,5
1713308798725,BIEB 138GS,A01,491492,Pirino; Giorgia,22,0,28,6
1713308799751,BILD 1,A01,491296,Staff,62,0,63,1
1713308799751,BILD 1,A02,491297,Staff,63,0,63,0
1713308800778,BILD 4,A01,517099,Gonzalez Gamboa; Ivonne,22,0,24,2
1713308800778,BILD 4,A02,517100,Gonzalez Gamboa; Ivonne,24,0,24,0
1713308801807,BILD 60GS,A00,491309,Lo; Stanley M.,27,0,28,1
1713308802837,BIMM 100,A01,517136,Staff,92,0,100,8
1713308803880,BIMM 110,A01,517182,Staff,75,0,100,25
1713308804904,BIMM 120,A01,517228,Pickett; Brooke Elizabeth,40,0,63,23
1713308804904,BIMM 120,A02,517240,Pickett; Brooke Elizabeth,48,0,63,15
1713308805937,BIMM 132GS,A01,491498,Pirino; Giorgia,22,0,28,6
1713308806971,BIMM 143,A01,491589,Bozinovic; Goran,20,0,40,20
1713308807997,BIPN 100,A01,491594,Armour; Jon Christopher,92,0,100,8
1713308809022,BIPN 140,A01,491602,Marino; Marc J,32,0,50,18
1713308811071,CAT 125,A00,515973,Staff,20,0,20,0
1713308812098,CAT 125GS,A00,515974,Rahimi; Babak,19,0,20,1
1713308813124,CAT 125R,A00,515980,Staff,15,0,20,5
1713308813124,CAT 125R,B00,515981,Tosun; Adriana,19,0,20,1
1713308813124,CAT 125R,C00,515987,Hyland; Tina Mae,3,0,20,17
1713308813124,CAT 125R,D00,515988,Bronstein; Phoebe Malan,18,0,20,2
1713308814151,CENG 15,A01,488699,Drews; Aaron,25,0,25,0
1713308815181,CENG 100,A00,505196,Opatkiewicz; Justin Paul,25,0,25,0
1713308816208,CGS 2A,A01,489598,Staff,33,0,35,2
1713308817232,CGS 112,A00,489599,Staff,15,0,15,0
1713308818262,CGS 119,A00,489603,Staff,10,0,10,0
1713308819294,CGS 120,A00,489604,Staff,14,0,15,1
1713308820325,CGS 150,A00,489607,Staff,15,0,15,0
1713308821354,CHEM 6A,A01,488715,Staff,98,0,100,2
1713308822380,CHEM 6B,A01,488719,Piercy; Marc Anthony,100,0,100,0
1713308823407,CHEM 6C,A01,488723,Albizati; Kim F.,94,0,100,6
1713308824444,CHEM 7L,A01,488728,Schurmeier; Kimberly,18,0,24,6
1713308824444,CHEM 7L,A02,488730,Schurmeier; Kimberly,23,0,24,1
1713308824444,CHEM 7L,A03,488734,Schurmeier; Kimberly,24,0,24,0
1713308824444,CHEM 7L,A04,488763,Schurmeier; Kimberly,23,0,24,1
1713308824444,CHEM 7L,B01,488798,Schurmeier; Kimberly,18,0,24,6
1713308824444,CHEM 7L,B02,488801,Schurmeier; Kimberly,23,0,24,1
1713308824444,CHEM 7L,B03,488808,Schurmeier; Kimberly,24,0,24,0
1713308824444,CHEM 7L,B04,488811,Schurmeier; Kimberly,24,0,24,0
1713308825475,CHEM 11,A01,488897,Stallings; Dontarie M,98,0,100,2
1713308826505,CHEM 40A,A01,488913,Albizati; Kim F.,91,0,100,9
1713308827535,CHEM 40B,A01,488920,Weizman; Haim,48,0,50,2
1713308827535,CHEM 40B,A02,488938,Weizman; Haim,46,0,50,4
1713308828560,CHEM 41A,A01,489029,Klosterman; Jeremy K,58,0,60,2
1713308829592,CHEM 41C,A01,500436,Tor; Yitzhak,55,0,60,5
1713308830620,CHEM 43A,A01,500426,Weizman; Haim,6,0,24,18
1713308830620,CHEM 43A,A02,500430,Weizman; Haim,13,0,24,11
1713308830620,CHEM 43A,B01,514041,Klosterman; Jeremy K,16,0,24,8
1713308830620,CHEM 43A,B02,514047,Klosterman; Jeremy K,23,0,24,1
1713308831649,CHEM 108,A01,489140,Jennings; Patricia A.,14,0,24,10
1713308831649,CHEM 108,A02,489142,Jennings; Patricia A.,15,0,24,9
1713308832675,CHEM 114A,A01,489147,Stallings; Dontarie M,81,0,100,19
1713308833707,CHIN 169A,A00,489171,Wang; Xiao,19,0,20,1
1713308835761,COGS 3,A01,518827,Boyle; Mary E. T.,30,0,40,10
1713308836784,COGS 11,A01,489175,Staff,28,0,30,2
1713308837814,COGS 14A,A01,518829,Staff,53,0,60,7
1713308838846,COGS 14B,A01,489177,Hoffman; Drew Ellen,69,0,75,6
1713308839873,COGS 100,A01,489181,Allen; Michael Gordon,66,0,75,9
1713308840898,COGS 101A,A01,489183,Staff,51,0,60,9
1713308841923,COGS 101B,A01,489185,Allen; Michael Gordon,13,0,30,17
1713308842952,COGS 101C,A01,526786,Staff,25,0,30,5
1713308845009,COGS 107A,A01,489189,Boyle; Mary E. T.,23,0,35,12
1713308846035,COGS 107B,A01,627144,Mooshagian; Eric Frederick,60,0,60,0
1713308847062,COGS 118A,A01,489191,Staff,0,27,40,40
1713308849115,COGS 171GS,A01,489194,Pineda; Jaime A,22,0,28,6
1713308850140,COGS 172,A01,489196,Staff,6,0,30,24
1713308851165,COGS 174GS,A01,489264,Pineda; Jaime A,22,0,28,6
1713308852190,COGS 180,A01,627150,Staff,29,0,30,1
1713308853214,COGS 186,A01,489274,Staff,4,0,30,26
1713308854244,COMM 10,A01,489276,Staff,24,0,25,1
1713308854244,COMM 10,A02,489303,Staff,23,0,25,2
1713308855271,COMM 100A,A01,489312,Staff,21,0,25,4
1713308855271,COMM 100A,A02,489313,Staff,24,0,25,1
1713308856300,COMM 106T,A00,512540,Staff,34,0,35,1
1713308857326,COMM 107,A00,489347,Staff,31,0,35,4
1713308858354,COMM 109P,A00,489358,Staff,31,0,35,4
1713308859379,COMM 132,A00,489361,McKenna; Denise,29,0,30,1
1713308860412,COMM 146,A00,489362,Halm; Gavin Patrick,27,0,30,3
1713308861441,COMM 190,A00,489363,Abuelhiga; Soraya Jill,21,0,23,2
1713308862468,CSE 8A,A50,489366,Staff,23,0,25,2
1713308862468,CSE 8A,A51,489367,Staff,24,0,25,1
1713308863495,CSE 11,A01,489398,Cao; Yingjun,83,0,100,17
1713308864521,CSE 12,A01,489487,Staff,43,0,50,7
1713308865551,CSE 20,A01,489497,Staff,49,0,50,1
1713308866577,CSE 21,A01,489517,Braun; Oliver,44,0,50,6
1713308867606,CSE 101,A01,489524,Braun; Oliver,0,11,50,50
1713308868631,CSE 105,A01,512594,Jones; Miles E,81,0,100,19
1713308868631,CSE 105,B01,512598,Jones; Miles E,69,0,100,31
1713308869662,CSE 140,A01,489538,Staff,44,0,50,6
1713308870687,CSE 141,A01,489550,Eldon; John,76,0,100,24
1713308871767,CSE 141L,A01,489571,Eldon; John,75,0,100,25
1713308872794,CSE 151A,A01,489583,Solares; Edwin A,152,0,200,48
1713308873823,CSE 175,A01,510886,Kumar; Rakesh,30,0,30,0
1713308874849,CSE 190,A00,516828,Dubnov; Shlomo,41,0,49,8
1713308875874,DOC 100D,A00,489667,Pass; Natalye Joann,23,0,25,2
1713308876903,DSC 10,A01,624268,Staff,72,0,75,3
1713308877930,DSC 20,A01,624476,Staff,50,0,50,0
1713308878955,DSC 40A,A01,624608,Staff,40,0,40,0
1713308879981,DSGN 1,A01,489179,Rill; Bryan,37,0,50,13
1713308881017,ECE 17,A01,490489,Sahay; Rajeev,19,0,30,11
1713308882043,ECE 65,A50,490492,Staff,17,0,20,3
1713308882043,ECE 65,A51,490493,Staff,20,0,20,0
1713308883068,ECON 1,A01,489715,Famulari; Melissa,69,0,70,1
1713308884095,ECON 2,A01,489717,Levkoff; Steven B.,68,0,70,2
1713308885120,ECON 3,A01,489948,Staff,70,0,70,0
1713308887177,ECON 5,A01,490103,Staff,28,0,30,2
1713308887177,ECON 5,B01,626281,Dai; Yinlin,45,0,45,0
1713308888207,ECON 100A,A01,490127,Famulari; Melissa,69,0,70,1
1713308889231,ECON 100B,A01,490129,Staff,64,0,70,6
1713308890260,ECON 109,A01,490187,Shishkin; Denis,27,0,35,8
1713308891287,ECON 110A,A01,490190,Levkoff; Steven B.,64,0,70,6
1713308892310,ECON 120A,A01,490245,Dai; Yinlin,67,0,70,3
1713308893337,ECON 120B,A01,490247,Nieto-Barthaburu; Augusto,60,0,70,10
1713308894368,ECON 120C,A01,490253,Sun; Yixiao,32,0,35,3
1713308894368,ECON 120C,B01,490255,Sun; Yixiao,34,0,35,1
1713308895411,ECON 129,A00,490256,Eckert; Fabian Paul,26,0,35,9
1713308896439,ECON 131,A00,490257,Nieto-Barthaburu; Augusto,4,0,35,31
1713308897465,ECON 138,A00,490258,Bharadwaj; Prashant,24,0,35,11
1713308897465,ECON 138,B00,490259,Bharadwaj; Prashant,18,0,35,17
1713308898495,ECON 159,A00,490260,Hendrickson; Gerald M.,0,6,0,0
1713308899522,ECON 178,A01,553995,Zhu; Ying,27,0,35,8
1713308900553,EDS 40,A01,512576,Black; Alison Michelle,20,0,20,0
1713308901578,EDS 107,A01,515848,Staff,30,0,30,0
1713308902606,EDS 110R,A01,490262,Staff,26,0,30,4
1713308903635,EDS 112,A01,490264,Chapman; Thandeka K,44,0,50,6
1713308904660,EDS 113,A00,490266,Staff,27,0,30,3
1713308905686,EDS 118,A00,490267,Warstadt; Melissa Fawn,26,0,30,4
1713308906712,EDS 124BR,A00,490268,Eguchi; Emi,10,0,25,15
1713308906712,EDS 124BR,B00,490269,Eguchi; Emi,25,0,25,0
1713308907740,EDS 126,A01,490271,Jones; Makeba,45,0,50,5
1713308908766,EDS 135,A01,490316,Staff,19,0,20,1
1713308909791,ENVR 142GS,A00,519514,Chang; Edmond Yi-Teh,28,0,28,0
1713308910818,ETHN 103,A00,490504,Staff,33,0,36,3
1713308911849,ETHN 103A,A00,490505,Man; Simeon S,7,0,9,2
1713308912875,ETHN 109,A00,490506,Staff,30,0,30,0
1713308913903,ETHN 118,A00,490507,Staff,35,0,36,1
1713308914933,ETHN 119,A00,490508,Staff,36,0,36,0
1713308915959,ETHN 121R,A00,490518,Choi; Esther Min,30,0,36,6
1713308916983,ETHN 127,A00,490528,Staff,15,0,15,0
1713308918009,ETHN 139,A00,490573,Staff,10,0,10,0
1713308919035,ETHN 150,A00,490575,Staff,15,0,15,0
1713308920063,GLBH 20,A00,491705,Elwardani; Nile Regina,38,0,40,2
1713308921088,GLBH 101,A00,491706,Staff,20,0,20,0
1713308922114,GLBH 111,A01,491708,Burgos; Jose L.,15,0,15,0
1713308923142,GLBH 146,A00,491709,Staff,11,0,20,9
1713308924168,GLBH 148,A00,491710,Olivas Hernandez; Olga Lid,16,0,20,4
1713308925195,GLBH 150,A00,491711,Sloane; Julia Kathryn,20,0,20,0
1713308926220,HIEA 131,A00,491760,Staff,30,0,32,2
1713308927245,HIEA 153,A00,491762,Staff,29,0,30,1
1713308928273,HIEU 124,A00,491811,Staff,26,0,32,6
1713308929300,HIEU 124GS,A00,491812,Markman; Kristina,28,0,28,0
1713308930326,HIEU 147,A00,491813,Staff,30,0,32,2
1713308931354,HIEU 149GS,A00,491816,Caldwell; Michael Alan,28,0,28,0
1713308932383,HILD 2C,A01,491713,Hendrickson; Gerald M.,28,0,30,2
1713308933411,HILD 7B,A01,491715,Kwak; Nancy,15,0,30,15
1713308934436,HILD 10,A01,491717,Staff,14,0,20,6
1713308935469,HILD 30GS,A00,491719,Edington; Claire Ellen,24,0,28,4
1713308936497,HINE 109,A00,491818,Shafir; Nir,28,0,32,4
1713308937522,HINE 128,A00,491821,Shafir; Nir,31,0,32,1
1713308938552,HISC 117,A00,491830,Staff,29,0,32,3
1713308939577,HIUS 103,A00,491834,Man; Simeon S,16,0,23,7
1713308940602,HIUS 108B,A00,491835,Staff,29,0,30,1
1713308941633,HIUS 141,A00,491836,Hendrickson; Gerald M.,29,0,32,3
1713308942658,HIUS 149,A00,491839,Staff,27,0,32,5
1713308943687,HUM 3,A01,512617,Crum; Matthew Stephen,46,0,50,4
1713308943687,HUM 3,A02,512618,Crum; Matthew Stephen,48,0,50,2
1713308944717,HUM 3GS,A00,512663,Markman; Kristina,0,0,0,0
1713308944717,HUM 3GS,B00,512664,Staff,0,0,0,0
1713308945747,HUM 4,A01,512620,West; Geoffrey Scott,36,0,50,14
1713308946772,HUM 4GS,A00,512666,Lyon; Antony J.,0,0,0,3
1713308947802,HUM 4R,A01,512625,Watkins; Eric,49,0,50,1
1713308948830,HUM 5,A01,512649,Zavodny; Tatiana Sophia,34,0,50,16
1713308948830,HUM 5,B01,512661,Zroka; Ryan Edward,49,0,50,1
1713308949858,INTL 190,A00,490577,Segui; Alan S,0,0,0,5
1713308950885,JAPN 20AR,A01,491267,Ross; Kayoko F,12,0,20,8
1713308951912,JAPN 180,A00,491285,Berman; Michael David,34,0,40,6
1713308952943,LATI 50,A01,502536,Kokinis; Troy Andreas,19,0,22,3
1713308952943,LATI 50,A02,502551,Kokinis; Troy Andreas,22,0,22,0
1713308952943,LATI 50,A03,502650,Kokinis; Troy Andreas,22,0,22,0
1713308952943,LATI 50,A04,502909,Kokinis; Troy Andreas,22,0,22,0
1713308953973,LATI 160,A01,502920,Kokinis; Troy Andreas,30,0,30,0
1713308955006,LIFR 1A,A00,490494,Van Moer; Vinciane G,17,0,20,3
1713308956031,LIFR 1AX,A00,490495,Van Moer; Vinciane G,17,0,20,3
1713308957058,LIFR 1B,A00,490496,Van Moer; Vinciane G,19,0,20,1
1713308958087,LIFR 1BX,A00,490497,Van Moer; Vinciane G,19,0,20,1
1713308959112,LIGN 8,A00,505198,McIntosh; Justin Daniel,141,0,150,9
1713308960141,LIGN 9GS,A00,491239,Lott; Margaret S.,18,0,20,2
1713308961167,LIGN 101,A01,505200,McIntosh; Justin Daniel,26,0,30,4
1713308962196,LIGN 120,A01,491244,Staff,24,0,30,6
1713308963225,LIGN 149GS,A00,491245,Lott; Margaret S.,18,0,20,2
1713308964253,LIGN 170,A00,491247,Staff,24,0,30,6
1713308965277,LISP 1D,A00,490498,Munoz Sanchez; Alicia,11,0,14,3
1713308965277,LISP 1D,B00,490499,Munoz Sanchez; Alicia,6,0,14,8
1713308965277,LISP 1D,C00,490500,Munoz Sanchez; Alicia,10,0,14,4
1713308965277,LISP 1D,D00,490501,Munoz Sanchez; Alicia,11,0,14,3
1713308966301,LISP 1DX,A00,490502,Munoz Sanchez; Alicia,18,0,28,10
1713308966301,LISP 1DX,B00,490503,Munoz Sanchez; Alicia,19,0,28,9
1713308968352,LTAM 110,A00,491847,Staff,23,0,25,2
1713308969381,LTCS 119,A00,491848,Staff,12,0,15,3
1713308970406,LTCS 130,A00,491849,Staff,24,0,25,1
1713308972461,LTEA 120C,A00,491852,Staff,35,0,40,5
1713308973489,LTEN 130GS,A00,491853,Lyon; Antony J.,25,0,28,3
1713308974513,LTEN 148,A00,491855,Staff,23,0,25,2
1713308975594,LTEN 159,A00,491856,Staff,21,0,25,4
1713308976622,LTEN 180,A00,491857,Staff,9,0,15,6
1713308978672,LTSP 123GS,A00,505928,Bessett; Ryan Matthew,25,0,28,3
1713308979697,LTSP 174GS,A00,506037,Bessett; Ryan Matthew,25,0,28,3
1713308981751,LTWR 102,A00,491861,Staff,12,0,15,3
1713308982777,LTWR 106,A00,491862,Staff,10,0,15,5
1713308983803,MAE 11,A00,490930,Bahadori; Mohammad Yousef,97,0,100,3
1713308984829,MAE 30A,A00,490931,Qi; Huihui,38,0,40,2
1713308985856,MAE 101A,A00,491036,Sadeghizadeh; Zahra,98,0,100,2
1713308986882,MAE 101C,A00,491037,Seshadri; Kalyanasundaram,77,0,100,23
1713308987908,MAE 113,A00,491040,Seshadri; Kalyanasundaram,67,0,80,13
1713308988932,MAE 131A,A00,491041,Ghazinejad; Maziar,39,0,40,1
1713308989957,MAE 142,A00,491053,Staff,39,0,40,1
1713308990987,MAE 143A,A00,491054,Staff,40,0,50,10
1713308992013,MAE 150,A00,491092,Truong; Phuong Thi Ngoc,24,0,35,11
1713308993040,MATH 3C,A01,494031,Pardo Guerra; Sebastian,30,0,30,0
1713308993040,MATH 3C,A02,494032,Pardo Guerra; Sebastian,29,0,30,1
1713308994066,MATH 10A,A01,494034,Staff,27,0,30,3
1713308994066,MATH 10A,A02,494035,Staff,29,0,30,1
1713308994066,MATH 10A,B01,494037,Staff,27,0,30,3
1713308994066,MATH 10A,B02,494038,Staff,29,0,30,1
1713308995096,MATH 10B,A01,494040,Habib; Yousaf,24,0,30,6
1713308995096,MATH 10B,A02,494041,Habib; Yousaf,28,0,30,2
1713308995096,MATH 10B,A03,494042,Habib; Yousaf,30,0,30,0
1713308995096,MATH 10B,A04,494043,Habib; Yousaf,30,0,30,0
1713308995096,MATH 10B,B01,494045,Habib; Yousaf,28,0,30,2
1713308995096,MATH 10B,B02,494046,Habib; Yousaf,30,0,30,0
1713308995096,MATH 10B,B03,494047,Habib; Yousaf,30,0,30,0
1713308995096,MATH 10B,B04,494048,Habib; Yousaf,30,0,30,0
1713308996127,MATH 18,A01,494050,Kemp; Todd Aahron,27,0,30,3
1713308996127,MATH 18,A02,494051,Kemp; Todd Aahron,29,0,30,1
1713308996127,MATH 18,B01,494054,Kemp; Todd Aahron,28,0,30,2
1713308996127,MATH 18,B02,494055,Kemp; Todd Aahron,29,0,30,1
1713308997153,MATH 20A,A01,494059,Suk; Andrew Hoon,30,0,30,0
1713308998183,MATH 20B,A01,494061,Briones; Jor-el Thomas Caparas,34,0,35,1
1713308998183,MATH 20B,B01,494063,Bach; Quang Tran,34,0,35,1
1713308999210,MATH 20C,A01,494065,Staff,28,0,30,2
1713308999210,MATH 20C,A02,494066,Staff,30,0,30,0
1713308999210,MATH 20C,A03,494067,Staff,30,0,30,0
1713308999210,MATH 20C,A04,494068,Staff,30,0,30,0
1713308999210,MATH 20C,B01,494070,Zhang; Ming,26,0,30,4
1713308999210,MATH 20C,B02,494071,Zhang; Ming,30,0,30,0
1713308999210,MATH 20C,B03,494072,Zhang; Ming,29,0,30,1
1713308999210,MATH 20C,B04,494073,Zhang; Ming,28,0,30,2
1713309000237,MATH 20D,A01,494075,Staff,26,0,30,4
1713309000237,MATH 20D,A02,494076,Staff,30,0,30,0
1713309001262,MATH 20E,A01,494079,Staff,25,0,30,5
1713309001262,MATH 20E,A02,494080,Staff,27,0,30,3
1713309001262,MATH 20E,B01,494082,Staff,28,0,30,2
1713309001262,MATH 20E,B02,494083,Staff,25,0,30,5
1713309002288,MATH 103A,A01,494085,Aliabadi Sr.; Mohsen,17,0,30,13
1713309002288,MATH 103A,A02,494086,Aliabadi Sr.; Mohsen,28,0,30,2
1713309002288,MATH 103A,B01,494088,Aliabadi Sr.; Mohsen,22,0,30,8
1713309002288,MATH 103A,B02,494089,Aliabadi Sr.; Mohsen,28,0,30,2
1713309003317,MATH 109,A01,494091,Staff,30,0,30,0
1713309003317,MATH 109,A02,494092,Staff,30,0,30,0
1713309003317,MATH 109,B01,494094,Staff,28,0,30,2
1713309003317,MATH 109,B02,494095,Staff,29,0,30,1
1713309004350,MATH 142A,A01,494097,Chow; Bennett,16,0,30,14
1713309004350,MATH 142A,A02,494098,Chow; Bennett,24,0,30,6
1713309004350,MATH 142A,B01,494100,Chow; Bennett,21,0,30,9
1713309004350,MATH 142A,B02,494101,Chow; Bennett,29,0,30,1
1713309006408,MATH 168A,A01,516677,Dumitriu; Ioana,16,0,35,19
1713309007434,MATH 170A,A01,516679,Dumitriu; Ioana,20,0,30,10
1713309007434,MATH 170A,A02,516680,Dumitriu; Ioana,28,0,30,2
1713309008463,MATH 193A,A01,494107,Staff,17,0,30,13
1713309008463,MATH 193A,A02,494108,Staff,23,0,30,7
1713309008463,MATH 193A,A03,494109,Staff,29,0,30,1
1713309008463,MATH 193A,A04,494110,Staff,24,0,30,6
1713309011549,MGT 16,A00,491930,McKay; Michael J,94,0,98,4
1713309012574,MGT 18,A00,491992,McKay; Michael J,97,0,98,1
1713309013600,MGT 71,A00,492003,Staff,78,0,98,20
1713309014631,MGT 103,A00,505209,Eberhard; Craig A,86,0,98,12
1713309015661,MGT 131A,A00,505210,Anderson; John Charles,91,0,98,7
1713309017725,MGT 153,A00,492077,Perols; Johan Lars,46,0,90,44
1713309020807,MGT 164,A00,492222,McKay; Mary A,94,0,98,4
1713309021833,MGT 172,A00,492245,Staff,59,0,60,1
1713309021833,MGT 172,B00,505526,Hedges; Kathleen,78,0,98,20
1713309022860,MGT 181,A00,505669,Dunn; Louis Jean,88,0,98,10
1713309023904,MMW 14,A01,494399,Staff,23,0,28,5
1713309023904,MMW 14,A02,494400,Staff,26,0,28,2
1713309023904,MMW 14,A03,494401,Staff,28,0,28,0
1713309023904,MMW 14,A04,494402,Staff,28,0,28,0
1713309023904,MMW 14,B01,494404,Carreras; Maria Victoria,16,0,28,12
1713309023904,MMW 14,B02,494405,Carreras; Maria Victoria,27,0,28,1
1713309023904,MMW 14,B03,494406,Carreras; Maria Victoria,28,0,28,0
1713309023904,MMW 14,B04,494407,Carreras; Maria Victoria,28,0,28,0
1713309024931,MMW 14GS,A00,506250,Chang; Edmond Yi-Teh,0,0,0,0
1713309025957,MMW 121R,A01,494415,Adamiak; Patrick John,15,0,28,13
1713309025957,MMW 121R,A02,494416,Adamiak; Patrick John,25,0,28,3
1713309026986,MUS 1A,A01,494113,Staff,12,0,25,13
1713309026986,MUS 1A,A02,494114,Staff,25,0,25,0
1713309028016,MUS 4,A01,494116,Staff,24,0,25,1
1713309028016,MUS 4,A02,494117,Staff,22,0,25,3
1713309029041,MUS 5R,A01,494236,Dubnov; Shlomo,12,0,25,13
1713309029041,MUS 5R,A02,494237,Dubnov; Shlomo,25,0,25,0
1713309030069,MUS 6,A01,494122,Staff,16,0,25,9
1713309030069,MUS 6,A02,494123,Staff,24,0,25,1
1713309031096,MUS 7,A01,494125,Staff,17,0,25,8
1713309031096,MUS 7,A02,494126,Staff,24,0,25,1
1713309032121,MUS 11,A01,494128,Staff,23,0,25,2
1713309032121,MUS 11,A02,494129,Staff,25,0,25,0
1713309033144,MUS 13,A01,494131,Staff,25,0,25,0
1713309033144,MUS 13,A02,494132,Staff,25,0,25,0
1713309034175,MUS 15,A01,494134,Staff,20,0,25,5
1713309034175,MUS 15,A02,494135,Staff,25,0,25,0
1713309034175,MUS 15,B01,494137,Staff,24,0,25,1
1713309035202,MUS 80,A00,494232,Staff,25,0,25,0
1713309035202,MUS 80,B00,494233,Staff,25,0,25,0
1713309035202,MUS 80,C00,494234,Staff,23,0,25,2
1713309036227,MUS 95C,A00,494141,Staff,73,0,75,2
1713309037252,MUS 114,A00,494142,Staff,41,0,50,9
1713309038279,NANO 15,A01,490636,Drews; Aaron,7,0,7,0
1713309039311,PHIL 1,A00,490578,Grush; Rick Scott,50,0,50,0
1713309040340,PHIL 10,A01,490580,Grush; Rick Scott,34,0,35,1
1713309040340,PHIL 10,A02,490586,Grush; Rick Scott,33,0,35,2
1713309041366,PHIL 27,A01,490591,Staff,24,0,25,1
1713309041366,PHIL 27,A02,490592,Staff,25,0,25,0
1713309041366,PHIL 27,A03,490593,Staff,25,0,25,0
1713309041366,PHIL 27,A04,490598,Staff,25,0,25,0
1713309042389,PHIL 32,A01,490611,Staff,20,0,20,0
1713309042389,PHIL 32,A02,490618,Staff,20,0,20,0
1713309043414,PHIL 90,A00,490624,Staff,40,0,40,0
1713309044444,PHIL 136,A00,490627,Cohen; Jonathan David,38,0,40,2
1713309045472,PHIL 155,A00,490634,Staff,66,0,70,4
1713309046496,PHYS 1A,A00,491610,Staff,246,0,250,4
1713309047523,PHYS 1AL,001,491616,Tsai; Philbert S,28,0,30,2
1713309047523,PHYS 1AL,002,491618,Tsai; Philbert S,30,0,30,0
1713309048552,PHYS 1B,A00,491623,Staff,244,0,250,6
1713309049579,PHYS 1BL,001,491626,Tsai; Philbert S,26,0,30,4
1713309049579,PHYS 1BL,002,491628,Tsai; Philbert S,28,0,30,2
1713309050603,PHYS 1C,A00,491632,Staff,225,0,245,20
1713309051628,PHYS 1CL,001,491635,Tsai; Philbert S,12,0,30,18
1713309051628,PHYS 1CL,002,491643,Tsai; Philbert S,24,0,30,6
1713309052658,PHYS 2AR,A01,491651,Meyertholen; Andrew D.,45,0,50,5
1713309053682,PHYS 2B,A01,491659,Staff,107,0,115,8
1713309054708,PHYS 2BL,A01,491685,Staff,23,0,24,1
1713309054708,PHYS 2BL,A02,491700,Staff,23,0,24,1
1713309055736,PHYS 2C,A01,505161,Staff,107,0,115,8
1713309056761,PHYS 4A,A01,491704,Grinstein; Benjamin,99,0,100,1
1713309057789,POLI 5D,A01,494144,Staff,3,0,5,2
1713309057789,POLI 5D,B01,626283,Dai; Yinlin,5,0,5,0
1713309058811,POLI 12,A00,494145,Staff,44,0,45,1
1713309059836,POLI 13R,A00,494146,Forman; Fonna,46,0,50,4
1713309060861,POLI 27,A01,494148,Staff,58,0,60,2
1713309061889,POLI 30,A00,494149,Staff,49,0,50,1
1713309062917,POLI 100DA,A00,494150,Staff,23,0,25,2
1713309065001,POLI 100I,A00,494152,Staff,28,0,30,2
1713309066026,POLI 104B,A00,494153,Smith; Glenn Chatmas,54,0,55,1
1713309067051,POLI 104F,A00,494154,Staff,28,0,30,2
1713309068076,POLI 104I,A00,494155,Smith; Glenn Chatmas,30,0,30,0
1713309069104,POLI 110C,A00,494156,Ingham; Sean,23,0,25,2
1713309070131,POLI 117R,A00,494157,Forman; Fonna,13,0,20,7
1713309071165,POLI 118,A00,494158,Ingham; Sean,23,0,25,2
1713309072190,POLI 120H,A00,494159,Fisk; David Lee,41,0,45,4
1713309073222,POLI 131CR,A00,494160,Hoston; Germaine,40,0,45,5
1713309074247,POLI 133J,A00,494161,Staff,33,0,35,2
1713309075278,POLI 135,A00,494162,Fisk; David Lee,33,0,35,2
1713309076302,POLI 140A,A00,494164,Staff,22,0,30,8
1713309077329,POLI 142I,A00,494165,Staff,30,0,30,0
1713309078355,POLI 144D,A00,494166,Staff,23,0,25,2
1713309079434,POLI 151,A00,494167,Staff,30,0,30,0
1713309080459,POLI 153,A00,494168,Staff,33,0,35,2
1713309081482,POLI 160AA,A00,494169,Staff,35,0,40,5
1713309082513,POLI 162,A00,494170,Mignozzetti; Umberto,21,0,25,4
1713309083543,POLI 171,A00,494171,Mignozzetti; Umberto,23,0,25,2
1713309084569,PSYC 1,A00,494172,Staff,97,0,100,3
1713309085599,PSYC 2,A00,494173,Moranton; Nirelia Melbina-,44,0,50,6
1713309086623,PSYC 3,A00,494174,Staff,30,0,30,0
1713309087649,PSYC 6,A00,494175,Staff,17,0,20,3
1713309088674,PSYC 60,A01,494177,Staff,40,0,45,5
1713309089699,PSYC 70,A01,505724,Geller; Emma Harlan,42,0,45,3
1713309090729,PSYC 101,A00,494180,Heyman; Gail D.,87,0,100,13
1713309091756,PSYC 105,A00,494181,Geller; Emma Harlan,66,0,90,24
1713309092787,PSYC 106,A00,494182,Dobkins; Karen R.,33,0,45,12
1713309093814,PSYC 108,A00,494183,Adrian; Julia Anna,94,0,100,6
1713309094838,PSYC 114,A01,494185,Winkielman; Piotr,3,0,30,27
1713309095862,PSYC 122,A00,494186,Moranton; Nirelia Melbina-,38,0,50,12
1713309096887,PSYC 124,A00,494187,Chapman; Eddie Nathaniel,72,0,80,8
1713309097913,PSYC 131,A00,494188,Anagnostaras; Stephan,59,0,80,21
1713309098941,PSYC 144,A00,494189,Staff,19,0,50,31
1713309099971,PSYC 154,A00,494190,Lacefield; Katharine I,135,0,180,45
1713309100997,PSYC 162,A00,494191,Wixted; John T,85,0,100,15
1713309102022,PSYC 172,A00,494192,Gorman; Michael R.,38,0,45,7
1713309103047,PSYC 178,A00,494193,Glaser; Dale,40,0,45,5
1713309104077,PSYC 193,A00,505725,Chapman; Eddie Nathaniel,20,0,20,0
1713309105109,RELI 145GS,A00,519817,Rahimi; Babak,19,0,20,1
1713309106135,SE 101A,A01,490862,Chadha; Mayank,24,0,25,1
1713309107161,SE 101C,A01,490924,Krysl; Petr,18,0,20,2
1713309108187,SE 110A,A01,490928,Staff,20,0,20,0
1713309109214,SE 130A,A00,490929,Morrison; Machel Leigh,64,0,70,6
1713309110243,SIO 1,A01,519325,Staff,39,0,40,1
1713309111277,SIO 30,A01,519327,Staff,40,0,40,0
1713309112306,SIO 40,A00,519328,Staff,40,0,40,0
1713309113330,SIO 46GS,A00,519819,Cook; Geoffrey W,18,0,25,7
1713309114360,SIO 109R,A00,494197,Forman; Fonna,7,0,20,13
1713309115388,SIO 121GS,A00,519827,Cook; Geoffrey W,18,0,25,7
1713309116413,SIO 132,A01,519330,Staff,38,0,40,2
1713309117438,SIO 133,A01,519397,Staff,38,0,40,2
1713309118464,SIO 139,A00,519396,Kacev; David,33,0,40,7
1713309119489,SOCI 1,A01,494199,Thorpe; Charles Robert,23,0,30,7
1713309119489,SOCI 1,A02,494200,Thorpe; Charles Robert,30,0,30,0
1713309119489,SOCI 1,A03,494201,Thorpe; Charles Robert,29,0,30,1
1713309119489,SOCI 1,A04,494202,Thorpe; Charles Robert,29,0,30,1
1713309119489,SOCI 1,A05,494203,Thorpe; Charles Robert,29,0,30,1
1713309119489,SOCI 1,A06,494204,Thorpe; Charles Robert,30,0,30,0
1713309119489,SOCI 1,A07,494205,Thorpe; Charles Robert,29,0,30,1
1713309120520,SOCI 60,A01,494207,Staff,36,0,40,4
1713309120520,SOCI 60,A02,494208,Staff,39,0,40,1
1713309121545,SOCI 100,A01,494210,Payne; Christine Anna,28,0,30,2
1713309121545,SOCI 100,A02,494211,Payne; Christine Anna,27,0,30,3
1713309122569,SOCI 109M,A00,494212,Staff,20,0,20,0
1713309123594,SOCI 110,A00,494213,Staff,35,0,40,5
1713309125646,SOCI 118E,A00,494215,Ng; Kwai,38,0,40,2
1713309126673,SOCI 125,A00,494216,Calderon-Zaks; Michael Aar,42,0,45,3
1713309127702,SOCI 126,A01,494218,Jones; Makeba,4,0,5,1
1713309128726,SOCI 131,A00,494219,Thorpe; Charles Robert,30,0,30,0
1713309130780,SOCI 135,A00,494221,Payne; Christine Anna,37,0,50,13
1713309131804,SOCI 136E,A00,626690,Ruiz; Jonathan Joseph,25,0,25,0
1713309132830,SOCI 138GS,A00,494222,Navon; Daniel,24,0,28,4
1713309134894,SOCI 145,A00,494224,Staff,42,0,45,3
1713309135919,SOCI 153,A00,494225,Staff,28,0,30,2
1713309136946,SOCI 160E,A00,494226,Ng; Kwai,34,0,40,6
1713309137975,SOCI 180,A00,494227,Staff,29,0,30,1
1713309139001,SOCI 189GS,A00,494228,Ribas Norris; Janet Vanesa,11,0,11,0
1713309140027,SOCI 190GS,A00,553232,Ribas Norris; Janet Vanesa,11,0,11,0
1713309141057,SOMI 220,A00,627178,Schneid; Stephen David,30,0,30,0
1713309142091,SYN 2,001,490768,Staff,14,0,15,1
1713309142091,SYN 2,002,490769,Staff,15,0,15,0
1713309142091,SYN 2,004,490775,Staff,0,0,0,0
1713309142091,SYN 2,003,490774,Staff,0,0,0,0
1713309142091,SYN 2,005,490776,Staff,0,0,0,0
1713309143121,SYN 2R,001,490779,Staff,14,0,15,1
1713309143121,SYN 2R,002,514635,Staff,14,0,15,1
1713309144150,SYN 100,A01,490783,Staff,17,0,20,3
1713309144150,SYN 100,B01,490787,Staff,12,0,20,8
1713309144150,SYN 100,C01,490789,Staff,13,0,20,7
1713309145175,SYN 150,A00,490817,Staff,14,0,15,1
1713309145175,SYN 150,B00,514610,Staff,15,0,15,0
1713309146208,TDAC 1,A00,492753,Walsh; Kim C.,19,0,20,1
1713309146208,TDAC 1,B00,492754,Harting; Carla Kelso,19,0,20,1
1713309146208,TDAC 1,C00,513995,Salovey; Todd,17,0,20,3
1713309147236,TDAC 101,A00,492766,Harting; Carla Kelso,18,0,20,2
1713309148266,TDAC 102,A00,492768,Basso; Beatrice,19,0,20,1
1713309149294,TDDE 111,A00,492769,Staff,25,0,25,0
1713309150317,TDDE 131,A00,492770,Staff,15,0,15,0
1713309150317,TDDE 131,B00,492771,Staff,15,0,15,0
1713309151344,TDDE 131GS,A00,523716,Guirguis; Mark C,25,0,28,3
1713309152368,TDGE 1,A01,492756,Salovey; Todd,57,0,60,3
1713309153396,TDGE 5,A01,492758,Staff,24,0,25,1
1713309154423,TDGE 10,A00,492759,Fulton; Julia,212,0,220,8
1713309155450,TDGE 11,A00,492760,Castro; Robert Jess,200,0,200,0
1713309156480,TDGE 50,A00,492761,Blair; Kyle Adam,0,0,0,0
1713309157509,TDGE 124,A00,492772,Fulton; Julia,196,0,220,24
1713309158543,TDGE 125,A00,492773,Meyer; Ursula,41,0,50,9
1713309158543,TDGE 125,B00,492774,Staff,50,0,50,0
1713309158543,TDGE 125,C00,523565,Staff,49,0,50,1
1713309159571,TDGE 125GS,A00,523580,Guirguis; Mark C,25,0,28,3
1713309160600,TDGE 127,A00,492775,Havis; Allan,42,0,50,8
1713309161628,TDHT 101,A00,492776,Staff,35,0,35,0
1713309162657,TDMV 1,A00,492762,Caligagan; Maria T.,30,0,30,0
1713309162657,TDMV 1,B00,492763,Arcidiacono; Kristin,25,0,30,5
1713309163687,TDMV 2,A00,492764,Weinberg; Sadie,29,0,30,1
1713309164717,TDMV 3,A00,492765,Mack; Kara Shanai',39,0,40,1
1713309165742,TDMV 138,A00,492777,Mack; Kara Shanai',37,0,40,3
1713309166769,TDMV 140,A00,492778,Lima; Paulo Henrique,40,0,40,0
1713309167793,TDMV 142,A00,492779,Caligagan; Maria T.,37,0,40,3
1713309167793,TDMV 142,B00,492780,Caligagan; Tony,37,0,40,3
1713309168828,TDMV 143,A00,492781,Fyall; Daunte Edward,39,0,40,1
1713309169858,USP 1,A01,492401,Kwak; Nancy,26,0,35,9
1713309170885,USP 2,A01,492453,Hinds; Juli Beth,35,0,35,0
1713309171907,USP 3,A01,492516,Staff,30,0,35,5
1713309172937,USP 4,A00,492522,McTague; Sarah,19,0,25,6
1713309173965,USP 100,A00,492523,Staff,33,0,35,2
1713309174990,USP 101,A00,492524,Staff,13,0,15,2
1713309176018,USP 105,A00,492525,Staff,22,0,25,3
1713309177048,USP 151,A00,492526,Shenkman; Michael Thomas,33,0,35,2
1713309178078,USP 170,A00,492545,Hinds; Juli Beth,33,0,35,2
1713309179107,USP 171GS,A00,492608,Bussell; Mirle Rabinowitz,26,0,28,2
1713309180139,USP 183GS,A00,492613,Peerson; Susan,26,0,28,2
1713309181170,VIS 30,A01,490693,Yoldas; Pinar,21,0,22,1
1713309181170,VIS 30,A02,490694,Yoldas; Pinar,19,0,22,3
1713309182202,VIS 83,A00,490695,Kester; Grant,67,0,75,8
1713309183282,VIS 105D,A00,490696,Staff,22,0,25,3
1713309184312,VIS 124CN,A00,490699,Rose; Jordan M,68,0,75,7
1713309185337,VIS 125GS,A00,511221,Williams; Alena J,21,0,22,1
1713309186366,VIS 128D,A00,490700,Staff,74,0,75,1
1713309187390,VIS 151,A01,490717,Staff,34,0,34,0
1713309187390,VIS 151,A02,490766,Staff,33,0,34,1
1713309188421,VIS 154GS,A00,511972,Williams; Alena J,21,0,22,1
1713309189447,VIS 160A,A00,490767,Stone; Patricia,7,0,10,3
1713309190474,WCWP 10A,A00,490638,Staff,15,0,15,0
1713309190474,WCWP 10A,B00,490640,Staff,15,0,15,0
1713309191500,WCWP 10B,A00,490641,Staff,0,0,0,0
1713309191500,WCWP 10B,B00,490642,Staff,14,0,15,1
1713309191500,WCWP 10B,C00,490644,Staff,13,0,15,2
1713309191500,WCWP 10B,D00,490647,Staff,0,0,0,0
1713309192530,WCWP 100,A00,490655,Staff,0,0,0,0
1713309192530,WCWP 100,B00,490687,Staff,12,0,15,3
1713309194631,ANAR 153,A00,487222,Braswell; Geoffrey E.,55,0,60,5
1713309195655,ANBI 134,A00,487223,Staff,13,0,20,7
1713309196680,ANBI 143GS,A00,487224,Noel; Geoffroy Pierre Jean,20,0,24,4
1713309197705,ANBI 144GS,A00,519548,Noel; Geoffroy Pierre Jean,20,0,24,4
1713309198729,ANSC 101,A00,487225,Staff,19,0,20,1
1713309199755,ANSC 125,A00,487227,Brenner; Suzanne A,39,0,40,1
1713309201832,ANSC 146,A00,487229,Staff,36,0,40,4
1713309202862,ANSC 148,A00,487230,Olivas Hernandez; Olga Lid,39,0,40,1
1713309203890,ANSC 150,A00,504165,Sloane; Julia Kathryn,19,0,20,1
1713309204916,ANSC 180,A00,487232,Staff,13,0,15,2
1713309205942,ANSC 188,A00,627155,Staff,40,0,40,0
1713309206969,ANTH 5,A00,519529,Semendeferi; Ekaterini,15,0,15,0
1713309207992,ANTH 10,A00,487219,Staff,58,0,60,2
1713309209019,ANTH 23,A01,487221,Staff,17,0,20,3
1713309210044,ANTH 102,A00,487233,Wilder; Linnea Lorene,53,0,60,7
1713309211069,ANTH 103,A00,487234,Varma; Saiba,57,0,60,3
1713309212100,ANTH 105,A00,487235,Stewart; Alexander B,57,0,60,3
1713309213131,BENG 100,A01,516685,Taylor Amos; Alyssa C,28,0,30,2
1713309214162,BIBC 102,A01,491316,Flagg; Matthew Paul,51,0,88,37
1713309214162,BIBC 102,A02,491366,Flagg; Matthew Paul,84,0,88,4
1713309215188,BIBC 103,A01,491486,Boumechache; Miyyada,16,0,24,8
1713309215188,BIBC 103,A02,491487,Boumechache; Miyyada,24,0,24,0
1713309216213,BICD 100,A01,516882,Staff,75,0,75,0
1713309216213,BICD 100,A02,516890,Staff,70,0,75,5
1713309217242,BICD 102GS,A00,491488,Lo; Stanley M.,27,0,28,1
1713309218269,BIEB 136GS,A00,516940,Holway; David A. & Shurin; Jonathan,19,0,24,5
1713309219293,BIEB 137GS,A01,517034,Holway; David A. & Shurin; Jonathan,19,0,24,5
1713309220319,BIEB 138GS,A01,491492,Pirino; Giorgia,22,0,28,6
1713309221344,BILD 1,A01,491296,Staff,62,0,63,1
1713309221344,BILD 1,A02,491297,Staff,63,0,63,0
1713309222369,BILD 4,A01,517099,Gonzalez Gamboa; Ivonne,22,0,24,2
1713309222369,BILD 4,A02,517100,Gonzalez Gamboa; Ivonne,24,0,24,0
1713309223397,BILD 60GS,A00,491309,Lo; Stanley M.,27,0,28,1
1713309224422,BIMM 100,A01,517136,Staff,91,0,100,9
1713309225451,BIMM 110,A01,517182,Staff,74,0,100,26
1713309226483,BIMM 120,A01,517228,Pickett; Brooke Elizabeth,40,0,63,23
1713309226483,BIMM 120,A02,517240,Pickett; Brooke Elizabeth,48,0,63,15
1713309227513,BIMM 132GS,A01,491498,Pirino; Giorgia,22,0,28,6
1713309228543,BIMM 143,A01,491589,Bozinovic; Goran,20,0,40,20
1713309229574,BIPN 100,A01,491594,Armour; Jon Christopher,92,0,100,8
1713309230605,BIPN 140,A01,491602,Marino; Marc J,31,0,50,19
1713309232659,CAT 125,A00,515973,Staff,20,0,20,0
1713309233690,CAT 125GS,A00,515974,Rahimi; Babak,19,0,20,1
1713309234721,CAT 125R,A00,515980,Staff,15,0,20,5
1713309234721,CAT 125R,B00,515981,Tosun; Adriana,19,0,20,1
1713309234721,CAT 125R,C00,515987,Hyland; Tina Mae,3,0,20,17
1713309234721,CAT 125R,D00,515988,Bronstein; Phoebe Malan,18,0,20,2
1713309235747,CENG 15,A01,488699,Drews; Aaron,25,0,25,0
1713309236774,CENG 100,A00,505196,Opatkiewicz; Justin Paul,25,0,25,0
1713309237801,CGS 2A,A01,489598,Staff,33,0,35,2
1713309238827,CGS 112,A00,489599,Staff,15,0,15,0
1713309239851,CGS 119,A00,489603,Staff,10,0,10,0
1713309240879,CGS 120,A00,489604,Staff,14,0,15,1
1713309241904,CGS 150,A00,489607,Staff,15,0,15,0
1713309242930,CHEM 6A,A01,488715,Staff,98,0,100,2
1713309243960,CHEM 6B,A01,488719,Piercy; Marc Anthony,100,0,100,0
1713309244984,CHEM 6C,A01,488723,Albizati; Kim F.,94,0,100,6
1713309246013,CHEM 7L,A01,488728,Schurmeier; Kimberly,18,0,24,6
1713309246013,CHEM 7L,A02,488730,Schurmeier; Kimberly,23,0,24,1
1713309246013,CHEM 7L,A03,488734,Schurmeier; Kimberly,24,0,24,0
1713309246013,CHEM 7L,A04,488763,Schurmeier; Kimberly,23,0,24,1
1713309246013,CHEM 7L,B01,488798,Schurmeier; Kimberly,18,0,24,6
1713309246013,CHEM 7L,B02,488801,Schurmeier; Kimberly,23,0,24,1
1713309246013,CHEM 7L,B03,488808,Schurmeier; Kimberly,24,0,24,0
1713309246013,CHEM 7L,B04,488811,Schurmeier; Kimberly,24,0,24,0
1713309247041,CHEM 11,A01,488897,Stallings; Dontarie M,98,0,100,2
1713309248066,CHEM 40A,A01,488913,Albizati; Kim F.,91,0,100,9
1713309249096,CHEM 40B,A01,488920,Weizman; Haim,48,0,50,2
1713309249096,CHEM 40B,A02,488938,Weizman; Haim,46,0,50,4
1713309250129,CHEM 41A,A01,489029,Klosterman; Jeremy K,58,0,60,2
1713309251160,CHEM 41C,A01,500436,Tor; Yitzhak,55,0,60,5
1713309252187,CHEM 43A,A01,500426,Weizman; Haim,6,0,24,18
1713309252187,CHEM 43A,A02,500430,Weizman; Haim,13,0,24,11
1713309252187,CHEM 43A,B01,514041,Klosterman; Jeremy K,16,0,24,8
1713309252187,CHEM 43A,B02,514047,Klosterman; Jeremy K,23,0,24,1
1713309253211,CHEM 108,A01,489140,Jennings; Patricia A.,13,0,24,11
1713309253211,CHEM 108,A02,489142,Jennings; Patricia A.,15,0,24,9
1713309254237,CHEM 114A,A01,489147,Stallings; Dontarie M,81,0,100,19
1713309255261,CHIN 169A,A00,489171,Wang; Xiao,19,0,20,1
1713309257310,COGS 3,A01,518827,Boyle; Mary E. T.,30,0,40,10
1713309258339,COGS 11,A01,489175,Staff,28,0,30,2
1713309259365,COGS 14A,A01,518829,Staff,53,0,60,7
1713309260392,COGS 14B,A01,489177,Hoffman; Drew Ellen,69,0,75,6
1713309261416,COGS 100,A01,489181,Allen; Michael Gordon,66,0,75,9
1713309262444,COGS 101A,A01,489183,Staff,51,0,60,9
1713309263474,COGS 101B,A01,489185,Allen; Michael Gordon,13,0,30,17
1713309264499,COGS 101C,A01,526786,Staff,25,0,30,5
1713309266554,COGS 107A,A01,489189,Boyle; Mary E. T.,23,0,35,12
1713309267580,COGS 107B,A01,627144,Mooshagian; Eric Frederick,60,0,60,0
1713309268608,COGS 118A,A01,489191,Staff,0,28,40,40
1713309270659,COGS 171GS,A01,489194,Pineda; Jaime A,22,0,28,6
1713309271683,COGS 172,A01,489196,Staff,6,0,30,24
1713309272707,COGS 174GS,A01,489264,Pineda; Jaime A,22,0,28,6
1713309273733,COGS 180,A01,627150,Staff,29,0,30,1
1713309274758,COGS 186,A01,489274,Staff,4,0,30,26
1713309275788,COMM 10,A01,489276,Staff,24,0,25,1
1713309275788,COMM 10,A02,489303,Staff,23,0,25,2
1713309276815,COMM 100A,A01,489312,Staff,19,0,25,6
1713309276815,COMM 100A,A02,489313,Staff,24,0,25,1
1713309277839,COMM 106T,A00,512540,Staff,34,0,35,1
1713309278870,COMM 107,A00,489347,Staff,31,0,35,4
1713309279894,COMM 109P,A00,489358,Staff,31,0,35,4
1713309280917,COMM 132,A00,489361,McKenna; Denise,29,0,30,1
1713309281943,COMM 146,A00,489362,Halm; Gavin Patrick,27,0,30,3
1713309282968,COMM 190,A00,489363,Abuelhiga; Soraya Jill,21,0,23,2
1713309283998,CSE 8A,A50,489366,Staff,23,0,25,2
1713309283998,CSE 8A,A51,489367,Staff,24,0,25,1
1713309285023,CSE 11,A01,489398,Cao; Yingjun,83,0,100,17
1713309286050,CSE 12,A01,489487,Staff,43,0,50,7
1713309287201,CSE 20,A01,489497,Staff,49,0,50,1
1713309288226,CSE 21,A01,489517,Braun; Oliver,44,0,50,6
1713309289253,CSE 101,A01,489524,Braun; Oliver,0,13,50,50
1713309290282,CSE 105,A01,512594,Jones; Miles E,81,0,100,19
1713309290282,CSE 105,B01,512598,Jones; Miles E,69,0,100,31
1713309291314,CSE 140,A01,489538,Staff,44,0,50,6
1713309292344,CSE 141,A01,489550,Eldon; John,76,0,100,24
1713309293368,CSE 141L,A01,489571,Eldon; John,75,0,100,25
1713309294399,CSE 151A,A01,489583,Solares; Edwin A,152,0,200,48
1713309295425,CSE 175,A01,510886,Kumar; Rakesh,30,0,30,0
1713309296451,CSE 190,A00,516828,Dubnov; Shlomo,41,0,49,8
1713309297479,DOC 100D,A00,489667,Pass; Natalye Joann,23,0,25,2
1713309298504,DSC 10,A01,624268,Staff,72,0,75,3
1713309299530,DSC 20,A01,624476,Staff,50,0,50,0
1713309300555,DSC 40A,A01,624608,Staff,40,0,40,0
1713309301582,DSGN 1,A01,489179,Rill; Bryan,37,0,50,13
1713309302608,ECE 17,A01,490489,Sahay; Rajeev,18,0,30,12
1713309303635,ECE 65,A50,490492,Staff,17,0,20,3
1713309303635,ECE 65,A51,490493,Staff,20,0,20,0
1713309304664,ECON 1,A01,489715,Famulari; Melissa,69,0,70,1
1713309305695,ECON 2,A01,489717,Levkoff; Steven B.,68,0,70,2
1713309306727,ECON 3,A01,489948,Staff,70,0,70,0
1713309308790,ECON 5,A01,490103,Staff,28,0,30,2
1713309308790,ECON 5,B01,626281,Dai; Yinlin,45,0,45,0
1713309309815,ECON 100A,A01,490127,Famulari; Melissa,68,0,70,2
1713309310844,ECON 100B,A01,490129,Staff,64,0,70,6
1713309311874,ECON 109,A01,490187,Shishkin; Denis,27,0,35,8
1713309312904,ECON 110A,A01,490190,Levkoff; Steven B.,63,0,70,7
1713309313930,ECON 120A,A01,490245,Dai; Yinlin,65,0,70,5
1713309314955,ECON 120B,A01,490247,Nieto-Barthaburu; Augusto,60,0,70,10
1713309315983,ECON 120C,A01,490253,Sun; Yixiao,32,0,35,3
1713309315983,ECON 120C,B01,490255,Sun; Yixiao,34,0,35,1
1713309317011,ECON 129,A00,490256,Eckert; Fabian Paul,26,0,35,9
1713309318044,ECON 131,A00,490257,Nieto-Barthaburu; Augusto,4,0,35,31
1713309319071,ECON 138,A00,490258,Bharadwaj; Prashant,23,0,35,12
1713309319071,ECON 138,B00,490259,Bharadwaj; Prashant,19,0,35,16
1713309320096,ECON 159,A00,490260,Hendrickson; Gerald M.,0,6,0,0
1713309321123,ECON 178,A01,553995,Zhu; Ying,27,0,35,8
1713309322153,EDS 40,A01,512576,Black; Alison Michelle,20,0,20,0
1713309323179,EDS 107,A01,515848,Staff,30,0,30,0
1713309324205,EDS 110R,A01,490262,Staff,26,0,30,4
1713309325229,EDS 112,A01,490264,Chapman; Thandeka K,44,0,50,6
1713309326256,EDS 113,A00,490266,Staff,27,0,30,3
1713309327281,EDS 118,A00,490267,Warstadt; Melissa Fawn,26,0,30,4
1713309328306,EDS 124BR,A00,490268,Eguchi; Emi,10,0,25,15
1713309328306,EDS 124BR,B00,490269,Eguchi; Emi,25,0,25,0
1713309329331,EDS 126,A01,490271,Jones; Makeba,45,0,50,5
1713309330361,EDS 135,A01,490316,Staff,19,0,20,1
1713309331386,ENVR 142GS,A00,519514,Chang; Edmond Yi-Teh,28,0,28,0
1713309332412,ETHN 103,A00,490504,Staff,33,0,36,3
1713309333441,ETHN 103A,A00,490505,Man; Simeon S,7,0,9,2
1713309334466,ETHN 109,A00,490506,Staff,30,0,30,0
1713309335490,ETHN 118,A00,490507,Staff,35,0,36,1
1713309336513,ETHN 119,A00,490508,Staff,36,0,36,0
1713309337542,ETHN 121R,A00,490518,Choi; Esther Min,30,0,36,6
1713309338566,ETHN 127,A00,490528,Staff,15,0,15,0
1713309339592,ETHN 139,A00,490573,Staff,10,0,10,0
1713309340619,ETHN 150,A00,490575,Staff,15,0,15,0
1713309341647,GLBH 20,A00,491705,Elwardani; Nile Regina,38,0,40,2
1713309342675,GLBH 101,A00,491706,Staff,20,0,20,0
1713309343699,GLBH 111,A01,491708,Burgos; Jose L.,15,0,15,0
1713309344727,GLBH 146,A00,491709,Staff,11,0,20,9
1713309345753,GLBH 148,A00,491710,Olivas Hernandez; Olga Lid,16,0,20,4
1713309346781,GLBH 150,A00,491711,Sloane; Julia Kathryn,20,0,20,0
1713309347811,HIEA 131,A00,491760,Staff,30,0,32,2
1713309348837,HIEA 153,A00,491762,Staff,29,0,30,1
1713309349864,HIEU 124,A00,491811,Staff,26,0,32,6
1713309350892,HIEU 124GS,A00,491812,Markman; Kristina,28,0,28,0
1713309351920,HIEU 147,A00,491813,Staff,30,0,32,2
1713309352946,HIEU 149GS,A00,491816,Caldwell; Michael Alan,28,0,28,0
1713309353977,HILD 2C,A01,491713,Hendrickson; Gerald M.,28,0,30,2
1713309355001,HILD 7B,A01,491715,Kwak; Nancy,15,0,30,15
1713309356028,HILD 10,A01,491717,Staff,14,0,20,6
1713309357056,HILD 30GS,A00,491719,Edington; Claire Ellen,24,0,28,4
1713309358085,HINE 109,A00,491818,Shafir; Nir,28,0,32,4
1713309359112,HINE 128,A00,491821,Shafir; Nir,31,0,32,1
1713309360137,HISC 117,A00,491830,Staff,29,0,32,3
1713309361167,HIUS 103,A00,491834,Man; Simeon S,16,0,23,7
1713309362192,HIUS 108B,A00,491835,Staff,29,0,30,1
1713309363221,HIUS 141,A00,491836,Hendrickson; Gerald M.,29,0,32,3
1713309364251,HIUS 149,A00,491839,Staff,27,0,32,5
1713309365278,HUM 3,A01,512617,Crum; Matthew Stephen,46,0,50,4
1713309365278,HUM 3,A02,512618,Crum; Matthew Stephen,48,0,50,2
1713309366303,HUM 3GS,A00,512663,Markman; Kristina,0,0,0,0
1713309366303,HUM 3GS,B00,512664,Staff,0,0,0,0
1713309367332,HUM 4,A01,512620,West; Geoffrey Scott,36,0,50,14
1713309368363,HUM 4GS,A00,512666,Lyon; Antony J.,0,0,0,3
1713309369389,HUM 4R,A01,512625,Watkins; Eric,49,0,50,1
1713309370422,HUM 5,A01,512649,Zavodny; Tatiana Sophia,34,0,50,16
1713309370422,HUM 5,B01,512661,Zroka; Ryan Edward,49,0,50,1
1713309371456,INTL 190,A00,490577,Segui; Alan S,0,0,0,5
1713309372485,JAPN 20AR,A01,491267,Ross; Kayoko F,12,0,20,8
1713309373508,JAPN 180,A00,491285,Berman; Michael David,34,0,40,6
1713309374535,LATI 50,A01,502536,Kokinis; Troy Andreas,19,0,22,3
1713309374535,LATI 50,A02,502551,Kokinis; Troy Andreas,22,0,22,0
1713309374535,LATI 50,A03,502650,Kokinis; Troy Andreas,22,0,22,0
1713309374535,LATI 50,A04,502909,Kokinis; Troy Andreas,22,0,22,0
1713309375562,LATI 160,A01,502920,Kokinis; Troy Andreas,30,0,30,0
1713309376588,LIFR 1A,A00,490494,Van Moer; Vinciane G,17,0,20,3
1713309377614,LIFR 1AX,A00,490495,Van Moer; Vinciane G,17,0,20,3
1713309378639,LIFR 1B,A00,490496,Van Moer; Vinciane G,19,0,20,1
1713309379664,LIFR 1BX,A00,490497,Van Moer; Vinciane G,19,0,20,1
1713309380690,LIGN 8,A00,505198,McIntosh; Justin Daniel,140,0,150,10
1713309381716,LIGN 9GS,A00,491239,Lott; Margaret S.,18,0,20,2
1713309382743,LIGN 101,A01,505200,McIntosh; Justin Daniel,26,0,30,4
1713309383769,LIGN 120,A01,491244,Staff,24,0,30,6
1713309384794,LIGN 149GS,A00,491245,Lott; Margaret S.,18,0,20,2
1713309385819,LIGN 170,A00,491247,Staff,24,0,30,6
1713309386844,LISP 1D,A00,490498,Munoz Sanchez; Alicia,11,0,14,3
1713309386844,LISP 1D,B00,490499,Munoz Sanchez; Alicia,6,0,14,8
1713309386844,LISP 1D,C00,490500,Munoz Sanchez; Alicia,10,0,14,4
1713309386844,LISP 1D,D00,490501,Munoz Sanchez; Alicia,11,0,14,3
1713309387870,LISP 1DX,A00,490502,Munoz Sanchez; Alicia,18,0,28,10
1713309387870,LISP 1DX,B00,490503,Munoz Sanchez; Alicia,19,0,28,9
1713309389920,LTAM 110,A00,491847,Staff,23,0,25,2
1713309391003,LTCS 119,A00,491848,Staff,12,0,15,3
1713309392034,LTCS 130,A00,491849,Staff,24,0,25,1
1713309394089,LTEA 120C,A00,491852,Staff,35,0,40,5
1713309395116,LTEN 130GS,A00,491853,Lyon; Antony J.,25,0,28,3
1713309396140,LTEN 148,A00,491855,Staff,23,0,25,2
1713309397169,LTEN 159,A00,491856,Staff,21,0,25,4
1713309398195,LTEN 180,A00,491857,Staff,9,0,15,6
1713309400252,LTSP 123GS,A00,505928,Bessett; Ryan Matthew,25,0,28,3
1713309401276,LTSP 174GS,A00,506037,Bessett; Ryan Matthew,25,0,28,3
1713309403331,LTWR 102,A00,491861,Staff,12,0,15,3
1713309404359,LTWR 106,A00,491862,Staff,10,0,15,5
1713309405384,MAE 11,A00,490930,Bahadori; Mohammad Yousef,97,0,100,3
1713309406415,MAE 30A,A00,490931,Qi; Huihui,38,0,40,2
1713309407441,MAE 101A,A00,491036,Sadeghizadeh; Zahra,98,0,100,2
1713309408466,MAE 101C,A00,491037,Seshadri; Kalyanasundaram,77,0,100,23
1713309409495,MAE 113,A00,491040,Seshadri; Kalyanasundaram,67,0,80,13
1713309410522,MAE 131A,A00,491041,Ghazinejad; Maziar,39,0,40,1
1713309411553,MAE 142,A00,491053,Staff,39,0,40,1
1713309412579,MAE 143A,A00,491054,Staff,40,0,50,10
1713309413605,MAE 150,A00,491092,Truong; Phuong Thi Ngoc,24,0,35,11
1713309414632,MATH 3C,A01,494031,Pardo Guerra; Sebastian,30,0,30,0
1713309414632,MATH 3C,A02,494032,Pardo Guerra; Sebastian,29,0,30,1
1713309415664,MATH 10A,A01,494034,Staff,27,0,30,3
1713309415664,MATH 10A,A02,494035,Staff,29,0,30,1
1713309415664,MATH 10A,B01,494037,Staff,27,0,30,3
1713309415664,MATH 10A,B02,494038,Staff,29,0,30,1
1713309416694,MATH 10B,A01,494040,Habib; Yousaf,24,0,30,6
1713309416694,MATH 10B,A02,494041,Habib; Yousaf,28,0,30,2
1713309416694,MATH 10B,A03,494042,Habib; Yousaf,30,0,30,0
1713309416694,MATH 10B,A04,494043,Habib; Yousaf,30,0,30,0
1713309416694,MATH 10B,B01,494045,Habib; Yousaf,28,0,30,2
1713309416694,MATH 10B,B02,494046,Habib; Yousaf,30,0,30,0
1713309416694,MATH 10B,B03,494047,Habib; Yousaf,30,0,30,0
1713309416694,MATH 10B,B04,494048,Habib; Yousaf,30,0,30,0
1713309417722,MATH 18,A01,494050,Kemp; Todd Aahron,27,0,30,3
1713309417722,MATH 18,A02,494051,Kemp; Todd Aahron,29,0,30,1
1713309417722,MATH 18,B01,494054,Kemp; Todd Aahron,28,0,30,2
1713309417722,MATH 18,B02,494055,Kemp; Todd Aahron,29,0,30,1
1713309418748,MATH 20A,A01,494059,Suk; Andrew Hoon,30,0,30,0
1713309419774,MATH 20B,A01,494061,Briones; Jor-el Thomas Caparas,34,0,35,1
1713309419774,MATH 20B,B01,494063,Bach; Quang Tran,34,0,35,1
1713309420800,MATH 20C,A01,494065,Staff,28,0,30,2
1713309420800,MATH 20C,A02,494066,Staff,30,0,30,0
1713309420800,MATH 20C,A03,494067,Staff,30,0,30,0
1713309420800,MATH 20C,A04,494068,Staff,30,0,30,0
1713309420800,MATH 20C,B01,494070,Zhang; Ming,26,0,30,4
1713309420800,MATH 20C,B02,494071,Zhang; Ming,29,0,30,1
1713309420800,MATH 20C,B03,494072,Zhang; Ming,29,0,30,1
1713309420800,MATH 20C,B04,494073,Zhang; Ming,29,0,30,1
1713309421918,MATH 20D,A01,494075,Staff,25,0,30,5
1713309421918,MATH 20D,A02,494076,Staff,30,0,30,0
1713309422944,MATH 20E,A01,494079,Staff,25,0,30,5
1713309422944,MATH 20E,A02,494080,Staff,27,0,30,3
1713309422944,MATH 20E,B01,494082,Staff,28,0,30,2
1713309422944,MATH 20E,B02,494083,Staff,25,0,30,5
1713309423975,MATH 103A,A01,494085,Aliabadi Sr.; Mohsen,17,0,30,13
1713309423975,MATH 103A,A02,494086,Aliabadi Sr.; Mohsen,28,0,30,2
1713309423975,MATH 103A,B01,494088,Aliabadi Sr.; Mohsen,22,0,30,8
1713309423975,MATH 103A,B02,494089,Aliabadi Sr.; Mohsen,28,0,30,2
1713309425001,MATH 109,A01,494091,Staff,30,0,30,0
1713309425001,MATH 109,A02,494092,Staff,30,0,30,0
1713309425001,MATH 109,B01,494094,Staff,28,0,30,2
1713309425001,MATH 109,B02,494095,Staff,29,0,30,1
1713309426028,MATH 142A,A01,494097,Chow; Bennett,16,0,30,14
1713309426028,MATH 142A,A02,494098,Chow; Bennett,24,0,30,6
1713309426028,MATH 142A,B01,494100,Chow; Bennett,21,0,30,9
1713309426028,MATH 142A,B02,494101,Chow; Bennett,29,0,30,1
1713309428077,MATH 168A,A01,516677,Dumitriu; Ioana,16,0,35,19
1713309429105,MATH 170A,A01,516679,Dumitriu; Ioana,20,0,30,10
1713309429105,MATH 170A,A02,516680,Dumitriu; Ioana,28,0,30,2
1713309430131,MATH 193A,A01,494107,Staff,16,0,30,14
1713309430131,MATH 193A,A02,494108,Staff,23,0,30,7
1713309430131,MATH 193A,A03,494109,Staff,29,0,30,1
1713309430131,MATH 193A,A04,494110,Staff,24,0,30,6
1713309433214,MGT 16,A00,491930,McKay; Michael J,94,0,98,4
1713309434241,MGT 18,A00,491992,McKay; Michael J,97,0,98,1
1713309435266,MGT 71,A00,492003,Staff,78,0,98,20
1713309436291,MGT 103,A00,505209,Eberhard; Craig A,86,0,98,12
1713309437321,MGT 131A,A00,505210,Anderson; John Charles,91,0,98,7
1713309439373,MGT 153,A00,492077,Perols; Johan Lars,45,0,90,45
1713309442458,MGT 164,A00,492222,McKay; Mary A,94,0,98,4
1713309443484,MGT 172,A00,492245,Staff,59,0,60,1
1713309443484,MGT 172,B00,505526,Hedges; Kathleen,78,0,98,20
1713309444508,MGT 181,A00,505669,Dunn; Louis Jean,88,0,98,10
1713309445533,MMW 14,A01,494399,Staff,23,0,28,5
1713309445533,MMW 14,A02,494400,Staff,26,0,28,2
1713309445533,MMW 14,A03,494401,Staff,28,0,28,0
1713309445533,MMW 14,A04,494402,Staff,28,0,28,0
1713309445533,MMW 14,B01,494404,Carreras; Maria Victoria,16,0,28,12
1713309445533,MMW 14,B02,494405,Carreras; Maria Victoria,27,0,28,1
1713309445533,MMW 14,B03,494406,Carreras; Maria Victoria,28,0,28,0
1713309445533,MMW 14,B04,494407,Carreras; Maria Victoria,28,0,28,0
1713309446563,MMW 14GS,A00,506250,Chang; Edmond Yi-Teh,0,0,0,0
1713309447587,MMW 121R,A01,494415,Adamiak; Patrick John,15,0,28,13
1713309447587,MMW 121R,A02,494416,Adamiak; Patrick John,25,0,28,3
1713309448615,MUS 1A,A01,494113,Staff,12,0,25,13
1713309448615,MUS 1A,A02,494114,Staff,25,0,25,0
1713309449643,MUS 4,A01,494116,Staff,24,0,25,1
1713309449643,MUS 4,A02,494117,Staff,22,0,25,3
1713309450669,MUS 5R,A01,494236,Dubnov; Shlomo,12,0,25,13
1713309450669,MUS 5R,A02,494237,Dubnov; Shlomo,25,0,25,0
1713309451701,MUS 6,A01,494122,Staff,16,0,25,9
1713309451701,MUS 6,A02,494123,Staff,24,0,25,1
1713309452727,MUS 7,A01,494125,Staff,17,0,25,8
1713309452727,MUS 7,A02,494126,Staff,24,0,25,1
1713309453753,MUS 11,A01,494128,Staff,23,0,25,2
1713309453753,MUS 11,A02,494129,Staff,25,0,25,0
1713309454778,MUS 13,A01,494131,Staff,25,0,25,0
1713309454778,MUS 13,A02,494132,Staff,25,0,25,0
1713309455809,MUS 15,A01,494134,Staff,20,0,25,5
1713309455809,MUS 15,A02,494135,Staff,25,0,25,0
1713309455809,MUS 15,B01,494137,Staff,24,0,25,1
1713309456842,MUS 80,A00,494232,Staff,25,0,25,0
1713309456842,MUS 80,B00,494233,Staff,25,0,25,0
1713309456842,MUS 80,C00,494234,Staff,23,0,25,2
1713309457871,MUS 95C,A00,494141,Staff,73,0,75,2
1713309458895,MUS 114,A00,494142,Staff,41,0,50,9
1713309459921,NANO 15,A01,490636,Drews; Aaron,7,0,7,0
1713309460951,PHIL 1,A00,490578,Grush; Rick Scott,50,0,50,0
1713309461976,PHIL 10,A01,490580,Grush; Rick Scott,34,0,35,1
1713309461976,PHIL 10,A02,490586,Grush; Rick Scott,33,0,35,2
1713309463009,PHIL 27,A01,490591,Staff,24,0,25,1
1713309463009,PHIL 27,A02,490592,Staff,25,0,25,0
1713309463009,PHIL 27,A03,490593,Staff,25,0,25,0
1713309463009,PHIL 27,A04,490598,Staff,25,0,25,0
1713309464035,PHIL 32,A01,490611,Staff,20,0,20,0
1713309464035,PHIL 32,A02,490618,Staff,20,0,20,0
1713309465064,PHIL 90,A00,490624,Staff,40,0,40,0
1713309466092,PHIL 136,A00,490627,Cohen; Jonathan David,38,0,40,2
1713309467116,PHIL 155,A00,490634,Staff,66,0,70,4
1713309468143,PHYS 1A,A00,491610,Staff,246,0,250,4
1713309469167,PHYS 1AL,001,491616,Tsai; Philbert S,28,0,30,2
1713309469167,PHYS 1AL,002,491618,Tsai; Philbert S,30,0,30,0
1713309470196,PHYS 1B,A00,491623,Staff,244,0,250,6
1713309471221,PHYS 1BL,001,491626,Tsai; Philbert S,26,0,30,4
1713309471221,PHYS 1BL,002,491628,Tsai; Philbert S,28,0,30,2
1713309472247,PHYS 1C,A00,491632,Staff,224,0,245,21
1713309473275,PHYS 1CL,001,491635,Tsai; Philbert S,12,0,30,18
1713309473275,PHYS 1CL,002,491643,Tsai; Philbert S,24,0,30,6
1713309474299,PHYS 2AR,A01,491651,Meyertholen; Andrew D.,45,0,50,5
1713309475324,PHYS 2B,A01,491659,Staff,107,0,115,8
1713309476352,PHYS 2BL,A01,491685,Staff,23,0,24,1
1713309476352,PHYS 2BL,A02,491700,Staff,23,0,24,1
1713309477380,PHYS 2C,A01,505161,Staff,107,0,115,8
1713309478411,PHYS 4A,A01,491704,Grinstein; Benjamin,99,0,100,1
1713309479438,POLI 5D,A01,494144,Staff,3,0,5,2
1713309479438,POLI 5D,B01,626283,Dai; Yinlin,5,0,5,0
1713309480466,POLI 12,A00,494145,Staff,44,0,45,1
1713309481492,POLI 13R,A00,494146,Forman; Fonna,46,0,50,4
1713309482520,POLI 27,A01,494148,Staff,58,0,60,2
1713309483545,POLI 30,A00,494149,Staff,49,0,50,1
1713309484571,POLI 100DA,A00,494150,Staff,23,0,25,2
1713309486620,POLI 100I,A00,494152,Staff,28,0,30,2
1713309487648,POLI 104B,A00,494153,Smith; Glenn Chatmas,54,0,55,1
1713309488673,POLI 104F,A00,494154,Staff,28,0,30,2
1713309489698,POLI 104I,A00,494155,Smith; Glenn Chatmas,30,0,30,0
1713309490727,POLI 110C,A00,494156,Ingham; Sean,23,0,25,2
1713309491753,POLI 117R,A00,494157,Forman; Fonna,13,0,20,7
1713309492782,POLI 118,A00,494158,Ingham; Sean,23,0,25,2
1713309493810,POLI 120H,A00,494159,Fisk; David Lee,41,0,45,4
1713309494893,POLI 131CR,A00,494160,Hoston; Germaine,40,0,45,5
1713309495918,POLI 133J,A00,494161,Staff,33,0,35,2
1713309496943,POLI 135,A00,494162,Fisk; David Lee,33,0,35,2
1713309497968,POLI 140A,A00,494164,Staff,22,0,30,8
1713309498993,POLI 142I,A00,494165,Staff,30,0,30,0
1713309500018,POLI 144D,A00,494166,Staff,23,0,25,2
1713309501045,POLI 151,A00,494167,Staff,30,0,30,0
1713309502069,POLI 153,A00,494168,Staff,33,0,35,2
1713309503093,POLI 160AA,A00,494169,Staff,35,0,40,5
1713309504119,POLI 162,A00,494170,Mignozzetti; Umberto,21,0,25,4
1713309505148,POLI 171,A00,494171,Mignozzetti; Umberto,23,0,25,2
1713309506176,PSYC 1,A00,494172,Staff,97,0,100,3
1713309507201,PSYC 2,A00,494173,Moranton; Nirelia Melbina-,44,0,50,6
1713309508227,PSYC 3,A00,494174,Staff,30,0,30,0
1713309509252,PSYC 6,A00,494175,Staff,17,0,20,3
1713309510276,PSYC 60,A01,494177,Staff,40,0,45,5
1713309511302,PSYC 70,A01,505724,Geller; Emma Harlan,42,0,45,3
1713309512330,PSYC 101,A00,494180,Heyman; Gail D.,87,0,100,13
1713309513356,PSYC 105,A00,494181,Geller; Emma Harlan,65,0,90,25
1713309514383,PSYC 106,A00,494182,Dobkins; Karen R.,33,0,45,12
1713309515409,PSYC 108,A00,494183,Adrian; Julia Anna,94,0,100,6
1713309516436,PSYC 114,A01,494185,Winkielman; Piotr,3,0,30,27
1713309517464,PSYC 122,A00,494186,Moranton; Nirelia Melbina-,38,0,50,12
1713309518495,PSYC 124,A00,494187,Chapman; Eddie Nathaniel,72,0,80,8
1713309519523,PSYC 131,A00,494188,Anagnostaras; Stephan,59,0,80,21
1713309520552,PSYC 144,A00,494189,Staff,19,0,50,31
1713309521576,PSYC 154,A00,494190,Lacefield; Katharine I,134,0,180,46
1713309522602,PSYC 162,A00,494191,Wixted; John T,85,0,100,15
1713309523631,PSYC 172,A00,494192,Gorman; Michael R.,38,0,45,7
1713309524661,PSYC 178,A00,494193,Glaser; Dale,40,0,45,5
1713309525686,PSYC 193,A00,505725,Chapman; Eddie Nathaniel,20,0,20,0
1713309526717,RELI 145GS,A00,519817,Rahimi; Babak,19,0,20,1
1713309527744,SE 101A,A01,490862,Chadha; Mayank,24,0,25,1
1713309528770,SE 101C,A01,490924,Krysl; Petr,18,0,20,2
1713309529796,SE 110A,A01,490928,Staff,20,0,20,0
1713309530823,SE 130A,A00,490929,Morrison; Machel Leigh,64,0,70,6
1713309531849,SIO 1,A01,519325,Staff,39,0,40,1
1713309532878,SIO 30,A01,519327,Staff,39,0,40,1
1713309533903,SIO 40,A00,519328,Staff,40,0,40,0
1713309534926,SIO 46GS,A00,519819,Cook; Geoffrey W,18,0,25,7
1713309535954,SIO 109R,A00,494197,Forman; Fonna,7,0,20,13
1713309536980,SIO 121GS,A00,519827,Cook; Geoffrey W,18,0,25,7
1713309538006,SIO 132,A01,519330,Staff,38,0,40,2
1713309539031,SIO 133,A01,519397,Staff,38,0,40,2
1713309540062,SIO 139,A00,519396,Kacev; David,33,0,40,7
1713309541088,SOCI 1,A01,494199,Thorpe; Charles Robert,23,0,30,7
1713309541088,SOCI 1,A02,494200,Thorpe; Charles Robert,30,0,30,0
1713309541088,SOCI 1,A03,494201,Thorpe; Charles Robert,29,0,30,1
1713309541088,SOCI 1,A04,494202,Thorpe; Charles Robert,29,0,30,1
1713309541088,SOCI 1,A05,494203,Thorpe; Charles Robert,29,0,30,1
1713309541088,SOCI 1,A06,494204,Thorpe; Charles Robert,30,0,30,0
1713309541088,SOCI 1,A07,494205,Thorpe; Charles Robert,29,0,30,1
1713309542114,SOCI 60,A01,494207,Staff,36,0,40,4
1713309542114,SOCI 60,A02,494208,Staff,39,0,40,1
1713309543139,SOCI 100,A01,494210,Payne; Christine Anna,28,0,30,2
1713309543139,SOCI 100,A02,494211,Payne; Christine Anna,27,0,30,3
1713309544165,SOCI 109M,A00,494212,Staff,20,0,20,0
1713309545190,SOCI 110,A00,494213,Staff,35,0,40,5
1713309547245,SOCI 118E,A00,494215,Ng; Kwai,38,0,40,2
1713309548272,SOCI 125,A00,494216,Calderon-Zaks; Michael Aar,42,0,45,3
1713309549297,SOCI 126,A01,494218,Jones; Makeba,4,0,5,1
1713309550327,SOCI 131,A00,494219,Thorpe; Charles Robert,29,0,30,1
1713309552382,SOCI 135,A00,494221,Payne; Christine Anna,37,0,50,13
1713309553411,SOCI 136E,A00,626690,Ruiz; Jonathan Joseph,25,0,25,0
1713309554437,SOCI 138GS,A00,494222,Navon; Daniel,24,0,28,4
1713309556488,SOCI 145,A00,494224,Staff,42,0,45,3
1713309557514,SOCI 153,A00,494225,Staff,28,0,30,2
1713309558539,SOCI 160E,A00,494226,Ng; Kwai,33,0,40,7
1713309559564,SOCI 180,A00,494227,Staff,29,0,30,1
1713309560591,SOCI 189GS,A00,494228,Ribas Norris; Janet Vanesa,11,0,11,0
1713309561620,SOCI 190GS,A00,553232,Ribas Norris; Janet Vanesa,11,0,11,0
1713309562647,SOMI 220,A00,627178,Schneid; Stephen David,30,0,30,0
1713309563673,SYN 2,001,490768,Staff,14,0,15,1
1713309563673,SYN 2,002,490769,Staff,15,0,15,0
1713309563673,SYN 2,004,490775,Staff,0,0,0,0
1713309563673,SYN 2,003,490774,Staff,0,0,0,0
1713309563673,SYN 2,005,490776,Staff,0,0,0,0
1713309564703,SYN 2R,001,490779,Staff,14,0,15,1
1713309564703,SYN 2R,002,514635,Staff,14,0,15,1
1713309565729,SYN 100,A01,490783,Staff,17,0,20,3
1713309565729,SYN 100,B01,490787,Staff,11,0,20,9
1713309565729,SYN 100,C01,490789,Staff,13,0,20,7
1713309566755,SYN 150,A00,490817,Staff,14,0,15,1
1713309566755,SYN 150,B00,514610,Staff,15,0,15,0
1713309567784,TDAC 1,A00,492753,Walsh; Kim C.,19,0,20,1
1713309567784,TDAC 1,B00,492754,Harting; Carla Kelso,19,0,20,1
1713309567784,TDAC 1,C00,513995,Salovey; Todd,17,0,20,3
1713309568811,TDAC 101,A00,492766,Harting; Carla Kelso,18,0,20,2
1713309569836,TDAC 102,A00,492768,Basso; Beatrice,19,0,20,1
1713309570864,TDDE 111,A00,492769,Staff,25,0,25,0
1713309571891,TDDE 131,A00,492770,Staff,15,0,15,0
1713309571891,TDDE 131,B00,492771,Staff,15,0,15,0
1713309572920,TDDE 131GS,A00,523716,Guirguis; Mark C,25,0,28,3
1713309573950,TDGE 1,A01,492756,Salovey; Todd,57,0,60,3
1713309574978,TDGE 5,A01,492758,Staff,24,0,25,1
1713309576004,TDGE 10,A00,492759,Fulton; Julia,212,0,220,8
1713309577030,TDGE 11,A00,492760,Castro; Robert Jess,200,0,200,0
1713309578059,TDGE 50,A00,492761,Blair; Kyle Adam,0,0,0,0
1713309579086,TDGE 124,A00,492772,Fulton; Julia,196,0,220,24
1713309580114,TDGE 125,A00,492773,Meyer; Ursula,40,0,50,10
1713309580114,TDGE 125,B00,492774,Staff,50,0,50,0
1713309580114,TDGE 125,C00,523565,Staff,49,0,50,1
1713309581139,TDGE 125GS,A00,523580,Guirguis; Mark C,25,0,28,3
1713309582166,TDGE 127,A00,492775,Havis; Allan,42,0,50,8
1713309583191,TDHT 101,A00,492776,Staff,35,0,35,0
1713309584215,TDMV 1,A00,492762,Caligagan; Maria T.,30,0,30,0
1713309584215,TDMV 1,B00,492763,Arcidiacono; Kristin,25,0,30,5
1713309585244,TDMV 2,A00,492764,Weinberg; Sadie,29,0,30,1
1713309586272,TDMV 3,A00,492765,Mack; Kara Shanai',39,0,40,1
1713309587301,TDMV 138,A00,492777,Mack; Kara Shanai',37,0,40,3
1713309588329,TDMV 140,A00,492778,Lima; Paulo Henrique,40,0,40,0
1713309589360,TDMV 142,A00,492779,Caligagan; Maria T.,37,0,40,3
1713309589360,TDMV 142,B00,492780,Caligagan; Tony,37,0,40,3
1713309590385,TDMV 143,A00,492781,Fyall; Daunte Edward,39,0,40,1
1713309591413,USP 1,A01,492401,Kwak; Nancy,26,0,35,9
1713309592439,USP 2,A01,492453,Hinds; Juli Beth,35,0,35,0
1713309593464,USP 3,A01,492516,Staff,29,0,35,6
1713309594490,USP 4,A00,492522,McTague; Sarah,19,0,25,6
1713309595517,USP 100,A00,492523,Staff,33,0,35,2
1713309596544,USP 101,A00,492524,Staff,13,0,15,2
1713309597571,USP 105,A00,492525,Staff,22,0,25,3
1713309598651,USP 151,A00,492526,Shenkman; Michael Thomas,33,0,35,2
1713309599678,USP 170,A00,492545,Hinds; Juli Beth,33,0,35,2
1713309600708,USP 171GS,A00,492608,Bussell; Mirle Rabinowitz,26,0,28,2
1713309601738,USP 183GS,A00,492613,Peerson; Susan,26,0,28,2
1713309602764,VIS 30,A01,490693,Yoldas; Pinar,21,0,22,1
1713309602764,VIS 30,A02,490694,Yoldas; Pinar,19,0,22,3
1713309603792,VIS 83,A00,490695,Kester; Grant,67,0,75,8
1713309604875,VIS 105D,A00,490696,Staff,22,0,25,3
1713309605909,VIS 124CN,A00,490699,Rose; Jordan M,68,0,75,7
1713309606935,VIS 125GS,A00,511221,Williams; Alena J,21,0,22,1
1713309607963,VIS 128D,A00,490700,Staff,74,0,75,1
1713309608988,VIS 151,A01,490717,Staff,34,0,34,0
1713309608988,VIS 151,A02,490766,Staff,33,0,34,1
1713309610013,VIS 154GS,A00,511972,Williams; Alena J,21,0,22,1
1713309611040,VIS 160A,A00,490767,Stone; Patricia,7,0,10,3
1713309612068,WCWP 10A,A00,490638,Staff,15,0,15,0
1713309612068,WCWP 10A,B00,490640,Staff,15,0,15,0
1713309613097,WCWP 10B,A00,490641,Staff,0,0,0,0
1713309613097,WCWP 10B,B00,490642,Staff,14,0,15,1
1713309613097,WCWP 10B,C00,490644,Staff,13,0,15,2
1713309613097,WCWP 10B,D00,490647,Staff,0,0,0,0
1713309614123,WCWP 100,A00,490655,Staff,0,0,0,0
1713309614123,WCWP 100,B00,490687,Staff,12,0,15,3
1713309616259,ANAR 153,A00,487222,Braswell; Geoffrey E.,55,0,60,5
1713309617284,ANBI 134,A00,487223,Staff,13,0,20,7
1713309618311,ANBI 143GS,A00,487224,Noel; Geoffroy Pierre Jean,20,0,24,4
1713309619335,ANBI 144GS,A00,519548,Noel; Geoffroy Pierre Jean,20,0,24,4
1713309620361,ANSC 101,A00,487225,Staff,19,0,20,1
1713309621384,ANSC 125,A00,487227,Brenner; Suzanne A,39,0,40,1
1713309623450,ANSC 146,A00,487229,Staff,36,0,40,4
1713309624483,ANSC 148,A00,487230,Olivas Hernandez; Olga Lid,39,0,40,1
1713309625515,ANSC 150,A00,504165,Sloane; Julia Kathryn,19,0,20,1
1713309626542,ANSC 180,A00,487232,Staff,13,0,15,2
1713309627566,ANSC 188,A00,627155,Staff,40,0,40,0
1713309628594,ANTH 5,A00,519529,Semendeferi; Ekaterini,15,0,15,0
1713309629623,ANTH 10,A00,487219,Staff,58,0,60,2
1713309630663,ANTH 23,A01,487221,Staff,17,0,20,3
1713309631690,ANTH 102,A00,487233,Wilder; Linnea Lorene,53,0,60,7
1713309632717,ANTH 103,A00,487234,Varma; Saiba,57,0,60,3
1713309633742,ANTH 105,A00,487235,Stewart; Alexander B,57,0,60,3
1713309634772,BENG 100,A01,516685,Taylor Amos; Alyssa C,28,0,30,2
1713309635797,BIBC 102,A01,491316,Flagg; Matthew Paul,51,0,88,37
1713309635797,BIBC 102,A02,491366,Flagg; Matthew Paul,84,0,88,4
1713309636828,BIBC 103,A01,491486,Boumechache; Miyyada,16,0,24,8
1713309636828,BIBC 103,A02,491487,Boumechache; Miyyada,24,0,24,0
1713309637853,BICD 100,A01,516882,Staff,75,0,75,0
1713309637853,BICD 100,A02,516890,Staff,70,0,75,5
1713309638877,BICD 102GS,A00,491488,Lo; Stanley M.,27,0,28,1
1713309639901,BIEB 136GS,A00,516940,Holway; David A. & Shurin; Jonathan,19,0,24,5
1713309640929,BIEB 137GS,A01,517034,Holway; David A. & Shurin; Jonathan,19,0,24,5
1713309641958,BIEB 138GS,A01,491492,Pirino; Giorgia,22,0,28,6
1713309642986,BILD 1,A01,491296,Staff,62,0,63,1
1713309642986,BILD 1,A02,491297,Staff,63,0,63,0
1713309644016,BILD 4,A01,517099,Gonzalez Gamboa; Ivonne,22,0,24,2
1713309644016,BILD 4,A02,517100,Gonzalez Gamboa; Ivonne,24,0,24,0
1713309645044,BILD 60GS,A00,491309,Lo; Stanley M.,27,0,28,1
1713309646070,BIMM 100,A01,517136,Staff,91,0,100,9
1713309647099,BIMM 110,A01,517182,Staff,74,0,100,26
1713309648130,BIMM 120,A01,517228,Pickett; Brooke Elizabeth,40,0,63,23
1713309648130,BIMM 120,A02,517240,Pickett; Brooke Elizabeth,48,0,63,15
1713309649160,BIMM 132GS,A01,491498,Pirino; Giorgia,22,0,28,6
1713309650191,BIMM 143,A01,491589,Bozinovic; Goran,20,0,40,20
1713309651216,BIPN 100,A01,491594,Armour; Jon Christopher,92,0,100,8
1713309652242,BIPN 140,A01,491602,Marino; Marc J,31,0,50,19
1713309654294,CAT 125,A00,515973,Staff,20,0,20,0
1713309655317,CAT 125GS,A00,515974,Rahimi; Babak,19,0,20,1
1713309656343,CAT 125R,A00,515980,Staff,15,0,20,5
1713309656343,CAT 125R,B00,515981,Tosun; Adriana,19,0,20,1
1713309656343,CAT 125R,C00,515987,Hyland; Tina Mae,3,0,20,17
1713309656343,CAT 125R,D00,515988,Bronstein; Phoebe Malan,18,0,20,2
1713309657367,CENG 15,A01,488699,Drews; Aaron,25,0,25,0
1713309658394,CENG 100,A00,505196,Opatkiewicz; Justin Paul,25,0,25,0
1713309659423,CGS 2A,A01,489598,Staff,33,0,35,2
1713309660452,CGS 112,A00,489599,Staff,15,0,15,0
1713309661476,CGS 119,A00,489603,Staff,10,0,10,0
1713309662501,CGS 120,A00,489604,Staff,14,0,15,1
1713309663525,CGS 150,A00,489607,Staff,15,0,15,0
1713309664551,CHEM 6A,A01,488715,Staff,98,0,100,2
1713309665585,CHEM 6B,A01,488719,Piercy; Marc Anthony,100,0,100,0
1713309666616,CHEM 6C,A01,488723,Albizati; Kim F.,94,0,100,6
1713309667642,CHEM 7L,A01,488728,Schurmeier; Kimberly,18,0,24,6
1713309667642,CHEM 7L,A02,488730,Schurmeier; Kimberly,23,0,24,1
1713309667642,CHEM 7L,A03,488734,Schurmeier; Kimberly,24,0,24,0
1713309667642,CHEM 7L,A04,488763,Schurmeier; Kimberly,23,0,24,1
1713309667642,CHEM 7L,B01,488798,Schurmeier; Kimberly,18,0,24,6
1713309667642,CHEM 7L,B02,488801,Schurmeier; Kimberly,23,0,24,1
1713309667642,CHEM 7L,B03,488808,Schurmeier; Kimberly,24,0,24,0
1713309667642,CHEM 7L,B04,488811,Schurmeier; Kimberly,24,0,24,0
1713309668667,CHEM 11,A01,488897,Stallings; Dontarie M,98,0,100,2
1713309669696,CHEM 40A,A01,488913,Albizati; Kim F.,91,0,100,9
1713309670721,CHEM 40B,A01,488920,Weizman; Haim,48,0,50,2
1713309670721,CHEM 40B,A02,488938,Weizman; Haim,46,0,50,4
1713309671750,CHEM 41A,A01,489029,Klosterman; Jeremy K,58,0,60,2
1713309672776,CHEM 41C,A01,500436,Tor; Yitzhak,55,0,60,5
1713309673801,CHEM 43A,A01,500426,Weizman; Haim,6,0,24,18
1713309673801,CHEM 43A,A02,500430,Weizman; Haim,13,0,24,11
1713309673801,CHEM 43A,B01,514041,Klosterman; Jeremy K,16,0,24,8
1713309673801,CHEM 43A,B02,514047,Klosterman; Jeremy K,23,0,24,1
1713309674831,CHEM 108,A01,489140,Jennings; Patricia A.,13,0,24,11
1713309674831,CHEM 108,A02,489142,Jennings; Patricia A.,15,0,24,9
1713309675860,CHEM 114A,A01,489147,Stallings; Dontarie M,81,0,100,19
1713309676891,CHIN 169A,A00,489171,Wang; Xiao,19,0,20,1
1713309678943,COGS 3,A01,518827,Boyle; Mary E. T.,30,0,40,10
1713309679967,COGS 11,A01,489175,Staff,28,0,30,2
1713309680992,COGS 14A,A01,518829,Staff,53,0,60,7
1713309682019,COGS 14B,A01,489177,Hoffman; Drew Ellen,69,0,75,6
1713309683056,COGS 100,A01,489181,Allen; Michael Gordon,66,0,75,9
1713309684084,COGS 101A,A01,489183,Staff,51,0,60,9
1713309685113,COGS 101B,A01,489185,Allen; Michael Gordon,13,0,30,17
1713309686138,COGS 101C,A01,526786,Staff,25,0,30,5
1713309688191,COGS 107A,A01,489189,Boyle; Mary E. T.,23,0,35,12
1713309689219,COGS 107B,A01,627144,Mooshagian; Eric Frederick,60,0,60,0
1713309690249,COGS 118A,A01,489191,Staff,0,28,40,40
1713309692313,COGS 171GS,A01,489194,Pineda; Jaime A,22,0,28,6
1713309693342,COGS 172,A01,489196,Staff,6,0,30,24
1713309694373,COGS 174GS,A01,489264,Pineda; Jaime A,22,0,28,6
1713309695402,COGS 180,A01,627150,Staff,29,0,30,1
1713309696426,COGS 186,A01,489274,Staff,4,0,30,26
1713309697451,COMM 10,A01,489276,Staff,23,0,25,2
1713309697451,COMM 10,A02,489303,Staff,23,0,25,2
1713309698478,COMM 100A,A01,489312,Staff,18,0,25,7
1713309698478,COMM 100A,A02,489313,Staff,24,0,25,1
1713309699503,COMM 106T,A00,512540,Staff,34,0,35,1
1713309700532,COMM 107,A00,489347,Staff,31,0,35,4
1713309701559,COMM 109P,A00,489358,Staff,31,0,35,4
1713309702639,COMM 132,A00,489361,McKenna; Denise,29,0,30,1
1713309703668,COMM 146,A00,489362,Halm; Gavin Patrick,27,0,30,3
1713309704694,COMM 190,A00,489363,Abuelhiga; Soraya Jill,20,0,23,3
1713309705725,CSE 8A,A50,489366,Staff,23,0,25,2
1713309705725,CSE 8A,A51,489367,Staff,24,0,25,1
1713309706752,CSE 11,A01,489398,Cao; Yingjun,83,0,100,17
1713309707778,CSE 12,A01,489487,Staff,43,0,50,7
1713309708806,CSE 20,A01,489497,Staff,49,0,50,1
1713309709835,CSE 21,A01,489517,Braun; Oliver,44,0,50,6
1713309710861,CSE 101,A01,489524,Braun; Oliver,0,13,50,50
1713309711887,CSE 105,A01,512594,Jones; Miles E,81,0,100,19
1713309711887,CSE 105,B01,512598,Jones; Miles E,67,0,100,33
1713309712912,CSE 140,A01,489538,Staff,44,0,50,6
1713309713940,CSE 141,A01,489550,Eldon; John,76,0,100,24
1713309714969,CSE 141L,A01,489571,Eldon; John,75,0,100,25
1713309715993,CSE 151A,A01,489583,Solares; Edwin A,151,0,200,49
1713309717018,CSE 175,A01,510886,Kumar; Rakesh,30,0,30,0
1713309718046,CSE 190,A00,516828,Dubnov; Shlomo,41,0,49,8
1713309719072,DOC 100D,A00,489667,Pass; Natalye Joann,23,0,25,2
1713309720111,DSC 10,A01,624268,Staff,72,0,75,3
1713309721136,DSC 20,A01,624476,Staff,50,0,50,0
1713309722161,DSC 40A,A01,624608,Staff,40,0,40,0
1713309723188,DSGN 1,A01,489179,Rill; Bryan,37,0,50,13
1713309724214,ECE 17,A01,490489,Sahay; Rajeev,18,0,30,12
1713309725239,ECE 65,A50,490492,Staff,17,0,20,3
1713309725239,ECE 65,A51,490493,Staff,20,0,20,0
1713309726266,ECON 1,A01,489715,Famulari; Melissa,69,0,70,1
1713309727292,ECON 2,A01,489717,Levkoff; Steven B.,68,0,70,2
1713309728318,ECON 3,A01,489948,Staff,70,0,70,0
1713309730369,ECON 5,A01,490103,Staff,28,0,30,2
1713309730369,ECON 5,B01,626281,Dai; Yinlin,45,0,45,0
1713309731394,ECON 100A,A01,490127,Famulari; Melissa,68,0,70,2
1713309732423,ECON 100B,A01,490129,Staff,64,0,70,6
1713309733453,ECON 109,A01,490187,Shishkin; Denis,27,0,35,8
1713309734481,ECON 110A,A01,490190,Levkoff; Steven B.,63,0,70,7
1713309735506,ECON 120A,A01,490245,Dai; Yinlin,65,0,70,5
1713309736533,ECON 120B,A01,490247,Nieto-Barthaburu; Augusto,60,0,70,10
1713309737563,ECON 120C,A01,490253,Sun; Yixiao,32,0,35,3
1713309737563,ECON 120C,B01,490255,Sun; Yixiao,34,0,35,1
1713309738592,ECON 129,A00,490256,Eckert; Fabian Paul,26,0,35,9
1713309739625,ECON 131,A00,490257,Nieto-Barthaburu; Augusto,4,0,35,31
1713309740651,ECON 138,A00,490258,Bharadwaj; Prashant,23,0,35,12
1713309740651,ECON 138,B00,490259,Bharadwaj; Prashant,19,0,35,16
1713309741680,ECON 159,A00,490260,Hendrickson; Gerald M.,0,6,0,0
1713309742712,ECON 178,A01,553995,Zhu; Ying,27,0,35,8
1713309743738,EDS 40,A01,512576,Black; Alison Michelle,20,0,20,0
1713309744764,EDS 107,A01,515848,Staff,30,0,30,0
1713309745793,EDS 110R,A01,490262,Staff,26,0,30,4
1713309746818,EDS 112,A01,490264,Chapman; Thandeka K,44,0,50,6
1713309747844,EDS 113,A00,490266,Staff,27,0,30,3
1713309748871,EDS 118,A00,490267,Warstadt; Melissa Fawn,26,0,30,4
1713309749895,EDS 124BR,A00,490268,Eguchi; Emi,9,0,25,16
1713309749895,EDS 124BR,B00,490269,Eguchi; Emi,25,0,25,0
1713309750919,EDS 126,A01,490271,Jones; Makeba,45,0,50,5
1713309751948,EDS 135,A01,490316,Staff,19,0,20,1
1713309752977,ENVR 142GS,A00,519514,Chang; Edmond Yi-Teh,28,0,28,0
1713309754006,ETHN 103,A00,490504,Staff,32,0,36,4
1713309755034,ETHN 103A,A00,490505,Man; Simeon S,7,0,9,2
1713309756062,ETHN 109,A00,490506,Staff,30,0,30,0
1713309757086,ETHN 118,A00,490507,Staff,35,0,36,1
1713309758113,ETHN 119,A00,490508,Staff,36,0,36,0
1713309759144,ETHN 121R,A00,490518,Choi; Esther Min,30,0,36,6
1713309760168,ETHN 127,A00,490528,Staff,15,0,15,0
1713309761193,ETHN 139,A00,490573,Staff,10,0,10,0
1713309762218,ETHN 150,A00,490575,Staff,15,0,15,0
1713309763247,GLBH 20,A00,491705,Elwardani; Nile Regina,38,0,40,2
1713309764273,GLBH 101,A00,491706,Staff,20,0,20,0
1713309765297,GLBH 111,A01,491708,Burgos; Jose L.,15,0,15,0
1713309766322,GLBH 146,A00,491709,Staff,11,0,20,9
1713309767348,GLBH 148,A00,491710,Olivas Hernandez; Olga Lid,15,0,20,5
1713309768373,GLBH 150,A00,491711,Sloane; Julia Kathryn,20,0,20,0
1713309769401,HIEA 131,A00,491760,Staff,30,0,32,2
1713309770427,HIEA 153,A00,491762,Staff,29,0,30,1
1713309771454,HIEU 124,A00,491811,Staff,26,0,32,6
1713309772482,HIEU 124GS,A00,491812,Markman; Kristina,28,0,28,0
1713309773508,HIEU 147,A00,491813,Staff,30,0,32,2
1713309774534,HIEU 149GS,A00,491816,Caldwell; Michael Alan,28,0,28,0
1713309775560,HILD 2C,A01,491713,Hendrickson; Gerald M.,28,0,30,2
1713309776587,HILD 7B,A01,491715,Kwak; Nancy,15,0,30,15
1713309777614,HILD 10,A01,491717,Staff,14,0,20,6
1713309778642,HILD 30GS,A00,491719,Edington; Claire Ellen,24,0,28,4
1713309779670,HINE 109,A00,491818,Shafir; Nir,28,0,32,4
1713309780693,HINE 128,A00,491821,Shafir; Nir,31,0,32,1
1713309781723,HISC 117,A00,491830,Staff,29,0,32,3
1713309782751,HIUS 103,A00,491834,Man; Simeon S,16,0,23,7
1713309783778,HIUS 108B,A00,491835,Staff,29,0,30,1
1713309784806,HIUS 141,A00,491836,Hendrickson; Gerald M.,29,0,32,3
1713309785831,HIUS 149,A00,491839,Staff,27,0,32,5
1713309786860,HUM 3,A01,512617,Crum; Matthew Stephen,45,0,50,5
1713309786860,HUM 3,A02,512618,Crum; Matthew Stephen,48,0,50,2
1713309787887,HUM 3GS,A00,512663,Markman; Kristina,0,0,0,0
1713309787887,HUM 3GS,B00,512664,Staff,0,0,0,0
1713309788913,HUM 4,A01,512620,West; Geoffrey Scott,35,0,50,15
1713309789940,HUM 4GS,A00,512666,Lyon; Antony J.,0,0,0,3
1713309790968,HUM 4R,A01,512625,Watkins; Eric,49,0,50,1
1713309791997,HUM 5,A01,512649,Zavodny; Tatiana Sophia,33,0,50,17
1713309791997,HUM 5,B01,512661,Zroka; Ryan Edward,49,0,50,1
1713309793021,INTL 190,A00,490577,Segui; Alan S,0,0,0,5
1713309794046,JAPN 20AR,A01,491267,Ross; Kayoko F,12,0,20,8
1713309795074,JAPN 180,A00,491285,Berman; Michael David,34,0,40,6
1713309796099,LATI 50,A01,502536,Kokinis; Troy Andreas,19,0,22,3
1713309796099,LATI 50,A02,502551,Kokinis; Troy Andreas,22,0,22,0
1713309796099,LATI 50,A03,502650,Kokinis; Troy Andreas,22,0,22,0
1713309796099,LATI 50,A04,502909,Kokinis; Troy Andreas,22,0,22,0
1713309797125,LATI 160,A01,502920,Kokinis; Troy Andreas,30,0,30,0
1713309798149,LIFR 1A,A00,490494,Van Moer; Vinciane G,17,0,20,3
1713309799177,LIFR 1AX,A00,490495,Van Moer; Vinciane G,17,0,20,3
1713309800206,LIFR 1B,A00,490496,Van Moer; Vinciane G,19,0,20,1
1713309801232,LIFR 1BX,A00,490497,Van Moer; Vinciane G,19,0,20,1
1713309802259,LIGN 8,A00,505198,McIntosh; Justin Daniel,138,0,150,12
1713309803289,LIGN 9GS,A00,491239,Lott; Margaret S.,18,0,20,2
1713309804314,LIGN 101,A01,505200,McIntosh; Justin Daniel,26,0,30,4
1713309805343,LIGN 120,A01,491244,Staff,24,0,30,6
1713309806426,LIGN 149GS,A00,491245,Lott; Margaret S.,18,0,20,2
1713309807453,LIGN 170,A00,491247,Staff,24,0,30,6
1713309808478,LISP 1D,A00,490498,Munoz Sanchez; Alicia,11,0,14,3
1713309808478,LISP 1D,B00,490499,Munoz Sanchez; Alicia,6,0,14,8
1713309808478,LISP 1D,C00,490500,Munoz Sanchez; Alicia,10,0,14,4
1713309808478,LISP 1D,D00,490501,Munoz Sanchez; Alicia,11,0,14,3
1713309809504,LISP 1DX,A00,490502,Munoz Sanchez; Alicia,18,0,28,10
1713309809504,LISP 1DX,B00,490503,Munoz Sanchez; Alicia,19,0,28,9
1713309811557,LTAM 110,A00,491847,Staff,23,0,25,2
1713309812582,LTCS 119,A00,491848,Staff,12,0,15,3
1713309813611,LTCS 130,A00,491849,Staff,24,0,25,1
1713309815664,LTEA 120C,A00,491852,Staff,35,0,40,5
1713309816692,LTEN 130GS,A00,491853,Lyon; Antony J.,25,0,28,3
1713309817716,LTEN 148,A00,491855,Staff,23,0,25,2
1713309818741,LTEN 159,A00,491856,Staff,21,0,25,4
1713309819770,LTEN 180,A00,491857,Staff,9,0,15,6
1713309821823,LTSP 123GS,A00,505928,Bessett; Ryan Matthew,25,0,28,3
1713309822846,LTSP 174GS,A00,506037,Bessett; Ryan Matthew,25,0,28,3
1713309824901,LTWR 102,A00,491861,Staff,12,0,15,3
1713309825928,LTWR 106,A00,491862,Staff,10,0,15,5
1713309826956,MAE 11,A00,490930,Bahadori; Mohammad Yousef,97,0,100,3
1713309827988,MAE 30A,A00,490931,Qi; Huihui,38,0,40,2
1713309829012,MAE 101A,A00,491036,Sadeghizadeh; Zahra,98,0,100,2
1713309830042,MAE 101C,A00,491037,Seshadri; Kalyanasundaram,77,0,100,23
1713309831066,MAE 113,A00,491040,Seshadri; Kalyanasundaram,67,0,80,13
1713309832096,MAE 131A,A00,491041,Ghazinejad; Maziar,39,0,40,1
1713309833122,MAE 142,A00,491053,Staff,39,0,40,1
1713309834147,MAE 143A,A00,491054,Staff,40,0,50,10
1713309835174,MAE 150,A00,491092,Truong; Phuong Thi Ngoc,24,0,35,11
1713309836201,MATH 3C,A01,494031,Pardo Guerra; Sebastian,30,0,30,0
1713309836201,MATH 3C,A02,494032,Pardo Guerra; Sebastian,29,0,30,1
1713309837227,MATH 10A,A01,494034,Staff,27,0,30,3
1713309837227,MATH 10A,A02,494035,Staff,29,0,30,1
1713309837227,MATH 10A,B01,494037,Staff,27,0,30,3
1713309837227,MATH 10A,B02,494038,Staff,29,0,30,1
1713309838256,MATH 10B,A01,494040,Habib; Yousaf,24,0,30,6
1713309838256,MATH 10B,A02,494041,Habib; Yousaf,28,0,30,2
1713309838256,MATH 10B,A03,494042,Habib; Yousaf,30,0,30,0
1713309838256,MATH 10B,A04,494043,Habib; Yousaf,30,0,30,0
1713309838256,MATH 10B,B01,494045,Habib; Yousaf,28,0,30,2
1713309838256,MATH 10B,B02,494046,Habib; Yousaf,30,0,30,0
1713309838256,MATH 10B,B03,494047,Habib; Yousaf,30,0,30,0
1713309838256,MATH 10B,B04,494048,Habib; Yousaf,30,0,30,0
1713309839286,MATH 18,A01,494050,Kemp; Todd Aahron,27,0,30,3
1713309839286,MATH 18,A02,494051,Kemp; Todd Aahron,29,0,30,1
1713309839286,MATH 18,B01,494054,Kemp; Todd Aahron,28,0,30,2
1713309839286,MATH 18,B02,494055,Kemp; Todd Aahron,29,0,30,1
1713309840313,MATH 20A,A01,494059,Suk; Andrew Hoon,30,0,30,0
1713309841340,MATH 20B,A01,494061,Briones; Jor-el Thomas Caparas,34,0,35,1
1713309841340,MATH 20B,B01,494063,Bach; Quang Tran,34,0,35,1
1713309842371,MATH 20C,A01,494065,Staff,28,0,30,2
1713309842371,MATH 20C,A02,494066,Staff,30,0,30,0
1713309842371,MATH 20C,A03,494067,Staff,30,0,30,0
1713309842371,MATH 20C,A04,494068,Staff,30,0,30,0
1713309842371,MATH 20C,B01,494070,Zhang; Ming,26,0,30,4
1713309842371,MATH 20C,B02,494071,Zhang; Ming,29,0,30,1
1713309842371,MATH 20C,B03,494072,Zhang; Ming,29,0,30,1
1713309842371,MATH 20C,B04,494073,Zhang; Ming,29,0,30,1
1713309843396,MATH 20D,A01,494075,Staff,25,0,30,5
1713309843396,MATH 20D,A02,494076,Staff,30,0,30,0
1713309844428,MATH 20E,A01,494079,Staff,25,0,30,5
1713309844428,MATH 20E,A02,494080,Staff,27,0,30,3
1713309844428,MATH 20E,B01,494082,Staff,28,0,30,2
1713309844428,MATH 20E,B02,494083,Staff,25,0,30,5
1713309845457,MATH 103A,A01,494085,Aliabadi Sr.; Mohsen,17,0,30,13
1713309845457,MATH 103A,A02,494086,Aliabadi Sr.; Mohsen,28,0,30,2
1713309845457,MATH 103A,B01,494088,Aliabadi Sr.; Mohsen,22,0,30,8
1713309845457,MATH 103A,B02,494089,Aliabadi Sr.; Mohsen,28,0,30,2
1713309846484,MATH 109,A01,494091,Staff,30,0,30,0
1713309846484,MATH 109,A02,494092,Staff,30,0,30,0
1713309846484,MATH 109,B01,494094,Staff,28,0,30,2
1713309846484,MATH 109,B02,494095,Staff,29,0,30,1
1713309847516,MATH 142A,A01,494097,Chow; Bennett,16,0,30,14
1713309847516,MATH 142A,A02,494098,Chow; Bennett,24,0,30,6
1713309847516,MATH 142A,B01,494100,Chow; Bennett,21,0,30,9
1713309847516,MATH 142A,B02,494101,Chow; Bennett,29,0,30,1
1713309849571,MATH 168A,A01,516677,Dumitriu; Ioana,16,0,35,19
1713309850595,MATH 170A,A01,516679,Dumitriu; Ioana,20,0,30,10
1713309850595,MATH 170A,A02,516680,Dumitriu; Ioana,28,0,30,2
1713309851624,MATH 193A,A01,494107,Staff,16,0,30,14
1713309851624,MATH 193A,A02,494108,Staff,23,0,30,7
1713309851624,MATH 193A,A03,494109,Staff,29,0,30,1
1713309851624,MATH 193A,A04,494110,Staff,24,0,30,6
1713309854703,MGT 16,A00,491930,McKay; Michael J,94,0,98,4
1713309855731,MGT 18,A00,491992,McKay; Michael J,97,0,98,1
1713309856759,MGT 71,A00,492003,Staff,78,0,98,20
1713309857782,MGT 103,A00,505209,Eberhard; Craig A,85,0,98,13
1713309858810,MGT 131A,A00,505210,Anderson; John Charles,91,0,98,7
1713309860867,MGT 153,A00,492077,Perols; Johan Lars,44,0,90,46
1713309863957,MGT 164,A00,492222,McKay; Mary A,94,0,98,4
1713309864988,MGT 172,A00,492245,Staff,59,0,60,1
1713309864988,MGT 172,B00,505526,Hedges; Kathleen,77,0,98,21
1713309866015,MGT 181,A00,505669,Dunn; Louis Jean,88,0,98,10
1713309867045,MMW 14,A01,494399,Staff,23,0,28,5
1713309867045,MMW 14,A02,494400,Staff,26,0,28,2
1713309867045,MMW 14,A03,494401,Staff,28,0,28,0
1713309867045,MMW 14,A04,494402,Staff,28,0,28,0
1713309867045,MMW 14,B01,494404,Carreras; Maria Victoria,16,0,28,12
1713309867045,MMW 14,B02,494405,Carreras; Maria Victoria,27,0,28,1
1713309867045,MMW 14,B03,494406,Carreras; Maria Victoria,28,0,28,0
1713309867045,MMW 14,B04,494407,Carreras; Maria Victoria,28,0,28,0
1713309868075,MMW 14GS,A00,506250,Chang; Edmond Yi-Teh,0,0,0,0
1713309869103,MMW 121R,A01,494415,Adamiak; Patrick John,15,0,28,13
1713309869103,MMW 121R,A02,494416,Adamiak; Patrick John,25,0,28,3
1713309870129,MUS 1A,A01,494113,Staff,12,0,25,13
1713309870129,MUS 1A,A02,494114,Staff,25,0,25,0
1713309871155,MUS 4,A01,494116,Staff,24,0,25,1
1713309871155,MUS 4,A02,494117,Staff,22,0,25,3
1713309872184,MUS 5R,A01,494236,Dubnov; Shlomo,12,0,25,13
1713309872184,MUS 5R,A02,494237,Dubnov; Shlomo,25,0,25,0
1713309873207,MUS 6,A01,494122,Staff,16,0,25,9
1713309873207,MUS 6,A02,494123,Staff,24,0,25,1
1713309874232,MUS 7,A01,494125,Staff,17,0,25,8
1713309874232,MUS 7,A02,494126,Staff,24,0,25,1
1713309875259,MUS 11,A01,494128,Staff,23,0,25,2
1713309875259,MUS 11,A02,494129,Staff,25,0,25,0
1713309876282,MUS 13,A01,494131,Staff,25,0,25,0
1713309876282,MUS 13,A02,494132,Staff,25,0,25,0
1713309877309,MUS 15,A01,494134,Staff,20,0,25,5
1713309877309,MUS 15,A02,494135,Staff,25,0,25,0
1713309877309,MUS 15,B01,494137,Staff,24,0,25,1
1713309878333,MUS 80,A00,494232,Staff,25,0,25,0
1713309878333,MUS 80,B00,494233,Staff,25,0,25,0
1713309878333,MUS 80,C00,494234,Staff,23,0,25,2
1713309879356,MUS 95C,A00,494141,Staff,73,0,75,2
1713309880380,MUS 114,A00,494142,Staff,41,0,50,9
1713309881406,NANO 15,A01,490636,Drews; Aaron,7,0,7,0
1713309882429,PHIL 1,A00,490578,Grush; Rick Scott,50,0,50,0
1713309883455,PHIL 10,A01,490580,Grush; Rick Scott,34,0,35,1
1713309883455,PHIL 10,A02,490586,Grush; Rick Scott,33,0,35,2
1713309884506,PHIL 27,A01,490591,Staff,24,0,25,1
1713309884506,PHIL 27,A02,490592,Staff,25,0,25,0
1713309884506,PHIL 27,A03,490593,Staff,25,0,25,0
1713309884506,PHIL 27,A04,490598,Staff,25,0,25,0
1713309885534,PHIL 32,A01,490611,Staff,20,0,20,0
1713309885534,PHIL 32,A02,490618,Staff,20,0,20,0
1713309886564,PHIL 90,A00,490624,Staff,40,0,40,0
1713309887590,PHIL 136,A00,490627,Cohen; Jonathan David,38,0,40,2
1713309888619,PHIL 155,A00,490634,Staff,65,0,70,5
1713309889646,PHYS 1A,A00,491610,Staff,246,0,250,4
1713309890676,PHYS 1AL,001,491616,Tsai; Philbert S,28,0,30,2
1713309890676,PHYS 1AL,002,491618,Tsai; Philbert S,30,0,30,0
1713309891702,PHYS 1B,A00,491623,Staff,244,0,250,6
1713309892731,PHYS 1BL,001,491626,Tsai; Philbert S,26,0,30,4
1713309892731,PHYS 1BL,002,491628,Tsai; Philbert S,28,0,30,2
1713309893754,PHYS 1C,A00,491632,Staff,224,0,245,21
1713309894780,PHYS 1CL,001,491635,Tsai; Philbert S,12,0,30,18
1713309894780,PHYS 1CL,002,491643,Tsai; Philbert S,24,0,30,6
1713309895812,PHYS 2AR,A01,491651,Meyertholen; Andrew D.,45,0,50,5
1713309896836,PHYS 2B,A01,491659,Staff,107,0,115,8
1713309897862,PHYS 2BL,A01,491685,Staff,22,0,24,2
1713309897862,PHYS 2BL,A02,491700,Staff,23,0,24,1
1713309898886,PHYS 2C,A01,505161,Staff,107,0,115,8
1713309899910,PHYS 4A,A01,491704,Grinstein; Benjamin,99,0,100,1
1713309900948,POLI 5D,A01,494144,Staff,3,0,5,2
1713309900948,POLI 5D,B01,626283,Dai; Yinlin,5,0,5,0
1713309901973,POLI 12,A00,494145,Staff,44,0,45,1
1713309902999,POLI 13R,A00,494146,Forman; Fonna,46,0,50,4
1713309904024,POLI 27,A01,494148,Staff,58,0,60,2
1713309905052,POLI 30,A00,494149,Staff,49,0,50,1
1713309906079,POLI 100DA,A00,494150,Staff,23,0,25,2
1713309908131,POLI 100I,A00,494152,Staff,28,0,30,2
1713309909162,POLI 104B,A00,494153,Smith; Glenn Chatmas,54,0,55,1
1713309910241,POLI 104F,A00,494154,Staff,28,0,30,2
1713309911266,POLI 104I,A00,494155,Smith; Glenn Chatmas,30,0,30,0
1713309912297,POLI 110C,A00,494156,Ingham; Sean,23,0,25,2
1713309913326,POLI 117R,A00,494157,Forman; Fonna,13,0,20,7
1713309914354,POLI 118,A00,494158,Ingham; Sean,23,0,25,2
1713309915383,POLI 120H,A00,494159,Fisk; David Lee,41,0,45,4
1713309916412,POLI 131CR,A00,494160,Hoston; Germaine,39,0,45,6
1713309917436,POLI 133J,A00,494161,Staff,33,0,35,2
1713309918461,POLI 135,A00,494162,Fisk; David Lee,33,0,35,2
1713309919489,POLI 140A,A00,494164,Staff,22,0,30,8
1713309920517,POLI 142I,A00,494165,Staff,30,0,30,0
1713309921542,POLI 144D,A00,494166,Staff,23,0,25,2
1713309922570,POLI 151,A00,494167,Staff,30,0,30,0
1713309923595,POLI 153,A00,494168,Staff,33,0,35,2
1713309924626,POLI 160AA,A00,494169,Staff,35,0,40,5
1713309925653,POLI 162,A00,494170,Mignozzetti; Umberto,20,0,25,5
1713309926681,POLI 171,A00,494171,Mignozzetti; Umberto,23,0,25,2
1713309927706,PSYC 1,A00,494172,Staff,97,0,100,3
1713309928730,PSYC 2,A00,494173,Moranton; Nirelia Melbina-,44,0,50,6
1713309929757,PSYC 3,A00,494174,Staff,30,0,30,0
1713309930782,PSYC 6,A00,494175,Staff,17,0,20,3
1713309931806,PSYC 60,A01,494177,Staff,40,0,45,5
1713309932839,PSYC 70,A01,505724,Geller; Emma Harlan,42,0,45,3
1713309933865,PSYC 101,A00,494180,Heyman; Gail D.,87,0,100,13
1713309934894,PSYC 105,A00,494181,Geller; Emma Harlan,64,0,90,26
1713309935920,PSYC 106,A00,494182,Dobkins; Karen R.,33,0,45,12
1713309936950,PSYC 108,A00,494183,Adrian; Julia Anna,94,0,100,6
1713309937975,PSYC 114,A01,494185,Winkielman; Piotr,3,0,30,27
1713309939000,PSYC 122,A00,494186,Moranton; Nirelia Melbina-,38,0,50,12
1713309940025,PSYC 124,A00,494187,Chapman; Eddie Nathaniel,72,0,80,8
1713309941050,PSYC 131,A00,494188,Anagnostaras; Stephan,59,0,80,21
1713309942077,PSYC 144,A00,494189,Staff,18,0,50,32
1713309943104,PSYC 154,A00,494190,Lacefield; Katharine I,134,0,180,46
1713309944130,PSYC 162,A00,494191,Wixted; John T,85,0,100,15
1713309945156,PSYC 172,A00,494192,Gorman; Michael R.,38,0,45,7
1713309946180,PSYC 178,A00,494193,Glaser; Dale,40,0,45,5
1713309947210,PSYC 193,A00,505725,Chapman; Eddie Nathaniel,20,0,20,0
1713309948235,RELI 145GS,A00,519817,Rahimi; Babak,19,0,20,1
1713309949261,SE 101A,A01,490862,Chadha; Mayank,24,0,25,1
1713309950285,SE 101C,A01,490924,Krysl; Petr,18,0,20,2
1713309951309,SE 110A,A01,490928,Staff,19,0,20,1
1713309952334,SE 130A,A00,490929,Morrison; Machel Leigh,64,0,70,6
1713309953363,SIO 1,A01,519325,Staff,39,0,40,1
1713309954389,SIO 30,A01,519327,Staff,39,0,40,1
1713309955415,SIO 40,A00,519328,Staff,40,0,40,0
1713309956441,SIO 46GS,A00,519819,Cook; Geoffrey W,18,0,25,7
1713309957470,SIO 109R,A00,494197,Forman; Fonna,7,0,20,13
1713309958495,SIO 121GS,A00,519827,Cook; Geoffrey W,18,0,25,7
1713309959520,SIO 132,A01,519330,Staff,38,0,40,2
1713309960543,SIO 133,A01,519397,Staff,38,0,40,2
1713309961574,SIO 139,A00,519396,Kacev; David,33,0,40,7
1713309962606,SOCI 1,A01,494199,Thorpe; Charles Robert,23,0,30,7
1713309962606,SOCI 1,A02,494200,Thorpe; Charles Robert,30,0,30,0
1713309962606,SOCI 1,A03,494201,Thorpe; Charles Robert,29,0,30,1
1713309962606,SOCI 1,A04,494202,Thorpe; Charles Robert,29,0,30,1
1713309962606,SOCI 1,A05,494203,Thorpe; Charles Robert,29,0,30,1
1713309962606,SOCI 1,A06,494204,Thorpe; Charles Robert,30,0,30,0
1713309962606,SOCI 1,A07,494205,Thorpe; Charles Robert,29,0,30,1
1713309963632,SOCI 60,A01,494207,Staff,36,0,40,4
1713309963632,SOCI 60,A02,494208,Staff,39,0,40,1
1713309964659,SOCI 100,A01,494210,Payne; Christine Anna,28,0,30,2
1713309964659,SOCI 100,A02,494211,Payne; Christine Anna,27,0,30,3
1713309965686,SOCI 109M,A00,494212,Staff,20,0,20,0
1713309966712,SOCI 110,A00,494213,Staff,35,0,40,5
1713309968770,SOCI 118E,A00,494215,Ng; Kwai,38,0,40,2
1713309969799,SOCI 125,A00,494216,Calderon-Zaks; Michael Aar,42,0,45,3
1713309970825,SOCI 126,A01,494218,Jones; Makeba,4,0,5,1
1713309971850,SOCI 131,A00,494219,Thorpe; Charles Robert,28,0,30,2
1713309973908,SOCI 135,A00,494221,Payne; Christine Anna,37,0,50,13
1713309974933,SOCI 136E,A00,626690,Ruiz; Jonathan Joseph,25,0,25,0
1713309975963,SOCI 138GS,A00,494222,Navon; Daniel,24,0,28,4
1713309978017,SOCI 145,A00,494224,Staff,42,0,45,3
1713309979045,SOCI 153,A00,494225,Staff,28,0,30,2
1713309980071,SOCI 160E,A00,494226,Ng; Kwai,33,0,40,7
1713309981098,SOCI 180,A00,494227,Staff,29,0,30,1
1713309982124,SOCI 189GS,A00,494228,Ribas Norris; Janet Vanesa,11,0,11,0
1713309983150,SOCI 190GS,A00,553232,Ribas Norris; Janet Vanesa,11,0,11,0
1713309984181,SOMI 220,A00,627178,Schneid; Stephen David,30,0,30,0
1713309985213,SYN 2,001,490768,Staff,14,0,15,1
1713309985213,SYN 2,002,490769,Staff,15,0,15,0
1713309985213,SYN 2,004,490775,Staff,0,0,0,0
1713309985213,SYN 2,003,490774,Staff,0,0,0,0
1713309985213,SYN 2,005,490776,Staff,0,0,0,0
1713309986240,SYN 2R,001,490779,Staff,14,0,15,1
1713309986240,SYN 2R,002,514635,Staff,14,0,15,1
1713309987266,SYN 100,A01,490783,Staff,15,0,20,5
1713309987266,SYN 100,B01,490787,Staff,11,0,20,9
1713309987266,SYN 100,C01,490789,Staff,13,0,20,7
1713309988290,SYN 150,A00,490817,Staff,14,0,15,1
1713309988290,SYN 150,B00,514610,Staff,15,0,15,0
1713309989322,TDAC 1,A00,492753,Walsh; Kim C.,19,0,20,1
1713309989322,TDAC 1,B00,492754,Harting; Carla Kelso,19,0,20,1
1713309989322,TDAC 1,C00,513995,Salovey; Todd,17,0,20,3
1713309990352,TDAC 101,A00,492766,Harting; Carla Kelso,18,0,20,2
1713309991379,TDAC 102,A00,492768,Basso; Beatrice,19,0,20,1
1713309992406,TDDE 111,A00,492769,Staff,25,0,25,0
1713309993431,TDDE 131,A00,492770,Staff,15,0,15,0
1713309993431,TDDE 131,B00,492771,Staff,15,0,15,0
1713309994459,TDDE 131GS,A00,523716,Guirguis; Mark C,25,0,28,3
1713309995486,TDGE 1,A01,492756,Salovey; Todd,57,0,60,3
1713309996512,TDGE 5,A01,492758,Staff,24,0,25,1
1713309997540,TDGE 10,A00,492759,Fulton; Julia,212,0,220,8
1713309998569,TDGE 11,A00,492760,Castro; Robert Jess,200,0,200,0
1713309999594,TDGE 50,A00,492761,Blair; Kyle Adam,0,0,0,0
1713310000620,TDGE 124,A00,492772,Fulton; Julia,196,0,220,24
1713310001645,TDGE 125,A00,492773,Meyer; Ursula,40,0,50,10
1713310001645,TDGE 125,B00,492774,Staff,50,0,50,0
1713310001645,TDGE 125,C00,523565,Staff,49,0,50,1
1713310002670,TDGE 125GS,A00,523580,Guirguis; Mark C,25,0,28,3
1713310003696,TDGE 127,A00,492775,Havis; Allan,42,0,50,8
1713310004723,TDHT 101,A00,492776,Staff,35,0,35,0
1713310005753,TDMV 1,A00,492762,Caligagan; Maria T.,30,0,30,0
1713310005753,TDMV 1,B00,492763,Arcidiacono; Kristin,25,0,30,5
1713310006780,TDMV 2,A00,492764,Weinberg; Sadie,29,0,30,1
1713310007807,TDMV 3,A00,492765,Mack; Kara Shanai',39,0,40,1
1713310008832,TDMV 138,A00,492777,Mack; Kara Shanai',36,0,40,4
1713310009861,TDMV 140,A00,492778,Lima; Paulo Henrique,40,0,40,0
1713310010891,TDMV 142,A00,492779,Caligagan; Maria T.,36,0,40,4
1713310010891,TDMV 142,B00,492780,Caligagan; Tony,37,0,40,3
1713310011915,TDMV 143,A00,492781,Fyall; Daunte Edward,39,0,40,1
1713310012943,USP 1,A01,492401,Kwak; Nancy,26,0,35,9
1713310014025,USP 2,A01,492453,Hinds; Juli Beth,35,0,35,0
1713310015050,USP 3,A01,492516,Staff,29,0,35,6
1713310016081,USP 4,A00,492522,McTague; Sarah,19,0,25,6
1713310017105,USP 100,A00,492523,Staff,33,0,35,2
1713310018130,USP 101,A00,492524,Staff,13,0,15,2
1713310019155,USP 105,A00,492525,Staff,21,0,25,4
1713310020179,USP 151,A00,492526,Shenkman; Michael Thomas,33,0,35,2
1713310021204,USP 170,A00,492545,Hinds; Juli Beth,33,0,35,2
1713310022231,USP 171GS,A00,492608,Bussell; Mirle Rabinowitz,26,0,28,2
1713310023261,USP 183GS,A00,492613,Peerson; Susan,26,0,28,2
1713310024291,VIS 30,A01,490693,Yoldas; Pinar,21,0,22,1
1713310024291,VIS 30,A02,490694,Yoldas; Pinar,19,0,22,3
1713310025317,VIS 83,A00,490695,Kester; Grant,67,0,75,8
1713310026341,VIS 105D,A00,490696,Staff,22,0,25,3
1713310027365,VIS 124CN,A00,490699,Rose; Jordan M,68,0,75,7
1713310028394,VIS 125GS,A00,511221,Williams; Alena J,21,0,22,1
1713310029422,VIS 128D,A00,490700,Staff,74,0,75,1
1713310030448,VIS 151,A01,490717,Staff,34,0,34,0
1713310030448,VIS 151,A02,490766,Staff,33,0,34,1
1713310031474,VIS 154GS,A00,511972,Williams; Alena J,21,0,22,1
1713310032502,VIS 160A,A00,490767,Stone; Patricia,7,0,10,3
1713310033529,WCWP 10A,A00,490638,Staff,15,0,15,0
1713310033529,WCWP 10A,B00,490640,Staff,15,0,15,0
1713310034588,WCWP 10B,A00,490641,Staff,0,0,0,0
1713310034588,WCWP 10B,B00,490642,Staff,14,0,15,1
1713310034588,WCWP 10B,C00,490644,Staff,13,0,15,2
1713310034588,WCWP 10B,D00,490647,Staff,0,0,0,0
1713310035613,WCWP 100,A00,490655,Staff,0,0,0,0
1713310035613,WCWP 100,B00,490687,Staff,12,0,15,3
1713310037701,ANAR 153,A00,487222,Braswell; Geoffrey E.,55,0,60,5
1713310038730,ANBI 134,A00,487223,Staff,13,0,20,7
1713310039761,ANBI 143GS,A00,487224,Noel; Geoffroy Pierre Jean,20,0,24,4
1713310040788,ANBI 144GS,A00,519548,Noel; Geoffroy Pierre Jean,20,0,24,4
1713310041816,ANSC 101,A00,487225,Staff,19,0,20,1
1713310042850,ANSC 125,A00,487227,Brenner; Suzanne A,39,0,40,1
1713310044900,ANSC 146,A00,487229,Staff,36,0,40,4
1713310045928,ANSC 148,A00,487230,Olivas Hernandez; Olga Lid,39,0,40,1
1713310046954,ANSC 150,A00,504165,Sloane; Julia Kathryn,19,0,20,1
1713310047978,ANSC 180,A00,487232,Staff,13,0,15,2
1713310049005,ANSC 188,A00,627155,Staff,40,0,40,0
1713310050034,ANTH 5,A00,519529,Semendeferi; Ekaterini,15,0,15,0
1713310051063,ANTH 10,A00,487219,Staff,58,0,60,2
1713310052091,ANTH 23,A01,487221,Staff,17,0,20,3
1713310053117,ANTH 102,A00,487233,Wilder; Linnea Lorene,53,0,60,7
1713310054142,ANTH 103,A00,487234,Varma; Saiba,57,0,60,3
1713310055169,ANTH 105,A00,487235,Stewart; Alexander B,57,0,60,3
1713310056198,BENG 100,A01,516685,Taylor Amos; Alyssa C,28,0,30,2
1713310057227,BIBC 102,A01,491316,Flagg; Matthew Paul,48,0,88,40
1713310057227,BIBC 102,A02,491366,Flagg; Matthew Paul,84,0,88,4
1713310058257,BIBC 103,A01,491486,Boumechache; Miyyada,16,0,24,8
1713310058257,BIBC 103,A02,491487,Boumechache; Miyyada,24,0,24,0
1713310059287,BICD 100,A01,516882,Staff,75,0,75,0
1713310059287,BICD 100,A02,516890,Staff,70,0,75,5
1713310060312,BICD 102GS,A00,491488,Lo; Stanley M.,27,0,28,1
1713310061337,BIEB 136GS,A00,516940,Holway; David A. & Shurin; Jonathan,19,0,24,5
1713310062360,BIEB 137GS,A01,517034,Holway; David A. & Shurin; Jonathan,19,0,24,5
1713310063385,BIEB 138GS,A01,491492,Pirino; Giorgia,22,0,28,6
1713310064410,BILD 1,A01,491296,Staff,62,0,63,1
1713310064410,BILD 1,A02,491297,Staff,63,0,63,0
1713310065436,BILD 4,A01,517099,Gonzalez Gamboa; Ivonne,22,0,24,2
1713310065436,BILD 4,A02,517100,Gonzalez Gamboa; Ivonne,24,0,24,0
1713310066462,BILD 60GS,A00,491309,Lo; Stanley M.,27,0,28,1
1713310067488,BIMM 100,A01,517136,Staff,91,0,100,9
1713310068518,BIMM 110,A01,517182,Staff,72,0,100,28
1713310069550,BIMM 120,A01,517228,Pickett; Brooke Elizabeth,40,0,63,23
1713310069550,BIMM 120,A02,517240,Pickett; Brooke Elizabeth,48,0,63,15
1713310070575,BIMM 132GS,A01,491498,Pirino; Giorgia,22,0,28,6
1713310071605,BIMM 143,A01,491589,Bozinovic; Goran,19,0,40,21
1713310072632,BIPN 100,A01,491594,Armour; Jon Christopher,92,0,100,8
1713310073655,BIPN 140,A01,491602,Marino; Marc J,31,0,50,19
1713310075709,CAT 125,A00,515973,Staff,20,0,20,0
1713310076735,CAT 125GS,A00,515974,Rahimi; Babak,19,0,20,1
1713310077761,CAT 125R,A00,515980,Staff,15,0,20,5
1713310077761,CAT 125R,B00,515981,Tosun; Adriana,19,0,20,1
1713310077761,CAT 125R,C00,515987,Hyland; Tina Mae,3,0,20,17
1713310077761,CAT 125R,D00,515988,Bronstein; Phoebe Malan,18,0,20,2
1713310078786,CENG 15,A01,488699,Drews; Aaron,25,0,25,0
1713310079812,CENG 100,A00,505196,Opatkiewicz; Justin Paul,25,0,25,0
1713310080838,CGS 2A,A01,489598,Staff,33,0,35,2
1713310081862,CGS 112,A00,489599,Staff,15,0,15,0
1713310082889,CGS 119,A00,489603,Staff,10,0,10,0
1713310083917,CGS 120,A00,489604,Staff,14,0,15,1
1713310084943,CGS 150,A00,489607,Staff,15,0,15,0
1713310085972,CHEM 6A,A01,488715,Staff,98,0,100,2
1713310086997,CHEM 6B,A01,488719,Piercy; Marc Anthony,100,0,100,0
1713310088028,CHEM 6C,A01,488723,Albizati; Kim F.,94,0,100,6
1713310089064,CHEM 7L,A01,488728,Schurmeier; Kimberly,18,0,24,6
1713310089064,CHEM 7L,A02,488730,Schurmeier; Kimberly,23,0,24,1
1713310089064,CHEM 7L,A03,488734,Schurmeier; Kimberly,24,0,24,0
1713310089064,CHEM 7L,A04,488763,Schurmeier; Kimberly,23,0,24,1
1713310089064,CHEM 7L,B01,488798,Schurmeier; Kimberly,18,0,24,6
1713310089064,CHEM 7L,B02,488801,Schurmeier; Kimberly,23,0,24,1
1713310089064,CHEM 7L,B03,488808,Schurmeier; Kimberly,24,0,24,0
1713310089064,CHEM 7L,B04,488811,Schurmeier; Kimberly,24,0,24,0
1713310090090,CHEM 11,A01,488897,Stallings; Dontarie M,98,0,100,2
1713310091116,CHEM 40A,A01,488913,Albizati; Kim F.,91,0,100,9
1713310092142,CHEM 40B,A01,488920,Weizman; Haim,48,0,50,2
1713310092142,CHEM 40B,A02,488938,Weizman; Haim,46,0,50,4
1713310093172,CHEM 41A,A01,489029,Klosterman; Jeremy K,58,0,60,2
1713310094197,CHEM 41C,A01,500436,Tor; Yitzhak,55,0,60,5
1713310095224,CHEM 43A,A01,500426,Weizman; Haim,4,0,24,20
1713310095224,CHEM 43A,A02,500430,Weizman; Haim,13,0,24,11
1713310095224,CHEM 43A,B01,514041,Klosterman; Jeremy K,16,0,24,8
1713310095224,CHEM 43A,B02,514047,Klosterman; Jeremy K,23,0,24,1
1713310096251,CHEM 108,A01,489140,Jennings; Patricia A.,13,0,24,11
1713310096251,CHEM 108,A02,489142,Jennings; Patricia A.,15,0,24,9
1713310097275,CHEM 114A,A01,489147,Stallings; Dontarie M,79,0,100,21
1713310098298,CHIN 169A,A00,489171,Wang; Xiao,19,0,20,1
1713310100349,COGS 3,A01,518827,Boyle; Mary E. T.,29,0,40,11
1713310101373,COGS 11,A01,489175,Staff,28,0,30,2
1713310102401,COGS 14A,A01,518829,Staff,53,0,60,7
1713310103425,COGS 14B,A01,489177,Hoffman; Drew Ellen,69,0,75,6
1713310104453,COGS 100,A01,489181,Allen; Michael Gordon,66,0,75,9
1713310105478,COGS 101A,A01,489183,Staff,51,0,60,9
1713310106503,COGS 101B,A01,489185,Allen; Michael Gordon,13,0,30,17
1713310107530,COGS 101C,A01,526786,Staff,25,0,30,5
1713310109590,COGS 107A,A01,489189,Boyle; Mary E. T.,23,0,35,12
1713310110625,COGS 107B,A01,627144,Mooshagian; Eric Frederick,60,0,60,0
1713310111654,COGS 118A,A01,489191,Staff,0,28,40,40
1713310113709,COGS 171GS,A01,489194,Pineda; Jaime A,22,0,28,6
1713310114735,COGS 172,A01,489196,Staff,6,0,30,24
1713310115763,COGS 174GS,A01,489264,Pineda; Jaime A,22,0,28,6
1713310116792,COGS 180,A01,627150,Staff,29,0,30,1
1713310117870,COGS 186,A01,489274,Staff,4,0,30,26
1713310118897,COMM 10,A01,489276,Staff,23,0,25,2
1713310118897,COMM 10,A02,489303,Staff,23,0,25,2
1713310119922,COMM 100A,A01,489312,Staff,18,0,25,7
1713310119922,COMM 100A,A02,489313,Staff,24,0,25,1
1713310120948,COMM 106T,A00,512540,Staff,34,0,35,1
1713310121976,COMM 107,A00,489347,Staff,31,0,35,4
1713310123002,COMM 109P,A00,489358,Staff,31,0,35,4
1713310124027,COMM 132,A00,489361,McKenna; Denise,29,0,30,1
1713310125052,COMM 146,A00,489362,Halm; Gavin Patrick,27,0,30,3
1713310126081,COMM 190,A00,489363,Abuelhiga; Soraya Jill,20,0,23,3
1713310127114,CSE 8A,A50,489366,Staff,23,0,25,2
1713310127114,CSE 8A,A51,489367,Staff,24,0,25,1
1713310128142,CSE 11,A01,489398,Cao; Yingjun,82,0,100,18
1713310129168,CSE 12,A01,489487,Staff,43,0,50,7
1713310130196,CSE 20,A01,489497,Staff,49,0,50,1
1713310131223,CSE 21,A01,489517,Braun; Oliver,44,0,50,6
1713310132252,CSE 101,A01,489524,Braun; Oliver,0,13,50,50
1713310133283,CSE 105,A01,512594,Jones; Miles E,81,0,100,19
1713310133283,CSE 105,B01,512598,Jones; Miles E,67,0,100,33
1713310134309,CSE 140,A01,489538,Staff,44,0,50,6
1713310135334,CSE 141,A01,489550,Eldon; John,76,0,100,24
1713310136360,CSE 141L,A01,489571,Eldon; John,75,0,100,25
1713310137385,CSE 151A,A01,489583,Solares; Edwin A,151,0,200,49
1713310138413,CSE 175,A01,510886,Kumar; Rakesh,30,0,30,0
1713310139447,CSE 190,A00,516828,Dubnov; Shlomo,41,0,49,8
1713310140473,DOC 100D,A00,489667,Pass; Natalye Joann,23,0,25,2
1713310141499,DSC 10,A01,624268,Staff,72,0,75,3
1713310142525,DSC 20,A01,624476,Staff,50,0,50,0
1713310143550,DSC 40A,A01,624608,Staff,40,0,40,0
1713310144581,DSGN 1,A01,489179,Rill; Bryan,36,0,50,14
1713310145606,ECE 17,A01,490489,Sahay; Rajeev,18,0,30,12
1713310146634,ECE 65,A50,490492,Staff,17,0,20,3
1713310146634,ECE 65,A51,490493,Staff,20,0,20,0
1713310147664,ECON 1,A01,489715,Famulari; Melissa,69,0,70,1
1713310148696,ECON 2,A01,489717,Levkoff; Steven B.,68,0,70,2
1713310149723,ECON 3,A01,489948,Staff,70,0,70,0
1713310151782,ECON 5,A01,490103,Staff,28,0,30,2
1713310151782,ECON 5,B01,626281,Dai; Yinlin,45,0,45,0
1713310152806,ECON 100A,A01,490127,Famulari; Melissa,68,0,70,2
1713310153835,ECON 100B,A01,490129,Staff,64,0,70,6
1713310154868,ECON 109,A01,490187,Shishkin; Denis,27,0,35,8
1713310155893,ECON 110A,A01,490190,Levkoff; Steven B.,63,0,70,7
1713310156918,ECON 120A,A01,490245,Dai; Yinlin,65,0,70,5
1713310157947,ECON 120B,A01,490247,Nieto-Barthaburu; Augusto,60,0,70,10
1713310158977,ECON 120C,A01,490253,Sun; Yixiao,32,0,35,3
1713310158977,ECON 120C,B01,490255,Sun; Yixiao,34,0,35,1
1713310160003,ECON 129,A00,490256,Eckert; Fabian Paul,26,0,35,9
1713310161029,ECON 131,A00,490257,Nieto-Barthaburu; Augusto,4,0,35,31
1713310162057,ECON 138,A00,490258,Bharadwaj; Prashant,22,0,35,13
1713310162057,ECON 138,B00,490259,Bharadwaj; Prashant,19,0,35,16
1713310163087,ECON 159,A00,490260,Hendrickson; Gerald M.,0,7,0,0
1713310164112,ECON 178,A01,553995,Zhu; Ying,27,0,35,8
1713310165138,EDS 40,A01,512576,Black; Alison Michelle,20,0,20,0
1713310166165,EDS 107,A01,515848,Staff,30,0,30,0
1713310167189,EDS 110R,A01,490262,Staff,26,0,30,4
1713310168219,EDS 112,A01,490264,Chapman; Thandeka K,44,0,50,6
1713310169247,EDS 113,A00,490266,Staff,27,0,30,3
1713310170274,EDS 118,A00,490267,Warstadt; Melissa Fawn,26,0,30,4
1713310171298,EDS 124BR,A00,490268,Eguchi; Emi,9,0,25,16
1713310171298,EDS 124BR,B00,490269,Eguchi; Emi,25,0,25,0
1713310172323,EDS 126,A01,490271,Jones; Makeba,45,0,50,5
1713310173349,EDS 135,A01,490316,Staff,19,0,20,1
1713310174376,ENVR 142GS,A00,519514,Chang; Edmond Yi-Teh,28,0,28,0
1713310175406,ETHN 103,A00,490504,Staff,32,0,36,4
1713310176431,ETHN 103A,A00,490505,Man; Simeon S,6,0,9,3
1713310177459,ETHN 109,A00,490506,Staff,30,0,30,0
1713310178485,ETHN 118,A00,490507,Staff,35,0,36,1
1713310179508,ETHN 119,A00,490508,Staff,36,0,36,0
1713310180535,ETHN 121R,A00,490518,Choi; Esther Min,30,0,36,6
1713310181563,ETHN 127,A00,490528,Staff,15,0,15,0
1713310182591,ETHN 139,A00,490573,Staff,10,0,10,0
1713310183615,ETHN 150,A00,490575,Staff,15,0,15,0
1713310184677,GLBH 20,A00,491705,Elwardani; Nile Regina,38,0,40,2
1713310185705,GLBH 101,A00,491706,Staff,20,0,20,0
1713310186733,GLBH 111,A01,491708,Burgos; Jose L.,15,0,15,0
1713310187763,GLBH 146,A00,491709,Staff,11,0,20,9
1713310188793,GLBH 148,A00,491710,Olivas Hernandez; Olga Lid,14,0,20,6
1713310189821,GLBH 150,A00,491711,Sloane; Julia Kathryn,20,0,20,0
1713310190849,HIEA 131,A00,491760,Staff,30,0,32,2
1713310191872,HIEA 153,A00,491762,Staff,29,0,30,1
1713310192896,HIEU 124,A00,491811,Staff,26,0,32,6
1713310193925,HIEU 124GS,A00,491812,Markman; Kristina,28,0,28,0
1713310194948,HIEU 147,A00,491813,Staff,30,0,32,2
1713310195977,HIEU 149GS,A00,491816,Caldwell; Michael Alan,28,0,28,0
1713310197002,HILD 2C,A01,491713,Hendrickson; Gerald M.,28,0,30,2
1713310198026,HILD 7B,A01,491715,Kwak; Nancy,15,0,30,15
1713310199053,HILD 10,A01,491717,Staff,14,0,20,6
1713310200096,HILD 30GS,A00,491719,Edington; Claire Ellen,24,0,28,4
1713310201123,HINE 109,A00,491818,Shafir; Nir,28,0,32,4
1713310202148,HINE 128,A00,491821,Shafir; Nir,31,0,32,1
1713310203179,HISC 117,A00,491830,Staff,29,0,32,3
1713310204204,HIUS 103,A00,491834,Man; Simeon S,16,0,23,7
1713310205234,HIUS 108B,A00,491835,Staff,29,0,30,1
1713310206260,HIUS 141,A00,491836,Hendrickson; Gerald M.,29,0,32,3
1713310207285,HIUS 149,A00,491839,Staff,27,0,32,5
1713310208311,HUM 3,A01,512617,Crum; Matthew Stephen,45,0,50,5
1713310208311,HUM 3,A02,512618,Crum; Matthew Stephen,48,0,50,2
1713310209335,HUM 3GS,A00,512663,Markman; Kristina,0,0,0,0
1713310209335,HUM 3GS,B00,512664,Staff,0,0,0,0
1713310210362,HUM 4,A01,512620,West; Geoffrey Scott,35,0,50,15
1713310211388,HUM 4GS,A00,512666,Lyon; Antony J.,0,0,0,3
1713310212418,HUM 4R,A01,512625,Watkins; Eric,49,0,50,1
1713310213446,HUM 5,A01,512649,Zavodny; Tatiana Sophia,33,0,50,17
1713310213446,HUM 5,B01,512661,Zroka; Ryan Edward,49,0,50,1
1713310214475,INTL 190,A00,490577,Segui; Alan S,0,0,0,5
1713310215504,JAPN 20AR,A01,491267,Ross; Kayoko F,12,0,20,8
1713310216530,JAPN 180,A00,491285,Berman; Michael David,34,0,40,6
1713310217557,LATI 50,A01,502536,Kokinis; Troy Andreas,19,0,22,3
1713310217557,LATI 50,A02,502551,Kokinis; Troy Andreas,22,0,22,0
1713310217557,LATI 50,A03,502650,Kokinis; Troy Andreas,22,0,22,0
1713310217557,LATI 50,A04,502909,Kokinis; Troy Andreas,22,0,22,0
1713310218584,LATI 160,A01,502920,Kokinis; Troy Andreas,30,0,30,0
1713310219614,LIFR 1A,A00,490494,Van Moer; Vinciane G,17,0,20,3
1713310220642,LIFR 1AX,A00,490495,Van Moer; Vinciane G,17,0,20,3
1713310221725,LIFR 1B,A00,490496,Van Moer; Vinciane G,19,0,20,1
1713310233347,LIFR 1BX,A00,490497,Van Moer; Vinciane G,19,0,20,1
1713310234376,LIGN 8,A00,505198,McIntosh; Justin Daniel,138,0,150,12
1713310235402,LIGN 9GS,A00,491239,Lott; Margaret S.,18,0,20,2
1713310236430,LIGN 101,A01,505200,McIntosh; Justin Daniel,26,0,30,4
1713310237456,LIGN 120,A01,491244,Staff,24,0,30,6
1713310238482,LIGN 149GS,A00,491245,Lott; Margaret S.,18,0,20,2
1713310239513,LIGN 170,A00,491247,Staff,24,0,30,6
1713310240543,LISP 1D,A00,490498,Munoz Sanchez; Alicia,11,0,14,3
1713310240543,LISP 1D,B00,490499,Munoz Sanchez; Alicia,6,0,14,8
1713310240543,LISP 1D,C00,490500,Munoz Sanchez; Alicia,10,0,14,4
1713310240543,LISP 1D,D00,490501,Munoz Sanchez; Alicia,11,0,14,3
1713310241572,LISP 1DX,A00,490502,Munoz Sanchez; Alicia,18,0,28,10
1713310241572,LISP 1DX,B00,490503,Munoz Sanchez; Alicia,19,0,28,9
1713310243626,LTAM 110,A00,491847,Staff,23,0,25,2
1713310244654,LTCS 119,A00,491848,Staff,12,0,15,3
1713310245679,LTCS 130,A00,491849,Staff,24,0,25,1
1713310247730,LTEA 120C,A00,491852,Staff,34,0,40,6
1713310248756,LTEN 130GS,A00,491853,Lyon; Antony J.,25,0,28,3
1713310249780,LTEN 148,A00,491855,Staff,23,0,25,2
1713310250808,LTEN 159,A00,491856,Staff,21,0,25,4
1713310251835,LTEN 180,A00,491857,Staff,9,0,15,6
1713310253904,LTSP 123GS,A00,505928,Bessett; Ryan Matthew,25,0,28,3
1713310254932,LTSP 174GS,A00,506037,Bessett; Ryan Matthew,25,0,28,3
1713310256983,LTWR 102,A00,491861,Staff,11,0,15,4
1713310258008,LTWR 106,A00,491862,Staff,10,0,15,5
1713310259033,MAE 11,A00,490930,Bahadori; Mohammad Yousef,97,0,100,3
1713310260107,MAE 30A,A00,490931,Qi; Huihui,38,0,40,2
1713310261133,MAE 101A,A00,491036,Sadeghizadeh; Zahra,98,0,100,2
1713310262158,MAE 101C,A00,491037,Seshadri; Kalyanasundaram,77,0,100,23
1713310263189,MAE 113,A00,491040,Seshadri; Kalyanasundaram,67,0,80,13
1713310264217,MAE 131A,A00,491041,Ghazinejad; Maziar,39,0,40,1
1713310265241,MAE 142,A00,491053,Staff,39,0,40,1
1713310266270,MAE 143A,A00,491054,Staff,40,0,50,10
1713310267296,MAE 150,A00,491092,Truong; Phuong Thi Ngoc,24,0,35,11
1713310268322,MATH 3C,A01,494031,Pardo Guerra; Sebastian,30,0,30,0
1713310268322,MATH 3C,A02,494032,Pardo Guerra; Sebastian,29,0,30,1
1713310269350,MATH 10A,A01,494034,Staff,27,0,30,3
1713310269350,MATH 10A,A02,494035,Staff,29,0,30,1
1713310269350,MATH 10A,B01,494037,Staff,27,0,30,3
1713310269350,MATH 10A,B02,494038,Staff,29,0,30,1
1713310270375,MATH 10B,A01,494040,Habib; Yousaf,24,0,30,6
1713310270375,MATH 10B,A02,494041,Habib; Yousaf,28,0,30,2
1713310270375,MATH 10B,A03,494042,Habib; Yousaf,30,0,30,0
1713310270375,MATH 10B,A04,494043,Habib; Yousaf,30,0,30,0
1713310270375,MATH 10B,B01,494045,Habib; Yousaf,28,0,30,2
1713310270375,MATH 10B,B02,494046,Habib; Yousaf,30,0,30,0
1713310270375,MATH 10B,B03,494047,Habib; Yousaf,30,0,30,0
1713310270375,MATH 10B,B04,494048,Habib; Yousaf,30,0,30,0
1713310271408,MATH 18,A01,494050,Kemp; Todd Aahron,27,0,30,3
1713310271408,MATH 18,A02,494051,Kemp; Todd Aahron,29,0,30,1
1713310271408,MATH 18,B01,494054,Kemp; Todd Aahron,28,0,30,2
1713310271408,MATH 18,B02,494055,Kemp; Todd Aahron,29,0,30,1
1713310272436,MATH 20A,A01,494059,Suk; Andrew Hoon,30,0,30,0
1713310273460,MATH 20B,A01,494061,Briones; Jor-el Thomas Caparas,34,0,35,1
1713310273460,MATH 20B,B01,494063,Bach; Quang Tran,34,0,35,1
1713310274487,MATH 20C,A01,494065,Staff,28,0,30,2
1713310274487,MATH 20C,A02,494066,Staff,30,0,30,0
1713310274487,MATH 20C,A03,494067,Staff,30,0,30,0
1713310274487,MATH 20C,A04,494068,Staff,30,0,30,0
1713310274487,MATH 20C,B01,494070,Zhang; Ming,26,0,30,4
1713310274487,MATH 20C,B02,494071,Zhang; Ming,29,0,30,1
1713310274487,MATH 20C,B03,494072,Zhang; Ming,29,0,30,1
1713310274487,MATH 20C,B04,494073,Zhang; Ming,29,0,30,1
1713310275511,MATH 20D,A01,494075,Staff,25,0,30,5
1713310275511,MATH 20D,A02,494076,Staff,30,0,30,0
1713310276541,MATH 20E,A01,494079,Staff,25,0,30,5
1713310276541,MATH 20E,A02,494080,Staff,27,0,30,3
1713310276541,MATH 20E,B01,494082,Staff,28,0,30,2
1713310276541,MATH 20E,B02,494083,Staff,25,0,30,5
1713310277572,MATH 103A,A01,494085,Aliabadi Sr.; Mohsen,17,0,30,13
1713310277572,MATH 103A,A02,494086,Aliabadi Sr.; Mohsen,28,0,30,2
1713310277572,MATH 103A,B01,494088,Aliabadi Sr.; Mohsen,22,0,30,8
1713310277572,MATH 103A,B02,494089,Aliabadi Sr.; Mohsen,28,0,30,2
1713310278597,MATH 109,A01,494091,Staff,30,0,30,0
1713310278597,MATH 109,A02,494092,Staff,30,0,30,0
1713310278597,MATH 109,B01,494094,Staff,28,0,30,2
1713310278597,MATH 109,B02,494095,Staff,29,0,30,1
1713310279630,MATH 142A,A01,494097,Chow; Bennett,16,0,30,14
1713310279630,MATH 142A,A02,494098,Chow; Bennett,24,0,30,6
1713310279630,MATH 142A,B01,494100,Chow; Bennett,20,0,30,10
1713310279630,MATH 142A,B02,494101,Chow; Bennett,29,0,30,1
1713310281687,MATH 168A,A01,516677,Dumitriu; Ioana,16,0,35,19
1713310282716,MATH 170A,A01,516679,Dumitriu; Ioana,20,0,30,10
1713310282716,MATH 170A,A02,516680,Dumitriu; Ioana,28,0,30,2
1713310283740,MATH 193A,A01,494107,Staff,16,0,30,14
1713310283740,MATH 193A,A02,494108,Staff,23,0,30,7
1713310283740,MATH 193A,A03,494109,Staff,29,0,30,1
1713310283740,MATH 193A,A04,494110,Staff,24,0,30,6
1713310286819,MGT 16,A00,491930,McKay; Michael J,94,0,98,4
1713310287846,MGT 18,A00,491992,McKay; Michael J,97,0,98,1
1713310288871,MGT 71,A00,492003,Staff,78,0,98,20
1713310289897,MGT 103,A00,505209,Eberhard; Craig A,85,0,98,13
1713310290925,MGT 131A,A00,505210,Anderson; John Charles,91,0,98,7
1713310292974,MGT 153,A00,492077,Perols; Johan Lars,43,0,90,47
1713310296050,MGT 164,A00,492222,McKay; Mary A,94,0,98,4
1713310297076,MGT 172,A00,492245,Staff,59,0,60,1
1713310297076,MGT 172,B00,505526,Hedges; Kathleen,77,0,98,21
1713310298102,MGT 181,A00,505669,Dunn; Louis Jean,88,0,98,10
1713310299133,MMW 14,A01,494399,Staff,23,0,28,5
1713310299133,MMW 14,A02,494400,Staff,26,0,28,2
1713310299133,MMW 14,A03,494401,Staff,28,0,28,0
1713310299133,MMW 14,A04,494402,Staff,28,0,28,0
1713310299133,MMW 14,B01,494404,Carreras; Maria Victoria,15,0,28,13
1713310299133,MMW 14,B02,494405,Carreras; Maria Victoria,27,0,28,1
1713310299133,MMW 14,B03,494406,Carreras; Maria Victoria,28,0,28,0
1713310299133,MMW 14,B04,494407,Carreras; Maria Victoria,28,0,28,0
1713310300160,MMW 14GS,A00,506250,Chang; Edmond Yi-Teh,0,0,0,0
1713310301188,MMW 121R,A01,494415,Adamiak; Patrick John,15,0,28,13
1713310301188,MMW 121R,A02,494416,Adamiak; Patrick John,25,0,28,3
1713310302212,MUS 1A,A01,494113,Staff,12,0,25,13
1713310302212,MUS 1A,A02,494114,Staff,25,0,25,0
1713310303238,MUS 4,A01,494116,Staff,24,0,25,1
1713310303238,MUS 4,A02,494117,Staff,22,0,25,3
1713310304266,MUS 5R,A01,494236,Dubnov; Shlomo,12,0,25,13
1713310304266,MUS 5R,A02,494237,Dubnov; Shlomo,25,0,25,0
1713310305316,MUS 6,A01,494122,Staff,16,0,25,9
1713310305316,MUS 6,A02,494123,Staff,24,0,25,1
1713310306341,MUS 7,A01,494125,Staff,17,0,25,8
1713310306341,MUS 7,A02,494126,Staff,24,0,25,1
1713310307368,MUS 11,A01,494128,Staff,23,0,25,2
1713310307368,MUS 11,A02,494129,Staff,25,0,25,0
1713310308396,MUS 13,A01,494131,Staff,25,0,25,0
1713310308396,MUS 13,A02,494132,Staff,25,0,25,0
1713310309420,MUS 15,A01,494134,Staff,20,0,25,5
1713310309420,MUS 15,A02,494135,Staff,25,0,25,0
1713310309420,MUS 15,B01,494137,Staff,24,0,25,1
1713310310448,MUS 80,A00,494232,Staff,25,0,25,0
1713310310448,MUS 80,B00,494233,Staff,25,0,25,0
1713310310448,MUS 80,C00,494234,Staff,23,0,25,2
1713310311472,MUS 95C,A00,494141,Staff,73,0,75,2
1713310312494,MUS 114,A00,494142,Staff,41,0,50,9
1713310313520,NANO 15,A01,490636,Drews; Aaron,7,0,7,0
1713310314546,PHIL 1,A00,490578,Grush; Rick Scott,50,0,50,0
1713310315576,PHIL 10,A01,490580,Grush; Rick Scott,34,0,35,1
1713310315576,PHIL 10,A02,490586,Grush; Rick Scott,33,0,35,2
1713310316601,PHIL 27,A01,490591,Staff,24,0,25,1
1713310316601,PHIL 27,A02,490592,Staff,25,0,25,0
1713310316601,PHIL 27,A03,490593,Staff,25,0,25,0
1713310316601,PHIL 27,A04,490598,Staff,25,0,25,0
1713310317627,PHIL 32,A01,490611,Staff,20,0,20,0
1713310317627,PHIL 32,A02,490618,Staff,20,0,20,0
1713310318652,PHIL 90,A00,490624,Staff,40,0,40,0
1713310319684,PHIL 136,A00,490627,Cohen; Jonathan David,38,0,40,2
1713310320713,PHIL 155,A00,490634,Staff,64,0,70,6
1713310321741,PHYS 1A,A00,491610,Staff,246,0,250,4
1713310322766,PHYS 1AL,001,491616,Tsai; Philbert S,28,0,30,2
1713310322766,PHYS 1AL,002,491618,Tsai; Philbert S,30,0,30,0
1713310323791,PHYS 1B,A00,491623,Staff,244,0,250,6
1713310324817,PHYS 1BL,001,491626,Tsai; Philbert S,26,0,30,4
1713310324817,PHYS 1BL,002,491628,Tsai; Philbert S,28,0,30,2
1713310325846,PHYS 1C,A00,491632,Staff,223,0,245,22
1713310326872,PHYS 1CL,001,491635,Tsai; Philbert S,11,0,30,19
1713310326872,PHYS 1CL,002,491643,Tsai; Philbert S,24,0,30,6
1713310327899,PHYS 2AR,A01,491651,Meyertholen; Andrew D.,45,0,50,5
1713310328925,PHYS 2B,A01,491659,Staff,107,0,115,8
1713310329950,PHYS 2BL,A01,491685,Staff,22,0,24,2
1713310329950,PHYS 2BL,A02,491700,Staff,23,0,24,1
1713310330974,PHYS 2C,A01,505161,Staff,107,0,115,8
1713310332000,PHYS 4A,A01,491704,Grinstein; Benjamin,99,0,100,1
1713310333028,POLI 5D,A01,494144,Staff,3,0,5,2
1713310333028,POLI 5D,B01,626283,Dai; Yinlin,5,0,5,0
1713310334056,POLI 12,A00,494145,Staff,44,0,45,1
1713310335082,POLI 13R,A00,494146,Forman; Fonna,46,0,50,4
1713310336160,POLI 27,A01,494148,Staff,58,0,60,2
1713310337189,POLI 30,A00,494149,Staff,49,0,50,1
1713310338212,POLI 100DA,A00,494150,Staff,23,0,25,2
1713310340265,POLI 100I,A00,494152,Staff,28,0,30,2
1713310341295,POLI 104B,A00,494153,Smith; Glenn Chatmas,54,0,55,1
1713310342328,POLI 104F,A00,494154,Staff,28,0,30,2
1713310343356,POLI 104I,A00,494155,Smith; Glenn Chatmas,30,0,30,0
1713310344379,POLI 110C,A00,494156,Ingham; Sean,23,0,25,2
1713310345403,POLI 117R,A00,494157,Forman; Fonna,12,0,20,8
1713310346432,POLI 118,A00,494158,Ingham; Sean,22,0,25,3
1713310347457,POLI 120H,A00,494159,Fisk; David Lee,41,0,45,4
1713310348481,POLI 131CR,A00,494160,Hoston; Germaine,39,0,45,6
1713310349510,POLI 133J,A00,494161,Staff,33,0,35,2
1713310350539,POLI 135,A00,494162,Fisk; David Lee,33,0,35,2
1713310351564,POLI 140A,A00,494164,Staff,22,0,30,8
1713310352588,POLI 142I,A00,494165,Staff,30,0,30,0
1713310353616,POLI 144D,A00,494166,Staff,23,0,25,2
1713310354639,POLI 151,A00,494167,Staff,30,0,30,0
1713310355665,POLI 153,A00,494168,Staff,33,0,35,2
1713310356689,POLI 160AA,A00,494169,Staff,35,0,40,5
1713310357714,POLI 162,A00,494170,Mignozzetti; Umberto,20,0,25,5
1713310358739,POLI 171,A00,494171,Mignozzetti; Umberto,21,0,25,4
1713310359762,PSYC 1,A00,494172,Staff,97,0,100,3
1713310360785,PSYC 2,A00,494173,Moranton; Nirelia Melbina-,44,0,50,6
1713310361810,PSYC 3,A00,494174,Staff,30,0,30,0
1713310362834,PSYC 6,A00,494175,Staff,17,0,20,3
1713310363858,PSYC 60,A01,494177,Staff,40,0,45,5
1713310364884,PSYC 70,A01,505724,Geller; Emma Harlan,42,0,45,3
1713310365913,PSYC 101,A00,494180,Heyman; Gail D.,87,0,100,13
1713310366941,PSYC 105,A00,494181,Geller; Emma Harlan,64,0,90,26
1713310367966,PSYC 106,A00,494182,Dobkins; Karen R.,33,0,45,12
1713310368996,PSYC 108,A00,494183,Adrian; Julia Anna,94,0,100,6
1713310370021,PSYC 114,A01,494185,Winkielman; Piotr,3,0,30,27
1713310371044,PSYC 122,A00,494186,Moranton; Nirelia Melbina-,38,0,50,12
1713310372072,PSYC 124,A00,494187,Chapman; Eddie Nathaniel,72,0,80,8
1713310373098,PSYC 131,A00,494188,Anagnostaras; Stephan,58,0,80,22
1713310374121,PSYC 144,A00,494189,Staff,17,0,50,33
1713310375149,PSYC 154,A00,494190,Lacefield; Katharine I,134,0,180,46
1713310376174,PSYC 162,A00,494191,Wixted; John T,85,0,100,15
1713310377201,PSYC 172,A00,494192,Gorman; Michael R.,38,0,45,7
1713310378227,PSYC 178,A00,494193,Glaser; Dale,40,0,45,5
1713310379251,PSYC 193,A00,505725,Chapman; Eddie Nathaniel,20,0,20,0
1713310380280,RELI 145GS,A00,519817,Rahimi; Babak,19,0,20,1
1713310381308,SE 101A,A01,490862,Chadha; Mayank,24,0,25,1
1713310382337,SE 101C,A01,490924,Krysl; Petr,18,0,20,2
1713310383360,SE 110A,A01,490928,Staff,19,0,20,1
1713310384392,SE 130A,A00,490929,Morrison; Machel Leigh,64,0,70,6
1713310385416,SIO 1,A01,519325,Staff,39,0,40,1
1713310386443,SIO 30,A01,519327,Staff,39,0,40,1
1713310387471,SIO 40,A00,519328,Staff,40,0,40,0
1713310388499,SIO 46GS,A00,519819,Cook; Geoffrey W,18,0,25,7
1713310389524,SIO 109R,A00,494197,Forman; Fonna,7,0,20,13
1713310390550,SIO 121GS,A00,519827,Cook; Geoffrey W,18,0,25,7
1713310391579,SIO 132,A01,519330,Staff,38,0,40,2
1713310392609,SIO 133,A01,519397,Staff,38,0,40,2
1713310393634,SIO 139,A00,519396,Kacev; David,33,0,40,7
1713310394660,SOCI 1,A01,494199,Thorpe; Charles Robert,23,0,30,7
1713310394660,SOCI 1,A02,494200,Thorpe; Charles Robert,30,0,30,0
1713310394660,SOCI 1,A03,494201,Thorpe; Charles Robert,29,0,30,1
1713310394660,SOCI 1,A04,494202,Thorpe; Charles Robert,29,0,30,1
1713310394660,SOCI 1,A05,494203,Thorpe; Charles Robert,29,0,30,1
1713310394660,SOCI 1,A06,494204,Thorpe; Charles Robert,30,0,30,0
1713310394660,SOCI 1,A07,494205,Thorpe; Charles Robert,29,0,30,1
1713310395690,SOCI 60,A01,494207,Staff,36,0,40,4
1713310395690,SOCI 60,A02,494208,Staff,39,0,40,1
1713310396719,SOCI 100,A01,494210,Payne; Christine Anna,28,0,30,2
1713310396719,SOCI 100,A02,494211,Payne; Christine Anna,27,0,30,3
1713310397750,SOCI 109M,A00,494212,Staff,20,0,20,0
1713310398776,SOCI 110,A00,494213,Staff,35,0,40,5
1713310400829,SOCI 118E,A00,494215,Ng; Kwai,38,0,40,2
1713310401857,SOCI 125,A00,494216,Calderon-Zaks; Michael Aar,42,0,45,3
1713310402885,SOCI 126,A01,494218,Jones; Makeba,4,0,5,1
1713310403914,SOCI 131,A00,494219,Thorpe; Charles Robert,28,0,30,2
1713310405968,SOCI 135,A00,494221,Payne; Christine Anna,37,0,50,13
1713310406998,SOCI 136E,A00,626690,Ruiz; Jonathan Joseph,25,0,25,0
1713310408025,SOCI 138GS,A00,494222,Navon; Daniel,24,0,28,4
1713310410079,SOCI 145,A00,494224,Staff,42,0,45,3
1713310411104,SOCI 153,A00,494225,Staff,28,0,30,2
1713310412134,SOCI 160E,A00,494226,Ng; Kwai,33,0,40,7
1713310413160,SOCI 180,A00,494227,Staff,29,0,30,1
1713310414186,SOCI 189GS,A00,494228,Ribas Norris; Janet Vanesa,11,0,11,0
1713310415209,SOCI 190GS,A00,553232,Ribas Norris; Janet Vanesa,11,0,11,0
1713310416237,SOMI 220,A00,627178,Schneid; Stephen David,30,0,30,0
1713310417264,SYN 2,001,490768,Staff,14,0,15,1
1713310417264,SYN 2,002,490769,Staff,15,0,15,0
1713310417264,SYN 2,004,490775,Staff,0,0,0,0
1713310417264,SYN 2,003,490774,Staff,0,0,0,0
1713310417264,SYN 2,005,490776,Staff,0,0,0,0
1713310418289,SYN 2R,001,490779,Staff,14,0,15,1
1713310418289,SYN 2R,002,514635,Staff,14,0,15,1
1713310419316,SYN 100,A01,490783,Staff,15,0,20,5
1713310419316,SYN 100,B01,490787,Staff,11,0,20,9
1713310419316,SYN 100,C01,490789,Staff,13,0,20,7
1713310420344,SYN 150,A00,490817,Staff,14,0,15,1
1713310420344,SYN 150,B00,514610,Staff,15,0,15,0
1713310421371,TDAC 1,A00,492753,Walsh; Kim C.,19,0,20,1
1713310421371,TDAC 1,B00,492754,Harting; Carla Kelso,19,0,20,1
1713310421371,TDAC 1,C00,513995,Salovey; Todd,17,0,20,3
1713310422400,TDAC 101,A00,492766,Harting; Carla Kelso,17,0,20,3
1713310423425,TDAC 102,A00,492768,Basso; Beatrice,19,0,20,1
1713310424455,TDDE 111,A00,492769,Staff,25,0,25,0
1713310425479,TDDE 131,A00,492770,Staff,15,0,15,0
1713310425479,TDDE 131,B00,492771,Staff,15,0,15,0
1713310426503,TDDE 131GS,A00,523716,Guirguis; Mark C,25,0,28,3
1713310427533,TDGE 1,A01,492756,Salovey; Todd,57,0,60,3
1713310428557,TDGE 5,A01,492758,Staff,24,0,25,1
1713310429585,TDGE 10,A00,492759,Fulton; Julia,212,0,220,8
1713310430612,TDGE 11,A00,492760,Castro; Robert Jess,200,0,200,0
1713310431637,TDGE 50,A00,492761,Blair; Kyle Adam,0,0,0,0
1713310432662,TDGE 124,A00,492772,Fulton; Julia,195,0,220,25
1713310433692,TDGE 125,A00,492773,Meyer; Ursula,40,0,50,10
1713310433692,TDGE 125,B00,492774,Staff,50,0,50,0
1713310433692,TDGE 125,C00,523565,Staff,49,0,50,1
1713310434717,TDGE 125GS,A00,523580,Guirguis; Mark C,25,0,28,3
1713310435746,TDGE 127,A00,492775,Havis; Allan,41,0,50,9
1713310436774,TDHT 101,A00,492776,Staff,35,0,35,0
1713310437804,TDMV 1,A00,492762,Caligagan; Maria T.,30,0,30,0
1713310437804,TDMV 1,B00,492763,Arcidiacono; Kristin,25,0,30,5
1713310438828,TDMV 2,A00,492764,Weinberg; Sadie,29,0,30,1
1713310439909,TDMV 3,A00,492765,Mack; Kara Shanai',39,0,40,1
1713310440933,TDMV 138,A00,492777,Mack; Kara Shanai',36,0,40,4
1713310441962,TDMV 140,A00,492778,Lima; Paulo Henrique,40,0,40,0
1713310442987,TDMV 142,A00,492779,Caligagan; Maria T.,36,0,40,4
1713310442987,TDMV 142,B00,492780,Caligagan; Tony,37,0,40,3
1713310444016,TDMV 143,A00,492781,Fyall; Daunte Edward,39,0,40,1
1713310445042,USP 1,A01,492401,Kwak; Nancy,26,0,35,9
1713310446069,USP 2,A01,492453,Hinds; Juli Beth,35,0,35,0
1713310447098,USP 3,A01,492516,Staff,29,0,35,6
1713310448130,USP 4,A00,492522,McTague; Sarah,19,0,25,6
1713310449160,USP 100,A00,492523,Staff,33,0,35,2
1713310450189,USP 101,A00,492524,Staff,13,0,15,2
1713310451218,USP 105,A00,492525,Staff,21,0,25,4
1713310452244,USP 151,A00,492526,Shenkman; Michael Thomas,33,0,35,2
1713310453272,USP 170,A00,492545,Hinds; Juli Beth,33,0,35,2
1713310454300,USP 171GS,A00,492608,Bussell; Mirle Rabinowitz,26,0,28,2
1713310455326,USP 183GS,A00,492613,Peerson; Susan,26,0,28,2
1713310456358,VIS 30,A01,490693,Yoldas; Pinar,21,0,22,1
1713310456358,VIS 30,A02,490694,Yoldas; Pinar,19,0,22,3
1713310457385,VIS 83,A00,490695,Kester; Grant,67,0,75,8
1713310458412,VIS 105D,A00,490696,Staff,22,0,25,3
1713310459442,VIS 124CN,A00,490699,Rose; Jordan M,68,0,75,7
1713310460471,VIS 125GS,A00,511221,Williams; Alena J,21,0,22,1
1713310461495,VIS 128D,A00,490700,Staff,74,0,75,1
1713310462520,VIS 151,A01,490717,Staff,34,0,34,0
1713310462520,VIS 151,A02,490766,Staff,33,0,34,1
1713310463546,VIS 154GS,A00,511972,Williams; Alena J,21,0,22,1
1713310464573,VIS 160A,A00,490767,Stone; Patricia,7,0,10,3
1713310465598,WCWP 10A,A00,490638,Staff,15,0,15,0
1713310465598,WCWP 10A,B00,490640,Staff,15,0,15,0
1713310466623,WCWP 10B,A00,490641,Staff,0,0,0,0
1713310466623,WCWP 10B,B00,490642,Staff,14,0,15,1
1713310466623,WCWP 10B,C00,490644,Staff,13,0,15,2
1713310466623,WCWP 10B,D00,490647,Staff,0,0,0,0
1713310467650,WCWP 100,A00,490655,Staff,0,0,0,0
1713310467650,WCWP 100,B00,490687,Staff,12,0,15,3
1713310469728,ANAR 153,A00,487222,Braswell; Geoffrey E.,55,0,60,5
1713310470756,ANBI 134,A00,487223,Staff,13,0,20,7
1713310471781,ANBI 143GS,A00,487224,Noel; Geoffroy Pierre Jean,20,0,24,4
1713310472807,ANBI 144GS,A00,519548,Noel; Geoffroy Pierre Jean,20,0,24,4
1713310473832,ANSC 101,A00,487225,Staff,19,0,20,1
1713310474863,ANSC 125,A00,487227,Brenner; Suzanne A,39,0,40,1
1713310476911,ANSC 146,A00,487229,Staff,36,0,40,4
1713310477936,ANSC 148,A00,487230,Olivas Hernandez; Olga Lid,39,0,40,1
1713310478962,ANSC 150,A00,504165,Sloane; Julia Kathryn,19,0,20,1
1713310479987,ANSC 180,A00,487232,Staff,13,0,15,2
1713310481016,ANSC 188,A00,627155,Staff,40,0,40,0
1713310482042,ANTH 5,A00,519529,Semendeferi; Ekaterini,15,0,15,0
1713310483066,ANTH 10,A00,487219,Staff,58,0,60,2
1713310484090,ANTH 23,A01,487221,Staff,17,0,20,3
1713310485119,ANTH 102,A00,487233,Wilder; Linnea Lorene,53,0,60,7
1713310486145,ANTH 103,A00,487234,Varma; Saiba,57,0,60,3
1713310487171,ANTH 105,A00,487235,Stewart; Alexander B,57,0,60,3
1713310488196,BENG 100,A01,516685,Taylor Amos; Alyssa C,28,0,30,2
1713310489224,BIBC 102,A01,491316,Flagg; Matthew Paul,48,0,88,40
1713310489224,BIBC 102,A02,491366,Flagg; Matthew Paul,83,0,88,5
1713310490249,BIBC 103,A01,491486,Boumechache; Miyyada,16,0,24,8
1713310490249,BIBC 103,A02,491487,Boumechache; Miyyada,24,0,24,0
1713310491281,BICD 100,A01,516882,Staff,75,0,75,0
1713310491281,BICD 100,A02,516890,Staff,70,0,75,5
1713310492306,BICD 102GS,A00,491488,Lo; Stanley M.,26,0,28,2
1713310493332,BIEB 136GS,A00,516940,Holway; David A. & Shurin; Jonathan,19,0,24,5
1713310494356,BIEB 137GS,A01,517034,Holway; David A. & Shurin; Jonathan,19,0,24,5
1713310495382,BIEB 138GS,A01,491492,Pirino; Giorgia,22,0,28,6
1713310496409,BILD 1,A01,491296,Staff,62,0,63,1
1713310496409,BILD 1,A02,491297,Staff,63,0,63,0
1713310497439,BILD 4,A01,517099,Gonzalez Gamboa; Ivonne,22,0,24,2
1713310497439,BILD 4,A02,517100,Gonzalez Gamboa; Ivonne,24,0,24,0
1713310498466,BILD 60GS,A00,491309,Lo; Stanley M.,26,0,28,2
1713310499491,BIMM 100,A01,517136,Staff,91,0,100,9
1713310500516,BIMM 110,A01,517182,Staff,72,0,100,28
1713310501550,BIMM 120,A01,517228,Pickett; Brooke Elizabeth,40,0,63,23
1713310501550,BIMM 120,A02,517240,Pickett; Brooke Elizabeth,48,0,63,15
1713310502576,BIMM 132GS,A01,491498,Pirino; Giorgia,22,0,28,6
1713310503602,BIMM 143,A01,491589,Bozinovic; Goran,19,0,40,21
1713310504629,BIPN 100,A01,491594,Armour; Jon Christopher,92,0,100,8
1713310505655,BIPN 140,A01,491602,Marino; Marc J,31,0,50,19
1713310507711,CAT 125,A00,515973,Staff,20,0,20,0
1713310508739,CAT 125GS,A00,515974,Rahimi; Babak,19,0,20,1
1713310509768,CAT 125R,A00,515980,Staff,15,0,20,5
1713310509768,CAT 125R,B00,515981,Tosun; Adriana,19,0,20,1
1713310509768,CAT 125R,C00,515987,Hyland; Tina Mae,3,0,20,17
1713310509768,CAT 125R,D00,515988,Bronstein; Phoebe Malan,18,0,20,2
1713310510799,CENG 15,A01,488699,Drews; Aaron,25,0,25,0
1713310511825,CENG 100,A00,505196,Opatkiewicz; Justin Paul,25,0,25,0
1713310512850,CGS 2A,A01,489598,Staff,33,0,35,2
1713310513876,CGS 112,A00,489599,Staff,15,0,15,0
1713310514903,CGS 119,A00,489603,Staff,10,0,10,0
1713310515931,CGS 120,A00,489604,Staff,14,0,15,1
1713310516957,CGS 150,A00,489607,Staff,15,0,15,0
1713310517982,CHEM 6A,A01,488715,Staff,98,0,100,2
1713310519010,CHEM 6B,A01,488719,Piercy; Marc Anthony,100,0,100,0
1713310520035,CHEM 6C,A01,488723,Albizati; Kim F.,94,0,100,6
1713310521072,CHEM 7L,A01,488728,Schurmeier; Kimberly,18,0,24,6
1713310521072,CHEM 7L,A02,488730,Schurmeier; Kimberly,23,0,24,1
1713310521072,CHEM 7L,A03,488734,Schurmeier; Kimberly,23,0,24,1
1713310521072,CHEM 7L,A04,488763,Schurmeier; Kimberly,23,0,24,1
1713310521072,CHEM 7L,B01,488798,Schurmeier; Kimberly,18,0,24,6
1713310521072,CHEM 7L,B02,488801,Schurmeier; Kimberly,23,0,24,1
1713310521072,CHEM 7L,B03,488808,Schurmeier; Kimberly,24,0,24,0
1713310521072,CHEM 7L,B04,488811,Schurmeier; Kimberly,24,0,24,0
1713310522101,CHEM 11,A01,488897,Stallings; Dontarie M,98,0,100,2
1713310523126,CHEM 40A,A01,488913,Albizati; Kim F.,91,0,100,9
1713310524159,CHEM 40B,A01,488920,Weizman; Haim,47,0,50,3
1713310524159,CHEM 40B,A02,488938,Weizman; Haim,46,0,50,4
1713310525185,CHEM 41A,A01,489029,Klosterman; Jeremy K,58,0,60,2
1713310526210,CHEM 41C,A01,500436,Tor; Yitzhak,55,0,60,5
1713310527236,CHEM 43A,A01,500426,Weizman; Haim,4,0,24,20
1713310527236,CHEM 43A,A02,500430,Weizman; Haim,13,0,24,11
1713310527236,CHEM 43A,B01,514041,Klosterman; Jeremy K,16,0,24,8
1713310527236,CHEM 43A,B02,514047,Klosterman; Jeremy K,23,0,24,1
1713310528269,CHEM 108,A01,489140,Jennings; Patricia A.,13,0,24,11
1713310528269,CHEM 108,A02,489142,Jennings; Patricia A.,15,0,24,9
1713310529302,CHEM 114A,A01,489147,Stallings; Dontarie M,79,0,100,21
1713310530333,CHIN 169A,A00,489171,Wang; Xiao,19,0,20,1
1713310532392,COGS 3,A01,518827,Boyle; Mary E. T.,29,0,40,11
1713310533417,COGS 11,A01,489175,Staff,28,0,30,2
1713310534444,COGS 14A,A01,518829,Staff,53,0,60,7
1713310535473,COGS 14B,A01,489177,Hoffman; Drew Ellen,69,0,75,6
1713310536496,COGS 100,A01,489181,Allen; Michael Gordon,66,0,75,9
1713310537525,COGS 101A,A01,489183,Staff,49,0,60,11
1713310538550,COGS 101B,A01,489185,Allen; Michael Gordon,13,0,30,17
1713310539575,COGS 101C,A01,526786,Staff,25,0,30,5
1713310541633,COGS 107A,A01,489189,Boyle; Mary E. T.,23,0,35,12
1713310542660,COGS 107B,A01,627144,Mooshagian; Eric Frederick,60,0,60,0
1713310543742,COGS 118A,A01,489191,Staff,0,29,40,40
1713310545796,COGS 171GS,A01,489194,Pineda; Jaime A,22,0,28,6
1713310546823,COGS 172,A01,489196,Staff,6,0,30,24
1713310547851,COGS 174GS,A01,489264,Pineda; Jaime A,22,0,28,6
1713310548880,COGS 180,A01,627150,Staff,29,0,30,1
1713310549905,COGS 186,A01,489274,Staff,4,0,30,26
1713310550934,COMM 10,A01,489276,Staff,23,0,25,2
1713310550934,COMM 10,A02,489303,Staff,23,0,25,2
1713310551959,COMM 100A,A01,489312,Staff,18,0,25,7
1713310551959,COMM 100A,A02,489313,Staff,24,0,25,1
1713310552989,COMM 106T,A00,512540,Staff,34,0,35,1
1713310554013,COMM 107,A00,489347,Staff,31,0,35,4
1713310555039,COMM 109P,A00,489358,Staff,31,0,35,4
1713310556063,COMM 132,A00,489361,McKenna; Denise,29,0,30,1
1713310557087,COMM 146,A00,489362,Halm; Gavin Patrick,27,0,30,3
1713310558112,COMM 190,A00,489363,Abuelhiga; Soraya Jill,20,0,23,3
1713310559139,CSE 8A,A50,489366,Staff,23,0,25,2
1713310559139,CSE 8A,A51,489367,Staff,24,0,25,1
1713310560169,CSE 11,A01,489398,Cao; Yingjun,82,0,100,18
1713310561196,CSE 12,A01,489487,Staff,43,0,50,7
1713310562221,CSE 20,A01,489497,Staff,49,0,50,1
1713310563250,CSE 21,A01,489517,Braun; Oliver,44,0,50,6
1713310564277,CSE 101,A01,489524,Braun; Oliver,0,13,50,50
1713310565302,CSE 105,A01,512594,Jones; Miles E,81,0,100,19
1713310565302,CSE 105,B01,512598,Jones; Miles E,65,0,100,35
1713310566331,CSE 140,A01,489538,Staff,44,0,50,6
1713310567358,CSE 141,A01,489550,Eldon; John,76,0,100,24
1713310568384,CSE 141L,A01,489571,Eldon; John,75,0,100,25
1713310569413,CSE 151A,A01,489583,Solares; Edwin A,151,0,200,49
1713310570441,CSE 175,A01,510886,Kumar; Rakesh,30,0,30,0
1713310571466,CSE 190,A00,516828,Dubnov; Shlomo,41,0,49,8
1713310572490,DOC 100D,A00,489667,Pass; Natalye Joann,23,0,25,2
1713310573515,DSC 10,A01,624268,Staff,72,0,75,3
1713310574540,DSC 20,A01,624476,Staff,50,0,50,0
1713310575564,DSC 40A,A01,624608,Staff,40,0,40,0
1713310576590,DSGN 1,A01,489179,Rill; Bryan,36,0,50,14
1713310577616,ECE 17,A01,490489,Sahay; Rajeev,18,0,30,12
1713310578640,ECE 65,A50,490492,Staff,17,0,20,3
1713310578640,ECE 65,A51,490493,Staff,20,0,20,0
1713310579667,ECON 1,A01,489715,Famulari; Melissa,69,0,70,1
1713310580691,ECON 2,A01,489717,Levkoff; Steven B.,68,0,70,2
1713310581716,ECON 3,A01,489948,Staff,70,0,70,0
1713310583775,ECON 5,A01,490103,Staff,28,0,30,2
1713310583775,ECON 5,B01,626281,Dai; Yinlin,45,0,45,0
1713310584805,ECON 100A,A01,490127,Famulari; Melissa,68,0,70,2
1713310585833,ECON 100B,A01,490129,Staff,64,0,70,6
1713310586857,ECON 109,A01,490187,Shishkin; Denis,27,0,35,8
1713310587882,ECON 110A,A01,490190,Levkoff; Steven B.,63,0,70,7
1713310588911,ECON 120A,A01,490245,Dai; Yinlin,65,0,70,5
1713310589939,ECON 120B,A01,490247,Nieto-Barthaburu; Augusto,60,0,70,10
1713310590965,ECON 120C,A01,490253,Sun; Yixiao,32,0,35,3
1713310590965,ECON 120C,B01,490255,Sun; Yixiao,34,0,35,1
1713310591989,ECON 129,A00,490256,Eckert; Fabian Paul,26,0,35,9
1713310593016,ECON 131,A00,490257,Nieto-Barthaburu; Augusto,4,0,35,31
1713310594040,ECON 138,A00,490258,Bharadwaj; Prashant,23,0,35,12
1713310594040,ECON 138,B00,490259,Bharadwaj; Prashant,18,0,35,17
1713310595067,ECON 159,A00,490260,Hendrickson; Gerald M.,0,7,0,0
1713310596093,ECON 178,A01,553995,Zhu; Ying,27,0,35,8
1713310597121,EDS 40,A01,512576,Black; Alison Michelle,20,0,20,0
1713310598150,EDS 107,A01,515848,Staff,30,0,30,0
1713310599175,EDS 110R,A01,490262,Staff,26,0,30,4
1713310600201,EDS 112,A01,490264,Chapman; Thandeka K,43,0,50,7
1713310601228,EDS 113,A00,490266,Staff,26,0,30,4
1713310602253,EDS 118,A00,490267,Warstadt; Melissa Fawn,26,0,30,4
1713310603279,EDS 124BR,A00,490268,Eguchi; Emi,9,0,25,16
1713310603279,EDS 124BR,B00,490269,Eguchi; Emi,25,0,25,0
1713310604307,EDS 126,A01,490271,Jones; Makeba,45,0,50,5
1713310605334,EDS 135,A01,490316,Staff,19,0,20,1
1713310606361,ENVR 142GS,A00,519514,Chang; Edmond Yi-Teh,28,0,28,0
1713310607386,ETHN 103,A00,490504,Staff,32,0,36,4
1713310608411,ETHN 103A,A00,490505,Man; Simeon S,5,0,9,4
1713310609439,ETHN 109,A00,490506,Staff,30,0,30,0
1713310610464,ETHN 118,A00,490507,Staff,35,0,36,1
1713310611487,ETHN 119,A00,490508,Staff,36,0,36,0
1713310612513,ETHN 121R,A00,490518,Choi; Esther Min,29,0,36,7
1713310613537,ETHN 127,A00,490528,Staff,15,0,15,0
1713310614568,ETHN 139,A00,490573,Staff,10,0,10,0
1713310615592,ETHN 150,A00,490575,Staff,15,0,15,0
1713310616624,GLBH 20,A00,491705,Elwardani; Nile Regina,38,0,40,2
1713310617658,GLBH 101,A00,491706,Staff,20,0,20,0
1713310618684,GLBH 111,A01,491708,Burgos; Jose L.,15,0,15,0
1713310619708,GLBH 146,A00,491709,Staff,11,0,20,9
1713310620736,GLBH 148,A00,491710,Olivas Hernandez; Olga Lid,14,0,20,6
1713310621762,GLBH 150,A00,491711,Sloane; Julia Kathryn,20,0,20,0
1713310622789,HIEA 131,A00,491760,Staff,30,0,32,2
1713310623817,HIEA 153,A00,491762,Staff,29,0,30,1
1713310624842,HIEU 124,A00,491811,Staff,26,0,32,6
1713310625868,HIEU 124GS,A00,491812,Markman; Kristina,28,0,28,0
1713310626893,HIEU 147,A00,491813,Staff,30,0,32,2
1713310627921,HIEU 149GS,A00,491816,Caldwell; Michael Alan,28,0,28,0
1713310628946,HILD 2C,A01,491713,Hendrickson; Gerald M.,27,0,30,3
1713310629971,HILD 7B,A01,491715,Kwak; Nancy,14,0,30,16
1713310630997,HILD 10,A01,491717,Staff,14,0,20,6
1713310632028,HILD 30GS,A00,491719,Edington; Claire Ellen,24,0,28,4
1713310633055,HINE 109,A00,491818,Shafir; Nir,28,0,32,4
1713310634080,HINE 128,A00,491821,Shafir; Nir,31,0,32,1
1713310635106,HISC 117,A00,491830,Staff,29,0,32,3
1713310636136,HIUS 103,A00,491834,Man; Simeon S,16,0,23,7
1713310637160,HIUS 108B,A00,491835,Staff,29,0,30,1
1713310638188,HIUS 141,A00,491836,Hendrickson; Gerald M.,29,0,32,3
1713310639216,HIUS 149,A00,491839,Staff,27,0,32,5
1713310640241,HUM 3,A01,512617,Crum; Matthew Stephen,45,0,50,5
1713310640241,HUM 3,A02,512618,Crum; Matthew Stephen,48,0,50,2
1713310641267,HUM 3GS,A00,512663,Markman; Kristina,0,0,0,0
1713310641267,HUM 3GS,B00,512664,Staff,0,0,0,0
1713310642293,HUM 4,A01,512620,West; Geoffrey Scott,35,0,50,15
1713310643316,HUM 4GS,A00,512666,Lyon; Antony J.,0,0,0,3
1713310644343,HUM 4R,A01,512625,Watkins; Eric,49,0,50,1
1713310645369,HUM 5,A01,512649,Zavodny; Tatiana Sophia,32,0,50,18
1713310645369,HUM 5,B01,512661,Zroka; Ryan Edward,48,0,50,2
1713310646396,INTL 190,A00,490577,Segui; Alan S,0,0,0,5
1713310647476,JAPN 20AR,A01,491267,Ross; Kayoko F,12,0,20,8
1713310648503,JAPN 180,A00,491285,Berman; Michael David,34,0,40,6
1713310649529,LATI 50,A01,502536,Kokinis; Troy Andreas,19,0,22,3
1713310649529,LATI 50,A02,502551,Kokinis; Troy Andreas,22,0,22,0
1713310649529,LATI 50,A03,502650,Kokinis; Troy Andreas,22,0,22,0
1713310649529,LATI 50,A04,502909,Kokinis; Troy Andreas,22,0,22,0
1713310650558,LATI 160,A01,502920,Kokinis; Troy Andreas,30,0,30,0
1713310651585,LIFR 1A,A00,490494,Van Moer; Vinciane G,17,0,20,3
1713310652613,LIFR 1AX,A00,490495,Van Moer; Vinciane G,17,0,20,3
1713310653639,LIFR 1B,A00,490496,Van Moer; Vinciane G,19,0,20,1
1713310654664,LIFR 1BX,A00,490497,Van Moer; Vinciane G,19,0,20,1
1713310655693,LIGN 8,A00,505198,McIntosh; Justin Daniel,137,0,150,13
1713310656719,LIGN 9GS,A00,491239,Lott; Margaret S.,18,0,20,2
1713310657744,LIGN 101,A01,505200,McIntosh; Justin Daniel,25,0,30,5
1713310658772,LIGN 120,A01,491244,Staff,24,0,30,6
1713310659798,LIGN 149GS,A00,491245,Lott; Margaret S.,18,0,20,2
1713310660823,LIGN 170,A00,491247,Staff,24,0,30,6
1713310661848,LISP 1D,A00,490498,Munoz Sanchez; Alicia,11,0,14,3
1713310661848,LISP 1D,B00,490499,Munoz Sanchez; Alicia,6,0,14,8
1713310661848,LISP 1D,C00,490500,Munoz Sanchez; Alicia,10,0,14,4
1713310661848,LISP 1D,D00,490501,Munoz Sanchez; Alicia,11,0,14,3
1713310662876,LISP 1DX,A00,490502,Munoz Sanchez; Alicia,18,0,28,10
1713310662876,LISP 1DX,B00,490503,Munoz Sanchez; Alicia,19,0,28,9
1713310664931,LTAM 110,A00,491847,Staff,23,0,25,2
1713310665956,LTCS 119,A00,491848,Staff,12,0,15,3
1713310666985,LTCS 130,A00,491849,Staff,24,0,25,1
1713310669038,LTEA 120C,A00,491852,Staff,34,0,40,6
1713310670063,LTEN 130GS,A00,491853,Lyon; Antony J.,25,0,28,3
1713310671087,LTEN 148,A00,491855,Staff,23,0,25,2
1713310672115,LTEN 159,A00,491856,Staff,21,0,25,4
1713310673142,LTEN 180,A00,491857,Staff,9,0,15,6
1713310675194,LTSP 123GS,A00,505928,Bessett; Ryan Matthew,25,0,28,3
1713310676219,LTSP 174GS,A00,506037,Bessett; Ryan Matthew,25,0,28,3
1713310678271,LTWR 102,A00,491861,Staff,11,0,15,4
1713310679296,LTWR 106,A00,491862,Staff,10,0,15,5
1713310680324,MAE 11,A00,490930,Bahadori; Mohammad Yousef,97,0,100,3
1713310681367,MAE 30A,A00,490931,Qi; Huihui,38,0,40,2
1713310682393,MAE 101A,A00,491036,Sadeghizadeh; Zahra,98,0,100,2
1713310683437,MAE 101C,A00,491037,Seshadri; Kalyanasundaram,76,0,100,24
1713310684469,MAE 113,A00,491040,Seshadri; Kalyanasundaram,67,0,80,13
1713310685497,MAE 131A,A00,491041,Ghazinejad; Maziar,39,0,40,1
1713310686524,MAE 142,A00,491053,Staff,39,0,40,1
1713310687552,MAE 143A,A00,491054,Staff,40,0,50,10
1713310688577,MAE 150,A00,491092,Truong; Phuong Thi Ngoc,24,0,35,11
1713310689603,MATH 3C,A01,494031,Pardo Guerra; Sebastian,30,0,30,0
1713310689603,MATH 3C,A02,494032,Pardo Guerra; Sebastian,29,0,30,1
1713310690634,MATH 10A,A01,494034,Staff,27,0,30,3
1713310690634,MATH 10A,A02,494035,Staff,29,0,30,1
1713310690634,MATH 10A,B01,494037,Staff,27,0,30,3
1713310690634,MATH 10A,B02,494038,Staff,29,0,30,1
1713310691661,MATH 10B,A01,494040,Habib; Yousaf,24,0,30,6
1713310691661,MATH 10B,A02,494041,Habib; Yousaf,28,0,30,2
1713310691661,MATH 10B,A03,494042,Habib; Yousaf,30,0,30,0
1713310691661,MATH 10B,A04,494043,Habib; Yousaf,30,0,30,0
1713310691661,MATH 10B,B01,494045,Habib; Yousaf,28,0,30,2
1713310691661,MATH 10B,B02,494046,Habib; Yousaf,30,0,30,0
1713310691661,MATH 10B,B03,494047,Habib; Yousaf,30,0,30,0
1713310691661,MATH 10B,B04,494048,Habib; Yousaf,30,0,30,0
1713310692690,MATH 18,A01,494050,Kemp; Todd Aahron,27,0,30,3
1713310692690,MATH 18,A02,494051,Kemp; Todd Aahron,29,0,30,1
1713310692690,MATH 18,B01,494054,Kemp; Todd Aahron,28,0,30,2
1713310692690,MATH 18,B02,494055,Kemp; Todd Aahron,29,0,30,1
1713310693716,MATH 20A,A01,494059,Suk; Andrew Hoon,30,0,30,0
1713310694741,MATH 20B,A01,494061,Briones; Jor-el Thomas Caparas,34,0,35,1
1713310694741,MATH 20B,B01,494063,Bach; Quang Tran,34,0,35,1
1713310695767,MATH 20C,A01,494065,Staff,28,0,30,2
1713310695767,MATH 20C,A02,494066,Staff,30,0,30,0
1713310695767,MATH 20C,A03,494067,Staff,30,0,30,0
1713310695767,MATH 20C,A04,494068,Staff,30,0,30,0
1713310695767,MATH 20C,B01,494070,Zhang; Ming,26,0,30,4
1713310695767,MATH 20C,B02,494071,Zhang; Ming,29,0,30,1
1713310695767,MATH 20C,B03,494072,Zhang; Ming,29,0,30,1
1713310695767,MATH 20C,B04,494073,Zhang; Ming,29,0,30,1
1713310696795,MATH 20D,A01,494075,Staff,25,0,30,5
1713310696795,MATH 20D,A02,494076,Staff,30,0,30,0
1713310697820,MATH 20E,A01,494079,Staff,25,0,30,5
1713310697820,MATH 20E,A02,494080,Staff,27,0,30,3
1713310697820,MATH 20E,B01,494082,Staff,28,0,30,2
1713310697820,MATH 20E,B02,494083,Staff,25,0,30,5
1713310698845,MATH 103A,A01,494085,Aliabadi Sr.; Mohsen,17,0,30,13
1713310698845,MATH 103A,A02,494086,Aliabadi Sr.; Mohsen,28,0,30,2
1713310698845,MATH 103A,B01,494088,Aliabadi Sr.; Mohsen,22,0,30,8
1713310698845,MATH 103A,B02,494089,Aliabadi Sr.; Mohsen,28,0,30,2
1713310699876,MATH 109,A01,494091,Staff,30,0,30,0
1713310699876,MATH 109,A02,494092,Staff,30,0,30,0
1713310699876,MATH 109,B01,494094,Staff,28,0,30,2
1713310699876,MATH 109,B02,494095,Staff,29,0,30,1
1713310700902,MATH 142A,A01,494097,Chow; Bennett,16,0,30,14
1713310700902,MATH 142A,A02,494098,Chow; Bennett,24,0,30,6
1713310700902,MATH 142A,B01,494100,Chow; Bennett,20,0,30,10
1713310700902,MATH 142A,B02,494101,Chow; Bennett,29,0,30,1
1713310702957,MATH 168A,A01,516677,Dumitriu; Ioana,16,0,35,19
1713310703982,MATH 170A,A01,516679,Dumitriu; Ioana,20,0,30,10
1713310703982,MATH 170A,A02,516680,Dumitriu; Ioana,28,0,30,2
1713310705020,MATH 193A,A01,494107,Staff,16,0,30,14
1713310705020,MATH 193A,A02,494108,Staff,23,0,30,7
1713310705020,MATH 193A,A03,494109,Staff,29,0,30,1
1713310705020,MATH 193A,A04,494110,Staff,24,0,30,6
1713310708099,MGT 16,A00,491930,McKay; Michael J,93,0,98,5
1713310709127,MGT 18,A00,491992,McKay; Michael J,97,0,98,1
1713310710153,MGT 71,A00,492003,Staff,78,0,98,20
1713310711180,MGT 103,A00,505209,Eberhard; Craig A,85,0,98,13
1713310712205,MGT 131A,A00,505210,Anderson; John Charles,91,0,98,7
1713310714256,MGT 153,A00,492077,Perols; Johan Lars,43,0,90,47
1713310717341,MGT 164,A00,492222,McKay; Mary A,94,0,98,4
1713310718374,MGT 172,A00,492245,Staff,59,0,60,1
1713310718374,MGT 172,B00,505526,Hedges; Kathleen,77,0,98,21
1713310719397,MGT 181,A00,505669,Dunn; Louis Jean,88,0,98,10
1713310720424,MMW 14,A01,494399,Staff,23,0,28,5
1713310720424,MMW 14,A02,494400,Staff,26,0,28,2
1713310720424,MMW 14,A03,494401,Staff,28,0,28,0
1713310720424,MMW 14,A04,494402,Staff,28,0,28,0
1713310720424,MMW 14,B01,494404,Carreras; Maria Victoria,15,0,28,13
1713310720424,MMW 14,B02,494405,Carreras; Maria Victoria,27,0,28,1
1713310720424,MMW 14,B03,494406,Carreras; Maria Victoria,28,0,28,0
1713310720424,MMW 14,B04,494407,Carreras; Maria Victoria,28,0,28,0
1713310721450,MMW 14GS,A00,506250,Chang; Edmond Yi-Teh,0,0,0,0
1713310722474,MMW 121R,A01,494415,Adamiak; Patrick John,15,0,28,13
1713310722474,MMW 121R,A02,494416,Adamiak; Patrick John,25,0,28,3
1713310723500,MUS 1A,A01,494113,Staff,12,0,25,13
1713310723500,MUS 1A,A02,494114,Staff,25,0,25,0
1713310724526,MUS 4,A01,494116,Staff,24,0,25,1
1713310724526,MUS 4,A02,494117,Staff,22,0,25,3
1713310725553,MUS 5R,A01,494236,Dubnov; Shlomo,12,0,25,13
1713310725553,MUS 5R,A02,494237,Dubnov; Shlomo,25,0,25,0
1713310726582,MUS 6,A01,494122,Staff,16,0,25,9
1713310726582,MUS 6,A02,494123,Staff,24,0,25,1
1713310727607,MUS 7,A01,494125,Staff,17,0,25,8
1713310727607,MUS 7,A02,494126,Staff,24,0,25,1
1713310728633,MUS 11,A01,494128,Staff,23,0,25,2
1713310728633,MUS 11,A02,494129,Staff,25,0,25,0
1713310729662,MUS 13,A01,494131,Staff,25,0,25,0
1713310729662,MUS 13,A02,494132,Staff,25,0,25,0
1713310730686,MUS 15,A01,494134,Staff,20,0,25,5
1713310730686,MUS 15,A02,494135,Staff,25,0,25,0
1713310730686,MUS 15,B01,494137,Staff,24,0,25,1
1713310731711,MUS 80,A00,494232,Staff,25,0,25,0
1713310731711,MUS 80,B00,494233,Staff,25,0,25,0
1713310731711,MUS 80,C00,494234,Staff,23,0,25,2
1713310732737,MUS 95C,A00,494141,Staff,73,0,75,2
1713310733761,MUS 114,A00,494142,Staff,41,0,50,9
1713310734787,NANO 15,A01,490636,Drews; Aaron,7,0,7,0
1713310735812,PHIL 1,A00,490578,Grush; Rick Scott,50,0,50,0
1713310736838,PHIL 10,A01,490580,Grush; Rick Scott,34,0,35,1
1713310736838,PHIL 10,A02,490586,Grush; Rick Scott,33,0,35,2
1713310737866,PHIL 27,A01,490591,Staff,24,0,25,1
1713310737866,PHIL 27,A02,490592,Staff,25,0,25,0
1713310737866,PHIL 27,A03,490593,Staff,25,0,25,0
1713310737866,PHIL 27,A04,490598,Staff,25,0,25,0
1713310738890,PHIL 32,A01,490611,Staff,20,0,20,0
1713310738890,PHIL 32,A02,490618,Staff,20,0,20,0
1713310739917,PHIL 90,A00,490624,Staff,40,0,40,0
1713310740946,PHIL 136,A00,490627,Cohen; Jonathan David,38,0,40,2
1713310741975,PHIL 155,A00,490634,Staff,64,0,70,6
1713310743001,PHYS 1A,A00,491610,Staff,246,0,250,4
1713310744031,PHYS 1AL,001,491616,Tsai; Philbert S,28,0,30,2
1713310744031,PHYS 1AL,002,491618,Tsai; Philbert S,30,0,30,0
1713310745054,PHYS 1B,A00,491623,Staff,244,0,250,6
1713310746083,PHYS 1BL,001,491626,Tsai; Philbert S,26,0,30,4
1713310746083,PHYS 1BL,002,491628,Tsai; Philbert S,28,0,30,2
1713310747109,PHYS 1C,A00,491632,Staff,223,0,245,22
1713310748134,PHYS 1CL,001,491635,Tsai; Philbert S,11,0,30,19
1713310748134,PHYS 1CL,002,491643,Tsai; Philbert S,24,0,30,6
1713310749163,PHYS 2AR,A01,491651,Meyertholen; Andrew D.,45,0,50,5
1713310750190,PHYS 2B,A01,491659,Staff,107,0,115,8
1713310751271,PHYS 2BL,A01,491685,Staff,22,0,24,2
1713310751271,PHYS 2BL,A02,491700,Staff,23,0,24,1
1713310752300,PHYS 2C,A01,505161,Staff,107,0,115,8
1713310753325,PHYS 4A,A01,491704,Grinstein; Benjamin,99,0,100,1
1713310754351,POLI 5D,A01,494144,Staff,3,0,5,2
1713310754351,POLI 5D,B01,626283,Dai; Yinlin,5,0,5,0
1713310755380,POLI 12,A00,494145,Staff,44,0,45,1
1713310756408,POLI 13R,A00,494146,Forman; Fonna,46,0,50,4
1713310757437,POLI 27,A01,494148,Staff,57,0,60,3
1713310758461,POLI 30,A00,494149,Staff,49,0,50,1
1713310759490,POLI 100DA,A00,494150,Staff,23,0,25,2
1713310761544,POLI 100I,A00,494152,Staff,28,0,30,2
1713310762574,POLI 104B,A00,494153,Smith; Glenn Chatmas,54,0,55,1
1713310763601,POLI 104F,A00,494154,Staff,28,0,30,2
1713310764630,POLI 104I,A00,494155,Smith; Glenn Chatmas,30,0,30,0
1713310765655,POLI 110C,A00,494156,Ingham; Sean,23,0,25,2
1713310766682,POLI 117R,A00,494157,Forman; Fonna,12,0,20,8
1713310767709,POLI 118,A00,494158,Ingham; Sean,22,0,25,3
1713310768733,POLI 120H,A00,494159,Fisk; David Lee,41,0,45,4
1713310769760,POLI 131CR,A00,494160,Hoston; Germaine,38,0,45,7
1713310770788,POLI 133J,A00,494161,Staff,33,0,35,2
1713310771813,POLI 135,A00,494162,Fisk; David Lee,33,0,35,2
1713310772844,POLI 140A,A00,494164,Staff,22,0,30,8
1713310773870,POLI 142I,A00,494165,Staff,30,0,30,0
1713310774897,POLI 144D,A00,494166,Staff,23,0,25,2
1713310775923,POLI 151,A00,494167,Staff,30,0,30,0
1713310776948,POLI 153,A00,494168,Staff,33,0,35,2
1713310777972,POLI 160AA,A00,494169,Staff,35,0,40,5
1713310779001,POLI 162,A00,494170,Mignozzetti; Umberto,20,0,25,5
1713310780024,POLI 171,A00,494171,Mignozzetti; Umberto,21,0,25,4
1713310781053,PSYC 1,A00,494172,Staff,97,0,100,3
1713310782077,PSYC 2,A00,494173,Moranton; Nirelia Melbina-,44,0,50,6
1713310783103,PSYC 3,A00,494174,Staff,30,0,30,0
1713310784129,PSYC 6,A00,494175,Staff,17,0,20,3
1713310785153,PSYC 60,A01,494177,Staff,40,0,45,5
1713310786178,PSYC 70,A01,505724,Geller; Emma Harlan,42,0,45,3
1713310787205,PSYC 101,A00,494180,Heyman; Gail D.,87,0,100,13
1713310788230,PSYC 105,A00,494181,Geller; Emma Harlan,64,0,90,26
1713310789255,PSYC 106,A00,494182,Dobkins; Karen R.,33,0,45,12
1713310790284,PSYC 108,A00,494183,Adrian; Julia Anna,94,0,100,6
1713310791313,PSYC 114,A01,494185,Winkielman; Piotr,3,0,30,27
1713310792338,PSYC 122,A00,494186,Moranton; Nirelia Melbina-,38,0,50,12
1713310793367,PSYC 124,A00,494187,Chapman; Eddie Nathaniel,72,0,80,8
1713310794397,PSYC 131,A00,494188,Anagnostaras; Stephan,58,0,80,22
1713310795423,PSYC 144,A00,494189,Staff,17,0,50,33
1713310796446,PSYC 154,A00,494190,Lacefield; Katharine I,134,0,180,46
1713310797470,PSYC 162,A00,494191,Wixted; John T,85,0,100,15
1713310798494,PSYC 172,A00,494192,Gorman; Michael R.,38,0,45,7
1713310799523,PSYC 178,A00,494193,Glaser; Dale,40,0,45,5
1713310800549,PSYC 193,A00,505725,Chapman; Eddie Nathaniel,20,0,20,0
1713310801578,RELI 145GS,A00,519817,Rahimi; Babak,19,0,20,1
1713310802609,SE 101A,A01,490862,Chadha; Mayank,24,0,25,1
1713310803641,SE 101C,A01,490924,Krysl; Petr,18,0,20,2
1713310804666,SE 110A,A01,490928,Staff,19,0,20,1
1713310805693,SE 130A,A00,490929,Morrison; Machel Leigh,64,0,70,6
1713310806720,SIO 1,A01,519325,Staff,39,0,40,1
1713310807748,SIO 30,A01,519327,Staff,39,0,40,1
1713310808773,SIO 40,A00,519328,Staff,40,0,40,0
1713310809798,SIO 46GS,A00,519819,Cook; Geoffrey W,18,0,25,7
1713310810826,SIO 109R,A00,494197,Forman; Fonna,6,0,20,14
1713310811851,SIO 121GS,A00,519827,Cook; Geoffrey W,18,0,25,7
1713310812878,SIO 132,A01,519330,Staff,38,0,40,2
1713310813908,SIO 133,A01,519397,Staff,38,0,40,2
1713310814934,SIO 139,A00,519396,Kacev; David,33,0,40,7
1713310815961,SOCI 1,A01,494199,Thorpe; Charles Robert,23,0,30,7
1713310815961,SOCI 1,A02,494200,Thorpe; Charles Robert,30,0,30,0
1713310815961,SOCI 1,A03,494201,Thorpe; Charles Robert,29,0,30,1
1713310815961,SOCI 1,A04,494202,Thorpe; Charles Robert,29,0,30,1
1713310815961,SOCI 1,A05,494203,Thorpe; Charles Robert,29,0,30,1
1713310815961,SOCI 1,A06,494204,Thorpe; Charles Robert,30,0,30,0
1713310815961,SOCI 1,A07,494205,Thorpe; Charles Robert,29,0,30,1
1713310816987,SOCI 60,A01,494207,Staff,36,0,40,4
1713310816987,SOCI 60,A02,494208,Staff,39,0,40,1
1713310818012,SOCI 100,A01,494210,Payne; Christine Anna,28,0,30,2
1713310818012,SOCI 100,A02,494211,Payne; Christine Anna,27,0,30,3
1713310819040,SOCI 109M,A00,494212,Staff,20,0,20,0
1713310820065,SOCI 110,A00,494213,Staff,35,0,40,5
1713310822125,SOCI 118E,A00,494215,Ng; Kwai,38,0,40,2
1713310823153,SOCI 125,A00,494216,Calderon-Zaks; Michael Aar,42,0,45,3
1713310824178,SOCI 126,A01,494218,Jones; Makeba,4,0,5,1
1713310825203,SOCI 131,A00,494219,Thorpe; Charles Robert,28,0,30,2
1713310827258,SOCI 135,A00,494221,Payne; Christine Anna,36,0,50,14
1713310828286,SOCI 136E,A00,626690,Ruiz; Jonathan Joseph,25,0,25,0
1713310829314,SOCI 138GS,A00,494222,Navon; Daniel,24,0,28,4
1713310831368,SOCI 145,A00,494224,Staff,42,0,45,3
1713310832400,SOCI 153,A00,494225,Staff,28,0,30,2
1713310833427,SOCI 160E,A00,494226,Ng; Kwai,33,0,40,7
1713310834453,SOCI 180,A00,494227,Staff,29,0,30,1
1713310835478,SOCI 189GS,A00,494228,Ribas Norris; Janet Vanesa,11,0,11,0
1713310836507,SOCI 190GS,A00,553232,Ribas Norris; Janet Vanesa,11,0,11,0
1713310837534,SOMI 220,A00,627178,Schneid; Stephen David,30,0,30,0
1713310838561,SYN 2,001,490768,Staff,14,0,15,1
1713310838561,SYN 2,002,490769,Staff,15,0,15,0
1713310838561,SYN 2,004,490775,Staff,0,0,0,0
1713310838561,SYN 2,003,490774,Staff,0,0,0,0
1713310838561,SYN 2,005,490776,Staff,0,0,0,0
1713310839586,SYN 2R,001,490779,Staff,13,0,15,2
1713310839586,SYN 2R,002,514635,Staff,14,0,15,1
1713310840611,SYN 100,A01,490783,Staff,15,0,20,5
1713310840611,SYN 100,B01,490787,Staff,11,0,20,9
1713310840611,SYN 100,C01,490789,Staff,13,0,20,7
1713310841636,SYN 150,A00,490817,Staff,14,0,15,1
1713310841636,SYN 150,B00,514610,Staff,15,0,15,0
1713310842663,TDAC 1,A00,492753,Walsh; Kim C.,19,0,20,1
1713310842663,TDAC 1,B00,492754,Harting; Carla Kelso,19,0,20,1
1713310842663,TDAC 1,C00,513995,Salovey; Todd,17,0,20,3
1713310843689,TDAC 101,A00,492766,Harting; Carla Kelso,17,0,20,3
1713310844719,TDAC 102,A00,492768,Basso; Beatrice,19,0,20,1
1713310845748,TDDE 111,A00,492769,Staff,25,0,25,0
1713310846776,TDDE 131,A00,492770,Staff,15,0,15,0
1713310846776,TDDE 131,B00,492771,Staff,15,0,15,0
1713310847803,TDDE 131GS,A00,523716,Guirguis; Mark C,25,0,28,3
1713310848834,TDGE 1,A01,492756,Salovey; Todd,57,0,60,3
1713310849859,TDGE 5,A01,492758,Staff,24,0,25,1
1713310850890,TDGE 10,A00,492759,Fulton; Julia,212,0,220,8
1713310851916,TDGE 11,A00,492760,Castro; Robert Jess,200,0,200,0
1713310853971,TDGE 124,A00,492772,Fulton; Julia,195,0,220,25
1713310855052,TDGE 125,A00,492773,Meyer; Ursula,40,0,50,10
1713310855052,TDGE 125,B00,492774,Staff,50,0,50,0
1713310855052,TDGE 125,C00,523565,Staff,49,0,50,1
1713310856078,TDGE 125GS,A00,523580,Guirguis; Mark C,25,0,28,3
1713310857103,TDGE 127,A00,492775,Havis; Allan,41,0,50,9
1713310858128,TDHT 101,A00,492776,Staff,35,0,35,0
1713310859155,TDMV 1,A00,492762,Caligagan; Maria T.,30,0,30,0
1713310859155,TDMV 1,B00,492763,Arcidiacono; Kristin,25,0,30,5
1713310860180,TDMV 2,A00,492764,Weinberg; Sadie,29,0,30,1
1713310861205,TDMV 3,A00,492765,Mack; Kara Shanai',39,0,40,1
1713310862229,TDMV 138,A00,492777,Mack; Kara Shanai',36,0,40,4
1713310863254,TDMV 140,A00,492778,Lima; Paulo Henrique,40,0,40,0
1713310864283,TDMV 142,A00,492779,Caligagan; Maria T.,36,0,40,4
1713310864283,TDMV 142,B00,492780,Caligagan; Tony,37,0,40,3
1713310865312,TDMV 143,A00,492781,Fyall; Daunte Edward,39,0,40,1
1713310866337,USP 1,A01,492401,Kwak; Nancy,26,0,35,9
1713310867368,USP 2,A01,492453,Hinds; Juli Beth,35,0,35,0
1713310868397,USP 3,A01,492516,Staff,29,0,35,6
1713310869421,USP 4,A00,492522,McTague; Sarah,19,0,25,6
1713310870449,USP 100,A00,492523,Staff,33,0,35,2
1713310871473,USP 101,A00,492524,Staff,13,0,15,2
1713310872500,USP 105,A00,492525,Staff,21,0,25,4
1713310873525,USP 151,A00,492526,Shenkman; Michael Thomas,33,0,35,2
1713310874553,USP 170,A00,492545,Hinds; Juli Beth,33,0,35,2
1713310875691,USP 171GS,A00,492608,Bussell; Mirle Rabinowitz,26,0,28,2
1713310876719,USP 183GS,A00,492613,Peerson; Susan,26,0,28,2
1713310877745,VIS 30,A01,490693,Yoldas; Pinar,21,0,22,1
1713310877745,VIS 30,A02,490694,Yoldas; Pinar,19,0,22,3
1713310878770,VIS 83,A00,490695,Kester; Grant,66,0,75,9
1713310879794,VIS 105D,A00,490696,Staff,22,0,25,3
1713310880819,VIS 124CN,A00,490699,Rose; Jordan M,68,0,75,7
1713310881848,VIS 125GS,A00,511221,Williams; Alena J,21,0,22,1
1713310882877,VIS 128D,A00,490700,Staff,74,0,75,1
1713310883942,VIS 151,A01,490717,Staff,33,0,34,1
1713310883942,VIS 151,A02,490766,Staff,33,0,34,1
1713310884966,VIS 154GS,A00,511972,Williams; Alena J,21,0,22,1
1713310885991,VIS 160A,A00,490767,Stone; Patricia,7,0,10,3
1713310887019,WCWP 10A,A00,490638,Staff,15,0,15,0
1713310887019,WCWP 10A,B00,490640,Staff,15,0,15,0
1713310888044,WCWP 10B,A00,490641,Staff,0,0,0,0
1713310888044,WCWP 10B,B00,490642,Staff,14,0,15,1
1713310888044,WCWP 10B,C00,490644,Staff,13,0,15,2
1713310888044,WCWP 10B,D00,490647,Staff,0,0,0,0
1713310889072,WCWP 100,A00,490655,Staff,0,0,0,0
1713310889072,WCWP 100,B00,490687,Staff,12,0,15,3
1713310891163,ANAR 153,A00,487222,Braswell; Geoffrey E.,55,0,60,5
1713310892188,ANBI 134,A00,487223,Staff,12,0,20,8
1713310893212,ANBI 143GS,A00,487224,Noel; Geoffroy Pierre Jean,20,0,24,4
1713310894242,ANBI 144GS,A00,519548,Noel; Geoffroy Pierre Jean,20,0,24,4
1713310895268,ANSC 101,A00,487225,Staff,19,0,20,1
1713310896293,ANSC 125,A00,487227,Brenner; Suzanne A,39,0,40,1
1713310898344,ANSC 146,A00,487229,Staff,36,0,40,4
1713310899375,ANSC 148,A00,487230,Olivas Hernandez; Olga Lid,39,0,40,1
1713310900403,ANSC 150,A00,504165,Sloane; Julia Kathryn,19,0,20,1
1713310901431,ANSC 180,A00,487232,Staff,13,0,15,2
1713310902455,ANSC 188,A00,627155,Staff,40,0,40,0
1713310903482,ANTH 5,A00,519529,Semendeferi; Ekaterini,15,0,15,0
1713310904513,ANTH 10,A00,487219,Staff,58,0,60,2
1713310905545,ANTH 23,A01,487221,Staff,17,0,20,3
1713310906569,ANTH 102,A00,487233,Wilder; Linnea Lorene,53,0,60,7
1713310907595,ANTH 103,A00,487234,Varma; Saiba,57,0,60,3
1713310908625,ANTH 105,A00,487235,Stewart; Alexander B,56,0,60,4
1713310909656,BENG 100,A01,516685,Taylor Amos; Alyssa C,28,0,30,2
1713310910685,BIBC 102,A01,491316,Flagg; Matthew Paul,47,0,88,41
1713310910685,BIBC 102,A02,491366,Flagg; Matthew Paul,83,0,88,5
1713310911714,BIBC 103,A01,491486,Boumechache; Miyyada,16,0,24,8
1713310911714,BIBC 103,A02,491487,Boumechache; Miyyada,24,0,24,0
1713310912744,BICD 100,A01,516882,Staff,75,0,75,0
1713310912744,BICD 100,A02,516890,Staff,70,0,75,5
1713310913770,BICD 102GS,A00,491488,Lo; Stanley M.,26,0,28,2
1713310914801,BIEB 136GS,A00,516940,Holway; David A. & Shurin; Jonathan,19,0,24,5
1713310915826,BIEB 137GS,A01,517034,Holway; David A. & Shurin; Jonathan,19,0,24,5
1713310916851,BIEB 138GS,A01,491492,Pirino; Giorgia,22,0,28,6
1713310917880,BILD 1,A01,491296,Staff,62,0,63,1
1713310917880,BILD 1,A02,491297,Staff,63,0,63,0
1713310918906,BILD 4,A01,517099,Gonzalez Gamboa; Ivonne,22,0,24,2
1713310918906,BILD 4,A02,517100,Gonzalez Gamboa; Ivonne,24,0,24,0
1713310920029,BILD 60GS,A00,491309,Lo; Stanley M.,26,0,28,2
1713310921055,BIMM 100,A01,517136,Staff,91,0,100,9
1713310922079,BIMM 110,A01,517182,Staff,72,0,100,28
1713310923106,BIMM 120,A01,517228,Pickett; Brooke Elizabeth,40,0,63,23
1713310923106,BIMM 120,A02,517240,Pickett; Brooke Elizabeth,48,0,63,15
1713310924134,BIMM 132GS,A01,491498,Pirino; Giorgia,22,0,28,6
1713310925175,BIMM 143,A01,491589,Bozinovic; Goran,18,0,40,22
1713310926205,BIPN 100,A01,491594,Armour; Jon Christopher,92,0,100,8
1713310927231,BIPN 140,A01,491602,Marino; Marc J,30,0,50,20
1713310929283,CAT 125,A00,515973,Staff,20,0,20,0
1713310930311,CAT 125GS,A00,515974,Rahimi; Babak,19,0,20,1
1713310931339,CAT 125R,A00,515980,Staff,15,0,20,5
1713310931339,CAT 125R,B00,515981,Tosun; Adriana,19,0,20,1
1713310931339,CAT 125R,C00,515987,Hyland; Tina Mae,3,0,20,17
1713310931339,CAT 125R,D00,515988,Bronstein; Phoebe Malan,18,0,20,2
1713310932365,CENG 15,A01,488699,Drews; Aaron,25,0,25,0
1713310933409,CENG 100,A00,505196,Opatkiewicz; Justin Paul,25,0,25,0
1713310934433,CGS 2A,A01,489598,Staff,33,0,35,2
1713310935456,CGS 112,A00,489599,Staff,15,0,15,0
1713310936483,CGS 119,A00,489603,Staff,10,0,10,0
1713310937509,CGS 120,A00,489604,Staff,14,0,15,1
1713310938534,CGS 150,A00,489607,Staff,15,0,15,0
1713310939562,CHEM 6A,A01,488715,Staff,98,0,100,2
1713310940588,CHEM 6B,A01,488719,Piercy; Marc Anthony,100,0,100,0
1713310941617,CHEM 6C,A01,488723,Albizati; Kim F.,94,0,100,6
1713310942652,CHEM 7L,A01,488728,Schurmeier; Kimberly,18,0,24,6
1713310942652,CHEM 7L,A02,488730,Schurmeier; Kimberly,23,0,24,1
1713310942652,CHEM 7L,A03,488734,Schurmeier; Kimberly,23,0,24,1
1713310942652,CHEM 7L,A04,488763,Schurmeier; Kimberly,23,0,24,1
1713310942652,CHEM 7L,B01,488798,Schurmeier; Kimberly,18,0,24,6
1713310942652,CHEM 7L,B02,488801,Schurmeier; Kimberly,23,0,24,1
1713310942652,CHEM 7L,B03,488808,Schurmeier; Kimberly,24,0,24,0
1713310942652,CHEM 7L,B04,488811,Schurmeier; Kimberly,24,0,24,0
1713310943680,CHEM 11,A01,488897,Stallings; Dontarie M,98,0,100,2
1713310944705,CHEM 40A,A01,488913,Albizati; Kim F.,91,0,100,9
1713310945734,CHEM 40B,A01,488920,Weizman; Haim,47,0,50,3
1713310945734,CHEM 40B,A02,488938,Weizman; Haim,46,0,50,4
1713310946762,CHEM 41A,A01,489029,Klosterman; Jeremy K,58,0,60,2
1713310947789,CHEM 41C,A01,500436,Tor; Yitzhak,55,0,60,5
1713310948820,CHEM 43A,A01,500426,Weizman; Haim,4,0,24,20
1713310948820,CHEM 43A,A02,500430,Weizman; Haim,13,0,24,11
1713310948820,CHEM 43A,B01,514041,Klosterman; Jeremy K,16,0,24,8
1713310948820,CHEM 43A,B02,514047,Klosterman; Jeremy K,23,0,24,1
1713310949846,CHEM 108,A01,489140,Jennings; Patricia A.,13,0,24,11
1713310949846,CHEM 108,A02,489142,Jennings; Patricia A.,15,0,24,9
1713310950870,CHEM 114A,A01,489147,Stallings; Dontarie M,79,0,100,21
1713310951901,CHIN 169A,A00,489171,Wang; Xiao,19,0,20,1
1713310953952,COGS 3,A01,518827,Boyle; Mary E. T.,29,0,40,11
1713310954977,COGS 11,A01,489175,Staff,28,0,30,2
1713310956005,COGS 14A,A01,518829,Staff,52,0,60,8
1713310957031,COGS 14B,A01,489177,Hoffman; Drew Ellen,69,0,75,6
1713310958059,COGS 100,A01,489181,Allen; Michael Gordon,66,0,75,9
1713310959136,COGS 101A,A01,489183,Staff,49,0,60,11
1713310960164,COGS 101B,A01,489185,Allen; Michael Gordon,13,0,30,17
1713310961193,COGS 101C,A01,526786,Staff,25,0,30,5
1713310963244,COGS 107A,A01,489189,Boyle; Mary E. T.,22,0,35,13
1713310964274,COGS 107B,A01,627144,Mooshagian; Eric Frederick,60,0,60,0
1713310965299,COGS 118A,A01,489191,Staff,0,30,40,40
1713310967352,COGS 171GS,A01,489194,Pineda; Jaime A,22,0,28,6
1713310968378,COGS 172,A01,489196,Staff,6,0,30,24
1713310969404,COGS 174GS,A01,489264,Pineda; Jaime A,22,0,28,6
1713310970431,COGS 180,A01,627150,Staff,29,0,30,1
1713310971455,COGS 186,A01,489274,Staff,4,0,30,26
1713310972478,COMM 10,A01,489276,Staff,23,0,25,2
1713310972478,COMM 10,A02,489303,Staff,23,0,25,2
1713310973504,COMM 100A,A01,489312,Staff,18,0,25,7
1713310973504,COMM 100A,A02,489313,Staff,24,0,25,1
1713310974532,COMM 106T,A00,512540,Staff,34,0,35,1
1713310975561,COMM 107,A00,489347,Staff,31,0,35,4
1713310976589,COMM 109P,A00,489358,Staff,31,0,35,4
1713310977615,COMM 132,A00,489361,McKenna; Denise,28,0,30,2
1713310978640,COMM 146,A00,489362,Halm; Gavin Patrick,27,0,30,3
1713310979667,COMM 190,A00,489363,Abuelhiga; Soraya Jill,20,0,23,3
1713310980694,CSE 8A,A50,489366,Staff,23,0,25,2
1713310980694,CSE 8A,A51,489367,Staff,24,0,25,1
1713310981720,CSE 11,A01,489398,Cao; Yingjun,81,0,100,19
1713310982748,CSE 12,A01,489487,Staff,43,0,50,7
1713310983778,CSE 20,A01,489497,Staff,49,0,50,1
1713310984806,CSE 21,A01,489517,Braun; Oliver,44,0,50,6
1713310985833,CSE 101,A01,489524,Braun; Oliver,0,14,50,50
1713310986858,CSE 105,A01,512594,Jones; Miles E,81,0,100,19
1713310986858,CSE 105,B01,512598,Jones; Miles E,63,0,100,37
1713310987886,CSE 140,A01,489538,Staff,44,0,50,6
1713310988912,CSE 141,A01,489550,Eldon; John,76,0,100,24
1713310989940,CSE 141L,A01,489571,Eldon; John,74,0,100,26
1713310990969,CSE 151A,A01,489583,Solares; Edwin A,151,0,200,49
1713310991996,CSE 175,A01,510886,Kumar; Rakesh,30,0,30,0
1713310993022,CSE 190,A00,516828,Dubnov; Shlomo,41,0,49,8
1713310994051,DOC 100D,A00,489667,Pass; Natalye Joann,23,0,25,2
1713310995082,DSC 10,A01,624268,Staff,72,0,75,3
1713310996108,DSC 20,A01,624476,Staff,50,0,50,0
1713310997133,DSC 40A,A01,624608,Staff,40,0,40,0
1713310998804,DSGN 1,A01,489179,Rill; Bryan,36,0,50,14
1713311000578,ECE 17,A01,490489,Sahay; Rajeev,18,0,30,12
1713311001603,ECE 65,A50,490492,Staff,16,0,20,4
1713311001603,ECE 65,A51,490493,Staff,20,0,20,0
1713311002628,ECON 1,A01,489715,Famulari; Melissa,69,0,70,1
1713311003663,ECON 2,A01,489717,Levkoff; Steven B.,68,0,70,2
1713311004689,ECON 3,A01,489948,Staff,70,0,70,0
1713311006737,ECON 5,A01,490103,Staff,28,0,30,2
1713311006737,ECON 5,B01,626281,Dai; Yinlin,45,0,45,0
1713311007766,ECON 100A,A01,490127,Famulari; Melissa,68,0,70,2
1713311008790,ECON 100B,A01,490129,Staff,64,0,70,6
1713311009814,ECON 109,A01,490187,Shishkin; Denis,27,0,35,8
1713311010841,ECON 110A,A01,490190,Levkoff; Steven B.,62,0,70,8
1713311011869,ECON 120A,A01,490245,Dai; Yinlin,65,0,70,5
1713311012896,ECON 120B,A01,490247,Nieto-Barthaburu; Augusto,60,0,70,10
1713311013925,ECON 120C,A01,490253,Sun; Yixiao,31,0,35,4
1713311013925,ECON 120C,B01,490255,Sun; Yixiao,34,0,35,1
1713311014950,ECON 129,A00,490256,Eckert; Fabian Paul,26,0,35,9
1713311015979,ECON 131,A00,490257,Nieto-Barthaburu; Augusto,2,0,35,33
1713311017004,ECON 138,A00,490258,Bharadwaj; Prashant,22,0,35,13
1713311017004,ECON 138,B00,490259,Bharadwaj; Prashant,18,0,35,17
1713311018029,ECON 159,A00,490260,Hendrickson; Gerald M.,0,7,0,0
1713311019055,ECON 178,A01,553995,Zhu; Ying,27,0,35,8
1713311020084,EDS 40,A01,512576,Black; Alison Michelle,20,0,20,0
1713311021109,EDS 107,A01,515848,Staff,30,0,30,0
1713311022133,EDS 110R,A01,490262,Staff,26,0,30,4
1713311023163,EDS 112,A01,490264,Chapman; Thandeka K,43,0,50,7
1713311024190,EDS 113,A00,490266,Staff,26,0,30,4
1713311025218,EDS 118,A00,490267,Warstadt; Melissa Fawn,26,0,30,4
1713311026245,EDS 124BR,A00,490268,Eguchi; Emi,9,0,25,16
1713311026245,EDS 124BR,B00,490269,Eguchi; Emi,25,0,25,0
1713311027271,EDS 126,A01,490271,Jones; Makeba,45,0,50,5
1713311028296,EDS 135,A01,490316,Staff,19,0,20,1
1713311029327,ENVR 142GS,A00,519514,Chang; Edmond Yi-Teh,28,0,28,0
1713311030353,ETHN 103,A00,490504,Staff,32,0,36,4
1713311031379,ETHN 103A,A00,490505,Man; Simeon S,5,0,9,4
1713311032410,ETHN 109,A00,490506,Staff,30,0,30,0
1713311033435,ETHN 118,A00,490507,Staff,35,0,36,1
1713311034460,ETHN 119,A00,490508,Staff,36,0,36,0
1713311035485,ETHN 121R,A00,490518,Choi; Esther Min,29,0,36,7
1713311036510,ETHN 127,A00,490528,Staff,15,0,15,0
1713311037538,ETHN 139,A00,490573,Staff,10,0,10,0
1713311038566,ETHN 150,A00,490575,Staff,15,0,15,0
1713311039591,GLBH 20,A00,491705,Elwardani; Nile Regina,38,0,40,2
1713311040620,GLBH 101,A00,491706,Staff,20,0,20,0
1713311041646,GLBH 111,A01,491708,Burgos; Jose L.,15,0,15,0
1713311042671,GLBH 146,A00,491709,Staff,11,0,20,9
1713311043698,GLBH 148,A00,491710,Olivas Hernandez; Olga Lid,14,0,20,6
1713311044724,GLBH 150,A00,491711,Sloane; Julia Kathryn,20,0,20,0
1713311045750,HIEA 131,A00,491760,Staff,30,0,32,2
1713311046773,HIEA 153,A00,491762,Staff,29,0,30,1
1713311047802,HIEU 124,A00,491811,Staff,26,0,32,6
1713311048832,HIEU 124GS,A00,491812,Markman; Kristina,28,0,28,0
1713311049857,HIEU 147,A00,491813,Staff,30,0,32,2
1713311050885,HIEU 149GS,A00,491816,Caldwell; Michael Alan,28,0,28,0
1713311051910,HILD 2C,A01,491713,Hendrickson; Gerald M.,27,0,30,3
1713311052937,HILD 7B,A01,491715,Kwak; Nancy,13,0,30,17
1713311053964,HILD 10,A01,491717,Staff,14,0,20,6
1713311054988,HILD 30GS,A00,491719,Edington; Claire Ellen,24,0,28,4
1713311056014,HINE 109,A00,491818,Shafir; Nir,28,0,32,4
1713311057042,HINE 128,A00,491821,Shafir; Nir,31,0,32,1
1713311058067,HISC 117,A00,491830,Staff,29,0,32,3
1713311059095,HIUS 103,A00,491834,Man; Simeon S,15,0,23,8
1713311060121,HIUS 108B,A00,491835,Staff,29,0,30,1
1713311061146,HIUS 141,A00,491836,Hendrickson; Gerald M.,29,0,32,3
1713311062172,HIUS 149,A00,491839,Staff,27,0,32,5
1713311063199,HUM 3,A01,512617,Crum; Matthew Stephen,45,0,50,5
1713311063199,HUM 3,A02,512618,Crum; Matthew Stephen,48,0,50,2
1713311064279,HUM 3GS,A00,512663,Markman; Kristina,0,0,0,0
1713311064279,HUM 3GS,B00,512664,Staff,0,0,0,0
1713311065305,HUM 4,A01,512620,West; Geoffrey Scott,33,0,50,17
1713311066334,HUM 4GS,A00,512666,Lyon; Antony J.,0,0,0,3
1713311067366,HUM 4R,A01,512625,Watkins; Eric,49,0,50,1
1713311068397,HUM 5,A01,512649,Zavodny; Tatiana Sophia,32,0,50,18
1713311068397,HUM 5,B01,512661,Zroka; Ryan Edward,48,0,50,2
1713311069424,INTL 190,A00,490577,Segui; Alan S,0,0,0,5
1713311070450,JAPN 20AR,A01,491267,Ross; Kayoko F,11,0,20,9
1713311071479,JAPN 180,A00,491285,Berman; Michael David,34,0,40,6
1713311072510,LATI 50,A01,502536,Kokinis; Troy Andreas,18,0,22,4
1713311072510,LATI 50,A02,502551,Kokinis; Troy Andreas,22,0,22,0
1713311072510,LATI 50,A03,502650,Kokinis; Troy Andreas,22,0,22,0
1713311072510,LATI 50,A04,502909,Kokinis; Troy Andreas,22,0,22,0
1713311073536,LATI 160,A01,502920,Kokinis; Troy Andreas,30,0,30,0
1713311074566,LIFR 1A,A00,490494,Van Moer; Vinciane G,17,0,20,3
1713311075590,LIFR 1AX,A00,490495,Van Moer; Vinciane G,17,0,20,3
1713311076615,LIFR 1B,A00,490496,Van Moer; Vinciane G,19,0,20,1
1713311077641,LIFR 1BX,A00,490497,Van Moer; Vinciane G,19,0,20,1
1713311078668,LIGN 8,A00,505198,McIntosh; Justin Daniel,137,0,150,13
1713311079697,LIGN 9GS,A00,491239,Lott; Margaret S.,18,0,20,2
1713311080722,LIGN 101,A01,505200,McIntosh; Justin Daniel,25,0,30,5
1713311081747,LIGN 120,A01,491244,Staff,24,0,30,6
1713311082776,LIGN 149GS,A00,491245,Lott; Margaret S.,18,0,20,2
1713311083804,LIGN 170,A00,491247,Staff,24,0,30,6
1713311084833,LISP 1D,A00,490498,Munoz Sanchez; Alicia,11,0,14,3
1713311084833,LISP 1D,B00,490499,Munoz Sanchez; Alicia,6,0,14,8
1713311084833,LISP 1D,C00,490500,Munoz Sanchez; Alicia,10,0,14,4
1713311084833,LISP 1D,D00,490501,Munoz Sanchez; Alicia,11,0,14,3
1713311085862,LISP 1DX,A00,490502,Munoz Sanchez; Alicia,18,0,28,10
1713311085862,LISP 1DX,B00,490503,Munoz Sanchez; Alicia,19,0,28,9
1713311087917,LTAM 110,A00,491847,Staff,23,0,25,2
1713311088942,LTCS 119,A00,491848,Staff,12,0,15,3
1713311089968,LTCS 130,A00,491849,Staff,24,0,25,1
1713311092022,LTEA 120C,A00,491852,Staff,34,0,40,6
1713311093047,LTEN 130GS,A00,491853,Lyon; Antony J.,25,0,28,3
1713311094073,LTEN 148,A00,491855,Staff,23,0,25,2
1713311095105,LTEN 159,A00,491856,Staff,21,0,25,4
1713311096130,LTEN 180,A00,491857,Staff,9,0,15,6
1713311098186,LTSP 123GS,A00,505928,Bessett; Ryan Matthew,25,0,28,3
1713311099214,LTSP 174GS,A00,506037,Bessett; Ryan Matthew,25,0,28,3
1713311101264,LTWR 102,A00,491861,Staff,11,0,15,4
1713311102292,LTWR 106,A00,491862,Staff,10,0,15,5
1713311103317,MAE 11,A00,490930,Bahadori; Mohammad Yousef,97,0,100,3
1713311104344,MAE 30A,A00,490931,Qi; Huihui,38,0,40,2
1713311105374,MAE 101A,A00,491036,Sadeghizadeh; Zahra,98,0,100,2
1713311106397,MAE 101C,A00,491037,Seshadri; Kalyanasundaram,76,0,100,24
1713311107422,MAE 113,A00,491040,Seshadri; Kalyanasundaram,66,0,80,14
1713311108450,MAE 131A,A00,491041,Ghazinejad; Maziar,39,0,40,1
1713311109476,MAE 142,A00,491053,Staff,39,0,40,1
1713311110501,MAE 143A,A00,491054,Staff,40,0,50,10
1713311111528,MAE 150,A00,491092,Truong; Phuong Thi Ngoc,24,0,35,11
1713311112554,MATH 3C,A01,494031,Pardo Guerra; Sebastian,30,0,30,0
1713311112554,MATH 3C,A02,494032,Pardo Guerra; Sebastian,29,0,30,1
1713311113585,MATH 10A,A01,494034,Staff,27,0,30,3
1713311113585,MATH 10A,A02,494035,Staff,29,0,30,1
1713311113585,MATH 10A,B01,494037,Staff,27,0,30,3
1713311113585,MATH 10A,B02,494038,Staff,29,0,30,1
1713311114640,MATH 10B,A01,494040,Habib; Yousaf,24,0,30,6
1713311114640,MATH 10B,A02,494041,Habib; Yousaf,28,0,30,2
1713311114640,MATH 10B,A03,494042,Habib; Yousaf,30,0,30,0
1713311114640,MATH 10B,A04,494043,Habib; Yousaf,30,0,30,0
1713311114640,MATH 10B,B01,494045,Habib; Yousaf,28,0,30,2
1713311114640,MATH 10B,B02,494046,Habib; Yousaf,30,0,30,0
1713311114640,MATH 10B,B03,494047,Habib; Yousaf,30,0,30,0
1713311114640,MATH 10B,B04,494048,Habib; Yousaf,30,0,30,0
1713311115673,MATH 18,A01,494050,Kemp; Todd Aahron,27,0,30,3
1713311115673,MATH 18,A02,494051,Kemp; Todd Aahron,29,0,30,1
1713311115673,MATH 18,B01,494054,Kemp; Todd Aahron,28,0,30,2
1713311115673,MATH 18,B02,494055,Kemp; Todd Aahron,29,0,30,1
1713311116696,MATH 20A,A01,494059,Suk; Andrew Hoon,30,0,30,0
1713311117727,MATH 20B,A01,494061,Briones; Jor-el Thomas Caparas,34,0,35,1
1713311117727,MATH 20B,B01,494063,Bach; Quang Tran,34,0,35,1
1713311118753,MATH 20C,A01,494065,Staff,28,0,30,2
1713311118753,MATH 20C,A02,494066,Staff,30,0,30,0
1713311118753,MATH 20C,A03,494067,Staff,30,0,30,0
1713311118753,MATH 20C,A04,494068,Staff,30,0,30,0
1713311118753,MATH 20C,B01,494070,Zhang; Ming,26,0,30,4
1713311118753,MATH 20C,B02,494071,Zhang; Ming,29,0,30,1
1713311118753,MATH 20C,B03,494072,Zhang; Ming,29,0,30,1
1713311118753,MATH 20C,B04,494073,Zhang; Ming,29,0,30,1
1713311119778,MATH 20D,A01,494075,Staff,25,0,30,5
1713311119778,MATH 20D,A02,494076,Staff,30,0,30,0
1713311120804,MATH 20E,A01,494079,Staff,25,0,30,5
1713311120804,MATH 20E,A02,494080,Staff,27,0,30,3
1713311120804,MATH 20E,B01,494082,Staff,28,0,30,2
1713311120804,MATH 20E,B02,494083,Staff,25,0,30,5
1713311121836,MATH 103A,A01,494085,Aliabadi Sr.; Mohsen,17,0,30,13
1713311121836,MATH 103A,A02,494086,Aliabadi Sr.; Mohsen,28,0,30,2
1713311121836,MATH 103A,B01,494088,Aliabadi Sr.; Mohsen,22,0,30,8
1713311121836,MATH 103A,B02,494089,Aliabadi Sr.; Mohsen,28,0,30,2
1713311122868,MATH 109,A01,494091,Staff,30,0,30,0
1713311122868,MATH 109,A02,494092,Staff,30,0,30,0
1713311122868,MATH 109,B01,494094,Staff,28,0,30,2
1713311122868,MATH 109,B02,494095,Staff,29,0,30,1
1713311123895,MATH 142A,A01,494097,Chow; Bennett,16,0,30,14
1713311123895,MATH 142A,A02,494098,Chow; Bennett,24,0,30,6
1713311123895,MATH 142A,B01,494100,Chow; Bennett,20,0,30,10
1713311123895,MATH 142A,B02,494101,Chow; Bennett,29,0,30,1
1713311125952,MATH 168A,A01,516677,Dumitriu; Ioana,16,0,35,19
1713311126982,MATH 170A,A01,516679,Dumitriu; Ioana,20,0,30,10
1713311126982,MATH 170A,A02,516680,Dumitriu; Ioana,28,0,30,2
1713311128007,MATH 193A,A01,494107,Staff,16,0,30,14
1713311128007,MATH 193A,A02,494108,Staff,23,0,30,7
1713311128007,MATH 193A,A03,494109,Staff,29,0,30,1
1713311128007,MATH 193A,A04,494110,Staff,24,0,30,6
1713311131083,MGT 16,A00,491930,McKay; Michael J,93,0,98,5
1713311132106,MGT 18,A00,491992,McKay; Michael J,97,0,98,1
1713311133132,MGT 71,A00,492003,Staff,78,0,98,20
1713311134160,MGT 103,A00,505209,Eberhard; Craig A,85,0,98,13
1713311135190,MGT 131A,A00,505210,Anderson; John Charles,91,0,98,7
1713311137245,MGT 153,A00,492077,Perols; Johan Lars,42,0,90,48
1713311140324,MGT 164,A00,492222,McKay; Mary A,94,0,98,4
1713311141352,MGT 172,A00,492245,Staff,59,0,60,1
1713311141352,MGT 172,B00,505526,Hedges; Kathleen,76,0,98,22
1713311142376,MGT 181,A00,505669,Dunn; Louis Jean,88,0,98,10
1713311143400,MMW 14,A01,494399,Staff,23,0,28,5
1713311143400,MMW 14,A02,494400,Staff,26,0,28,2
1713311143400,MMW 14,A03,494401,Staff,28,0,28,0
1713311143400,MMW 14,A04,494402,Staff,28,0,28,0
1713311143400,MMW 14,B01,494404,Carreras; Maria Victoria,14,0,28,14
1713311143400,MMW 14,B02,494405,Carreras; Maria Victoria,27,0,28,1
1713311143400,MMW 14,B03,494406,Carreras; Maria Victoria,28,0,28,0
1713311143400,MMW 14,B04,494407,Carreras; Maria Victoria,28,0,28,0
1713311144424,MMW 14GS,A00,506250,Chang; Edmond Yi-Teh,0,0,0,0
1713311145451,MMW 121R,A01,494415,Adamiak; Patrick John,14,0,28,14
1713311145451,MMW 121R,A02,494416,Adamiak; Patrick John,25,0,28,3
1713311146478,MUS 1A,A01,494113,Staff,12,0,25,13
1713311146478,MUS 1A,A02,494114,Staff,25,0,25,0
1713311147506,MUS 4,A01,494116,Staff,24,0,25,1
1713311147506,MUS 4,A02,494117,Staff,22,0,25,3
1713311148531,MUS 5R,A01,494236,Dubnov; Shlomo,11,0,25,14
1713311148531,MUS 5R,A02,494237,Dubnov; Shlomo,25,0,25,0
1713311149558,MUS 6,A01,494122,Staff,16,0,25,9
1713311149558,MUS 6,A02,494123,Staff,24,0,25,1
1713311150583,MUS 7,A01,494125,Staff,17,0,25,8
1713311150583,MUS 7,A02,494126,Staff,24,0,25,1
1713311151610,MUS 11,A01,494128,Staff,23,0,25,2
1713311151610,MUS 11,A02,494129,Staff,25,0,25,0
1713311152637,MUS 13,A01,494131,Staff,25,0,25,0
1713311152637,MUS 13,A02,494132,Staff,25,0,25,0
1713311153665,MUS 15,A01,494134,Staff,20,0,25,5
1713311153665,MUS 15,A02,494135,Staff,25,0,25,0
1713311153665,MUS 15,B01,494137,Staff,24,0,25,1
1713311154691,MUS 80,A00,494232,Staff,25,0,25,0
1713311154691,MUS 80,B00,494233,Staff,25,0,25,0
1713311154691,MUS 80,C00,494234,Staff,23,0,25,2
1713311155716,MUS 95C,A00,494141,Staff,73,0,75,2
1713311156741,MUS 114,A00,494142,Staff,41,0,50,9
1713311157772,NANO 15,A01,490636,Drews; Aaron,7,0,7,0
1713311158803,PHIL 1,A00,490578,Grush; Rick Scott,50,0,50,0
1713311159830,PHIL 10,A01,490580,Grush; Rick Scott,33,0,35,2
1713311159830,PHIL 10,A02,490586,Grush; Rick Scott,33,0,35,2
1713311160860,PHIL 27,A01,490591,Staff,24,0,25,1
1713311160860,PHIL 27,A02,490592,Staff,25,0,25,0
1713311160860,PHIL 27,A03,490593,Staff,25,0,25,0
1713311160860,PHIL 27,A04,490598,Staff,25,0,25,0
1713311161887,PHIL 32,A01,490611,Staff,20,0,20,0
1713311161887,PHIL 32,A02,490618,Staff,20,0,20,0
1713311162916,PHIL 90,A00,490624,Staff,40,0,40,0
1713311163945,PHIL 136,A00,490627,Cohen; Jonathan David,38,0,40,2
1713311164973,PHIL 155,A00,490634,Staff,64,0,70,6
1713311165999,PHYS 1A,A00,491610,Staff,246,0,250,4
1713311167022,PHYS 1AL,001,491616,Tsai; Philbert S,28,0,30,2
1713311167022,PHYS 1AL,002,491618,Tsai; Philbert S,30,0,30,0
1713311168105,PHYS 1B,A00,491623,Staff,244,0,250,6
1713311169134,PHYS 1BL,001,491626,Tsai; Philbert S,26,0,30,4
1713311169134,PHYS 1BL,002,491628,Tsai; Philbert S,28,0,30,2
1713311170163,PHYS 1C,A00,491632,Staff,223,0,245,22
1713311171187,PHYS 1CL,001,491635,Tsai; Philbert S,11,0,30,19
1713311171187,PHYS 1CL,002,491643,Tsai; Philbert S,24,0,30,6
1713311172212,PHYS 2AR,A01,491651,Meyertholen; Andrew D.,45,0,50,5
1713311173242,PHYS 2B,A01,491659,Staff,107,0,115,8
1713311174271,PHYS 2BL,A01,491685,Staff,22,0,24,2
1713311174271,PHYS 2BL,A02,491700,Staff,23,0,24,1
1713311175299,PHYS 2C,A01,505161,Staff,107,0,115,8
1713311176331,PHYS 4A,A01,491704,Grinstein; Benjamin,99,0,100,1
1713311177363,POLI 5D,A01,494144,Staff,3,0,5,2
1713311177363,POLI 5D,B01,626283,Dai; Yinlin,5,0,5,0
1713311178389,POLI 12,A00,494145,Staff,44,0,45,1
1713311179415,POLI 13R,A00,494146,Forman; Fonna,46,0,50,4
1713311180441,POLI 27,A01,494148,Staff,57,0,60,3
1713311181466,POLI 30,A00,494149,Staff,49,0,50,1
1713311182495,POLI 100DA,A00,494150,Staff,23,0,25,2
1713311184546,POLI 100I,A00,494152,Staff,28,0,30,2
1713311185573,POLI 104B,A00,494153,Smith; Glenn Chatmas,54,0,55,1
1713311186597,POLI 104F,A00,494154,Staff,28,0,30,2
1713311187626,POLI 104I,A00,494155,Smith; Glenn Chatmas,30,0,30,0
1713311188653,POLI 110C,A00,494156,Ingham; Sean,23,0,25,2
1713311189679,POLI 117R,A00,494157,Forman; Fonna,13,0,20,7
1713311190704,POLI 118,A00,494158,Ingham; Sean,22,0,25,3
1713311191730,POLI 120H,A00,494159,Fisk; David Lee,41,0,45,4
1713311192759,POLI 131CR,A00,494160,Hoston; Germaine,38,0,45,7
1713311193784,POLI 133J,A00,494161,Staff,33,0,35,2
1713311194812,POLI 135,A00,494162,Fisk; David Lee,33,0,35,2
1713311195839,POLI 140A,A00,494164,Staff,22,0,30,8
1713311196865,POLI 142I,A00,494165,Staff,30,0,30,0
1713311197889,POLI 144D,A00,494166,Staff,23,0,25,2
1713311198920,POLI 151,A00,494167,Staff,30,0,30,0
1713311199944,POLI 153,A00,494168,Staff,33,0,35,2
1713311200969,POLI 160AA,A00,494169,Staff,35,0,40,5
1713311202000,POLI 162,A00,494170,Mignozzetti; Umberto,20,0,25,5
1713311203029,POLI 171,A00,494171,Mignozzetti; Umberto,21,0,25,4
1713311204054,PSYC 1,A00,494172,Staff,97,0,100,3
1713311205083,PSYC 2,A00,494173,Moranton; Nirelia Melbina-,44,0,50,6
1713311206112,PSYC 3,A00,494174,Staff,30,0,30,0
1713311207141,PSYC 6,A00,494175,Staff,17,0,20,3
1713311208169,PSYC 60,A01,494177,Staff,40,0,45,5
1713311209199,PSYC 70,A01,505724,Geller; Emma Harlan,42,0,45,3
1713311210230,PSYC 101,A00,494180,Heyman; Gail D.,87,0,100,13
1713311211258,PSYC 105,A00,494181,Geller; Emma Harlan,64,0,90,26
1713311212282,PSYC 106,A00,494182,Dobkins; Karen R.,33,0,45,12
1713311213308,PSYC 108,A00,494183,Adrian; Julia Anna,94,0,100,6
1713311214333,PSYC 114,A01,494185,Winkielman; Piotr,2,0,30,28
1713311215357,PSYC 122,A00,494186,Moranton; Nirelia Melbina-,38,0,50,12
1713311216383,PSYC 124,A00,494187,Chapman; Eddie Nathaniel,71,0,80,9
1713311217412,PSYC 131,A00,494188,Anagnostaras; Stephan,58,0,80,22
1713311218434,PSYC 144,A00,494189,Staff,16,0,50,34
1713311219460,PSYC 154,A00,494190,Lacefield; Katharine I,133,0,180,47
1713311220485,PSYC 162,A00,494191,Wixted; John T,83,0,100,17
1713311221512,PSYC 172,A00,494192,Gorman; Michael R.,38,0,45,7
1713311222536,PSYC 178,A00,494193,Glaser; Dale,40,0,45,5
1713311223575,PSYC 193,A00,505725,Chapman; Eddie Nathaniel,20,0,20,0
1713311224609,RELI 145GS,A00,519817,Rahimi; Babak,19,0,20,1
1713311225640,SE 101A,A01,490862,Chadha; Mayank,24,0,25,1
1713311226665,SE 101C,A01,490924,Krysl; Petr,18,0,20,2
1713311227688,SE 110A,A01,490928,Staff,19,0,20,1
1713311228718,SE 130A,A00,490929,Morrison; Machel Leigh,64,0,70,6
1713311229747,SIO 1,A01,519325,Staff,39,0,40,1
1713311230774,SIO 30,A01,519327,Staff,39,0,40,1
1713311231800,SIO 40,A00,519328,Staff,40,0,40,0
1713311232825,SIO 46GS,A00,519819,Cook; Geoffrey W,18,0,25,7
1713311233848,SIO 109R,A00,494197,Forman; Fonna,4,0,20,16
1713311234876,SIO 121GS,A00,519827,Cook; Geoffrey W,18,0,25,7
1713311235901,SIO 132,A01,519330,Staff,38,0,40,2
1713311236929,SIO 133,A01,519397,Staff,38,0,40,2
1713311237954,SIO 139,A00,519396,Kacev; David,33,0,40,7
1713311238982,SOCI 1,A01,494199,Thorpe; Charles Robert,23,0,30,7
1713311238982,SOCI 1,A02,494200,Thorpe; Charles Robert,30,0,30,0
1713311238982,SOCI 1,A03,494201,Thorpe; Charles Robert,29,0,30,1
1713311238982,SOCI 1,A04,494202,Thorpe; Charles Robert,29,0,30,1
1713311238982,SOCI 1,A05,494203,Thorpe; Charles Robert,29,0,30,1
1713311238982,SOCI 1,A06,494204,Thorpe; Charles Robert,30,0,30,0
1713311238982,SOCI 1,A07,494205,Thorpe; Charles Robert,29,0,30,1
1713311240012,SOCI 60,A01,494207,Staff,36,0,40,4
1713311240012,SOCI 60,A02,494208,Staff,39,0,40,1
1713311241036,SOCI 100,A01,494210,Payne; Christine Anna,28,0,30,2
1713311241036,SOCI 100,A02,494211,Payne; Christine Anna,27,0,30,3
1713311242060,SOCI 109M,A00,494212,Staff,20,0,20,0
1713311243089,SOCI 110,A00,494213,Staff,35,0,40,5
1713311245141,SOCI 118E,A00,494215,Ng; Kwai,38,0,40,2
1713311246166,SOCI 125,A00,494216,Calderon-Zaks; Michael Aar,42,0,45,3
1713311247189,SOCI 126,A01,494218,Jones; Makeba,4,0,5,1
1713311248216,SOCI 131,A00,494219,Thorpe; Charles Robert,28,0,30,2
1713311250268,SOCI 135,A00,494221,Payne; Christine Anna,35,0,50,15
1713311251300,SOCI 136E,A00,626690,Ruiz; Jonathan Joseph,25,0,25,0
1713311252324,SOCI 138GS,A00,494222,Navon; Daniel,24,0,28,4
1713311254372,SOCI 145,A00,494224,Staff,42,0,45,3
1713311255412,SOCI 153,A00,494225,Staff,28,0,30,2
1713311256437,SOCI 160E,A00,494226,Ng; Kwai,33,0,40,7
1713311257464,SOCI 180,A00,494227,Staff,29,0,30,1
1713311258492,SOCI 189GS,A00,494228,Ribas Norris; Janet Vanesa,11,0,11,0
1713311259516,SOCI 190GS,A00,553232,Ribas Norris; Janet Vanesa,11,0,11,0
1713311260540,SOMI 220,A00,627178,Schneid; Stephen David,30,0,30,0
1713311261567,SYN 2,001,490768,Staff,14,0,15,1
1713311261567,SYN 2,002,490769,Staff,15,0,15,0
1713311261567,SYN 2,004,490775,Staff,0,0,0,0
1713311261567,SYN 2,003,490774,Staff,0,0,0,0
1713311261567,SYN 2,005,490776,Staff,0,0,0,0
1713311262596,SYN 2R,001,490779,Staff,13,0,15,2
1713311262596,SYN 2R,002,514635,Staff,14,0,15,1
1713311263627,SYN 100,A01,490783,Staff,15,0,20,5
1713311263627,SYN 100,B01,490787,Staff,11,0,20,9
1713311263627,SYN 100,C01,490789,Staff,13,0,20,7
1713311264654,SYN 150,A00,490817,Staff,14,0,15,1
1713311264654,SYN 150,B00,514610,Staff,15,0,15,0
1713311265682,TDAC 1,A00,492753,Walsh; Kim C.,19,0,20,1
1713311265682,TDAC 1,B00,492754,Harting; Carla Kelso,19,0,20,1
1713311265682,TDAC 1,C00,513995,Salovey; Todd,17,0,20,3
1713311266709,TDAC 101,A00,492766,Harting; Carla Kelso,17,0,20,3
1713311267737,TDAC 102,A00,492768,Basso; Beatrice,19,0,20,1
1713311268763,TDDE 111,A00,492769,Staff,25,0,25,0
1713311269794,TDDE 131,A00,492770,Staff,15,0,15,0
1713311269794,TDDE 131,B00,492771,Staff,15,0,15,0
1713311270822,TDDE 131GS,A00,523716,Guirguis; Mark C,24,0,28,4
1713311271907,TDGE 1,A01,492756,Salovey; Todd,57,0,60,3
1713311272937,TDGE 5,A01,492758,Staff,24,0,25,1
1713311273960,TDGE 10,A00,492759,Fulton; Julia,212,0,220,8
1713311274990,TDGE 11,A00,492760,Castro; Robert Jess,200,0,200,0
1713311277041,TDGE 124,A00,492772,Fulton; Julia,193,0,220,27
1713311278068,TDGE 125,A00,492773,Meyer; Ursula,40,0,50,10
1713311278068,TDGE 125,B00,492774,Staff,50,0,50,0
1713311278068,TDGE 125,C00,523565,Staff,49,0,50,1
1713311279093,TDGE 125GS,A00,523580,Guirguis; Mark C,24,0,28,4
1713311280122,TDGE 127,A00,492775,Havis; Allan,41,0,50,9
1713311281147,TDHT 101,A00,492776,Staff,35,0,35,0
1713311282174,TDMV 1,A00,492762,Caligagan; Maria T.,30,0,30,0
1713311282174,TDMV 1,B00,492763,Arcidiacono; Kristin,25,0,30,5
1713311283200,TDMV 2,A00,492764,Weinberg; Sadie,29,0,30,1
1713311284229,TDMV 3,A00,492765,Mack; Kara Shanai',39,0,40,1
1713311285255,TDMV 138,A00,492777,Mack; Kara Shanai',36,0,40,4
1713311286281,TDMV 140,A00,492778,Lima; Paulo Henrique,40,0,40,0
1713311287311,TDMV 142,A00,492779,Caligagan; Maria T.,36,0,40,4
1713311287311,TDMV 142,B00,492780,Caligagan; Tony,37,0,40,3
1713311288340,TDMV 143,A00,492781,Fyall; Daunte Edward,39,0,40,1
1713311289375,USP 1,A01,492401,Kwak; Nancy,26,0,35,9
1713311290407,USP 2,A01,492453,Hinds; Juli Beth,35,0,35,0
1713311291432,USP 3,A01,492516,Staff,29,0,35,6
1713311292457,USP 4,A00,492522,McTague; Sarah,19,0,25,6
1713311293481,USP 100,A00,492523,Staff,33,0,35,2
1713311294506,USP 101,A00,492524,Staff,13,0,15,2
1713311295530,USP 105,A00,492525,Staff,21,0,25,4
1713311296555,USP 151,A00,492526,Shenkman; Michael Thomas,33,0,35,2
1713311297583,USP 170,A00,492545,Hinds; Juli Beth,33,0,35,2
1713311298611,USP 171GS,A00,492608,Bussell; Mirle Rabinowitz,25,0,28,3
1713311299640,USP 183GS,A00,492613,Peerson; Susan,25,0,28,3
1713311300675,VIS 30,A01,490693,Yoldas; Pinar,21,0,22,1
1713311300675,VIS 30,A02,490694,Yoldas; Pinar,19,0,22,3
1713311301708,VIS 83,A00,490695,Kester; Grant,66,0,75,9
1713311302731,VIS 105D,A00,490696,Staff,22,0,25,3
1713311303757,VIS 124CN,A00,490699,Rose; Jordan M,68,0,75,7
1713311304781,VIS 125GS,A00,511221,Williams; Alena J,21,0,22,1
1713311305805,VIS 128D,A00,490700,Staff,74,0,75,1
1713311306830,VIS 151,A01,490717,Staff,33,0,34,1
1713311306830,VIS 151,A02,490766,Staff,33,0,34,1
1713311307854,VIS 154GS,A00,511972,Williams; Alena J,21,0,22,1
1713311308880,VIS 160A,A00,490767,Stone; Patricia,7,0,10,3
1713311309909,WCWP 10A,A00,490638,Staff,15,0,15,0
1713311309909,WCWP 10A,B00,490640,Staff,15,0,15,0
1713311310936,WCWP 10B,A00,490641,Staff,0,0,0,0
1713311310936,WCWP 10B,B00,490642,Staff,14,0,15,1
1713311310936,WCWP 10B,C00,490644,Staff,13,0,15,2
1713311310936,WCWP 10B,D00,490647,Staff,0,0,0,0
1713311311961,WCWP 100,A00,490655,Staff,0,0,0,0
1713311311961,WCWP 100,B00,490687,Staff,12,0,15,3
1713311314068,ANAR 153,A00,487222,Braswell; Geoffrey E.,55,0,60,5
1713311315093,ANBI 134,A00,487223,Staff,12,0,20,8
1713311316121,ANBI 143GS,A00,487224,Noel; Geoffroy Pierre Jean,20,0,24,4
1713311317145,ANBI 144GS,A00,519548,Noel; Geoffroy Pierre Jean,20,0,24,4
1713311318170,ANSC 101,A00,487225,Staff,19,0,20,1
1713311319197,ANSC 125,A00,487227,Brenner; Suzanne A,39,0,40,1
1713311321249,ANSC 146,A00,487229,Staff,36,0,40,4
1713311322276,ANSC 148,A00,487230,Olivas Hernandez; Olga Lid,39,0,40,1
1713311323307,ANSC 150,A00,504165,Sloane; Julia Kathryn,19,0,20,1
1713311324335,ANSC 180,A00,487232,Staff,13,0,15,2
1713311325358,ANSC 188,A00,627155,Staff,40,0,40,0
1713311326385,ANTH 5,A00,519529,Semendeferi; Ekaterini,15,0,15,0
1713311327410,ANTH 10,A00,487219,Staff,58,0,60,2
1713311328438,ANTH 23,A01,487221,Staff,17,0,20,3
1713311329462,ANTH 102,A00,487233,Wilder; Linnea Lorene,53,0,60,7
1713311330487,ANTH 103,A00,487234,Varma; Saiba,56,0,60,4
1713311331515,ANTH 105,A00,487235,Stewart; Alexander B,56,0,60,4
1713311332543,BENG 100,A01,516685,Taylor Amos; Alyssa C,28,0,30,2
1713311333568,BIBC 102,A01,491316,Flagg; Matthew Paul,44,0,88,44
1713311333568,BIBC 102,A02,491366,Flagg; Matthew Paul,83,0,88,5
1713311334598,BIBC 103,A01,491486,Boumechache; Miyyada,16,0,24,8
1713311334598,BIBC 103,A02,491487,Boumechache; Miyyada,24,0,24,0
1713311335625,BICD 100,A01,516882,Staff,75,0,75,0
1713311335625,BICD 100,A02,516890,Staff,70,0,75,5
1713311336650,BICD 102GS,A00,491488,Lo; Stanley M.,26,0,28,2
1713311337675,BIEB 136GS,A00,516940,Holway; David A. & Shurin; Jonathan,19,0,24,5
1713311338700,BIEB 137GS,A01,517034,Holway; David A. & Shurin; Jonathan,19,0,24,5
1713311339729,BIEB 138GS,A01,491492,Pirino; Giorgia,21,0,28,7
1713311340759,BILD 1,A01,491296,Staff,62,0,63,1
1713311340759,BILD 1,A02,491297,Staff,63,0,63,0
1713311341785,BILD 4,A01,517099,Gonzalez Gamboa; Ivonne,22,0,24,2
1713311341785,BILD 4,A02,517100,Gonzalez Gamboa; Ivonne,24,0,24,0
1713311342814,BILD 60GS,A00,491309,Lo; Stanley M.,26,0,28,2
1713311343890,BIMM 100,A01,517136,Staff,91,0,100,9
1713311344916,BIMM 110,A01,517182,Staff,72,0,100,28
1713311345947,BIMM 120,A01,517228,Pickett; Brooke Elizabeth,40,0,63,23
1713311345947,BIMM 120,A02,517240,Pickett; Brooke Elizabeth,48,0,63,15
1713311346972,BIMM 132GS,A01,491498,Pirino; Giorgia,21,0,28,7
1713311348002,BIMM 143,A01,491589,Bozinovic; Goran,18,0,40,22
1713311349037,BIPN 100,A01,491594,Armour; Jon Christopher,92,0,100,8
1713311350063,BIPN 140,A01,491602,Marino; Marc J,30,0,50,20
1713311352114,CAT 125,A00,515973,Staff,20,0,20,0
1713311353139,CAT 125GS,A00,515974,Rahimi; Babak,19,0,20,1
1713311354169,CAT 125R,A00,515980,Staff,15,0,20,5
1713311354169,CAT 125R,B00,515981,Tosun; Adriana,19,0,20,1
1713311354169,CAT 125R,C00,515987,Hyland; Tina Mae,3,0,20,17
1713311354169,CAT 125R,D00,515988,Bronstein; Phoebe Malan,18,0,20,2
1713311355199,CENG 15,A01,488699,Drews; Aaron,25,0,25,0
1713311356229,CENG 100,A00,505196,Opatkiewicz; Justin Paul,25,0,25,0
1713311357259,CGS 2A,A01,489598,Staff,33,0,35,2
1713311358285,CGS 112,A00,489599,Staff,15,0,15,0
1713311359315,CGS 119,A00,489603,Staff,10,0,10,0
1713311360339,CGS 120,A00,489604,Staff,14,0,15,1
1713311361364,CGS 150,A00,489607,Staff,15,0,15,0
1713311362388,CHEM 6A,A01,488715,Staff,98,0,100,2
1713311363416,CHEM 6B,A01,488719,Piercy; Marc Anthony,100,0,100,0
1713311364442,CHEM 6C,A01,488723,Albizati; Kim F.,94,0,100,6
1713311365470,CHEM 7L,A01,488728,Schurmeier; Kimberly,18,0,24,6
1713311365470,CHEM 7L,A02,488730,Schurmeier; Kimberly,23,0,24,1
1713311365470,CHEM 7L,A03,488734,Schurmeier; Kimberly,23,0,24,1
1713311365470,CHEM 7L,A04,488763,Schurmeier; Kimberly,23,0,24,1
1713311365470,CHEM 7L,B01,488798,Schurmeier; Kimberly,18,0,24,6
1713311365470,CHEM 7L,B02,488801,Schurmeier; Kimberly,23,0,24,1
1713311365470,CHEM 7L,B03,488808,Schurmeier; Kimberly,24,0,24,0
1713311365470,CHEM 7L,B04,488811,Schurmeier; Kimberly,24,0,24,0
1713311366496,CHEM 11,A01,488897,Stallings; Dontarie M,98,0,100,2
1713311367520,CHEM 40A,A01,488913,Albizati; Kim F.,91,0,100,9
1713311368552,CHEM 40B,A01,488920,Weizman; Haim,47,0,50,3
1713311368552,CHEM 40B,A02,488938,Weizman; Haim,46,0,50,4
1713311369579,CHEM 41A,A01,489029,Klosterman; Jeremy K,58,0,60,2
1713311370604,CHEM 41C,A01,500436,Tor; Yitzhak,55,0,60,5
1713311371630,CHEM 43A,A01,500426,Weizman; Haim,4,0,24,20
1713311371630,CHEM 43A,A02,500430,Weizman; Haim,13,0,24,11
1713311371630,CHEM 43A,B01,514041,Klosterman; Jeremy K,16,0,24,8
1713311371630,CHEM 43A,B02,514047,Klosterman; Jeremy K,23,0,24,1
1713311372661,CHEM 108,A01,489140,Jennings; Patricia A.,13,0,24,11
1713311372661,CHEM 108,A02,489142,Jennings; Patricia A.,15,0,24,9
1713311373686,CHEM 114A,A01,489147,Stallings; Dontarie M,79,0,100,21
1713311374716,CHIN 169A,A00,489171,Wang; Xiao,19,0,20,1
1713311376821,COGS 3,A01,518827,Boyle; Mary E. T.,29,0,40,11
1713311377850,COGS 11,A01,489175,Staff,28,0,30,2
1713311378879,COGS 14A,A01,518829,Staff,52,0,60,8
1713311379910,COGS 14B,A01,489177,Hoffman; Drew Ellen,69,0,75,6
1713311380937,COGS 100,A01,489181,Allen; Michael Gordon,66,0,75,9
1713311381962,COGS 101A,A01,489183,Staff,49,0,60,11
1713311382994,COGS 101B,A01,489185,Allen; Michael Gordon,13,0,30,17
1713311384019,COGS 101C,A01,526786,Staff,24,0,30,6
1713311386070,COGS 107A,A01,489189,Boyle; Mary E. T.,22,0,35,13
1713311387097,COGS 107B,A01,627144,Mooshagian; Eric Frederick,60,0,60,0
1713311388122,COGS 118A,A01,489191,Staff,0,30,40,40
1713311390174,COGS 171GS,A01,489194,Pineda; Jaime A,22,0,28,6
1713311391203,COGS 172,A01,489196,Staff,6,0,30,24
1713311392228,COGS 174GS,A01,489264,Pineda; Jaime A,22,0,28,6
1713311393257,COGS 180,A01,627150,Staff,28,0,30,2
1713311394281,COGS 186,A01,489274,Staff,3,0,30,27
1713311395306,COMM 10,A01,489276,Staff,23,0,25,2
1713311395306,COMM 10,A02,489303,Staff,23,0,25,2
1713311396334,COMM 100A,A01,489312,Staff,18,0,25,7
1713311396334,COMM 100A,A02,489313,Staff,24,0,25,1
1713311397363,COMM 106T,A00,512540,Staff,34,0,35,1
1713311398389,COMM 107,A00,489347,Staff,31,0,35,4
1713311399414,COMM 109P,A00,489358,Staff,31,0,35,4
1713311400443,COMM 132,A00,489361,McKenna; Denise,28,0,30,2
1713311401468,COMM 146,A00,489362,Halm; Gavin Patrick,27,0,30,3
1713311402493,COMM 190,A00,489363,Abuelhiga; Soraya Jill,20,0,23,3
1713311403524,CSE 8A,A50,489366,Staff,23,0,25,2
1713311403524,CSE 8A,A51,489367,Staff,24,0,25,1
1713311404550,CSE 11,A01,489398,Cao; Yingjun,81,0,100,19
1713311405579,CSE 12,A01,489487,Staff,43,0,50,7
1713311406603,CSE 20,A01,489497,Staff,49,0,50,1
1713311407630,CSE 21,A01,489517,Braun; Oliver,44,0,50,6
1713311408656,CSE 101,A01,489524,Braun; Oliver,0,15,50,50
1713311409688,CSE 105,A01,512594,Jones; Miles E,81,0,100,19
1713311409688,CSE 105,B01,512598,Jones; Miles E,62,0,100,38
1713311410716,CSE 140,A01,489538,Staff,44,0,50,6
1713311411741,CSE 141,A01,489550,Eldon; John,76,0,100,24
1713311412766,CSE 141L,A01,489571,Eldon; John,74,0,100,26
1713311413793,CSE 151A,A01,489583,Solares; Edwin A,151,0,200,49
1713311414822,CSE 175,A01,510886,Kumar; Rakesh,30,0,30,0
1713311415847,CSE 190,A00,516828,Dubnov; Shlomo,41,0,49,8
1713311416872,DOC 100D,A00,489667,Pass; Natalye Joann,23,0,25,2
1713311417897,DSC 10,A01,624268,Staff,72,0,75,3
1713311418922,DSC 20,A01,624476,Staff,50,0,50,0
1713311419947,DSC 40A,A01,624608,Staff,40,0,40,0
1713311420973,DSGN 1,A01,489179,Rill; Bryan,36,0,50,14
1713311422000,ECE 17,A01,490489,Sahay; Rajeev,18,0,30,12
1713311423029,ECE 65,A50,490492,Staff,16,0,20,4
1713311423029,ECE 65,A51,490493,Staff,20,0,20,0
1713311424055,ECON 1,A01,489715,Famulari; Melissa,69,0,70,1
1713311425081,ECON 2,A01,489717,Levkoff; Steven B.,68,0,70,2
1713311426107,ECON 3,A01,489948,Staff,70,0,70,0
1713311428164,ECON 5,A01,490103,Staff,28,0,30,2
1713311428164,ECON 5,B01,626281,Dai; Yinlin,45,0,45,0
1713311429194,ECON 100A,A01,490127,Famulari; Melissa,68,0,70,2
1713311430219,ECON 100B,A01,490129,Staff,64,0,70,6
1713311431245,ECON 109,A01,490187,Shishkin; Denis,27,0,35,8
1713311432269,ECON 110A,A01,490190,Levkoff; Steven B.,62,0,70,8
1713311433295,ECON 120A,A01,490245,Dai; Yinlin,65,0,70,5
1713311434319,ECON 120B,A01,490247,Nieto-Barthaburu; Augusto,60,0,70,10
1713311435346,ECON 120C,A01,490253,Sun; Yixiao,31,0,35,4
1713311435346,ECON 120C,B01,490255,Sun; Yixiao,34,0,35,1
1713311436376,ECON 129,A00,490256,Eckert; Fabian Paul,26,0,35,9
1713311437400,ECON 131,A00,490257,Nieto-Barthaburu; Augusto,2,0,35,33
1713311438431,ECON 138,A00,490258,Bharadwaj; Prashant,22,0,35,13
1713311438431,ECON 138,B00,490259,Bharadwaj; Prashant,18,0,35,17
1713311439458,ECON 159,A00,490260,Hendrickson; Gerald M.,0,7,0,0
1713311440488,ECON 178,A01,553995,Zhu; Ying,27,0,35,8
1713311441517,EDS 40,A01,512576,Black; Alison Michelle,20,0,20,0
1713311442540,EDS 107,A01,515848,Staff,30,0,30,0
1713311443567,EDS 110R,A01,490262,Staff,26,0,30,4
1713311444597,EDS 112,A01,490264,Chapman; Thandeka K,43,0,50,7
1713311445625,EDS 113,A00,490266,Staff,26,0,30,4
1713311446651,EDS 118,A00,490267,Warstadt; Melissa Fawn,26,0,30,4
1713311447676,EDS 124BR,A00,490268,Eguchi; Emi,9,0,25,16
1713311447676,EDS 124BR,B00,490269,Eguchi; Emi,25,0,25,0
1713311448704,EDS 126,A01,490271,Jones; Makeba,45,0,50,5
1713311449728,EDS 135,A01,490316,Staff,19,0,20,1
1713311450759,ENVR 142GS,A00,519514,Chang; Edmond Yi-Teh,28,0,28,0
1713311451787,ETHN 103,A00,490504,Staff,32,0,36,4
1713311452822,ETHN 103A,A00,490505,Man; Simeon S,5,0,9,4
1713311453846,ETHN 109,A00,490506,Staff,30,0,30,0
1713311454871,ETHN 118,A00,490507,Staff,35,0,36,1
1713311455894,ETHN 119,A00,490508,Staff,36,0,36,0
1713311456921,ETHN 121R,A00,490518,Choi; Esther Min,29,0,36,7
1713311457945,ETHN 127,A00,490528,Staff,15,0,15,0
1713311458970,ETHN 139,A00,490573,Staff,10,0,10,0
1713311459995,ETHN 150,A00,490575,Staff,15,0,15,0
1713311461027,GLBH 20,A00,491705,Elwardani; Nile Regina,38,0,40,2
1713311462055,GLBH 101,A00,491706,Staff,20,0,20,0
1713311463081,GLBH 111,A01,491708,Burgos; Jose L.,15,0,15,0
1713311464106,GLBH 146,A00,491709,Staff,11,0,20,9
1713311465136,GLBH 148,A00,491710,Olivas Hernandez; Olga Lid,14,0,20,6
1713311466161,GLBH 150,A00,491711,Sloane; Julia Kathryn,20,0,20,0
1713311467188,HIEA 131,A00,491760,Staff,30,0,32,2
1713311468213,HIEA 153,A00,491762,Staff,29,0,30,1
1713311469258,HIEU 124,A00,491811,Staff,26,0,32,6
1713311470284,HIEU 124GS,A00,491812,Markman; Kristina,28,0,28,0
1713311471310,HIEU 147,A00,491813,Staff,30,0,32,2
1713311472333,HIEU 149GS,A00,491816,Caldwell; Michael Alan,28,0,28,0
1713311473366,HILD 2C,A01,491713,Hendrickson; Gerald M.,27,0,30,3
1713311474391,HILD 7B,A01,491715,Kwak; Nancy,13,0,30,17
1713311475420,HILD 10,A01,491717,Staff,14,0,20,6
1713311476444,HILD 30GS,A00,491719,Edington; Claire Ellen,24,0,28,4
1713311477472,HINE 109,A00,491818,Shafir; Nir,28,0,32,4
1713311478497,HINE 128,A00,491821,Shafir; Nir,31,0,32,1
1713311479581,HISC 117,A00,491830,Staff,29,0,32,3
1713311480615,HIUS 103,A00,491834,Man; Simeon S,15,0,23,8
1713311481640,HIUS 108B,A00,491835,Staff,29,0,30,1
1713311482666,HIUS 141,A00,491836,Hendrickson; Gerald M.,29,0,32,3
1713311483692,HIUS 149,A00,491839,Staff,27,0,32,5
1713311484717,HUM 3,A01,512617,Crum; Matthew Stephen,45,0,50,5
1713311484717,HUM 3,A02,512618,Crum; Matthew Stephen,48,0,50,2
1713311485744,HUM 3GS,A00,512663,Markman; Kristina,0,0,0,0
1713311485744,HUM 3GS,B00,512664,Staff,0,0,0,0
1713311486769,HUM 4,A01,512620,West; Geoffrey Scott,33,0,50,17
1713311487796,HUM 4GS,A00,512666,Lyon; Antony J.,0,0,0,3
1713311488822,HUM 4R,A01,512625,Watkins; Eric,49,0,50,1
1713311489848,HUM 5,A01,512649,Zavodny; Tatiana Sophia,31,0,50,19
1713311489848,HUM 5,B01,512661,Zroka; Ryan Edward,48,0,50,2
1713311490876,INTL 190,A00,490577,Segui; Alan S,0,0,0,5
1713311491906,JAPN 20AR,A01,491267,Ross; Kayoko F,11,0,20,9
1713311492937,JAPN 180,A00,491285,Berman; Michael David,34,0,40,6
1713311493967,LATI 50,A01,502536,Kokinis; Troy Andreas,18,0,22,4
1713311493967,LATI 50,A02,502551,Kokinis; Troy Andreas,22,0,22,0
1713311493967,LATI 50,A03,502650,Kokinis; Troy Andreas,22,0,22,0
1713311493967,LATI 50,A04,502909,Kokinis; Troy Andreas,22,0,22,0
1713311494992,LATI 160,A01,502920,Kokinis; Troy Andreas,30,0,30,0
1713311496017,LIFR 1A,A00,490494,Van Moer; Vinciane G,17,0,20,3
1713311497046,LIFR 1AX,A00,490495,Van Moer; Vinciane G,17,0,20,3
1713311498070,LIFR 1B,A00,490496,Van Moer; Vinciane G,19,0,20,1
1713311499097,LIFR 1BX,A00,490497,Van Moer; Vinciane G,19,0,20,1
1713311500121,LIGN 8,A00,505198,McIntosh; Justin Daniel,137,0,150,13
1713311501147,LIGN 9GS,A00,491239,Lott; Margaret S.,18,0,20,2
1713311502172,LIGN 101,A01,505200,McIntosh; Justin Daniel,25,0,30,5
1713311503197,LIGN 120,A01,491244,Staff,24,0,30,6
1713311504221,LIGN 149GS,A00,491245,Lott; Margaret S.,18,0,20,2
1713311505249,LIGN 170,A00,491247,Staff,24,0,30,6
1713311506276,LISP 1D,A00,490498,Munoz Sanchez; Alicia,11,0,14,3
1713311506276,LISP 1D,B00,490499,Munoz Sanchez; Alicia,6,0,14,8
1713311506276,LISP 1D,C00,490500,Munoz Sanchez; Alicia,10,0,14,4
1713311506276,LISP 1D,D00,490501,Munoz Sanchez; Alicia,11,0,14,3
1713311507303,LISP 1DX,A00,490502,Munoz Sanchez; Alicia,18,0,28,10
1713311507303,LISP 1DX,B00,490503,Munoz Sanchez; Alicia,19,0,28,9
1713311509354,LTAM 110,A00,491847,Staff,23,0,25,2
1713311510381,LTCS 119,A00,491848,Staff,12,0,15,3
1713311511406,LTCS 130,A00,491849,Staff,24,0,25,1
1713311513459,LTEA 120C,A00,491852,Staff,34,0,40,6
1713311514487,LTEN 130GS,A00,491853,Lyon; Antony J.,25,0,28,3
1713311515516,LTEN 148,A00,491855,Staff,23,0,25,2
1713311516546,LTEN 159,A00,491856,Staff,21,0,25,4
1713311517569,LTEN 180,A00,491857,Staff,9,0,15,6
1713311519619,LTSP 123GS,A00,505928,Bessett; Ryan Matthew,25,0,28,3
1713311520645,LTSP 174GS,A00,506037,Bessett; Ryan Matthew,25,0,28,3
1713311522695,LTWR 102,A00,491861,Staff,11,0,15,4
1713311523720,LTWR 106,A00,491862,Staff,10,0,15,5
1713311524746,MAE 11,A00,490930,Bahadori; Mohammad Yousef,97,0,100,3
1713311525769,MAE 30A,A00,490931,Qi; Huihui,38,0,40,2
1713311526798,MAE 101A,A00,491036,Sadeghizadeh; Zahra,98,0,100,2
1713311527827,MAE 101C,A00,491037,Seshadri; Kalyanasundaram,76,0,100,24
1713311528856,MAE 113,A00,491040,Seshadri; Kalyanasundaram,66,0,80,14
1713311529904,MAE 131A,A00,491041,Ghazinejad; Maziar,39,0,40,1
1713311530929,MAE 142,A00,491053,Staff,39,0,40,1
1713311531954,MAE 143A,A00,491054,Staff,40,0,50,10
1713311532980,MAE 150,A00,491092,Truong; Phuong Thi Ngoc,24,0,35,11
1713311534006,MATH 3C,A01,494031,Pardo Guerra; Sebastian,30,0,30,0
1713311534006,MATH 3C,A02,494032,Pardo Guerra; Sebastian,29,0,30,1
1713311535039,MATH 10A,A01,494034,Staff,27,0,30,3
1713311535039,MATH 10A,A02,494035,Staff,29,0,30,1
1713311535039,MATH 10A,B01,494037,Staff,27,0,30,3
1713311535039,MATH 10A,B02,494038,Staff,29,0,30,1
1713311536064,MATH 10B,A01,494040,Habib; Yousaf,24,0,30,6
1713311536064,MATH 10B,A02,494041,Habib; Yousaf,28,0,30,2
1713311536064,MATH 10B,A03,494042,Habib; Yousaf,30,0,30,0
1713311536064,MATH 10B,A04,494043,Habib; Yousaf,30,0,30,0
1713311536064,MATH 10B,B01,494045,Habib; Yousaf,28,0,30,2
1713311536064,MATH 10B,B02,494046,Habib; Yousaf,30,0,30,0
1713311536064,MATH 10B,B03,494047,Habib; Yousaf,30,0,30,0
1713311536064,MATH 10B,B04,494048,Habib; Yousaf,30,0,30,0
1713311537090,MATH 18,A01,494050,Kemp; Todd Aahron,27,0,30,3
1713311537090,MATH 18,A02,494051,Kemp; Todd Aahron,29,0,30,1
1713311537090,MATH 18,B01,494054,Kemp; Todd Aahron,28,0,30,2
1713311537090,MATH 18,B02,494055,Kemp; Todd Aahron,29,0,30,1
1713311538119,MATH 20A,A01,494059,Suk; Andrew Hoon,30,0,30,0
1713311539146,MATH 20B,A01,494061,Briones; Jor-el Thomas Caparas,34,0,35,1
1713311539146,MATH 20B,B01,494063,Bach; Quang Tran,34,0,35,1
1713311540172,MATH 20C,A01,494065,Staff,28,0,30,2
1713311540172,MATH 20C,A02,494066,Staff,30,0,30,0
1713311540172,MATH 20C,A03,494067,Staff,30,0,30,0
1713311540172,MATH 20C,A04,494068,Staff,30,0,30,0
1713311540172,MATH 20C,B01,494070,Zhang; Ming,26,0,30,4
1713311540172,MATH 20C,B02,494071,Zhang; Ming,29,0,30,1
1713311540172,MATH 20C,B03,494072,Zhang; Ming,29,0,30,1
1713311540172,MATH 20C,B04,494073,Zhang; Ming,29,0,30,1
1713311541197,MATH 20D,A01,494075,Staff,25,0,30,5
1713311541197,MATH 20D,A02,494076,Staff,30,0,30,0
1713311542224,MATH 20E,A01,494079,Staff,25,0,30,5
1713311542224,MATH 20E,A02,494080,Staff,27,0,30,3
1713311542224,MATH 20E,B01,494082,Staff,28,0,30,2
1713311542224,MATH 20E,B02,494083,Staff,25,0,30,5
1713311543251,MATH 103A,A01,494085,Aliabadi Sr.; Mohsen,17,0,30,13
1713311543251,MATH 103A,A02,494086,Aliabadi Sr.; Mohsen,28,0,30,2
1713311543251,MATH 103A,B01,494088,Aliabadi Sr.; Mohsen,22,0,30,8
1713311543251,MATH 103A,B02,494089,Aliabadi Sr.; Mohsen,28,0,30,2
1713311544278,MATH 109,A01,494091,Staff,30,0,30,0
1713311544278,MATH 109,A02,494092,Staff,30,0,30,0
1713311544278,MATH 109,B01,494094,Staff,28,0,30,2
1713311544278,MATH 109,B02,494095,Staff,29,0,30,1
1713311545309,MATH 142A,A01,494097,Chow; Bennett,16,0,30,14
1713311545309,MATH 142A,A02,494098,Chow; Bennett,24,0,30,6
1713311545309,MATH 142A,B01,494100,Chow; Bennett,20,0,30,10
1713311545309,MATH 142A,B02,494101,Chow; Bennett,29,0,30,1
1713311547360,MATH 168A,A01,516677,Dumitriu; Ioana,16,0,35,19
1713311548385,MATH 170A,A01,516679,Dumitriu; Ioana,20,0,30,10
1713311548385,MATH 170A,A02,516680,Dumitriu; Ioana,28,0,30,2
1713311549410,MATH 193A,A01,494107,Staff,16,0,30,14
1713311549410,MATH 193A,A02,494108,Staff,23,0,30,7
1713311549410,MATH 193A,A03,494109,Staff,29,0,30,1
1713311549410,MATH 193A,A04,494110,Staff,24,0,30,6
1713311552481,MGT 16,A00,491930,McKay; Michael J,93,0,98,5
1713311553505,MGT 18,A00,491992,McKay; Michael J,97,0,98,1
1713311554528,MGT 71,A00,492003,Staff,78,0,98,20
1713311555553,MGT 103,A00,505209,Eberhard; Craig A,85,0,98,13
1713311556582,MGT 131A,A00,505210,Anderson; John Charles,91,0,98,7
1713311558637,MGT 153,A00,492077,Perols; Johan Lars,42,0,90,48
1713311561723,MGT 164,A00,492222,McKay; Mary A,94,0,98,4
1713311562753,MGT 172,A00,492245,Staff,59,0,60,1
1713311562753,MGT 172,B00,505526,Hedges; Kathleen,76,0,98,22
1713311563779,MGT 181,A00,505669,Dunn; Louis Jean,88,0,98,10
1713311564809,MMW 14,A01,494399,Staff,23,0,28,5
1713311564809,MMW 14,A02,494400,Staff,26,0,28,2
1713311564809,MMW 14,A03,494401,Staff,28,0,28,0
1713311564809,MMW 14,A04,494402,Staff,28,0,28,0
1713311564809,MMW 14,B01,494404,Carreras; Maria Victoria,14,0,28,14
1713311564809,MMW 14,B02,494405,Carreras; Maria Victoria,27,0,28,1
1713311564809,MMW 14,B03,494406,Carreras; Maria Victoria,28,0,28,0
1713311564809,MMW 14,B04,494407,Carreras; Maria Victoria,28,0,28,0
1713311565834,MMW 14GS,A00,506250,Chang; Edmond Yi-Teh,0,0,0,0
1713311566862,MMW 121R,A01,494415,Adamiak; Patrick John,14,0,28,14
1713311566862,MMW 121R,A02,494416,Adamiak; Patrick John,25,0,28,3
1713311567892,MUS 1A,A01,494113,Staff,12,0,25,13
1713311567892,MUS 1A,A02,494114,Staff,25,0,25,0
1713311568916,MUS 4,A01,494116,Staff,24,0,25,1
1713311568916,MUS 4,A02,494117,Staff,22,0,25,3
1713311569941,MUS 5R,A01,494236,Dubnov; Shlomo,11,0,25,14
1713311569941,MUS 5R,A02,494237,Dubnov; Shlomo,25,0,25,0
1713311570967,MUS 6,A01,494122,Staff,16,0,25,9
1713311570967,MUS 6,A02,494123,Staff,24,0,25,1
1713311571995,MUS 7,A01,494125,Staff,17,0,25,8
1713311571995,MUS 7,A02,494126,Staff,24,0,25,1
1713311573020,MUS 11,A01,494128,Staff,23,0,25,2
1713311573020,MUS 11,A02,494129,Staff,25,0,25,0
1713311574050,MUS 13,A01,494131,Staff,25,0,25,0
1713311574050,MUS 13,A02,494132,Staff,25,0,25,0
1713311575080,MUS 15,A01,494134,Staff,20,0,25,5
1713311575080,MUS 15,A02,494135,Staff,25,0,25,0
1713311575080,MUS 15,B01,494137,Staff,24,0,25,1
1713311576105,MUS 80,A00,494232,Staff,25,0,25,0
1713311576105,MUS 80,B00,494233,Staff,25,0,25,0
1713311576105,MUS 80,C00,494234,Staff,23,0,25,2
1713311577130,MUS 95C,A00,494141,Staff,73,0,75,2
1713311578156,MUS 114,A00,494142,Staff,41,0,50,9
1713311579187,NANO 15,A01,490636,Drews; Aaron,7,0,7,0
1713311580214,PHIL 1,A00,490578,Grush; Rick Scott,50,0,50,0
1713311581240,PHIL 10,A01,490580,Grush; Rick Scott,33,0,35,2
1713311581240,PHIL 10,A02,490586,Grush; Rick Scott,33,0,35,2
1713311582272,PHIL 27,A01,490591,Staff,24,0,25,1
1713311582272,PHIL 27,A02,490592,Staff,25,0,25,0
1713311582272,PHIL 27,A03,490593,Staff,25,0,25,0
1713311582272,PHIL 27,A04,490598,Staff,25,0,25,0
1713311583356,PHIL 32,A01,490611,Staff,20,0,20,0
1713311583356,PHIL 32,A02,490618,Staff,20,0,20,0
1713311584385,PHIL 90,A00,490624,Staff,40,0,40,0
1713311585416,PHIL 136,A00,490627,Cohen; Jonathan David,38,0,40,2
1713311586442,PHIL 155,A00,490634,Staff,64,0,70,6
1713311587471,PHYS 1A,A00,491610,Staff,246,0,250,4
1713311588499,PHYS 1AL,001,491616,Tsai; Philbert S,28,0,30,2
1713311588499,PHYS 1AL,002,491618,Tsai; Philbert S,30,0,30,0
1713311589526,PHYS 1B,A00,491623,Staff,244,0,250,6
1713311590551,PHYS 1BL,001,491626,Tsai; Philbert S,26,0,30,4
1713311590551,PHYS 1BL,002,491628,Tsai; Philbert S,28,0,30,2
1713311591575,PHYS 1C,A00,491632,Staff,223,0,245,22
1713311592603,PHYS 1CL,001,491635,Tsai; Philbert S,11,0,30,19
1713311592603,PHYS 1CL,002,491643,Tsai; Philbert S,24,0,30,6
1713311593634,PHYS 2AR,A01,491651,Meyertholen; Andrew D.,45,0,50,5
1713311594662,PHYS 2B,A01,491659,Staff,107,0,115,8
1713311595698,PHYS 2BL,A01,491685,Staff,22,0,24,2
1713311595698,PHYS 2BL,A02,491700,Staff,23,0,24,1
1713311596727,PHYS 2C,A01,505161,Staff,107,0,115,8
1713311597757,PHYS 4A,A01,491704,Grinstein; Benjamin,99,0,100,1
1713311598784,POLI 5D,A01,494144,Staff,3,0,5,2
1713311598784,POLI 5D,B01,626283,Dai; Yinlin,5,0,5,0
1713311599812,POLI 12,A00,494145,Staff,44,0,45,1
1713311600837,POLI 13R,A00,494146,Forman; Fonna,46,0,50,4
1713311601865,POLI 27,A01,494148,Staff,57,0,60,3
1713311602890,POLI 30,A00,494149,Staff,49,0,50,1
1713311603915,POLI 100DA,A00,494150,Staff,23,0,25,2
1713311605967,POLI 100I,A00,494152,Staff,28,0,30,2
1713311606998,POLI 104B,A00,494153,Smith; Glenn Chatmas,54,0,55,1
1713311608022,POLI 104F,A00,494154,Staff,28,0,30,2
1713311609046,POLI 104I,A00,494155,Smith; Glenn Chatmas,30,0,30,0
1713311610076,POLI 110C,A00,494156,Ingham; Sean,23,0,25,2
1713311611102,POLI 117R,A00,494157,Forman; Fonna,12,0,20,8
1713311612126,POLI 118,A00,494158,Ingham; Sean,22,0,25,3
1713311613154,POLI 120H,A00,494159,Fisk; David Lee,41,0,45,4
1713311614182,POLI 131CR,A00,494160,Hoston; Germaine,38,0,45,7
1713311615215,POLI 133J,A00,494161,Staff,33,0,35,2
1713311616240,POLI 135,A00,494162,Fisk; David Lee,33,0,35,2
1713311617265,POLI 140A,A00,494164,Staff,22,0,30,8
1713311618290,POLI 142I,A00,494165,Staff,30,0,30,0
1713311619317,POLI 144D,A00,494166,Staff,23,0,25,2
1713311620345,POLI 151,A00,494167,Staff,30,0,30,0
1713311621370,POLI 153,A00,494168,Staff,33,0,35,2
1713311622394,POLI 160AA,A00,494169,Staff,35,0,40,5
1713311623423,POLI 162,A00,494170,Mignozzetti; Umberto,20,0,25,5
1713311624452,POLI 171,A00,494171,Mignozzetti; Umberto,21,0,25,4
1713311625476,PSYC 1,A00,494172,Staff,97,0,100,3
1713311626507,PSYC 2,A00,494173,Moranton; Nirelia Melbina-,44,0,50,6
1713311627532,PSYC 3,A00,494174,Staff,30,0,30,0
1713311628562,PSYC 6,A00,494175,Staff,17,0,20,3
1713311629589,PSYC 60,A01,494177,Staff,40,0,45,5
1713311630620,PSYC 70,A01,505724,Geller; Emma Harlan,42,0,45,3
1713311631645,PSYC 101,A00,494180,Heyman; Gail D.,87,0,100,13
1713311632673,PSYC 105,A00,494181,Geller; Emma Harlan,64,0,90,26
1713311633699,PSYC 106,A00,494182,Dobkins; Karen R.,33,0,45,12
1713311634725,PSYC 108,A00,494183,Adrian; Julia Anna,94,0,100,6
1713311635757,PSYC 114,A01,494185,Winkielman; Piotr,2,0,30,28
1713311636781,PSYC 122,A00,494186,Moranton; Nirelia Melbina-,38,0,50,12
1713311637810,PSYC 124,A00,494187,Chapman; Eddie Nathaniel,72,0,80,8
1713311638835,PSYC 131,A00,494188,Anagnostaras; Stephan,57,0,80,23
1713311639862,PSYC 144,A00,494189,Staff,15,0,50,35
1713311640889,PSYC 154,A00,494190,Lacefield; Katharine I,133,0,180,47
1713311641919,PSYC 162,A00,494191,Wixted; John T,83,0,100,17
1713311642951,PSYC 172,A00,494192,Gorman; Michael R.,38,0,45,7
1713311643976,PSYC 178,A00,494193,Glaser; Dale,40,0,45,5
1713311645006,PSYC 193,A00,505725,Chapman; Eddie Nathaniel,20,0,20,0
1713311646034,RELI 145GS,A00,519817,Rahimi; Babak,19,0,20,1
1713311647066,SE 101A,A01,490862,Chadha; Mayank,24,0,25,1
1713311648090,SE 101C,A01,490924,Krysl; Petr,18,0,20,2
1713311649115,SE 110A,A01,490928,Staff,19,0,20,1
1713311650143,SE 130A,A00,490929,Morrison; Machel Leigh,64,0,70,6
1713311651171,SIO 1,A01,519325,Staff,39,0,40,1
1713311652196,SIO 30,A01,519327,Staff,39,0,40,1
1713311653221,SIO 40,A00,519328,Staff,40,0,40,0
1713311654246,SIO 46GS,A00,519819,Cook; Geoffrey W,18,0,25,7
1713311655273,SIO 109R,A00,494197,Forman; Fonna,4,0,20,16
1713311656304,SIO 121GS,A00,519827,Cook; Geoffrey W,18,0,25,7
1713311657333,SIO 132,A01,519330,Staff,38,0,40,2
1713311658358,SIO 133,A01,519397,Staff,38,0,40,2
1713311659384,SIO 139,A00,519396,Kacev; David,33,0,40,7
1713311660409,SOCI 1,A01,494199,Thorpe; Charles Robert,23,0,30,7
1713311660409,SOCI 1,A02,494200,Thorpe; Charles Robert,30,0,30,0
1713311660409,SOCI 1,A03,494201,Thorpe; Charles Robert,29,0,30,1
1713311660409,SOCI 1,A04,494202,Thorpe; Charles Robert,29,0,30,1
1713311660409,SOCI 1,A05,494203,Thorpe; Charles Robert,29,0,30,1
1713311660409,SOCI 1,A06,494204,Thorpe; Charles Robert,30,0,30,0
1713311660409,SOCI 1,A07,494205,Thorpe; Charles Robert,29,0,30,1
1713311661439,SOCI 60,A01,494207,Staff,36,0,40,4
1713311661439,SOCI 60,A02,494208,Staff,39,0,40,1
1713311662465,SOCI 100,A01,494210,Payne; Christine Anna,28,0,30,2
1713311662465,SOCI 100,A02,494211,Payne; Christine Anna,27,0,30,3
1713311663491,SOCI 109M,A00,494212,Staff,20,0,20,0
1713311664516,SOCI 110,A00,494213,Staff,35,0,40,5
1713311666571,SOCI 118E,A00,494215,Ng; Kwai,38,0,40,2
1713311667597,SOCI 125,A00,494216,Calderon-Zaks; Michael Aar,42,0,45,3
1713311668622,SOCI 126,A01,494218,Jones; Makeba,4,0,5,1
1713311669647,SOCI 131,A00,494219,Thorpe; Charles Robert,28,0,30,2
1713311671701,SOCI 135,A00,494221,Payne; Christine Anna,35,0,50,15
1713311672728,SOCI 136E,A00,626690,Ruiz; Jonathan Joseph,25,0,25,0
1713311673756,SOCI 138GS,A00,494222,Navon; Daniel,24,0,28,4
1713311675812,SOCI 145,A00,494224,Staff,42,0,45,3
1713311676837,SOCI 153,A00,494225,Staff,28,0,30,2
1713311677862,SOCI 160E,A00,494226,Ng; Kwai,33,0,40,7
1713311678886,SOCI 180,A00,494227,Staff,29,0,30,1
1713311679915,SOCI 189GS,A00,494228,Ribas Norris; Janet Vanesa,11,0,11,0
1713311680939,SOCI 190GS,A00,553232,Ribas Norris; Janet Vanesa,11,0,11,0
1713311681965,SOMI 220,A00,627178,Schneid; Stephen David,30,0,30,0
1713311682991,SYN 2,001,490768,Staff,14,0,15,1
1713311682991,SYN 2,002,490769,Staff,15,0,15,0
1713311682991,SYN 2,004,490775,Staff,0,0,0,0
1713311682991,SYN 2,003,490774,Staff,0,0,0,0
1713311682991,SYN 2,005,490776,Staff,0,0,0,0
1713311684022,SYN 2R,001,490779,Staff,13,0,15,2
1713311684022,SYN 2R,002,514635,Staff,14,0,15,1
1713311685046,SYN 100,A01,490783,Staff,15,0,20,5
1713311685046,SYN 100,B01,490787,Staff,10,0,20,10
1713311685046,SYN 100,C01,490789,Staff,13,0,20,7
1713311686074,SYN 150,A00,490817,Staff,14,0,15,1
1713311686074,SYN 150,B00,514610,Staff,15,0,15,0
1713311687166,TDAC 1,A00,492753,Walsh; Kim C.,19,0,20,1
1713311687166,TDAC 1,B00,492754,Harting; Carla Kelso,19,0,20,1
1713311687166,TDAC 1,C00,513995,Salovey; Todd,17,0,20,3
1713311688192,TDAC 101,A00,492766,Harting; Carla Kelso,17,0,20,3
1713311689218,TDAC 102,A00,492768,Basso; Beatrice,19,0,20,1
1713311690244,TDDE 111,A00,492769,Staff,25,0,25,0
1713311691270,TDDE 131,A00,492770,Staff,15,0,15,0
1713311691270,TDDE 131,B00,492771,Staff,15,0,15,0
1713311692295,TDDE 131GS,A00,523716,Guirguis; Mark C,24,0,28,4
1713311693327,TDGE 1,A01,492756,Salovey; Todd,57,0,60,3
1713311694356,TDGE 5,A01,492758,Staff,24,0,25,1
1713311695383,TDGE 10,A00,492759,Fulton; Julia,211,0,220,9
1713311696409,TDGE 11,A00,492760,Castro; Robert Jess,200,0,200,0
1713311698462,TDGE 124,A00,492772,Fulton; Julia,193,0,220,27
1713311699488,TDGE 125,A00,492773,Meyer; Ursula,40,0,50,10
1713311699488,TDGE 125,B00,492774,Staff,50,0,50,0
1713311699488,TDGE 125,C00,523565,Staff,49,0,50,1
1713311700517,TDGE 125GS,A00,523580,Guirguis; Mark C,24,0,28,4
1713311701543,TDGE 127,A00,492775,Havis; Allan,41,0,50,9
1713311702578,TDHT 101,A00,492776,Staff,35,0,35,0
1713311703604,TDMV 1,A00,492762,Caligagan; Maria T.,30,0,30,0
1713311703604,TDMV 1,B00,492763,Arcidiacono; Kristin,25,0,30,5
1713311704630,TDMV 2,A00,492764,Weinberg; Sadie,29,0,30,1
1713311705655,TDMV 3,A00,492765,Mack; Kara Shanai',39,0,40,1
1713311706680,TDMV 138,A00,492777,Mack; Kara Shanai',36,0,40,4
1713311707705,TDMV 140,A00,492778,Lima; Paulo Henrique,40,0,40,0
1713311708736,TDMV 142,A00,492779,Caligagan; Maria T.,36,0,40,4
1713311708736,TDMV 142,B00,492780,Caligagan; Tony,37,0,40,3
1713311709764,TDMV 143,A00,492781,Fyall; Daunte Edward,39,0,40,1
1713311710789,USP 1,A01,492401,Kwak; Nancy,26,0,35,9
1713311711819,USP 2,A01,492453,Hinds; Juli Beth,35,0,35,0
1713311712843,USP 3,A01,492516,Staff,29,0,35,6
1713311713872,USP 4,A00,492522,McTague; Sarah,19,0,25,6
1713311714898,USP 100,A00,492523,Staff,33,0,35,2
1713311715922,USP 101,A00,492524,Staff,13,0,15,2
1713311716948,USP 105,A00,492525,Staff,21,0,25,4
1713311717981,USP 151,A00,492526,Shenkman; Michael Thomas,33,0,35,2
1713311719010,USP 170,A00,492545,Hinds; Juli Beth,33,0,35,2
1713311720035,USP 171GS,A00,492608,Bussell; Mirle Rabinowitz,25,0,28,3
1713311721060,USP 183GS,A00,492613,Peerson; Susan,25,0,28,3
1713311722087,VIS 30,A01,490693,Yoldas; Pinar,21,0,22,1
1713311722087,VIS 30,A02,490694,Yoldas; Pinar,19,0,22,3
1713311723115,VIS 83,A00,490695,Kester; Grant,66,0,75,9
1713311724140,VIS 105D,A00,490696,Staff,22,0,25,3
1713311725165,VIS 124CN,A00,490699,Rose; Jordan M,68,0,75,7
1713311726194,VIS 125GS,A00,511221,Williams; Alena J,21,0,22,1
1713311727223,VIS 128D,A00,490700,Staff,74,0,75,1
1713311728251,VIS 151,A01,490717,Staff,33,0,34,1
1713311728251,VIS 151,A02,490766,Staff,33,0,34,1
1713311729280,VIS 154GS,A00,511972,Williams; Alena J,21,0,22,1
1713311730306,VIS 160A,A00,490767,Stone; Patricia,7,0,10,3
1713311731336,WCWP 10A,A00,490638,Staff,14,0,15,1
1713311731336,WCWP 10A,B00,490640,Staff,15,0,15,0
1713311732362,WCWP 10B,A00,490641,Staff,0,0,0,0
1713311732362,WCWP 10B,B00,490642,Staff,14,0,15,1
1713311732362,WCWP 10B,C00,490644,Staff,13,0,15,2
1713311732362,WCWP 10B,D00,490647,Staff,0,0,0,0
1713311733388,WCWP 100,A00,490655,Staff,0,0,0,0
1713311733388,WCWP 100,B00,490687,Staff,12,0,15,3
1713311735485,ANAR 153,A00,487222,Braswell; Geoffrey E.,55,0,60,5
1713311736509,ANBI 134,A00,487223,Staff,12,0,20,8
1713311737537,ANBI 143GS,A00,487224,Noel; Geoffroy Pierre Jean,20,0,24,4
1713311738563,ANBI 144GS,A00,519548,Noel; Geoffroy Pierre Jean,20,0,24,4
1713311739588,ANSC 101,A00,487225,Staff,19,0,20,1
1713311740612,ANSC 125,A00,487227,Brenner; Suzanne A,39,0,40,1
1713311742663,ANSC 146,A00,487229,Staff,36,0,40,4
1713311743689,ANSC 148,A00,487230,Olivas Hernandez; Olga Lid,39,0,40,1
1713311744722,ANSC 150,A00,504165,Sloane; Julia Kathryn,19,0,20,1
1713311745766,ANSC 180,A00,487232,Staff,13,0,15,2
1713311746798,ANSC 188,A00,627155,Staff,40,0,40,0
1713311747826,ANTH 5,A00,519529,Semendeferi; Ekaterini,15,0,15,0
1713311748851,ANTH 10,A00,487219,Staff,58,0,60,2
1713311749877,ANTH 23,A01,487221,Staff,17,0,20,3
1713311750902,ANTH 102,A00,487233,Wilder; Linnea Lorene,52,0,60,8
1713311751932,ANTH 103,A00,487234,Varma; Saiba,56,0,60,4
1713311752962,ANTH 105,A00,487235,Stewart; Alexander B,56,0,60,4
1713311753987,BENG 100,A01,516685,Taylor Amos; Alyssa C,28,0,30,2
1713311755017,BIBC 102,A01,491316,Flagg; Matthew Paul,43,0,88,45
1713311755017,BIBC 102,A02,491366,Flagg; Matthew Paul,83,0,88,5
1713311756047,BIBC 103,A01,491486,Boumechache; Miyyada,16,0,24,8
1713311756047,BIBC 103,A02,491487,Boumechache; Miyyada,24,0,24,0
1713311757074,BICD 100,A01,516882,Staff,75,0,75,0
1713311757074,BICD 100,A02,516890,Staff,70,0,75,5
1713311758098,BICD 102GS,A00,491488,Lo; Stanley M.,26,0,28,2
1713311759128,BIEB 136GS,A00,516940,Holway; David A. & Shurin; Jonathan,19,0,24,5
1713311760157,BIEB 137GS,A01,517034,Holway; David A. & Shurin; Jonathan,19,0,24,5
1713311761185,BIEB 138GS,A01,491492,Pirino; Giorgia,21,0,28,7
1713311762208,BILD 1,A01,491296,Staff,62,0,63,1
1713311762208,BILD 1,A02,491297,Staff,63,0,63,0
1713311763238,BILD 4,A01,517099,Gonzalez Gamboa; Ivonne,22,0,24,2
1713311763238,BILD 4,A02,517100,Gonzalez Gamboa; Ivonne,24,0,24,0
1713311764269,BILD 60GS,A00,491309,Lo; Stanley M.,26,0,28,2
1713311765295,BIMM 100,A01,517136,Staff,91,0,100,9
1713311766324,BIMM 110,A01,517182,Staff,71,0,100,29
1713311767352,BIMM 120,A01,517228,Pickett; Brooke Elizabeth,40,0,63,23
1713311767352,BIMM 120,A02,517240,Pickett; Brooke Elizabeth,48,0,63,15
1713311768380,BIMM 132GS,A01,491498,Pirino; Giorgia,21,0,28,7
1713311769406,BIMM 143,A01,491589,Bozinovic; Goran,18,0,40,22
1713311770434,BIPN 100,A01,491594,Armour; Jon Christopher,92,0,100,8
1713311771458,BIPN 140,A01,491602,Marino; Marc J,30,0,50,20
1713311773510,CAT 125,A00,515973,Staff,20,0,20,0
1713311774537,CAT 125GS,A00,515974,Rahimi; Babak,19,0,20,1
1713311775563,CAT 125R,A00,515980,Staff,14,0,20,6
1713311775563,CAT 125R,B00,515981,Tosun; Adriana,19,0,20,1
1713311775563,CAT 125R,C00,515987,Hyland; Tina Mae,3,0,20,17
1713311775563,CAT 125R,D00,515988,Bronstein; Phoebe Malan,18,0,20,2
1713311776588,CENG 15,A01,488699,Drews; Aaron,25,0,25,0
1713311777614,CENG 100,A00,505196,Opatkiewicz; Justin Paul,25,0,25,0
1713311778638,CGS 2A,A01,489598,Staff,33,0,35,2
1713311779662,CGS 112,A00,489599,Staff,15,0,15,0
1713311780687,CGS 119,A00,489603,Staff,10,0,10,0
1713311781714,CGS 120,A00,489604,Staff,14,0,15,1
1713311782738,CGS 150,A00,489607,Staff,15,0,15,0
1713311783769,CHEM 6A,A01,488715,Staff,98,0,100,2
1713311784792,CHEM 6B,A01,488719,Piercy; Marc Anthony,100,0,100,0
1713311785821,CHEM 6C,A01,488723,Albizati; Kim F.,94,0,100,6
1713311786849,CHEM 7L,A01,488728,Schurmeier; Kimberly,18,0,24,6
1713311786849,CHEM 7L,A02,488730,Schurmeier; Kimberly,23,0,24,1
1713311786849,CHEM 7L,A03,488734,Schurmeier; Kimberly,23,0,24,1
1713311786849,CHEM 7L,A04,488763,Schurmeier; Kimberly,23,0,24,1
1713311786849,CHEM 7L,B01,488798,Schurmeier; Kimberly,18,0,24,6
1713311786849,CHEM 7L,B02,488801,Schurmeier; Kimberly,23,0,24,1
1713311786849,CHEM 7L,B03,488808,Schurmeier; Kimberly,24,0,24,0
1713311786849,CHEM 7L,B04,488811,Schurmeier; Kimberly,24,0,24,0
1713311787873,CHEM 11,A01,488897,Stallings; Dontarie M,98,0,100,2
1713311788903,CHEM 40A,A01,488913,Albizati; Kim F.,91,0,100,9
1713311789932,CHEM 40B,A01,488920,Weizman; Haim,47,0,50,3
1713311789932,CHEM 40B,A02,488938,Weizman; Haim,46,0,50,4
1713311791013,CHEM 41A,A01,489029,Klosterman; Jeremy K,58,0,60,2
1713311792038,CHEM 41C,A01,500436,Tor; Yitzhak,55,0,60,5
1713311793070,CHEM 43A,A01,500426,Weizman; Haim,3,0,24,21
1713311793070,CHEM 43A,A02,500430,Weizman; Haim,13,0,24,11
1713311793070,CHEM 43A,B01,514041,Klosterman; Jeremy K,16,0,24,8
1713311793070,CHEM 43A,B02,514047,Klosterman; Jeremy K,23,0,24,1
1713311794097,CHEM 108,A01,489140,Jennings; Patricia A.,13,0,24,11
1713311794097,CHEM 108,A02,489142,Jennings; Patricia A.,15,0,24,9
1713311795122,CHEM 114A,A01,489147,Stallings; Dontarie M,78,0,100,22
1713311796151,CHIN 169A,A00,489171,Wang; Xiao,19,0,20,1
1713311798206,COGS 3,A01,518827,Boyle; Mary E. T.,29,0,40,11
1713311799231,COGS 11,A01,489175,Staff,28,0,30,2
1713311800255,COGS 14A,A01,518829,Staff,52,0,60,8
1713311801284,COGS 14B,A01,489177,Hoffman; Drew Ellen,69,0,75,6
1713311802313,COGS 100,A01,489181,Allen; Michael Gordon,66,0,75,9
1713311803341,COGS 101A,A01,489183,Staff,49,0,60,11
1713311804370,COGS 101B,A01,489185,Allen; Michael Gordon,13,0,30,17
1713311805398,COGS 101C,A01,526786,Staff,24,0,30,6
1713311807449,COGS 107A,A01,489189,Boyle; Mary E. T.,22,0,35,13
1713311808474,COGS 107B,A01,627144,Mooshagian; Eric Frederick,60,0,60,0
1713311809502,COGS 118A,A01,489191,Staff,0,30,40,40
1713311811555,COGS 171GS,A01,489194,Pineda; Jaime A,22,0,28,6
1713311812581,COGS 172,A01,489196,Staff,6,0,30,24
1713311813610,COGS 174GS,A01,489264,Pineda; Jaime A,22,0,28,6
1713311814637,COGS 180,A01,627150,Staff,28,0,30,2
1713311815664,COGS 186,A01,489274,Staff,2,0,30,28
1713311816689,COMM 10,A01,489276,Staff,23,0,25,2
1713311816689,COMM 10,A02,489303,Staff,23,0,25,2
1713311817719,COMM 100A,A01,489312,Staff,17,0,25,8
1713311817719,COMM 100A,A02,489313,Staff,24,0,25,1
1713311818745,COMM 106T,A00,512540,Staff,34,0,35,1
1713311819775,COMM 107,A00,489347,Staff,31,0,35,4
1713311820801,COMM 109P,A00,489358,Staff,31,0,35,4
1713311821834,COMM 132,A00,489361,McKenna; Denise,28,0,30,2
1713311822860,COMM 146,A00,489362,Halm; Gavin Patrick,27,0,30,3
1713311823887,COMM 190,A00,489363,Abuelhiga; Soraya Jill,20,0,23,3
1713311824915,CSE 8A,A50,489366,Staff,23,0,25,2
1713311824915,CSE 8A,A51,489367,Staff,24,0,25,1
1713311825941,CSE 11,A01,489398,Cao; Yingjun,80,0,100,20
1713311826967,CSE 12,A01,489487,Staff,43,0,50,7
1713311827991,CSE 20,A01,489497,Staff,49,0,50,1
1713311829019,CSE 21,A01,489517,Braun; Oliver,44,0,50,6
1713311830049,CSE 101,A01,489524,Braun; Oliver,0,15,50,50
1713311831074,CSE 105,A01,512594,Jones; Miles E,81,0,100,19
1713311831074,CSE 105,B01,512598,Jones; Miles E,62,0,100,38
1713311832101,CSE 140,A01,489538,Staff,44,0,50,6
1713311833127,CSE 141,A01,489550,Eldon; John,76,0,100,24
1713311834156,CSE 141L,A01,489571,Eldon; John,74,0,100,26
1713311835182,CSE 151A,A01,489583,Solares; Edwin A,151,0,200,49
1713311836212,CSE 175,A01,510886,Kumar; Rakesh,30,0,30,0
1713311837237,CSE 190,A00,516828,Dubnov; Shlomo,41,0,49,8
1713311838268,DOC 100D,A00,489667,Pass; Natalye Joann,23,0,25,2
1713311839293,DSC 10,A01,624268,Staff,72,0,75,3
1713311840319,DSC 20,A01,624476,Staff,50,0,50,0
1713311841345,DSC 40A,A01,624608,Staff,40,0,40,0
1713311842369,DSGN 1,A01,489179,Rill; Bryan,36,0,50,14
1713311843396,ECE 17,A01,490489,Sahay; Rajeev,18,0,30,12
1713311844425,ECE 65,A50,490492,Staff,16,0,20,4
1713311844425,ECE 65,A51,490493,Staff,20,0,20,0
1713311845455,ECON 1,A01,489715,Famulari; Melissa,69,0,70,1
1713311846480,ECON 2,A01,489717,Levkoff; Steven B.,68,0,70,2
1713311847506,ECON 3,A01,489948,Staff,70,0,70,0
1713311849559,ECON 5,A01,490103,Staff,28,0,30,2
1713311849559,ECON 5,B01,626281,Dai; Yinlin,45,0,45,0
1713311850586,ECON 100A,A01,490127,Famulari; Melissa,68,0,70,2
1713311851610,ECON 100B,A01,490129,Staff,64,0,70,6
1713311852638,ECON 109,A01,490187,Shishkin; Denis,27,0,35,8
1713311853664,ECON 110A,A01,490190,Levkoff; Steven B.,62,0,70,8
1713311854690,ECON 120A,A01,490245,Dai; Yinlin,65,0,70,5
1713311855717,ECON 120B,A01,490247,Nieto-Barthaburu; Augusto,59,0,70,11
1713311856745,ECON 120C,A01,490253,Sun; Yixiao,31,0,35,4
1713311856745,ECON 120C,B01,490255,Sun; Yixiao,34,0,35,1
1713311857771,ECON 129,A00,490256,Eckert; Fabian Paul,25,0,35,10
1713311858798,ECON 131,A00,490257,Nieto-Barthaburu; Augusto,2,0,35,33
1713311859838,ECON 138,A00,490258,Bharadwaj; Prashant,22,0,35,13
1713311859838,ECON 138,B00,490259,Bharadwaj; Prashant,17,0,35,18
1713311860865,ECON 159,A00,490260,Hendrickson; Gerald M.,0,7,0,0
1713311861891,ECON 178,A01,553995,Zhu; Ying,27,0,35,8
1713311862915,EDS 40,A01,512576,Black; Alison Michelle,20,0,20,0
1713311863943,EDS 107,A01,515848,Staff,30,0,30,0
1713311864968,EDS 110R,A01,490262,Staff,26,0,30,4
1713311865994,EDS 112,A01,490264,Chapman; Thandeka K,43,0,50,7
1713311867019,EDS 113,A00,490266,Staff,26,0,30,4
1713311868044,EDS 118,A00,490267,Warstadt; Melissa Fawn,26,0,30,4
1713311869070,EDS 124BR,A00,490268,Eguchi; Emi,9,0,25,16
1713311869070,EDS 124BR,B00,490269,Eguchi; Emi,25,0,25,0
1713311870095,EDS 126,A01,490271,Jones; Makeba,45,0,50,5
1713311871122,EDS 135,A01,490316,Staff,19,0,20,1
1713311872149,ENVR 142GS,A00,519514,Chang; Edmond Yi-Teh,28,0,28,0
1713311873184,ETHN 103,A00,490504,Staff,32,0,36,4
1713311874211,ETHN 103A,A00,490505,Man; Simeon S,5,0,9,4
1713311875241,ETHN 109,A00,490506,Staff,30,0,30,0
1713311876270,ETHN 118,A00,490507,Staff,35,0,36,1
1713311877294,ETHN 119,A00,490508,Staff,36,0,36,0
1713311878320,ETHN 121R,A00,490518,Choi; Esther Min,28,0,36,8
1713311879350,ETHN 127,A00,490528,Staff,15,0,15,0
1713311880377,ETHN 139,A00,490573,Staff,10,0,10,0
1713311881400,ETHN 150,A00,490575,Staff,15,0,15,0
1713311882425,GLBH 20,A00,491705,Elwardani; Nile Regina,38,0,40,2
1713311883449,GLBH 101,A00,491706,Staff,20,0,20,0
1713311884474,GLBH 111,A01,491708,Burgos; Jose L.,15,0,15,0
1713311885499,GLBH 146,A00,491709,Staff,11,0,20,9
1713311886531,GLBH 148,A00,491710,Olivas Hernandez; Olga Lid,14,0,20,6
1713311887557,GLBH 150,A00,491711,Sloane; Julia Kathryn,20,0,20,0
1713311888588,HIEA 131,A00,491760,Staff,29,0,32,3
1713311889613,HIEA 153,A00,491762,Staff,29,0,30,1
1713311890638,HIEU 124,A00,491811,Staff,26,0,32,6
1713311891663,HIEU 124GS,A00,491812,Markman; Kristina,28,0,28,0
1713311892688,HIEU 147,A00,491813,Staff,30,0,32,2
1713311893712,HIEU 149GS,A00,491816,Caldwell; Michael Alan,28,0,28,0
1713311894797,HILD 2C,A01,491713,Hendrickson; Gerald M.,27,0,30,3
1713311895826,HILD 7B,A01,491715,Kwak; Nancy,12,0,30,18
1713311896854,HILD 10,A01,491717,Staff,14,0,20,6
1713311897877,HILD 30GS,A00,491719,Edington; Claire Ellen,24,0,28,4
1713311898904,HINE 109,A00,491818,Shafir; Nir,28,0,32,4
1713311899932,HINE 128,A00,491821,Shafir; Nir,31,0,32,1
1713311900960,HISC 117,A00,491830,Staff,29,0,32,3
1713311901985,HIUS 103,A00,491834,Man; Simeon S,15,0,23,8
1713311903011,HIUS 108B,A00,491835,Staff,29,0,30,1
1713311904037,HIUS 141,A00,491836,Hendrickson; Gerald M.,29,0,32,3
1713311905061,HIUS 149,A00,491839,Staff,27,0,32,5
1713311906088,HUM 3,A01,512617,Crum; Matthew Stephen,45,0,50,5
1713311906088,HUM 3,A02,512618,Crum; Matthew Stephen,48,0,50,2
1713311907117,HUM 3GS,A00,512663,Markman; Kristina,0,0,0,0
1713311907117,HUM 3GS,B00,512664,Staff,0,0,0,0
1713311908145,HUM 4,A01,512620,West; Geoffrey Scott,33,0,50,17
1713311909171,HUM 4GS,A00,512666,Lyon; Antony J.,0,0,0,3
1713311910201,HUM 4R,A01,512625,Watkins; Eric,49,0,50,1
1713311911235,HUM 5,A01,512649,Zavodny; Tatiana Sophia,31,0,50,19
1713311911235,HUM 5,B01,512661,Zroka; Ryan Edward,48,0,50,2
1713311912261,INTL 190,A00,490577,Segui; Alan S,0,0,0,5
1713311913286,JAPN 20AR,A01,491267,Ross; Kayoko F,11,0,20,9
1713311914315,JAPN 180,A00,491285,Berman; Michael David,34,0,40,6
1713311915348,LATI 50,A01,502536,Kokinis; Troy Andreas,18,0,22,4
1713311915348,LATI 50,A02,502551,Kokinis; Troy Andreas,22,0,22,0
1713311915348,LATI 50,A03,502650,Kokinis; Troy Andreas,22,0,22,0
1713311915348,LATI 50,A04,502909,Kokinis; Troy Andreas,22,0,22,0
1713311916373,LATI 160,A01,502920,Kokinis; Troy Andreas,30,0,30,0
1713311917400,LIFR 1A,A00,490494,Van Moer; Vinciane G,17,0,20,3
1713311918423,LIFR 1AX,A00,490495,Van Moer; Vinciane G,17,0,20,3
1713311919446,LIFR 1B,A00,490496,Van Moer; Vinciane G,19,0,20,1
1713311920475,LIFR 1BX,A00,490497,Van Moer; Vinciane G,19,0,20,1
1713311921502,LIGN 8,A00,505198,McIntosh; Justin Daniel,137,0,150,13
1713311922526,LIGN 9GS,A00,491239,Lott; Margaret S.,18,0,20,2
1713311923553,LIGN 101,A01,505200,McIntosh; Justin Daniel,25,0,30,5
1713311924578,LIGN 120,A01,491244,Staff,24,0,30,6
1713311925603,LIGN 149GS,A00,491245,Lott; Margaret S.,18,0,20,2
1713311926633,LIGN 170,A00,491247,Staff,24,0,30,6
1713311927659,LISP 1D,A00,490498,Munoz Sanchez; Alicia,11,0,14,3
1713311927659,LISP 1D,B00,490499,Munoz Sanchez; Alicia,6,0,14,8
1713311927659,LISP 1D,C00,490500,Munoz Sanchez; Alicia,10,0,14,4
1713311927659,LISP 1D,D00,490501,Munoz Sanchez; Alicia,11,0,14,3
1713311928685,LISP 1DX,A00,490502,Munoz Sanchez; Alicia,18,0,28,10
1713311928685,LISP 1DX,B00,490503,Munoz Sanchez; Alicia,19,0,28,9
1713311930742,LTAM 110,A00,491847,Staff,23,0,25,2
1713311931770,LTCS 119,A00,491848,Staff,12,0,15,3
1713311932799,LTCS 130,A00,491849,Staff,24,0,25,1
1713311934851,LTEA 120C,A00,491852,Staff,34,0,40,6
1713311935899,LTEN 130GS,A00,491853,Lyon; Antony J.,25,0,28,3
1713311936924,LTEN 148,A00,491855,Staff,23,0,25,2
1713311937949,LTEN 159,A00,491856,Staff,21,0,25,4
1713311938978,LTEN 180,A00,491857,Staff,9,0,15,6
1713311941034,LTSP 123GS,A00,505928,Bessett; Ryan Matthew,25,0,28,3
1713311942062,LTSP 174GS,A00,506037,Bessett; Ryan Matthew,25,0,28,3
1713311944122,LTWR 102,A00,491861,Staff,11,0,15,4
1713311945146,LTWR 106,A00,491862,Staff,10,0,15,5
1713311946172,MAE 11,A00,490930,Bahadori; Mohammad Yousef,97,0,100,3
1713311947201,MAE 30A,A00,490931,Qi; Huihui,38,0,40,2
1713311948227,MAE 101A,A00,491036,Sadeghizadeh; Zahra,98,0,100,2
1713311949256,MAE 101C,A00,491037,Seshadri; Kalyanasundaram,76,0,100,24
1713311950285,MAE 113,A00,491040,Seshadri; Kalyanasundaram,66,0,80,14
1713311951309,MAE 131A,A00,491041,Ghazinejad; Maziar,39,0,40,1
1713311952336,MAE 142,A00,491053,Staff,39,0,40,1
1713311953366,MAE 143A,A00,491054,Staff,40,0,50,10
1713311954392,MAE 150,A00,491092,Truong; Phuong Thi Ngoc,24,0,35,11
1713311955418,MATH 3C,A01,494031,Pardo Guerra; Sebastian,30,0,30,0
1713311955418,MATH 3C,A02,494032,Pardo Guerra; Sebastian,29,0,30,1
1713311956445,MATH 10A,A01,494034,Staff,27,0,30,3
1713311956445,MATH 10A,A02,494035,Staff,29,0,30,1
1713311956445,MATH 10A,B01,494037,Staff,27,0,30,3
1713311956445,MATH 10A,B02,494038,Staff,29,0,30,1
1713311957473,MATH 10B,A01,494040,Habib; Yousaf,24,0,30,6
1713311957473,MATH 10B,A02,494041,Habib; Yousaf,28,0,30,2
1713311957473,MATH 10B,A03,494042,Habib; Yousaf,30,0,30,0
1713311957473,MATH 10B,A04,494043,Habib; Yousaf,30,0,30,0
1713311957473,MATH 10B,B01,494045,Habib; Yousaf,28,0,30,2
1713311957473,MATH 10B,B02,494046,Habib; Yousaf,30,0,30,0
1713311957473,MATH 10B,B03,494047,Habib; Yousaf,30,0,30,0
1713311957473,MATH 10B,B04,494048,Habib; Yousaf,30,0,30,0
1713311958503,MATH 18,A01,494050,Kemp; Todd Aahron,27,0,30,3
1713311958503,MATH 18,A02,494051,Kemp; Todd Aahron,29,0,30,1
1713311958503,MATH 18,B01,494054,Kemp; Todd Aahron,28,0,30,2
1713311958503,MATH 18,B02,494055,Kemp; Todd Aahron,29,0,30,1
1713311959529,MATH 20A,A01,494059,Suk; Andrew Hoon,30,0,30,0
1713311960560,MATH 20B,A01,494061,Briones; Jor-el Thomas Caparas,34,0,35,1
1713311960560,MATH 20B,B01,494063,Bach; Quang Tran,34,0,35,1
1713311961588,MATH 20C,A01,494065,Staff,28,0,30,2
1713311961588,MATH 20C,A02,494066,Staff,30,0,30,0
1713311961588,MATH 20C,A03,494067,Staff,30,0,30,0
1713311961588,MATH 20C,A04,494068,Staff,30,0,30,0
1713311961588,MATH 20C,B01,494070,Zhang; Ming,26,0,30,4
1713311961588,MATH 20C,B02,494071,Zhang; Ming,29,0,30,1
1713311961588,MATH 20C,B03,494072,Zhang; Ming,29,0,30,1
1713311961588,MATH 20C,B04,494073,Zhang; Ming,29,0,30,1
1713311962614,MATH 20D,A01,494075,Staff,25,0,30,5
1713311962614,MATH 20D,A02,494076,Staff,30,0,30,0
1713311963639,MATH 20E,A01,494079,Staff,25,0,30,5
1713311963639,MATH 20E,A02,494080,Staff,27,0,30,3
1713311963639,MATH 20E,B01,494082,Staff,28,0,30,2
1713311963639,MATH 20E,B02,494083,Staff,25,0,30,5
1713311964672,MATH 103A,A01,494085,Aliabadi Sr.; Mohsen,17,0,30,13
1713311964672,MATH 103A,A02,494086,Aliabadi Sr.; Mohsen,28,0,30,2
1713311964672,MATH 103A,B01,494088,Aliabadi Sr.; Mohsen,22,0,30,8
1713311964672,MATH 103A,B02,494089,Aliabadi Sr.; Mohsen,28,0,30,2
1713311965700,MATH 109,A01,494091,Staff,30,0,30,0
1713311965700,MATH 109,A02,494092,Staff,30,0,30,0
1713311965700,MATH 109,B01,494094,Staff,28,0,30,2
1713311965700,MATH 109,B02,494095,Staff,29,0,30,1
1713311966731,MATH 142A,A01,494097,Chow; Bennett,16,0,30,14
1713311966731,MATH 142A,A02,494098,Chow; Bennett,24,0,30,6
1713311966731,MATH 142A,B01,494100,Chow; Bennett,20,0,30,10
1713311966731,MATH 142A,B02,494101,Chow; Bennett,29,0,30,1
1713311968788,MATH 168A,A01,516677,Dumitriu; Ioana,16,0,35,19
1713311969819,MATH 170A,A01,516679,Dumitriu; Ioana,20,0,30,10
1713311969819,MATH 170A,A02,516680,Dumitriu; Ioana,28,0,30,2
1713311970844,MATH 193A,A01,494107,Staff,16,0,30,14
1713311970844,MATH 193A,A02,494108,Staff,23,0,30,7
1713311970844,MATH 193A,A03,494109,Staff,29,0,30,1
1713311970844,MATH 193A,A04,494110,Staff,24,0,30,6
1713311973921,MGT 16,A00,491930,McKay; Michael J,93,0,98,5
1713311974946,MGT 18,A00,491992,McKay; Michael J,97,0,98,1
1713311975970,MGT 71,A00,492003,Staff,78,0,98,20
1713311976995,MGT 103,A00,505209,Eberhard; Craig A,85,0,98,13
1713311978021,MGT 131A,A00,505210,Anderson; John Charles,91,0,98,7
1713311980073,MGT 153,A00,492077,Perols; Johan Lars,41,0,90,49
1713311983148,MGT 164,A00,492222,McKay; Mary A,94,0,98,4
1713311984181,MGT 172,A00,492245,Staff,59,0,60,1
1713311984181,MGT 172,B00,505526,Hedges; Kathleen,76,0,98,22
1713311985212,MGT 181,A00,505669,Dunn; Louis Jean,88,0,98,10
1713311986239,MMW 14,A01,494399,Staff,23,0,28,5
1713311986239,MMW 14,A02,494400,Staff,26,0,28,2
1713311986239,MMW 14,A03,494401,Staff,28,0,28,0
1713311986239,MMW 14,A04,494402,Staff,28,0,28,0
1713311986239,MMW 14,B01,494404,Carreras; Maria Victoria,14,0,28,14
1713311986239,MMW 14,B02,494405,Carreras; Maria Victoria,27,0,28,1
1713311986239,MMW 14,B03,494406,Carreras; Maria Victoria,28,0,28,0
1713311986239,MMW 14,B04,494407,Carreras; Maria Victoria,28,0,28,0
1713311987268,MMW 14GS,A00,506250,Chang; Edmond Yi-Teh,0,0,0,0
1713311988293,MMW 121R,A01,494415,Adamiak; Patrick John,14,0,28,14
1713311988293,MMW 121R,A02,494416,Adamiak; Patrick John,25,0,28,3
1713311989324,MUS 1A,A01,494113,Staff,12,0,25,13
1713311989324,MUS 1A,A02,494114,Staff,25,0,25,0
1713311990349,MUS 4,A01,494116,Staff,24,0,25,1
1713311990349,MUS 4,A02,494117,Staff,22,0,25,3
1713311991376,MUS 5R,A01,494236,Dubnov; Shlomo,11,0,25,14
1713311991376,MUS 5R,A02,494237,Dubnov; Shlomo,25,0,25,0
1713311992400,MUS 6,A01,494122,Staff,16,0,25,9
1713311992400,MUS 6,A02,494123,Staff,24,0,25,1
1713311993429,MUS 7,A01,494125,Staff,17,0,25,8
1713311993429,MUS 7,A02,494126,Staff,24,0,25,1
1713311994455,MUS 11,A01,494128,Staff,23,0,25,2
1713311994455,MUS 11,A02,494129,Staff,25,0,25,0
1713311995480,MUS 13,A01,494131,Staff,25,0,25,0
1713311995480,MUS 13,A02,494132,Staff,25,0,25,0
1713311996504,MUS 15,A01,494134,Staff,20,0,25,5
1713311996504,MUS 15,A02,494135,Staff,25,0,25,0
1713311996504,MUS 15,B01,494137,Staff,24,0,25,1
1713311997530,MUS 80,A00,494232,Staff,25,0,25,0
1713311997530,MUS 80,B00,494233,Staff,25,0,25,0
1713311997530,MUS 80,C00,494234,Staff,23,0,25,2
1713311998607,MUS 95C,A00,494141,Staff,72,0,75,3
1713311999632,MUS 114,A00,494142,Staff,41,0,50,9
1713312000660,NANO 15,A01,490636,Drews; Aaron,7,0,7,0
1713312001686,PHIL 1,A00,490578,Grush; Rick Scott,50,0,50,0
1713312002717,PHIL 10,A01,490580,Grush; Rick Scott,33,0,35,2
1713312002717,PHIL 10,A02,490586,Grush; Rick Scott,33,0,35,2
1713312003746,PHIL 27,A01,490591,Staff,24,0,25,1
1713312003746,PHIL 27,A02,490592,Staff,25,0,25,0
1713312003746,PHIL 27,A03,490593,Staff,25,0,25,0
1713312003746,PHIL 27,A04,490598,Staff,25,0,25,0
1713312004774,PHIL 32,A01,490611,Staff,20,0,20,0
1713312004774,PHIL 32,A02,490618,Staff,20,0,20,0
1713312005804,PHIL 90,A00,490624,Staff,40,0,40,0
1713312006836,PHIL 136,A00,490627,Cohen; Jonathan David,38,0,40,2
1713312007861,PHIL 155,A00,490634,Staff,64,0,70,6
1713312008893,PHYS 1A,A00,491610,Staff,246,0,250,4
1713312009920,PHYS 1AL,001,491616,Tsai; Philbert S,28,0,30,2
1713312009920,PHYS 1AL,002,491618,Tsai; Philbert S,30,0,30,0
1713312010948,PHYS 1B,A00,491623,Staff,244,0,250,6
1713312011978,PHYS 1BL,001,491626,Tsai; Philbert S,26,0,30,4
1713312011978,PHYS 1BL,002,491628,Tsai; Philbert S,28,0,30,2
1713312013005,PHYS 1C,A00,491632,Staff,222,0,245,23
1713312014035,PHYS 1CL,001,491635,Tsai; Philbert S,11,0,30,19
1713312014035,PHYS 1CL,002,491643,Tsai; Philbert S,24,0,30,6
1713312015060,PHYS 2AR,A01,491651,Meyertholen; Andrew D.,45,0,50,5
1713312016090,PHYS 2B,A01,491659,Staff,107,0,115,8
1713312017115,PHYS 2BL,A01,491685,Staff,22,0,24,2
1713312017115,PHYS 2BL,A02,491700,Staff,23,0,24,1
1713312018140,PHYS 2C,A01,505161,Staff,107,0,115,8
1713312019166,PHYS 4A,A01,491704,Grinstein; Benjamin,99,0,100,1
1713312020197,POLI 5D,A01,494144,Staff,3,0,5,2
1713312020197,POLI 5D,B01,626283,Dai; Yinlin,5,0,5,0
1713312021221,POLI 12,A00,494145,Staff,44,0,45,1
1713312022247,POLI 13R,A00,494146,Forman; Fonna,46,0,50,4
1713312023275,POLI 27,A01,494148,Staff,57,0,60,3
1713312024302,POLI 30,A00,494149,Staff,49,0,50,1
1713312025330,POLI 100DA,A00,494150,Staff,23,0,25,2
1713312027383,POLI 100I,A00,494152,Staff,28,0,30,2
1713312028407,POLI 104B,A00,494153,Smith; Glenn Chatmas,54,0,55,1
1713312029432,POLI 104F,A00,494154,Staff,28,0,30,2
1713312030457,POLI 104I,A00,494155,Smith; Glenn Chatmas,30,0,30,0
1713312031483,POLI 110C,A00,494156,Ingham; Sean,23,0,25,2
1713312032512,POLI 117R,A00,494157,Forman; Fonna,12,0,20,8
1713312033540,POLI 118,A00,494158,Ingham; Sean,22,0,25,3
1713312034567,POLI 120H,A00,494159,Fisk; David Lee,41,0,45,4
1713312035596,POLI 131CR,A00,494160,Hoston; Germaine,37,0,45,8
1713312036620,POLI 133J,A00,494161,Staff,33,0,35,2
1713312037647,POLI 135,A00,494162,Fisk; David Lee,33,0,35,2
1713312038675,POLI 140A,A00,494164,Staff,22,0,30,8
1713312039700,POLI 142I,A00,494165,Staff,30,0,30,0
1713312040725,POLI 144D,A00,494166,Staff,23,0,25,2
1713312041753,POLI 151,A00,494167,Staff,30,0,30,0
1713312042782,POLI 153,A00,494168,Staff,33,0,35,2
1713312043805,POLI 160AA,A00,494169,Staff,35,0,40,5
1713312044834,POLI 162,A00,494170,Mignozzetti; Umberto,20,0,25,5
1713312045858,POLI 171,A00,494171,Mignozzetti; Umberto,21,0,25,4
1713312046885,PSYC 1,A00,494172,Staff,97,0,100,3
1713312047910,PSYC 2,A00,494173,Moranton; Nirelia Melbina-,44,0,50,6
1713312048935,PSYC 3,A00,494174,Staff,30,0,30,0
1713312049962,PSYC 6,A00,494175,Staff,17,0,20,3
1713312050987,PSYC 60,A01,494177,Staff,40,0,45,5
1713312052011,PSYC 70,A01,505724,Geller; Emma Harlan,42,0,45,3
1713312053041,PSYC 101,A00,494180,Heyman; Gail D.,87,0,100,13
1713312054065,PSYC 105,A00,494181,Geller; Emma Harlan,64,0,90,26
1713312055095,PSYC 106,A00,494182,Dobkins; Karen R.,33,0,45,12
1713312056120,PSYC 108,A00,494183,Adrian; Julia Anna,94,0,100,6
1713312057147,PSYC 114,A01,494185,Winkielman; Piotr,2,0,30,28
1713312058176,PSYC 122,A00,494186,Moranton; Nirelia Melbina-,38,0,50,12
1713312059204,PSYC 124,A00,494187,Chapman; Eddie Nathaniel,72,0,80,8
1713312060235,PSYC 131,A00,494188,Anagnostaras; Stephan,57,0,80,23
1713312061261,PSYC 144,A00,494189,Staff,15,0,50,35
1713312062288,PSYC 154,A00,494190,Lacefield; Katharine I,133,0,180,47
1713312063317,PSYC 162,A00,494191,Wixted; John T,83,0,100,17
1713312064343,PSYC 172,A00,494192,Gorman; Michael R.,38,0,45,7
1713312065371,PSYC 178,A00,494193,Glaser; Dale,40,0,45,5
1713312066396,PSYC 193,A00,505725,Chapman; Eddie Nathaniel,20,0,20,0
1713312067427,RELI 145GS,A00,519817,Rahimi; Babak,19,0,20,1
1713312068460,SE 101A,A01,490862,Chadha; Mayank,24,0,25,1
1713312069489,SE 101C,A01,490924,Krysl; Petr,18,0,20,2
1713312070513,SE 110A,A01,490928,Staff,19,0,20,1
1713312071547,SE 130A,A00,490929,Morrison; Machel Leigh,64,0,70,6
1713312072573,SIO 1,A01,519325,Staff,39,0,40,1
1713312073599,SIO 30,A01,519327,Staff,39,0,40,1
1713312074624,SIO 40,A00,519328,Staff,40,0,40,0
1713312075648,SIO 46GS,A00,519819,Cook; Geoffrey W,18,0,25,7
1713312076678,SIO 109R,A00,494197,Forman; Fonna,4,0,20,16
1713312077707,SIO 121GS,A00,519827,Cook; Geoffrey W,18,0,25,7
1713312078734,SIO 132,A01,519330,Staff,38,0,40,2
1713312079760,SIO 133,A01,519397,Staff,38,0,40,2
1713312080785,SIO 139,A00,519396,Kacev; David,33,0,40,7
1713312081811,SOCI 1,A01,494199,Thorpe; Charles Robert,23,0,30,7
1713312081811,SOCI 1,A02,494200,Thorpe; Charles Robert,30,0,30,0
1713312081811,SOCI 1,A03,494201,Thorpe; Charles Robert,29,0,30,1
1713312081811,SOCI 1,A04,494202,Thorpe; Charles Robert,29,0,30,1
1713312081811,SOCI 1,A05,494203,Thorpe; Charles Robert,29,0,30,1
1713312081811,SOCI 1,A06,494204,Thorpe; Charles Robert,30,0,30,0
1713312081811,SOCI 1,A07,494205,Thorpe; Charles Robert,29,0,30,1
1713312082836,SOCI 60,A01,494207,Staff,36,0,40,4
1713312082836,SOCI 60,A02,494208,Staff,39,0,40,1
1713312083862,SOCI 100,A01,494210,Payne; Christine Anna,28,0,30,2
1713312083862,SOCI 100,A02,494211,Payne; Christine Anna,27,0,30,3
1713312084888,SOCI 109M,A00,494212,Staff,20,0,20,0
1713312085918,SOCI 110,A00,494213,Staff,35,0,40,5
1713312087977,SOCI 118E,A00,494215,Ng; Kwai,38,0,40,2
1713312089001,SOCI 125,A00,494216,Calderon-Zaks; Michael Aar,42,0,45,3
1713312090026,SOCI 126,A01,494218,Jones; Makeba,4,0,5,1
1713312091052,SOCI 131,A00,494219,Thorpe; Charles Robert,28,0,30,2
1713312093113,SOCI 135,A00,494221,Payne; Christine Anna,35,0,50,15
1713312094142,SOCI 136E,A00,626690,Ruiz; Jonathan Joseph,25,0,25,0
1713312095172,SOCI 138GS,A00,494222,Navon; Daniel,24,0,28,4
1713312097224,SOCI 145,A00,494224,Staff,42,0,45,3
1713312098249,SOCI 153,A00,494225,Staff,28,0,30,2
1713312099274,SOCI 160E,A00,494226,Ng; Kwai,33,0,40,7
1713312100302,SOCI 180,A00,494227,Staff,29,0,30,1
1713312101328,SOCI 189GS,A00,494228,Ribas Norris; Janet Vanesa,11,0,11,0
1713312102404,SOCI 190GS,A00,553232,Ribas Norris; Janet Vanesa,11,0,11,0
1713312103430,SOMI 220,A00,627178,Schneid; Stephen David,30,0,30,0
1713312104465,SYN 2,001,490768,Staff,14,0,15,1
1713312104465,SYN 2,002,490769,Staff,15,0,15,0
1713312104465,SYN 2,004,490775,Staff,0,0,0,0
1713312104465,SYN 2,003,490774,Staff,0,0,0,0
1713312104465,SYN 2,005,490776,Staff,0,0,0,0
1713312105490,SYN 2R,001,490779,Staff,13,0,15,2
1713312105490,SYN 2R,002,514635,Staff,14,0,15,1
1713312106521,SYN 100,A01,490783,Staff,15,0,20,5
1713312106521,SYN 100,B01,490787,Staff,10,0,20,10
1713312106521,SYN 100,C01,490789,Staff,13,0,20,7
1713312107549,SYN 150,A00,490817,Staff,14,0,15,1
1713312107549,SYN 150,B00,514610,Staff,15,0,15,0
1713312108583,TDAC 1,A00,492753,Walsh; Kim C.,19,0,20,1
1713312108583,TDAC 1,B00,492754,Harting; Carla Kelso,19,0,20,1
1713312108583,TDAC 1,C00,513995,Salovey; Todd,17,0,20,3
1713312109609,TDAC 101,A00,492766,Harting; Carla Kelso,17,0,20,3
1713312110641,TDAC 102,A00,492768,Basso; Beatrice,19,0,20,1
1713312111669,TDDE 111,A00,492769,Staff,25,0,25,0
1713312112696,TDDE 131,A00,492770,Staff,15,0,15,0
1713312112696,TDDE 131,B00,492771,Staff,15,0,15,0
1713312113725,TDDE 131GS,A00,523716,Guirguis; Mark C,24,0,28,4
1713312114752,TDGE 1,A01,492756,Salovey; Todd,57,0,60,3
1713312115780,TDGE 5,A01,492758,Staff,24,0,25,1
1713312116809,TDGE 10,A00,492759,Fulton; Julia,211,0,220,9
1713312117834,TDGE 11,A00,492760,Castro; Robert Jess,200,0,200,0
1713312119886,TDGE 124,A00,492772,Fulton; Julia,192,0,220,28
1713312120917,TDGE 125,A00,492773,Meyer; Ursula,40,0,50,10
1713312120917,TDGE 125,B00,492774,Staff,50,0,50,0
1713312120917,TDGE 125,C00,523565,Staff,49,0,50,1
1713312121945,TDGE 125GS,A00,523580,Guirguis; Mark C,24,0,28,4
1713312122971,TDGE 127,A00,492775,Havis; Allan,41,0,50,9
1713312124001,TDHT 101,A00,492776,Staff,35,0,35,0
1713312125031,TDMV 1,A00,492762,Caligagan; Maria T.,30,0,30,0
1713312125031,TDMV 1,B00,492763,Arcidiacono; Kristin,25,0,30,5
1713312126060,TDMV 2,A00,492764,Weinberg; Sadie,29,0,30,1
1713312127085,TDMV 3,A00,492765,Mack; Kara Shanai',39,0,40,1
1713312128115,TDMV 138,A00,492777,Mack; Kara Shanai',36,0,40,4
1713312129140,TDMV 140,A00,492778,Lima; Paulo Henrique,40,0,40,0
1713312130167,TDMV 142,A00,492779,Caligagan; Maria T.,36,0,40,4
1713312130167,TDMV 142,B00,492780,Caligagan; Tony,37,0,40,3
1713312131191,TDMV 143,A00,492781,Fyall; Daunte Edward,39,0,40,1
1713312132223,USP 1,A01,492401,Kwak; Nancy,26,0,35,9
1713312133253,USP 2,A01,492453,Hinds; Juli Beth,35,0,35,0
1713312134281,USP 3,A01,492516,Staff,29,0,35,6
1713312135311,USP 4,A00,492522,McTague; Sarah,19,0,25,6
1713312136335,USP 100,A00,492523,Staff,33,0,35,2
1713312137363,USP 101,A00,492524,Staff,13,0,15,2
1713312138388,USP 105,A00,492525,Staff,21,0,25,4
1713312139414,USP 151,A00,492526,Shenkman; Michael Thomas,33,0,35,2
1713312140443,USP 170,A00,492545,Hinds; Juli Beth,33,0,35,2
1713312141470,USP 171GS,A00,492608,Bussell; Mirle Rabinowitz,25,0,28,3
1713312142500,USP 183GS,A00,492613,Peerson; Susan,25,0,28,3
1713312143526,VIS 30,A01,490693,Yoldas; Pinar,21,0,22,1
1713312143526,VIS 30,A02,490694,Yoldas; Pinar,19,0,22,3
1713312144553,VIS 83,A00,490695,Kester; Grant,66,0,75,9
1713312145580,VIS 105D,A00,490696,Staff,22,0,25,3
1713312146606,VIS 124CN,A00,490699,Rose; Jordan M,68,0,75,7
1713312147631,VIS 125GS,A00,511221,Williams; Alena J,21,0,22,1
1713312148659,VIS 128D,A00,490700,Staff,74,0,75,1
1713312149685,VIS 151,A01,490717,Staff,33,0,34,1
1713312149685,VIS 151,A02,490766,Staff,33,0,34,1
1713312150714,VIS 154GS,A00,511972,Williams; Alena J,21,0,22,1
1713312151739,VIS 160A,A00,490767,Stone; Patricia,7,0,10,3
1713312152764,WCWP 10A,A00,490638,Staff,14,0,15,1
1713312152764,WCWP 10A,B00,490640,Staff,15,0,15,0
1713312153792,WCWP 10B,A00,490641,Staff,0,0,0,0
1713312153792,WCWP 10B,B00,490642,Staff,14,0,15,1
1713312153792,WCWP 10B,C00,490644,Staff,13,0,15,2
1713312153792,WCWP 10B,D00,490647,Staff,0,0,0,0
1713312154818,WCWP 100,A00,490655,Staff,0,0,0,0
1713312154818,WCWP 100,B00,490687,Staff,12,0,15,3
1713312156945,ANAR 153,A00,487222,Braswell; Geoffrey E.,54,0,60,6
1713312157980,ANBI 134,A00,487223,Staff,12,0,20,8
1713312159007,ANBI 143GS,A00,487224,Noel; Geoffroy Pierre Jean,20,0,24,4
1713312160032,ANBI 144GS,A00,519548,Noel; Geoffroy Pierre Jean,20,0,24,4
1713312161062,ANSC 101,A00,487225,Staff,19,0,20,1
1713312162096,ANSC 125,A00,487227,Brenner; Suzanne A,39,0,40,1
1713312164146,ANSC 146,A00,487229,Staff,36,0,40,4
1713312165172,ANSC 148,A00,487230,Olivas Hernandez; Olga Lid,39,0,40,1
1713312166199,ANSC 150,A00,504165,Sloane; Julia Kathryn,19,0,20,1
1713312167225,ANSC 180,A00,487232,Staff,13,0,15,2
1713312168250,ANSC 188,A00,627155,Staff,40,0,40,0
1713312169276,ANTH 5,A00,519529,Semendeferi; Ekaterini,15,0,15,0
1713312170301,ANTH 10,A00,487219,Staff,58,0,60,2
1713312171328,ANTH 23,A01,487221,Staff,17,0,20,3
1713312172359,ANTH 102,A00,487233,Wilder; Linnea Lorene,52,0,60,8
1713312173385,ANTH 103,A00,487234,Varma; Saiba,56,0,60,4
1713312174413,ANTH 105,A00,487235,Stewart; Alexander B,56,0,60,4
1713312175444,BENG 100,A01,516685,Taylor Amos; Alyssa C,28,0,30,2
1713312176474,BIBC 102,A01,491316,Flagg; Matthew Paul,42,0,88,46
1713312176474,BIBC 102,A02,491366,Flagg; Matthew Paul,83,0,88,5
1713312177503,BIBC 103,A01,491486,Boumechache; Miyyada,16,0,24,8
1713312177503,BIBC 103,A02,491487,Boumechache; Miyyada,24,0,24,0
1713312178531,BICD 100,A01,516882,Staff,75,0,75,0
1713312178531,BICD 100,A02,516890,Staff,70,0,75,5
1713312179560,BICD 102GS,A00,491488,Lo; Stanley M.,26,0,28,2
1713312180587,BIEB 136GS,A00,516940,Holway; David A. & Shurin; Jonathan,19,0,24,5
1713312181612,BIEB 137GS,A01,517034,Holway; David A. & Shurin; Jonathan,19,0,24,5
1713312182642,BIEB 138GS,A01,491492,Pirino; Giorgia,21,0,28,7
1713312183667,BILD 1,A01,491296,Staff,62,0,63,1
1713312183667,BILD 1,A02,491297,Staff,63,0,63,0
1713312184692,BILD 4,A01,517099,Gonzalez Gamboa; Ivonne,22,0,24,2
1713312184692,BILD 4,A02,517100,Gonzalez Gamboa; Ivonne,24,0,24,0
1713312185721,BILD 60GS,A00,491309,Lo; Stanley M.,26,0,28,2
1713312186746,BIMM 100,A01,517136,Staff,91,0,100,9
1713312187771,BIMM 110,A01,517182,Staff,71,0,100,29
1713312188799,BIMM 120,A01,517228,Pickett; Brooke Elizabeth,40,0,63,23
1713312188799,BIMM 120,A02,517240,Pickett; Brooke Elizabeth,48,0,63,15
1713312189827,BIMM 132GS,A01,491498,Pirino; Giorgia,21,0,28,7
1713312190854,BIMM 143,A01,491589,Bozinovic; Goran,18,0,40,22
1713312191881,BIPN 100,A01,491594,Armour; Jon Christopher,91,0,100,9
1713312192909,BIPN 140,A01,491602,Marino; Marc J,30,0,50,20
1713312194963,CAT 125,A00,515973,Staff,20,0,20,0
1713312195987,CAT 125GS,A00,515974,Rahimi; Babak,18,0,20,2
1713312197024,CAT 125R,A00,515980,Staff,14,0,20,6
1713312197024,CAT 125R,B00,515981,Tosun; Adriana,19,0,20,1
1713312197024,CAT 125R,C00,515987,Hyland; Tina Mae,3,0,20,17
1713312197024,CAT 125R,D00,515988,Bronstein; Phoebe Malan,18,0,20,2
1713312198051,CENG 15,A01,488699,Drews; Aaron,25,0,25,0
1713312199083,CENG 100,A00,505196,Opatkiewicz; Justin Paul,25,0,25,0
1713312200115,CGS 2A,A01,489598,Staff,33,0,35,2
1713312201140,CGS 112,A00,489599,Staff,15,0,15,0
1713312202168,CGS 119,A00,489603,Staff,10,0,10,0
1713312203195,CGS 120,A00,489604,Staff,14,0,15,1
1713312204220,CGS 150,A00,489607,Staff,15,0,15,0
1713312205250,CHEM 6A,A01,488715,Staff,98,0,100,2
1713312206340,CHEM 6B,A01,488719,Piercy; Marc Anthony,100,0,100,0
1713312207365,CHEM 6C,A01,488723,Albizati; Kim F.,94,0,100,6
1713312208393,CHEM 7L,A01,488728,Schurmeier; Kimberly,18,0,24,6
1713312208393,CHEM 7L,A02,488730,Schurmeier; Kimberly,23,0,24,1
1713312208393,CHEM 7L,A03,488734,Schurmeier; Kimberly,23,0,24,1
1713312208393,CHEM 7L,A04,488763,Schurmeier; Kimberly,23,0,24,1
1713312208393,CHEM 7L,B01,488798,Schurmeier; Kimberly,18,0,24,6
1713312208393,CHEM 7L,B02,488801,Schurmeier; Kimberly,23,0,24,1
1713312208393,CHEM 7L,B03,488808,Schurmeier; Kimberly,24,0,24,0
1713312208393,CHEM 7L,B04,488811,Schurmeier; Kimberly,24,0,24,0
1713312209418,CHEM 11,A01,488897,Stallings; Dontarie M,98,0,100,2
1713312210443,CHEM 40A,A01,488913,Albizati; Kim F.,90,0,100,10
1713312211470,CHEM 40B,A01,488920,Weizman; Haim,47,0,50,3
1713312211470,CHEM 40B,A02,488938,Weizman; Haim,46,0,50,4
1713312212495,CHEM 41A,A01,489029,Klosterman; Jeremy K,58,0,60,2
1713312213520,CHEM 41C,A01,500436,Tor; Yitzhak,55,0,60,5
1713312214553,CHEM 43A,A01,500426,Weizman; Haim,2,0,24,22
1713312214553,CHEM 43A,A02,500430,Weizman; Haim,13,0,24,11
1713312214553,CHEM 43A,B01,514041,Klosterman; Jeremy K,15,0,24,9
1713312214553,CHEM 43A,B02,514047,Klosterman; Jeremy K,23,0,24,1
1713312215579,CHEM 108,A01,489140,Jennings; Patricia A.,13,0,24,11
1713312215579,CHEM 108,A02,489142,Jennings; Patricia A.,15,0,24,9
1713312216606,CHEM 114A,A01,489147,Stallings; Dontarie M,78,0,100,22
1713312217632,CHIN 169A,A00,489171,Wang; Xiao,19,0,20,1
1713312219688,COGS 3,A01,518827,Boyle; Mary E. T.,29,0,40,11
1713312220712,COGS 11,A01,489175,Staff,28,0,30,2
1713312221738,COGS 14A,A01,518829,Staff,52,0,60,8
1713312222769,COGS 14B,A01,489177,Hoffman; Drew Ellen,69,0,75,6
1713312223800,COGS 100,A01,489181,Allen; Michael Gordon,66,0,75,9
1713312224825,COGS 101A,A01,489183,Staff,49,0,60,11
1713312225849,COGS 101B,A01,489185,Allen; Michael Gordon,13,0,30,17
1713312226874,COGS 101C,A01,526786,Staff,24,0,30,6
1713312228932,COGS 107A,A01,489189,Boyle; Mary E. T.,22,0,35,13
1713312229955,COGS 107B,A01,627144,Mooshagian; Eric Frederick,60,0,60,0
1713312230980,COGS 118A,A01,489191,Staff,0,31,40,40
1713312233043,COGS 171GS,A01,489194,Pineda; Jaime A,22,0,28,6
1713312234073,COGS 172,A01,489196,Staff,5,0,30,25
1713312235095,COGS 174GS,A01,489264,Pineda; Jaime A,22,0,28,6
1713312236120,COGS 180,A01,627150,Staff,28,0,30,2
1713312237150,COGS 186,A01,489274,Staff,2,0,30,28
1713312238174,COMM 10,A01,489276,Staff,23,0,25,2
1713312238174,COMM 10,A02,489303,Staff,23,0,25,2
1713312239199,COMM 100A,A01,489312,Staff,17,0,25,8
1713312239199,COMM 100A,A02,489313,Staff,24,0,25,1
1713312240229,COMM 106T,A00,512540,Staff,34,0,35,1
1713312241255,COMM 107,A00,489347,Staff,31,0,35,4
1713312242278,COMM 109P,A00,489358,Staff,31,0,35,4
1713312243303,COMM 132,A00,489361,McKenna; Denise,28,0,30,2
1713312244330,COMM 146,A00,489362,Halm; Gavin Patrick,27,0,30,3
1713312245354,COMM 190,A00,489363,Abuelhiga; Soraya Jill,20,0,23,3
1713312246388,CSE 8A,A50,489366,Staff,23,0,25,2
1713312246388,CSE 8A,A51,489367,Staff,24,0,25,1
1713312247417,CSE 11,A01,489398,Cao; Yingjun,79,0,100,21
1713312248442,CSE 12,A01,489487,Staff,43,0,50,7
1713312249465,CSE 20,A01,489497,Staff,49,0,50,1
1713312250494,CSE 21,A01,489517,Braun; Oliver,44,0,50,6
1713312251518,CSE 101,A01,489524,Braun; Oliver,0,15,50,50
1713312252544,CSE 105,A01,512594,Jones; Miles E,80,0,100,20
1713312252544,CSE 105,B01,512598,Jones; Miles E,62,0,100,38
1713312253572,CSE 140,A01,489538,Staff,44,0,50,6
1713312254602,CSE 141,A01,489550,Eldon; John,76,0,100,24
1713312255628,CSE 141L,A01,489571,Eldon; John,74,0,100,26
1713312256654,CSE 151A,A01,489583,Solares; Edwin A,151,0,200,49
1713312257680,CSE 175,A01,510886,Kumar; Rakesh,30,0,30,0
1713312258705,CSE 190,A00,516828,Dubnov; Shlomo,41,0,49,8
1713312259732,DOC 100D,A00,489667,Pass; Natalye Joann,23,0,25,2
1713312260763,DSC 10,A01,624268,Staff,72,0,75,3
1713312261789,DSC 20,A01,624476,Staff,50,0,50,0
1713312262814,DSC 40A,A01,624608,Staff,40,0,40,0
1713312263847,DSGN 1,A01,489179,Rill; Bryan,36,0,50,14
1713312264876,ECE 17,A01,490489,Sahay; Rajeev,18,0,30,12
1713312265904,ECE 65,A50,490492,Staff,16,0,20,4
1713312265904,ECE 65,A51,490493,Staff,20,0,20,0
1713312266929,ECON 1,A01,489715,Famulari; Melissa,69,0,70,1
1713312267960,ECON 2,A01,489717,Levkoff; Steven B.,68,0,70,2
1713312268989,ECON 3,A01,489948,Staff,70,0,70,0
1713312271042,ECON 5,A01,490103,Staff,28,0,30,2
1713312271042,ECON 5,B01,626281,Dai; Yinlin,45,0,45,0
1713312272072,ECON 100A,A01,490127,Famulari; Melissa,68,0,70,2
1713312273097,ECON 100B,A01,490129,Staff,64,0,70,6
1713312274131,ECON 109,A01,490187,Shishkin; Denis,27,0,35,8
1713312275161,ECON 110A,A01,490190,Levkoff; Steven B.,62,0,70,8
1713312276187,ECON 120A,A01,490245,Dai; Yinlin,65,0,70,5
1713312277220,ECON 120B,A01,490247,Nieto-Barthaburu; Augusto,59,0,70,11
1713312278245,ECON 120C,A01,490253,Sun; Yixiao,31,0,35,4
1713312278245,ECON 120C,B01,490255,Sun; Yixiao,34,0,35,1
1713312279270,ECON 129,A00,490256,Eckert; Fabian Paul,25,0,35,10
1713312280302,ECON 131,A00,490257,Nieto-Barthaburu; Augusto,1,0,35,34
1713312281335,ECON 138,A00,490258,Bharadwaj; Prashant,21,0,35,14
1713312281335,ECON 138,B00,490259,Bharadwaj; Prashant,17,0,35,18
1713312282360,ECON 159,A00,490260,Hendrickson; Gerald M.,0,7,0,0
1713312283391,ECON 178,A01,553995,Zhu; Ying,27,0,35,8
1713312284423,EDS 40,A01,512576,Black; Alison Michelle,20,0,20,0
1713312285447,EDS 107,A01,515848,Staff,30,0,30,0
1713312286472,EDS 110R,A01,490262,Staff,26,0,30,4
1713312287504,EDS 112,A01,490264,Chapman; Thandeka K,43,0,50,7
1713312288526,EDS 113,A00,490266,Staff,26,0,30,4
1713312289552,EDS 118,A00,490267,Warstadt; Melissa Fawn,26,0,30,4
1713312290578,EDS 124BR,A00,490268,Eguchi; Emi,9,0,25,16
1713312290578,EDS 124BR,B00,490269,Eguchi; Emi,25,0,25,0
1713312291607,EDS 126,A01,490271,Jones; Makeba,45,0,50,5
1713312292637,EDS 135,A01,490316,Staff,19,0,20,1
1713312293667,ENVR 142GS,A00,519514,Chang; Edmond Yi-Teh,28,0,28,0
1713312294690,ETHN 103,A00,490504,Staff,31,0,36,5
1713312295729,ETHN 103A,A00,490505,Man; Simeon S,5,0,9,4
1713312296753,ETHN 109,A00,490506,Staff,30,0,30,0
1713312297780,ETHN 118,A00,490507,Staff,35,0,36,1
1713312298810,ETHN 119,A00,490508,Staff,36,0,36,0
1713312299835,ETHN 121R,A00,490518,Choi; Esther Min,28,0,36,8
1713312300861,ETHN 127,A00,490528,Staff,15,0,15,0
1713312301885,ETHN 139,A00,490573,Staff,10,0,10,0
1713312302912,ETHN 150,A00,490575,Staff,15,0,15,0
1713312303941,GLBH 20,A00,491705,Elwardani; Nile Regina,38,0,40,2
1713312304974,GLBH 101,A00,491706,Staff,20,0,20,0
1713312306004,GLBH 111,A01,491708,Burgos; Jose L.,15,0,15,0
1713312307035,GLBH 146,A00,491709,Staff,11,0,20,9
1713312308072,GLBH 148,A00,491710,Olivas Hernandez; Olga Lid,14,0,20,6
1713312309105,GLBH 150,A00,491711,Sloane; Julia Kathryn,20,0,20,0
1713312310185,HIEA 131,A00,491760,Staff,29,0,32,3
1713312311215,HIEA 153,A00,491762,Staff,29,0,30,1
1713312312243,HIEU 124,A00,491811,Staff,26,0,32,6
1713312313270,HIEU 124GS,A00,491812,Markman; Kristina,28,0,28,0
1713312314296,HIEU 147,A00,491813,Staff,30,0,32,2
1713312315323,HIEU 149GS,A00,491816,Caldwell; Michael Alan,28,0,28,0
1713312316350,HILD 2C,A01,491713,Hendrickson; Gerald M.,27,0,30,3
1713312317376,HILD 7B,A01,491715,Kwak; Nancy,11,0,30,19
1713312318403,HILD 10,A01,491717,Staff,14,0,20,6
1713312319431,HILD 30GS,A00,491719,Edington; Claire Ellen,24,0,28,4
1713312320461,HINE 109,A00,491818,Shafir; Nir,28,0,32,4
1713312321489,HINE 128,A00,491821,Shafir; Nir,31,0,32,1
1713312322514,HISC 117,A00,491830,Staff,29,0,32,3
1713312323542,HIUS 103,A00,491834,Man; Simeon S,15,0,23,8
1713312324571,HIUS 108B,A00,491835,Staff,29,0,30,1
1713312325596,HIUS 141,A00,491836,Hendrickson; Gerald M.,29,0,32,3
1713312326622,HIUS 149,A00,491839,Staff,27,0,32,5
1713312327649,HUM 3,A01,512617,Crum; Matthew Stephen,45,0,50,5
1713312327649,HUM 3,A02,512618,Crum; Matthew Stephen,48,0,50,2
1713312328675,HUM 3GS,A00,512663,Markman; Kristina,0,0,0,0
1713312328675,HUM 3GS,B00,512664,Staff,0,0,0,0
1713312329701,HUM 4,A01,512620,West; Geoffrey Scott,32,0,50,18
1713312330729,HUM 4GS,A00,512666,Lyon; Antony J.,0,0,0,3
1713312331756,HUM 4R,A01,512625,Watkins; Eric,49,0,50,1
1713312332781,HUM 5,A01,512649,Zavodny; Tatiana Sophia,31,0,50,19
1713312332781,HUM 5,B01,512661,Zroka; Ryan Edward,48,0,50,2
1713312333806,INTL 190,A00,490577,Segui; Alan S,0,0,0,5
1713312334838,JAPN 20AR,A01,491267,Ross; Kayoko F,11,0,20,9
1713312335864,JAPN 180,A00,491285,Berman; Michael David,34,0,40,6
1713312336896,LATI 50,A01,502536,Kokinis; Troy Andreas,17,0,22,5
1713312336896,LATI 50,A02,502551,Kokinis; Troy Andreas,22,0,22,0
1713312336896,LATI 50,A03,502650,Kokinis; Troy Andreas,22,0,22,0
1713312336896,LATI 50,A04,502909,Kokinis; Troy Andreas,22,0,22,0
1713312337927,LATI 160,A01,502920,Kokinis; Troy Andreas,30,0,30,0
1713312338960,LIFR 1A,A00,490494,Van Moer; Vinciane G,17,0,20,3
1713312339986,LIFR 1AX,A00,490495,Van Moer; Vinciane G,17,0,20,3
1713312341015,LIFR 1B,A00,490496,Van Moer; Vinciane G,19,0,20,1
1713312342042,LIFR 1BX,A00,490497,Van Moer; Vinciane G,19,0,20,1
1713312343066,LIGN 8,A00,505198,McIntosh; Justin Daniel,136,0,150,14
1713312344091,LIGN 9GS,A00,491239,Lott; Margaret S.,18,0,20,2
1713312345120,LIGN 101,A01,505200,McIntosh; Justin Daniel,25,0,30,5
1713312346150,LIGN 120,A01,491244,Staff,24,0,30,6
1713312347178,LIGN 149GS,A00,491245,Lott; Margaret S.,18,0,20,2
1713312348202,LIGN 170,A00,491247,Staff,24,0,30,6
1713312349227,LISP 1D,A00,490498,Munoz Sanchez; Alicia,11,0,14,3
1713312349227,LISP 1D,B00,490499,Munoz Sanchez; Alicia,6,0,14,8
1713312349227,LISP 1D,C00,490500,Munoz Sanchez; Alicia,10,0,14,4
1713312349227,LISP 1D,D00,490501,Munoz Sanchez; Alicia,11,0,14,3
1713312350254,LISP 1DX,A00,490502,Munoz Sanchez; Alicia,18,0,28,10
1713312350254,LISP 1DX,B00,490503,Munoz Sanchez; Alicia,19,0,28,9
1713312352314,LTAM 110,A00,491847,Staff,23,0,25,2
1713312353343,LTCS 119,A00,491848,Staff,12,0,15,3
1713312354369,LTCS 130,A00,491849,Staff,24,0,25,1
1713312356418,LTEA 120C,A00,491852,Staff,34,0,40,6
1713312357448,LTEN 130GS,A00,491853,Lyon; Antony J.,25,0,28,3
1713312358478,LTEN 148,A00,491855,Staff,23,0,25,2
1713312359507,LTEN 159,A00,491856,Staff,21,0,25,4
1713312360533,LTEN 180,A00,491857,Staff,9,0,15,6
1713312362584,LTSP 123GS,A00,505928,Bessett; Ryan Matthew,25,0,28,3
1713312363618,LTSP 174GS,A00,506037,Bessett; Ryan Matthew,25,0,28,3
1713312365672,LTWR 102,A00,491861,Staff,11,0,15,4
1713312366697,LTWR 106,A00,491862,Staff,10,0,15,5
1713312367725,MAE 11,A00,490930,Bahadori; Mohammad Yousef,97,0,100,3
1713312368752,MAE 30A,A00,490931,Qi; Huihui,37,0,40,3
1713312369777,MAE 101A,A00,491036,Sadeghizadeh; Zahra,97,0,100,3
1713312370808,MAE 101C,A00,491037,Seshadri; Kalyanasundaram,76,0,100,24
1713312371832,MAE 113,A00,491040,Seshadri; Kalyanasundaram,66,0,80,14
1713312372860,MAE 131A,A00,491041,Ghazinejad; Maziar,39,0,40,1
1713312373885,MAE 142,A00,491053,Staff,39,0,40,1
1713312374909,MAE 143A,A00,491054,Staff,39,0,50,11
1713312375939,MAE 150,A00,491092,Truong; Phuong Thi Ngoc,24,0,35,11
1713312376970,MATH 3C,A01,494031,Pardo Guerra; Sebastian,30,0,30,0
1713312376970,MATH 3C,A02,494032,Pardo Guerra; Sebastian,29,0,30,1
1713312377997,MATH 10A,A01,494034,Staff,27,0,30,3
1713312377997,MATH 10A,A02,494035,Staff,29,0,30,1
1713312377997,MATH 10A,B01,494037,Staff,27,0,30,3
1713312377997,MATH 10A,B02,494038,Staff,29,0,30,1
1713312379026,MATH 10B,A01,494040,Habib; Yousaf,24,0,30,6
1713312379026,MATH 10B,A02,494041,Habib; Yousaf,28,0,30,2
1713312379026,MATH 10B,A03,494042,Habib; Yousaf,30,0,30,0
1713312379026,MATH 10B,A04,494043,Habib; Yousaf,30,0,30,0
1713312379026,MATH 10B,B01,494045,Habib; Yousaf,28,0,30,2
1713312379026,MATH 10B,B02,494046,Habib; Yousaf,30,0,30,0
1713312379026,MATH 10B,B03,494047,Habib; Yousaf,30,0,30,0
1713312379026,MATH 10B,B04,494048,Habib; Yousaf,30,0,30,0
1713312380053,MATH 18,A01,494050,Kemp; Todd Aahron,27,0,30,3
1713312380053,MATH 18,A02,494051,Kemp; Todd Aahron,29,0,30,1
1713312380053,MATH 18,B01,494054,Kemp; Todd Aahron,28,0,30,2
1713312380053,MATH 18,B02,494055,Kemp; Todd Aahron,29,0,30,1
1713312381088,MATH 20A,A01,494059,Suk; Andrew Hoon,30,0,30,0
1713312382116,MATH 20B,A01,494061,Briones; Jor-el Thomas Caparas,33,0,35,2
1713312382116,MATH 20B,B01,494063,Bach; Quang Tran,34,0,35,1
1713312383147,MATH 20C,A01,494065,Staff,28,0,30,2
1713312383147,MATH 20C,A02,494066,Staff,30,0,30,0
1713312383147,MATH 20C,A03,494067,Staff,30,0,30,0
1713312383147,MATH 20C,A04,494068,Staff,30,0,30,0
1713312383147,MATH 20C,B01,494070,Zhang; Ming,26,0,30,4
1713312383147,MATH 20C,B02,494071,Zhang; Ming,29,0,30,1
1713312383147,MATH 20C,B03,494072,Zhang; Ming,29,0,30,1
1713312383147,MATH 20C,B04,494073,Zhang; Ming,29,0,30,1
1713312384172,MATH 20D,A01,494075,Staff,25,0,30,5
1713312384172,MATH 20D,A02,494076,Staff,30,0,30,0
1713312385198,MATH 20E,A01,494079,Staff,25,0,30,5
1713312385198,MATH 20E,A02,494080,Staff,27,0,30,3
1713312385198,MATH 20E,B01,494082,Staff,28,0,30,2
1713312385198,MATH 20E,B02,494083,Staff,25,0,30,5
1713312386228,MATH 103A,A01,494085,Aliabadi Sr.; Mohsen,17,0,30,13
1713312386228,MATH 103A,A02,494086,Aliabadi Sr.; Mohsen,28,0,30,2
1713312386228,MATH 103A,B01,494088,Aliabadi Sr.; Mohsen,22,0,30,8
1713312386228,MATH 103A,B02,494089,Aliabadi Sr.; Mohsen,28,0,30,2
1713312387260,MATH 109,A01,494091,Staff,30,0,30,0
1713312387260,MATH 109,A02,494092,Staff,30,0,30,0
1713312387260,MATH 109,B01,494094,Staff,28,0,30,2
1713312387260,MATH 109,B02,494095,Staff,29,0,30,1
1713312388287,MATH 142A,A01,494097,Chow; Bennett,16,0,30,14
1713312388287,MATH 142A,A02,494098,Chow; Bennett,24,0,30,6
1713312388287,MATH 142A,B01,494100,Chow; Bennett,20,0,30,10
1713312388287,MATH 142A,B02,494101,Chow; Bennett,29,0,30,1
1713312390341,MATH 168A,A01,516677,Dumitriu; Ioana,16,0,35,19
1713312391400,MATH 170A,A01,516679,Dumitriu; Ioana,20,0,30,10
1713312391400,MATH 170A,A02,516680,Dumitriu; Ioana,28,0,30,2
1713312392427,MATH 193A,A01,494107,Staff,16,0,30,14
1713312392427,MATH 193A,A02,494108,Staff,23,0,30,7
1713312392427,MATH 193A,A03,494109,Staff,29,0,30,1
1713312392427,MATH 193A,A04,494110,Staff,24,0,30,6
1713312395509,MGT 16,A00,491930,McKay; Michael J,93,0,98,5
1713312396536,MGT 18,A00,491992,McKay; Michael J,97,0,98,1
1713312397562,MGT 71,A00,492003,Staff,77,0,98,21
1713312398588,MGT 103,A00,505209,Eberhard; Craig A,85,0,98,13
1713312399623,MGT 131A,A00,505210,Anderson; John Charles,91,0,98,7
1713312401673,MGT 153,A00,492077,Perols; Johan Lars,41,0,90,49
1713312404892,MGT 164,A00,492222,McKay; Mary A,94,0,98,4
1713312405917,MGT 172,A00,492245,Staff,59,0,60,1
1713312405917,MGT 172,B00,505526,Hedges; Kathleen,76,0,98,22
1713312406945,MGT 181,A00,505669,Dunn; Louis Jean,88,0,98,10
1713312407973,MMW 14,A01,494399,Staff,23,0,28,5
1713312407973,MMW 14,A02,494400,Staff,26,0,28,2
1713312407973,MMW 14,A03,494401,Staff,28,0,28,0
1713312407973,MMW 14,A04,494402,Staff,28,0,28,0
1713312407973,MMW 14,B01,494404,Carreras; Maria Victoria,13,0,28,15
1713312407973,MMW 14,B02,494405,Carreras; Maria Victoria,27,0,28,1
1713312407973,MMW 14,B03,494406,Carreras; Maria Victoria,28,0,28,0
1713312407973,MMW 14,B04,494407,Carreras; Maria Victoria,28,0,28,0
1713312409006,MMW 14GS,A00,506250,Chang; Edmond Yi-Teh,0,0,0,0
1713312410035,MMW 121R,A01,494415,Adamiak; Patrick John,14,0,28,14
1713312410035,MMW 121R,A02,494416,Adamiak; Patrick John,25,0,28,3
1713312411061,MUS 1A,A01,494113,Staff,12,0,25,13
1713312411061,MUS 1A,A02,494114,Staff,25,0,25,0
1713312412086,MUS 4,A01,494116,Staff,24,0,25,1
1713312412086,MUS 4,A02,494117,Staff,22,0,25,3
1713312413112,MUS 5R,A01,494236,Dubnov; Shlomo,11,0,25,14
1713312413112,MUS 5R,A02,494237,Dubnov; Shlomo,25,0,25,0
1713312414193,MUS 6,A01,494122,Staff,15,0,25,10
1713312414193,MUS 6,A02,494123,Staff,24,0,25,1
1713312415219,MUS 7,A01,494125,Staff,17,0,25,8
1713312415219,MUS 7,A02,494126,Staff,24,0,25,1
1713312416245,MUS 11,A01,494128,Staff,23,0,25,2
1713312416245,MUS 11,A02,494129,Staff,25,0,25,0
1713312417271,MUS 13,A01,494131,Staff,25,0,25,0
1713312417271,MUS 13,A02,494132,Staff,25,0,25,0
1713312418296,MUS 15,A01,494134,Staff,20,0,25,5
1713312418296,MUS 15,A02,494135,Staff,25,0,25,0
1713312418296,MUS 15,B01,494137,Staff,24,0,25,1
1713312419326,MUS 80,A00,494232,Staff,25,0,25,0
1713312419326,MUS 80,B00,494233,Staff,25,0,25,0
1713312419326,MUS 80,C00,494234,Staff,23,0,25,2
1713312420354,MUS 95C,A00,494141,Staff,72,0,75,3
1713312421381,MUS 114,A00,494142,Staff,41,0,50,9
1713312422413,NANO 15,A01,490636,Drews; Aaron,7,0,7,0
1713312423450,PHIL 1,A00,490578,Grush; Rick Scott,49,0,50,1
1713312424476,PHIL 10,A01,490580,Grush; Rick Scott,33,0,35,2
1713312424476,PHIL 10,A02,490586,Grush; Rick Scott,33,0,35,2
1713312425506,PHIL 27,A01,490591,Staff,24,0,25,1
1713312425506,PHIL 27,A02,490592,Staff,25,0,25,0
1713312425506,PHIL 27,A03,490593,Staff,25,0,25,0
1713312425506,PHIL 27,A04,490598,Staff,25,0,25,0
1713312426533,PHIL 32,A01,490611,Staff,20,0,20,0
1713312426533,PHIL 32,A02,490618,Staff,20,0,20,0
1713312427562,PHIL 90,A00,490624,Staff,40,0,40,0
1713312428589,PHIL 136,A00,490627,Cohen; Jonathan David,38,0,40,2
1713312429617,PHIL 155,A00,490634,Staff,64,0,70,6
1713312430642,PHYS 1A,A00,491610,Staff,246,0,250,4
1713312431676,PHYS 1AL,001,491616,Tsai; Philbert S,28,0,30,2
1713312431676,PHYS 1AL,002,491618,Tsai; Philbert S,30,0,30,0
1713312432705,PHYS 1B,A00,491623,Staff,244,0,250,6
1713312433731,PHYS 1BL,001,491626,Tsai; Philbert S,26,0,30,4
1713312433731,PHYS 1BL,002,491628,Tsai; Philbert S,28,0,30,2
1713312434761,PHYS 1C,A00,491632,Staff,222,0,245,23
1713312435787,PHYS 1CL,001,491635,Tsai; Philbert S,11,0,30,19
1713312435787,PHYS 1CL,002,491643,Tsai; Philbert S,24,0,30,6
1713312436813,PHYS 2AR,A01,491651,Meyertholen; Andrew D.,45,0,50,5
1713312437840,PHYS 2B,A01,491659,Staff,107,0,115,8
1713312438863,PHYS 2BL,A01,491685,Staff,22,0,24,2
1713312438863,PHYS 2BL,A02,491700,Staff,23,0,24,1
1713312439888,PHYS 2C,A01,505161,Staff,107,0,115,8
1713312440919,PHYS 4A,A01,491704,Grinstein; Benjamin,99,0,100,1
1713312441946,POLI 5D,A01,494144,Staff,3,0,5,2
1713312441946,POLI 5D,B01,626283,Dai; Yinlin,5,0,5,0
1713312442972,POLI 12,A00,494145,Staff,44,0,45,1
1713312444003,POLI 13R,A00,494146,Forman; Fonna,46,0,50,4
1713312445034,POLI 27,A01,494148,Staff,57,0,60,3
1713312446058,POLI 30,A00,494149,Staff,49,0,50,1
1713312447086,POLI 100DA,A00,494150,Staff,23,0,25,2
1713312449137,POLI 100I,A00,494152,Staff,28,0,30,2
1713312450169,POLI 104B,A00,494153,Smith; Glenn Chatmas,54,0,55,1
1713312451197,POLI 104F,A00,494154,Staff,28,0,30,2
1713312452224,POLI 104I,A00,494155,Smith; Glenn Chatmas,30,0,30,0
1713312453254,POLI 110C,A00,494156,Ingham; Sean,23,0,25,2
1713312454279,POLI 117R,A00,494157,Forman; Fonna,11,0,20,9
1713312455305,POLI 118,A00,494158,Ingham; Sean,22,0,25,3
1713312456329,POLI 120H,A00,494159,Fisk; David Lee,41,0,45,4
1713312457354,POLI 131CR,A00,494160,Hoston; Germaine,37,0,45,8
1713312458381,POLI 133J,A00,494161,Staff,33,0,35,2
1713312459406,POLI 135,A00,494162,Fisk; David Lee,33,0,35,2
1713312460432,POLI 140A,A00,494164,Staff,22,0,30,8
1713312461460,POLI 142I,A00,494165,Staff,30,0,30,0
1713312462484,POLI 144D,A00,494166,Staff,23,0,25,2
1713312463510,POLI 151,A00,494167,Staff,30,0,30,0
1713312464536,POLI 153,A00,494168,Staff,33,0,35,2
1713312465563,POLI 160AA,A00,494169,Staff,35,0,40,5
1713312466587,POLI 162,A00,494170,Mignozzetti; Umberto,20,0,25,5
1713312467615,POLI 171,A00,494171,Mignozzetti; Umberto,21,0,25,4
1713312468640,PSYC 1,A00,494172,Staff,97,0,100,3
1713312469665,PSYC 2,A00,494173,Moranton; Nirelia Melbina-,43,0,50,7
1713312470690,PSYC 3,A00,494174,Staff,29,0,30,1
1713312471720,PSYC 6,A00,494175,Staff,17,0,20,3
1713312472747,PSYC 60,A01,494177,Staff,39,0,45,6
1713312473780,PSYC 70,A01,505724,Geller; Emma Harlan,42,0,45,3
1713312474807,PSYC 101,A00,494180,Heyman; Gail D.,87,0,100,13
1713312475840,PSYC 105,A00,494181,Geller; Emma Harlan,64,0,90,26
1713312476867,PSYC 106,A00,494182,Dobkins; Karen R.,33,0,45,12
1713312477893,PSYC 108,A00,494183,Adrian; Julia Anna,94,0,100,6
1713312478921,PSYC 114,A01,494185,Winkielman; Piotr,2,0,30,28
1713312479946,PSYC 122,A00,494186,Moranton; Nirelia Melbina-,38,0,50,12
1713312480972,PSYC 124,A00,494187,Chapman; Eddie Nathaniel,72,0,80,8
1713312481999,PSYC 131,A00,494188,Anagnostaras; Stephan,57,0,80,23
1713312483027,PSYC 144,A00,494189,Staff,15,0,50,35
1713312484052,PSYC 154,A00,494190,Lacefield; Katharine I,133,0,180,47
1713312485082,PSYC 162,A00,494191,Wixted; John T,83,0,100,17
1713312486107,PSYC 172,A00,494192,Gorman; Michael R.,38,0,45,7
1713312487133,PSYC 178,A00,494193,Glaser; Dale,40,0,45,5
1713312488159,PSYC 193,A00,505725,Chapman; Eddie Nathaniel,20,0,20,0
1713312489184,RELI 145GS,A00,519817,Rahimi; Babak,18,0,20,2
1713312490215,SE 101A,A01,490862,Chadha; Mayank,24,0,25,1
1713312491242,SE 101C,A01,490924,Krysl; Petr,18,0,20,2
1713312492268,SE 110A,A01,490928,Staff,19,0,20,1
1713312493295,SE 130A,A00,490929,Morrison; Machel Leigh,64,0,70,6
1713312494324,SIO 1,A01,519325,Staff,39,0,40,1
1713312495355,SIO 30,A01,519327,Staff,39,0,40,1
1713312496381,SIO 40,A00,519328,Staff,40,0,40,0
1713312497409,SIO 46GS,A00,519819,Cook; Geoffrey W,18,0,25,7
1713312498435,SIO 109R,A00,494197,Forman; Fonna,4,0,20,16
1713312499465,SIO 121GS,A00,519827,Cook; Geoffrey W,18,0,25,7
1713312500489,SIO 132,A01,519330,Staff,38,0,40,2
1713312501517,SIO 133,A01,519397,Staff,38,0,40,2
1713312502548,SIO 139,A00,519396,Kacev; David,33,0,40,7
1713312503576,SOCI 1,A01,494199,Thorpe; Charles Robert,23,0,30,7
1713312503576,SOCI 1,A02,494200,Thorpe; Charles Robert,30,0,30,0
1713312503576,SOCI 1,A03,494201,Thorpe; Charles Robert,29,0,30,1
1713312503576,SOCI 1,A04,494202,Thorpe; Charles Robert,29,0,30,1
1713312503576,SOCI 1,A05,494203,Thorpe; Charles Robert,29,0,30,1
1713312503576,SOCI 1,A06,494204,Thorpe; Charles Robert,30,0,30,0
1713312503576,SOCI 1,A07,494205,Thorpe; Charles Robert,29,0,30,1
1713312504601,SOCI 60,A01,494207,Staff,36,0,40,4
1713312504601,SOCI 60,A02,494208,Staff,39,0,40,1
1713312505636,SOCI 100,A01,494210,Payne; Christine Anna,28,0,30,2
1713312505636,SOCI 100,A02,494211,Payne; Christine Anna,27,0,30,3
1713312506665,SOCI 109M,A00,494212,Staff,20,0,20,0
1713312507695,SOCI 110,A00,494213,Staff,35,0,40,5
1713312509752,SOCI 118E,A00,494215,Ng; Kwai,38,0,40,2
1713312510784,SOCI 125,A00,494216,Calderon-Zaks; Michael Aar,42,0,45,3
1713312511808,SOCI 126,A01,494218,Jones; Makeba,4,0,5,1
1713312512834,SOCI 131,A00,494219,Thorpe; Charles Robert,28,0,30,2
1713312514895,SOCI 135,A00,494221,Payne; Christine Anna,35,0,50,15
1713312515925,SOCI 136E,A00,626690,Ruiz; Jonathan Joseph,25,0,25,0
1713312516952,SOCI 138GS,A00,494222,Navon; Daniel,24,0,28,4
1713312519064,SOCI 145,A00,494224,Staff,42,0,45,3
1713312520095,SOCI 153,A00,494225,Staff,28,0,30,2
1713312521122,SOCI 160E,A00,494226,Ng; Kwai,33,0,40,7
1713312522147,SOCI 180,A00,494227,Staff,29,0,30,1
1713312523173,SOCI 189GS,A00,494228,Ribas Norris; Janet Vanesa,11,0,11,0
1713312524202,SOCI 190GS,A00,553232,Ribas Norris; Janet Vanesa,11,0,11,0
1713312525228,SOMI 220,A00,627178,Schneid; Stephen David,30,0,30,0
1713312526254,SYN 2,001,490768,Staff,14,0,15,1
1713312526254,SYN 2,002,490769,Staff,15,0,15,0
1713312526254,SYN 2,004,490775,Staff,0,0,0,0
1713312526254,SYN 2,003,490774,Staff,0,0,0,0
1713312526254,SYN 2,005,490776,Staff,0,0,0,0
1713312527286,SYN 2R,001,490779,Staff,13,0,15,2
1713312527286,SYN 2R,002,514635,Staff,14,0,15,1
1713312528310,SYN 100,A01,490783,Staff,15,0,20,5
1713312528310,SYN 100,B01,490787,Staff,10,0,20,10
1713312528310,SYN 100,C01,490789,Staff,13,0,20,7
1713312529335,SYN 150,A00,490817,Staff,14,0,15,1
1713312529335,SYN 150,B00,514610,Staff,15,0,15,0
1713312530363,TDAC 1,A00,492753,Walsh; Kim C.,19,0,20,1
1713312530363,TDAC 1,B00,492754,Harting; Carla Kelso,19,0,20,1
1713312530363,TDAC 1,C00,513995,Salovey; Todd,17,0,20,3
1713312531393,TDAC 101,A00,492766,Harting; Carla Kelso,17,0,20,3
1713312532418,TDAC 102,A00,492768,Basso; Beatrice,19,0,20,1
1713312533448,TDDE 111,A00,492769,Staff,25,0,25,0
1713312534473,TDDE 131,A00,492770,Staff,15,0,15,0
1713312534473,TDDE 131,B00,492771,Staff,15,0,15,0
1713312535503,TDDE 131GS,A00,523716,Guirguis; Mark C,24,0,28,4
1713312536528,TDGE 1,A01,492756,Salovey; Todd,57,0,60,3
1713312537555,TDGE 5,A01,492758,Staff,24,0,25,1
1713312538585,TDGE 10,A00,492759,Fulton; Julia,211,0,220,9
1713312539612,TDGE 11,A00,492760,Castro; Robert Jess,200,0,200,0
1713312541678,TDGE 124,A00,492772,Fulton; Julia,192,0,220,28
1713312542703,TDGE 125,A00,492773,Meyer; Ursula,40,0,50,10
1713312542703,TDGE 125,B00,492774,Staff,50,0,50,0
1713312542703,TDGE 125,C00,523565,Staff,49,0,50,1
1713312543745,TDGE 125GS,A00,523580,Guirguis; Mark C,24,0,28,4
1713312544770,TDGE 127,A00,492775,Havis; Allan,41,0,50,9
1713312545795,TDHT 101,A00,492776,Staff,35,0,35,0
1713312546820,TDMV 1,A00,492762,Caligagan; Maria T.,30,0,30,0
1713312546820,TDMV 1,B00,492763,Arcidiacono; Kristin,25,0,30,5
1713312548025,TDMV 2,A00,492764,Weinberg; Sadie,29,0,30,1
1713312549050,TDMV 3,A00,492765,Mack; Kara Shanai',39,0,40,1
1713312550079,TDMV 138,A00,492777,Mack; Kara Shanai',36,0,40,4
1713312551105,TDMV 140,A00,492778,Lima; Paulo Henrique,40,0,40,0
1713312552130,TDMV 142,A00,492779,Caligagan; Maria T.,36,0,40,4
1713312552130,TDMV 142,B00,492780,Caligagan; Tony,37,0,40,3
1713312553154,TDMV 143,A00,492781,Fyall; Daunte Edward,39,0,40,1
1713312554183,USP 1,A01,492401,Kwak; Nancy,26,0,35,9
1713312555209,USP 2,A01,492453,Hinds; Juli Beth,35,0,35,0
1713312556239,USP 3,A01,492516,Staff,29,0,35,6
1713312557264,USP 4,A00,492522,McTague; Sarah,19,0,25,6
1713312558290,USP 100,A00,492523,Staff,33,0,35,2
1713312559319,USP 101,A00,492524,Staff,13,0,15,2
1713312560351,USP 105,A00,492525,Staff,21,0,25,4
1713312561379,USP 151,A00,492526,Shenkman; Michael Thomas,33,0,35,2
1713312562403,USP 170,A00,492545,Hinds; Juli Beth,33,0,35,2
1713312563428,USP 171GS,A00,492608,Bussell; Mirle Rabinowitz,25,0,28,3
1713312564457,USP 183GS,A00,492613,Peerson; Susan,25,0,28,3
1713312565488,VIS 30,A01,490693,Yoldas; Pinar,21,0,22,1
1713312565488,VIS 30,A02,490694,Yoldas; Pinar,19,0,22,3
1713312566520,VIS 83,A00,490695,Kester; Grant,66,0,75,9
1713312567611,VIS 105D,A00,490696,Staff,22,0,25,3
1713312568636,VIS 124CN,A00,490699,Rose; Jordan M,68,0,75,7
1713312569659,VIS 125GS,A00,511221,Williams; Alena J,21,0,22,1
1713312570685,VIS 128D,A00,490700,Staff,74,0,75,1
1713312571711,VIS 151,A01,490717,Staff,33,0,34,1
1713312571711,VIS 151,A02,490766,Staff,33,0,34,1
1713312572737,VIS 154GS,A00,511972,Williams; Alena J,21,0,22,1
1713312573768,VIS 160A,A00,490767,Stone; Patricia,7,0,10,3
1713312574794,WCWP 10A,A00,490638,Staff,14,0,15,1
1713312574794,WCWP 10A,B00,490640,Staff,15,0,15,0
1713312575819,WCWP 10B,A00,490641,Staff,0,0,0,0
1713312575819,WCWP 10B,B00,490642,Staff,14,0,15,1
1713312575819,WCWP 10B,C00,490644,Staff,13,0,15,2
1713312575819,WCWP 10B,D00,490647,Staff,0,0,0,0
1713312576846,WCWP 100,A00,490655,Staff,0,0,0,0
1713312576846,WCWP 100,B00,490687,Staff,12,0,15,3
1713312578934,ANAR 153,A00,487222,Braswell; Geoffrey E.,54,0,60,6
1713312579958,ANBI 134,A00,487223,Staff,12,0,20,8
1713312580985,ANBI 143GS,A00,487224,Noel; Geoffroy Pierre Jean,20,0,24,4
1713312582010,ANBI 144GS,A00,519548,Noel; Geoffroy Pierre Jean,20,0,24,4
1713312583035,ANSC 101,A00,487225,Staff,19,0,20,1
1713312584064,ANSC 125,A00,487227,Brenner; Suzanne A,39,0,40,1
1713312586115,ANSC 146,A00,487229,Staff,36,0,40,4
1713312587144,ANSC 148,A00,487230,Olivas Hernandez; Olga Lid,39,0,40,1
1713312588167,ANSC 150,A00,504165,Sloane; Julia Kathryn,19,0,20,1
1713312589195,ANSC 180,A00,487232,Staff,13,0,15,2
1713312590221,ANSC 188,A00,627155,Staff,40,0,40,0
1713312591248,ANTH 5,A00,519529,Semendeferi; Ekaterini,15,0,15,0
1713312592275,ANTH 10,A00,487219,Staff,58,0,60,2
1713312593311,ANTH 23,A01,487221,Staff,17,0,20,3
1713312594336,ANTH 102,A00,487233,Wilder; Linnea Lorene,52,0,60,8
1713312595365,ANTH 103,A00,487234,Varma; Saiba,56,0,60,4
1713312596395,ANTH 105,A00,487235,Stewart; Alexander B,56,0,60,4
1713312597430,BENG 100,A01,516685,Taylor Amos; Alyssa C,28,0,30,2
1713312598458,BIBC 102,A01,491316,Flagg; Matthew Paul,42,0,88,46
1713312598458,BIBC 102,A02,491366,Flagg; Matthew Paul,83,0,88,5
1713312599487,BIBC 103,A01,491486,Boumechache; Miyyada,16,0,24,8
1713312599487,BIBC 103,A02,491487,Boumechache; Miyyada,24,0,24,0
1713312600514,BICD 100,A01,516882,Staff,75,0,75,0
1713312600514,BICD 100,A02,516890,Staff,70,0,75,5
1713312601544,BICD 102GS,A00,491488,Lo; Stanley M.,26,0,28,2
1713312602573,BIEB 136GS,A00,516940,Holway; David A. & Shurin; Jonathan,19,0,24,5
1713312603604,BIEB 137GS,A01,517034,Holway; David A. & Shurin; Jonathan,19,0,24,5
1713312604633,BIEB 138GS,A01,491492,Pirino; Giorgia,21,0,28,7
1713312605659,BILD 1,A01,491296,Staff,62,0,63,1
1713312605659,BILD 1,A02,491297,Staff,63,0,63,0
1713312606685,BILD 4,A01,517099,Gonzalez Gamboa; Ivonne,22,0,24,2
1713312606685,BILD 4,A02,517100,Gonzalez Gamboa; Ivonne,24,0,24,0
1713312607712,BILD 60GS,A00,491309,Lo; Stanley M.,26,0,28,2
1713312608740,BIMM 100,A01,517136,Staff,91,0,100,9
1713312609770,BIMM 110,A01,517182,Staff,71,0,100,29
1713312610801,BIMM 120,A01,517228,Pickett; Brooke Elizabeth,40,0,63,23
1713312610801,BIMM 120,A02,517240,Pickett; Brooke Elizabeth,48,0,63,15
1713312611828,BIMM 132GS,A01,491498,Pirino; Giorgia,21,0,28,7
1713312612864,BIMM 143,A01,491589,Bozinovic; Goran,18,0,40,22
1713312613906,BIPN 100,A01,491594,Armour; Jon Christopher,91,0,100,9
1713312614933,BIPN 140,A01,491602,Marino; Marc J,30,0,50,20
1713312616985,CAT 125,A00,515973,Staff,20,0,20,0
1713312618013,CAT 125GS,A00,515974,Rahimi; Babak,18,0,20,2
1713312619040,CAT 125R,A00,515980,Staff,14,0,20,6
1713312619040,CAT 125R,B00,515981,Tosun; Adriana,19,0,20,1
1713312619040,CAT 125R,C00,515987,Hyland; Tina Mae,2,0,20,18
1713312619040,CAT 125R,D00,515988,Bronstein; Phoebe Malan,18,0,20,2
1713312620071,CENG 15,A01,488699,Drews; Aaron,25,0,25,0
1713312621098,CENG 100,A00,505196,Opatkiewicz; Justin Paul,25,0,25,0
1713312622179,CGS 2A,A01,489598,Staff,33,0,35,2
1713312623204,CGS 112,A00,489599,Staff,15,0,15,0
1713312624229,CGS 119,A00,489603,Staff,10,0,10,0
1713312625254,CGS 120,A00,489604,Staff,14,0,15,1
1713312626280,CGS 150,A00,489607,Staff,15,0,15,0
1713312627312,CHEM 6A,A01,488715,Staff,98,0,100,2
1713312628340,CHEM 6B,A01,488719,Piercy; Marc Anthony,100,0,100,0
1713312629367,CHEM 6C,A01,488723,Albizati; Kim F.,94,0,100,6
1713312630396,CHEM 7L,A01,488728,Schurmeier; Kimberly,18,0,24,6
1713312630396,CHEM 7L,A02,488730,Schurmeier; Kimberly,23,0,24,1
1713312630396,CHEM 7L,A03,488734,Schurmeier; Kimberly,23,0,24,1
1713312630396,CHEM 7L,A04,488763,Schurmeier; Kimberly,23,0,24,1
1713312630396,CHEM 7L,B01,488798,Schurmeier; Kimberly,18,0,24,6
1713312630396,CHEM 7L,B02,488801,Schurmeier; Kimberly,23,0,24,1
1713312630396,CHEM 7L,B03,488808,Schurmeier; Kimberly,24,0,24,0
1713312630396,CHEM 7L,B04,488811,Schurmeier; Kimberly,24,0,24,0
1713312631427,CHEM 11,A01,488897,Stallings; Dontarie M,98,0,100,2
1713312632457,CHEM 40A,A01,488913,Albizati; Kim F.,90,0,100,10
1713312633483,CHEM 40B,A01,488920,Weizman; Haim,47,0,50,3
1713312633483,CHEM 40B,A02,488938,Weizman; Haim,46,0,50,4
1713312634512,CHEM 41A,A01,489029,Klosterman; Jeremy K,58,0,60,2
1713312635537,CHEM 41C,A01,500436,Tor; Yitzhak,55,0,60,5
1713312636564,CHEM 43A,A01,500426,Weizman; Haim,2,0,24,22
1713312636564,CHEM 43A,A02,500430,Weizman; Haim,13,0,24,11
1713312636564,CHEM 43A,B01,514041,Klosterman; Jeremy K,15,0,24,9
1713312636564,CHEM 43A,B02,514047,Klosterman; Jeremy K,23,0,24,1
1713312637594,CHEM 108,A01,489140,Jennings; Patricia A.,13,0,24,11
1713312637594,CHEM 108,A02,489142,Jennings; Patricia A.,15,0,24,9
1713312638620,CHEM 114A,A01,489147,Stallings; Dontarie M,78,0,100,22
1713312639654,CHIN 169A,A00,489171,Wang; Xiao,19,0,20,1
1713312641714,COGS 3,A01,518827,Boyle; Mary E. T.,29,0,40,11
1713312642743,COGS 11,A01,489175,Staff,28,0,30,2
1713312643768,COGS 14A,A01,518829,Staff,52,0,60,8
1713312644794,COGS 14B,A01,489177,Hoffman; Drew Ellen,69,0,75,6
1713312645818,COGS 100,A01,489181,Allen; Michael Gordon,66,0,75,9
1713312646844,COGS 101A,A01,489183,Staff,49,0,60,11
1713312647870,COGS 101B,A01,489185,Allen; Michael Gordon,13,0,30,17
1713312648985,COGS 101C,A01,526786,Staff,24,0,30,6
1713312651046,COGS 107A,A01,489189,Boyle; Mary E. T.,22,0,35,13
1713312652072,COGS 107B,A01,627144,Mooshagian; Eric Frederick,60,0,60,0
1713312653102,COGS 118A,A01,489191,Staff,0,32,40,40
1713312655160,COGS 171GS,A01,489194,Pineda; Jaime A,22,0,28,6
1713312656184,COGS 172,A01,489196,Staff,5,0,30,25
1713312657209,COGS 174GS,A01,489264,Pineda; Jaime A,22,0,28,6
1713312658237,COGS 180,A01,627150,Staff,28,0,30,2
1713312659267,COGS 186,A01,489274,Staff,2,0,30,28
1713312660297,COMM 10,A01,489276,Staff,23,0,25,2
1713312660297,COMM 10,A02,489303,Staff,23,0,25,2
1713312661323,COMM 100A,A01,489312,Staff,16,0,25,9
1713312661323,COMM 100A,A02,489313,Staff,24,0,25,1
1713312662354,COMM 106T,A00,512540,Staff,34,0,35,1
1713312663383,COMM 107,A00,489347,Staff,31,0,35,4
1713312664411,COMM 109P,A00,489358,Staff,31,0,35,4
1713312665446,COMM 132,A00,489361,McKenna; Denise,28,0,30,2
1713312666474,COMM 146,A00,489362,Halm; Gavin Patrick,27,0,30,3
1713312667499,COMM 190,A00,489363,Abuelhiga; Soraya Jill,20,0,23,3
1713312668525,CSE 8A,A50,489366,Staff,22,0,25,3
1713312668525,CSE 8A,A51,489367,Staff,24,0,25,1
1713312669557,CSE 11,A01,489398,Cao; Yingjun,79,0,100,21
1713312670591,CSE 12,A01,489487,Staff,43,0,50,7
1713312671619,CSE 20,A01,489497,Staff,48,0,50,2
1713312672653,CSE 21,A01,489517,Braun; Oliver,44,0,50,6
1713312673679,CSE 101,A01,489524,Braun; Oliver,0,15,50,50
1713312674708,CSE 105,A01,512594,Jones; Miles E,80,0,100,20
1713312674708,CSE 105,B01,512598,Jones; Miles E,61,0,100,39
1713312675735,CSE 140,A01,489538,Staff,44,0,50,6
1713312676769,CSE 141,A01,489550,Eldon; John,76,0,100,24
1713312677800,CSE 141L,A01,489571,Eldon; John,74,0,100,26
1713312678825,CSE 151A,A01,489583,Solares; Edwin A,150,0,200,50
1713312679852,CSE 175,A01,510886,Kumar; Rakesh,30,0,30,0
1713312680878,CSE 190,A00,516828,Dubnov; Shlomo,41,0,49,8
1713312681905,DOC 100D,A00,489667,Pass; Natalye Joann,21,0,25,4
1713312682929,DSC 10,A01,624268,Staff,72,0,75,3
1713312683968,DSC 20,A01,624476,Staff,50,0,50,0
1713312684993,DSC 40A,A01,624608,Staff,40,0,40,0
1713312686019,DSGN 1,A01,489179,Rill; Bryan,36,0,50,14
1713312687044,ECE 17,A01,490489,Sahay; Rajeev,18,0,30,12
1713312688074,ECE 65,A50,490492,Staff,16,0,20,4
1713312688074,ECE 65,A51,490493,Staff,20,0,20,0
1713312689107,ECON 1,A01,489715,Famulari; Melissa,69,0,70,1
1713312690146,ECON 2,A01,489717,Levkoff; Steven B.,68,0,70,2
1713312691175,ECON 3,A01,489948,Staff,70,0,70,0
1713312693250,ECON 5,A01,490103,Staff,28,0,30,2
1713312693250,ECON 5,B01,626281,Dai; Yinlin,45,0,45,0
1713312694278,ECON 100A,A01,490127,Famulari; Melissa,68,0,70,2
1713312695309,ECON 100B,A01,490129,Staff,64,0,70,6
1713312696348,ECON 109,A01,490187,Shishkin; Denis,27,0,35,8
1713312697381,ECON 110A,A01,490190,Levkoff; Steven B.,62,0,70,8
1713312698412,ECON 120A,A01,490245,Dai; Yinlin,65,0,70,5
1713312699442,ECON 120B,A01,490247,Nieto-Barthaburu; Augusto,58,0,70,12
1713312700476,ECON 120C,A01,490253,Sun; Yixiao,31,0,35,4
1713312700476,ECON 120C,B01,490255,Sun; Yixiao,34,0,35,1
1713312701509,ECON 129,A00,490256,Eckert; Fabian Paul,25,0,35,10
1713312702556,ECON 131,A00,490257,Nieto-Barthaburu; Augusto,0,0,35,35
1713312703596,ECON 138,A00,490258,Bharadwaj; Prashant,21,0,35,14
1713312703596,ECON 138,B00,490259,Bharadwaj; Prashant,17,0,35,18
1713312704626,ECON 159,A00,490260,Hendrickson; Gerald M.,0,8,0,0
1713312705662,ECON 178,A01,553995,Zhu; Ying,26,0,35,9
1713312706690,EDS 40,A01,512576,Black; Alison Michelle,20,0,20,0
1713312707722,EDS 107,A01,515848,Staff,30,0,30,0
1713312708756,EDS 110R,A01,490262,Staff,26,0,30,4
1713312709781,EDS 112,A01,490264,Chapman; Thandeka K,43,0,50,7
1713312710809,EDS 113,A00,490266,Staff,26,0,30,4
1713312711845,EDS 118,A00,490267,Warstadt; Melissa Fawn,26,0,30,4
1713312712872,EDS 124BR,A00,490268,Eguchi; Emi,8,0,25,17
1713312712872,EDS 124BR,B00,490269,Eguchi; Emi,25,0,25,0
1713312713899,EDS 126,A01,490271,Jones; Makeba,45,0,50,5
1713312714925,EDS 135,A01,490316,Staff,19,0,20,1
1713312715954,ENVR 142GS,A00,519514,Chang; Edmond Yi-Teh,28,0,28,0
1713312716981,ETHN 103,A00,490504,Staff,31,0,36,5
1713312718022,ETHN 103A,A00,490505,Man; Simeon S,5,0,9,4
1713312719047,ETHN 109,A00,490506,Staff,30,0,30,0
1713312720072,ETHN 118,A00,490507,Staff,35,0,36,1
1713312721098,ETHN 119,A00,490508,Staff,35,0,36,1
1713312722125,ETHN 121R,A00,490518,Choi; Esther Min,28,0,36,8
1713312723150,ETHN 127,A00,490528,Staff,15,0,15,0
1713312724175,ETHN 139,A00,490573,Staff,10,0,10,0
1713312725201,ETHN 150,A00,490575,Staff,15,0,15,0
1713312726283,GLBH 20,A00,491705,Elwardani; Nile Regina,38,0,40,2
1713312727316,GLBH 101,A00,491706,Staff,20,0,20,0
1713312728340,GLBH 111,A01,491708,Burgos; Jose L.,15,0,15,0
1713312729365,GLBH 146,A00,491709,Staff,11,0,20,9
1713312730392,GLBH 148,A00,491710,Olivas Hernandez; Olga Lid,14,0,20,6
1713312731428,GLBH 150,A00,491711,Sloane; Julia Kathryn,20,0,20,0
1713312732460,HIEA 131,A00,491760,Staff,29,0,32,3
1713312733487,HIEA 153,A00,491762,Staff,29,0,30,1
1713312734514,HIEU 124,A00,491811,Staff,26,0,32,6
1713312735544,HIEU 124GS,A00,491812,Markman; Kristina,28,0,28,0
1713312736574,HIEU 147,A00,491813,Staff,30,0,32,2
1713312737601,HIEU 149GS,A00,491816,Caldwell; Michael Alan,28,0,28,0
1713312738627,HILD 2C,A01,491713,Hendrickson; Gerald M.,27,0,30,3
1713312739653,HILD 7B,A01,491715,Kwak; Nancy,10,0,30,20
1713312740676,HILD 10,A01,491717,Staff,13,0,20,7
1713312741708,HILD 30GS,A00,491719,Edington; Claire Ellen,24,0,28,4
1713312742734,HINE 109,A00,491818,Shafir; Nir,28,0,32,4
1713312743782,HINE 128,A00,491821,Shafir; Nir,31,0,32,1
1713312744806,HISC 117,A00,491830,Staff,29,0,32,3
1713312745834,HIUS 103,A00,491834,Man; Simeon S,15,0,23,8
1713312746859,HIUS 108B,A00,491835,Staff,29,0,30,1
1713312747882,HIUS 141,A00,491836,Hendrickson; Gerald M.,29,0,32,3
1713312748907,HIUS 149,A00,491839,Staff,27,0,32,5
1713312749938,HUM 3,A01,512617,Crum; Matthew Stephen,45,0,50,5
1713312749938,HUM 3,A02,512618,Crum; Matthew Stephen,48,0,50,2
1713312750963,HUM 3GS,A00,512663,Markman; Kristina,0,0,0,0
1713312750963,HUM 3GS,B00,512664,Staff,0,0,0,0
1713312751995,HUM 4,A01,512620,West; Geoffrey Scott,32,0,50,18
1713312753022,HUM 4GS,A00,512666,Lyon; Antony J.,0,0,0,3
1713312754049,HUM 4R,A01,512625,Watkins; Eric,49,0,50,1
1713312755076,HUM 5,A01,512649,Zavodny; Tatiana Sophia,31,0,50,19
1713312755076,HUM 5,B01,512661,Zroka; Ryan Edward,48,0,50,2
1713312756108,INTL 190,A00,490577,Segui; Alan S,0,0,0,5
1713312757141,JAPN 20AR,A01,491267,Ross; Kayoko F,10,0,20,10
1713312758172,JAPN 180,A00,491285,Berman; Michael David,34,0,40,6
1713312759197,LATI 50,A01,502536,Kokinis; Troy Andreas,17,0,22,5
1713312759197,LATI 50,A02,502551,Kokinis; Troy Andreas,22,0,22,0
1713312759197,LATI 50,A03,502650,Kokinis; Troy Andreas,22,0,22,0
1713312759197,LATI 50,A04,502909,Kokinis; Troy Andreas,22,0,22,0
1713312760229,LATI 160,A01,502920,Kokinis; Troy Andreas,30,0,30,0
1713312761262,LIFR 1A,A00,490494,Van Moer; Vinciane G,17,0,20,3
1713312762286,LIFR 1AX,A00,490495,Van Moer; Vinciane G,17,0,20,3
1713312763325,LIFR 1B,A00,490496,Van Moer; Vinciane G,19,0,20,1
1713312764349,LIFR 1BX,A00,490497,Van Moer; Vinciane G,19,0,20,1
1713312765381,LIGN 8,A00,505198,McIntosh; Justin Daniel,135,0,150,15
1713312766405,LIGN 9GS,A00,491239,Lott; Margaret S.,18,0,20,2
1713312767436,LIGN 101,A01,505200,McIntosh; Justin Daniel,25,0,30,5
1713312768462,LIGN 120,A01,491244,Staff,24,0,30,6
1713312769489,LIGN 149GS,A00,491245,Lott; Margaret S.,18,0,20,2
1713312770518,LIGN 170,A00,491247,Staff,24,0,30,6
1713312771550,LISP 1D,A00,490498,Munoz Sanchez; Alicia,11,0,14,3
1713312771550,LISP 1D,B00,490499,Munoz Sanchez; Alicia,6,0,14,8
1713312771550,LISP 1D,C00,490500,Munoz Sanchez; Alicia,10,0,14,4
1713312771550,LISP 1D,D00,490501,Munoz Sanchez; Alicia,11,0,14,3
1713312772575,LISP 1DX,A00,490502,Munoz Sanchez; Alicia,18,0,28,10
1713312772575,LISP 1DX,B00,490503,Munoz Sanchez; Alicia,19,0,28,9
1713312774631,LTAM 110,A00,491847,Staff,23,0,25,2
1713312775655,LTCS 119,A00,491848,Staff,12,0,15,3
1713312776681,LTCS 130,A00,491849,Staff,24,0,25,1
1713312778752,LTEA 120C,A00,491852,Staff,34,0,40,6
1713312779783,LTEN 130GS,A00,491853,Lyon; Antony J.,25,0,28,3
1713312780809,LTEN 148,A00,491855,Staff,23,0,25,2
1713312781838,LTEN 159,A00,491856,Staff,21,0,25,4
1713312782864,LTEN 180,A00,491857,Staff,9,0,15,6
1713312785000,LTSP 123GS,A00,505928,Bessett; Ryan Matthew,25,0,28,3
1713312786028,LTSP 174GS,A00,506037,Bessett; Ryan Matthew,25,0,28,3
1713312788091,LTWR 102,A00,491861,Staff,11,0,15,4
1713312789129,LTWR 106,A00,491862,Staff,10,0,15,5
1713312790156,MAE 11,A00,490930,Bahadori; Mohammad Yousef,97,0,100,3
1713312791195,MAE 30A,A00,490931,Qi; Huihui,37,0,40,3
1713312792222,MAE 101A,A00,491036,Sadeghizadeh; Zahra,97,0,100,3
1713312793247,MAE 101C,A00,491037,Seshadri; Kalyanasundaram,76,0,100,24
1713312794275,MAE 113,A00,491040,Seshadri; Kalyanasundaram,66,0,80,14
1713312795298,MAE 131A,A00,491041,Ghazinejad; Maziar,39,0,40,1
1713312796324,MAE 142,A00,491053,Staff,39,0,40,1
1713312797348,MAE 143A,A00,491054,Staff,38,0,50,12
1713312798375,MAE 150,A00,491092,Truong; Phuong Thi Ngoc,23,0,35,12
1713312799406,MATH 3C,A01,494031,Pardo Guerra; Sebastian,30,0,30,0
1713312799406,MATH 3C,A02,494032,Pardo Guerra; Sebastian,29,0,30,1
1713312800440,MATH 10A,A01,494034,Staff,27,0,30,3
1713312800440,MATH 10A,A02,494035,Staff,29,0,30,1
1713312800440,MATH 10A,B01,494037,Staff,27,0,30,3
1713312800440,MATH 10A,B02,494038,Staff,29,0,30,1
1713312801467,MATH 10B,A01,494040,Habib; Yousaf,24,0,30,6
1713312801467,MATH 10B,A02,494041,Habib; Yousaf,28,0,30,2
1713312801467,MATH 10B,A03,494042,Habib; Yousaf,30,0,30,0
1713312801467,MATH 10B,A04,494043,Habib; Yousaf,30,0,30,0
1713312801467,MATH 10B,B01,494045,Habib; Yousaf,28,0,30,2
1713312801467,MATH 10B,B02,494046,Habib; Yousaf,30,0,30,0
1713312801467,MATH 10B,B03,494047,Habib; Yousaf,30,0,30,0
1713312801467,MATH 10B,B04,494048,Habib; Yousaf,30,0,30,0
1713312802497,MATH 18,A01,494050,Kemp; Todd Aahron,27,0,30,3
1713312802497,MATH 18,A02,494051,Kemp; Todd Aahron,29,0,30,1
1713312802497,MATH 18,B01,494054,Kemp; Todd Aahron,28,0,30,2
1713312802497,MATH 18,B02,494055,Kemp; Todd Aahron,29,0,30,1
1713312803534,MATH 20A,A01,494059,Suk; Andrew Hoon,30,0,30,0
1713312804561,MATH 20B,A01,494061,Briones; Jor-el Thomas Caparas,33,0,35,2
1713312804561,MATH 20B,B01,494063,Bach; Quang Tran,34,0,35,1
1713312805602,MATH 20C,A01,494065,Staff,28,0,30,2
1713312805602,MATH 20C,A02,494066,Staff,30,0,30,0
1713312805602,MATH 20C,A03,494067,Staff,30,0,30,0
1713312805602,MATH 20C,A04,494068,Staff,30,0,30,0
1713312805602,MATH 20C,B01,494070,Zhang; Ming,26,0,30,4
1713312805602,MATH 20C,B02,494071,Zhang; Ming,29,0,30,1
1713312805602,MATH 20C,B03,494072,Zhang; Ming,29,0,30,1
1713312805602,MATH 20C,B04,494073,Zhang; Ming,29,0,30,1
1713312806633,MATH 20D,A01,494075,Staff,24,0,30,6
1713312806633,MATH 20D,A02,494076,Staff,30,0,30,0
1713312807666,MATH 20E,A01,494079,Staff,25,0,30,5
1713312807666,MATH 20E,A02,494080,Staff,27,0,30,3
1713312807666,MATH 20E,B01,494082,Staff,27,0,30,3
1713312807666,MATH 20E,B02,494083,Staff,25,0,30,5
1713312808694,MATH 103A,A01,494085,Aliabadi Sr.; Mohsen,17,0,30,13
1713312808694,MATH 103A,A02,494086,Aliabadi Sr.; Mohsen,28,0,30,2
1713312808694,MATH 103A,B01,494088,Aliabadi Sr.; Mohsen,22,0,30,8
1713312808694,MATH 103A,B02,494089,Aliabadi Sr.; Mohsen,28,0,30,2
1713312809728,MATH 109,A01,494091,Staff,30,0,30,0
1713312809728,MATH 109,A02,494092,Staff,29,0,30,1
1713312809728,MATH 109,B01,494094,Staff,28,0,30,2
1713312809728,MATH 109,B02,494095,Staff,29,0,30,1
1713312810757,MATH 142A,A01,494097,Chow; Bennett,16,0,30,14
1713312810757,MATH 142A,A02,494098,Chow; Bennett,24,0,30,6
1713312810757,MATH 142A,B01,494100,Chow; Bennett,20,0,30,10
1713312810757,MATH 142A,B02,494101,Chow; Bennett,29,0,30,1
1713312812817,MATH 168A,A01,516677,Dumitriu; Ioana,16,0,35,19
1713312813842,MATH 170A,A01,516679,Dumitriu; Ioana,20,0,30,10
1713312813842,MATH 170A,A02,516680,Dumitriu; Ioana,28,0,30,2
1713312814871,MATH 193A,A01,494107,Staff,16,0,30,14
1713312814871,MATH 193A,A02,494108,Staff,23,0,30,7
1713312814871,MATH 193A,A03,494109,Staff,29,0,30,1
1713312814871,MATH 193A,A04,494110,Staff,24,0,30,6
1713312817952,MGT 16,A00,491930,McKay; Michael J,93,0,98,5
1713312818987,MGT 18,A00,491992,McKay; Michael J,97,0,98,1
1713312820012,MGT 71,A00,492003,Staff,77,0,98,21
1713312821054,MGT 103,A00,505209,Eberhard; Craig A,85,0,98,13
1713312822149,MGT 131A,A00,505210,Anderson; John Charles,91,0,98,7
1713312824207,MGT 153,A00,492077,Perols; Johan Lars,41,0,90,49
1713312827308,MGT 164,A00,492222,McKay; Mary A,94,0,98,4
1713312828333,MGT 172,A00,492245,Staff,59,0,60,1
1713312828333,MGT 172,B00,505526,Hedges; Kathleen,75,0,98,23
1713312829360,MGT 181,A00,505669,Dunn; Louis Jean,88,0,98,10
1713312830467,MMW 14,A01,494399,Staff,23,0,28,5
1713312830467,MMW 14,A02,494400,Staff,26,0,28,2
1713312830467,MMW 14,A03,494401,Staff,28,0,28,0
1713312830467,MMW 14,A04,494402,Staff,28,0,28,0
1713312830467,MMW 14,B01,494404,Carreras; Maria Victoria,13,0,28,15
1713312830467,MMW 14,B02,494405,Carreras; Maria Victoria,26,0,28,2
1713312830467,MMW 14,B03,494406,Carreras; Maria Victoria,28,0,28,0
1713312830467,MMW 14,B04,494407,Carreras; Maria Victoria,28,0,28,0
1713312831497,MMW 14GS,A00,506250,Chang; Edmond Yi-Teh,0,0,0,0
1713312832535,MMW 121R,A01,494415,Adamiak; Patrick John,14,0,28,14
1713312832535,MMW 121R,A02,494416,Adamiak; Patrick John,25,0,28,3
1713312833560,MUS 1A,A01,494113,Staff,12,0,25,13
1713312833560,MUS 1A,A02,494114,Staff,25,0,25,0
1713312834585,MUS 4,A01,494116,Staff,24,0,25,1
1713312834585,MUS 4,A02,494117,Staff,22,0,25,3
1713312835612,MUS 5R,A01,494236,Dubnov; Shlomo,11,0,25,14
1713312835612,MUS 5R,A02,494237,Dubnov; Shlomo,25,0,25,0
1713312836643,MUS 6,A01,494122,Staff,14,0,25,11
1713312836643,MUS 6,A02,494123,Staff,24,0,25,1
1713312837669,MUS 7,A01,494125,Staff,17,0,25,8
1713312837669,MUS 7,A02,494126,Staff,24,0,25,1
1713312838694,MUS 11,A01,494128,Staff,23,0,25,2
1713312838694,MUS 11,A02,494129,Staff,25,0,25,0
1713312839719,MUS 13,A01,494131,Staff,25,0,25,0
1713312839719,MUS 13,A02,494132,Staff,25,0,25,0
1713312840746,MUS 15,A01,494134,Staff,20,0,25,5
1713312840746,MUS 15,A02,494135,Staff,25,0,25,0
1713312840746,MUS 15,B01,494137,Staff,24,0,25,1
1713312841786,MUS 80,A00,494232,Staff,24,0,25,1
1713312841786,MUS 80,B00,494233,Staff,25,0,25,0
1713312841786,MUS 80,C00,494234,Staff,23,0,25,2
1713312842811,MUS 95C,A00,494141,Staff,72,0,75,3
1713312843838,MUS 114,A00,494142,Staff,41,0,50,9
1713312844863,NANO 15,A01,490636,Drews; Aaron,7,0,7,0
1713312845890,PHIL 1,A00,490578,Grush; Rick Scott,49,0,50,1
1713312846925,PHIL 10,A01,490580,Grush; Rick Scott,33,0,35,2
1713312846925,PHIL 10,A02,490586,Grush; Rick Scott,33,0,35,2
1713312847955,PHIL 27,A01,490591,Staff,24,0,25,1
1713312847955,PHIL 27,A02,490592,Staff,25,0,25,0
1713312847955,PHIL 27,A03,490593,Staff,25,0,25,0
1713312847955,PHIL 27,A04,490598,Staff,25,0,25,0
1713312848991,PHIL 32,A01,490611,Staff,20,0,20,0
1713312848991,PHIL 32,A02,490618,Staff,20,0,20,0
1713312850022,PHIL 90,A00,490624,Staff,40,0,40,0
1713312851059,PHIL 136,A00,490627,Cohen; Jonathan David,38,0,40,2
1713312852086,PHIL 155,A00,490634,Staff,64,0,70,6
1713312853120,PHYS 1A,A00,491610,Staff,246,0,250,4
1713312854147,PHYS 1AL,001,491616,Tsai; Philbert S,28,0,30,2
1713312854147,PHYS 1AL,002,491618,Tsai; Philbert S,30,0,30,0
1713312855173,PHYS 1B,A00,491623,Staff,244,0,250,6
1713312856198,PHYS 1BL,001,491626,Tsai; Philbert S,26,0,30,4
1713312856198,PHYS 1BL,002,491628,Tsai; Philbert S,28,0,30,2
1713312857223,PHYS 1C,A00,491632,Staff,222,0,245,23
1713312858256,PHYS 1CL,001,491635,Tsai; Philbert S,11,0,30,19
1713312858256,PHYS 1CL,002,491643,Tsai; Philbert S,24,0,30,6
1713312859284,PHYS 2AR,A01,491651,Meyertholen; Andrew D.,45,0,50,5
1713312860308,PHYS 2B,A01,491659,Staff,106,0,115,9
1713312861341,PHYS 2BL,A01,491685,Staff,22,0,24,2
1713312861341,PHYS 2BL,A02,491700,Staff,23,0,24,1
1713312862369,PHYS 2C,A01,505161,Staff,107,0,115,8
1713312863399,PHYS 4A,A01,491704,Grinstein; Benjamin,99,0,100,1
1713312864426,POLI 5D,A01,494144,Staff,3,0,5,2
1713312864426,POLI 5D,B01,626283,Dai; Yinlin,5,0,5,0
1713312865457,POLI 12,A00,494145,Staff,44,0,45,1
1713312866484,POLI 13R,A00,494146,Forman; Fonna,46,0,50,4
1713312867508,POLI 27,A01,494148,Staff,57,0,60,3
1713312868540,POLI 30,A00,494149,Staff,49,0,50,1
1713312869567,POLI 100DA,A00,494150,Staff,22,0,25,3
1713312871623,POLI 100I,A00,494152,Staff,28,0,30,2
1713312872648,POLI 104B,A00,494153,Smith; Glenn Chatmas,54,0,55,1
1713312873673,POLI 104F,A00,494154,Staff,28,0,30,2
1713312874699,POLI 104I,A00,494155,Smith; Glenn Chatmas,30,0,30,0
1713312875725,POLI 110C,A00,494156,Ingham; Sean,23,0,25,2
1713312876750,POLI 117R,A00,494157,Forman; Fonna,11,0,20,9
1713312877781,POLI 118,A00,494158,Ingham; Sean,22,0,25,3
1713312878807,POLI 120H,A00,494159,Fisk; David Lee,41,0,45,4
1713312879834,POLI 131CR,A00,494160,Hoston; Germaine,37,0,45,8
1713312880862,POLI 133J,A00,494161,Staff,33,0,35,2
1713312881888,POLI 135,A00,494162,Fisk; David Lee,33,0,35,2
1713312882918,POLI 140A,A00,494164,Staff,22,0,30,8
1713312883954,POLI 142I,A00,494165,Staff,30,0,30,0
1713312884983,POLI 144D,A00,494166,Staff,23,0,25,2
1713312886010,POLI 151,A00,494167,Staff,30,0,30,0
1713312887040,POLI 153,A00,494168,Staff,33,0,35,2
1713312888065,POLI 160AA,A00,494169,Staff,35,0,40,5
1713312889091,POLI 162,A00,494170,Mignozzetti; Umberto,20,0,25,5
1713312890116,POLI 171,A00,494171,Mignozzetti; Umberto,21,0,25,4
1713312891140,PSYC 1,A00,494172,Staff,97,0,100,3
1713312892173,PSYC 2,A00,494173,Moranton; Nirelia Melbina-,43,0,50,7
1713312893198,PSYC 3,A00,494174,Staff,29,0,30,1
1713312894223,PSYC 6,A00,494175,Staff,17,0,20,3
1713312895249,PSYC 60,A01,494177,Staff,39,0,45,6
1713312896277,PSYC 70,A01,505724,Geller; Emma Harlan,42,0,45,3
1713312897301,PSYC 101,A00,494180,Heyman; Gail D.,87,0,100,13
1713312898326,PSYC 105,A00,494181,Geller; Emma Harlan,64,0,90,26
1713312899352,PSYC 106,A00,494182,Dobkins; Karen R.,33,0,45,12
1713312900390,PSYC 108,A00,494183,Adrian; Julia Anna,94,0,100,6
1713312901417,PSYC 114,A01,494185,Winkielman; Piotr,2,0,30,28
1713312902442,PSYC 122,A00,494186,Moranton; Nirelia Melbina-,37,0,50,13
1713312903474,PSYC 124,A00,494187,Chapman; Eddie Nathaniel,72,0,80,8
1713312904505,PSYC 131,A00,494188,Anagnostaras; Stephan,55,0,80,25
1713312905528,PSYC 144,A00,494189,Staff,15,0,50,35
1713312906583,PSYC 154,A00,494190,Lacefield; Katharine I,132,0,180,48
1713312907613,PSYC 162,A00,494191,Wixted; John T,82,0,100,18
1713312908641,PSYC 172,A00,494192,Gorman; Michael R.,38,0,45,7
1713312909667,PSYC 178,A00,494193,Glaser; Dale,40,0,45,5
1713312910692,PSYC 193,A00,505725,Chapman; Eddie Nathaniel,20,0,20,0
1713312911722,RELI 145GS,A00,519817,Rahimi; Babak,18,0,20,2
1713312912755,SE 101A,A01,490862,Chadha; Mayank,23,0,25,2
1713312913781,SE 101C,A01,490924,Krysl; Petr,18,0,20,2
1713312914807,SE 110A,A01,490928,Staff,19,0,20,1
1713312915833,SE 130A,A00,490929,Morrison; Machel Leigh,63,0,70,7
1713312916864,SIO 1,A01,519325,Staff,39,0,40,1
1713312917893,SIO 30,A01,519327,Staff,39,0,40,1
1713312918918,SIO 40,A00,519328,Staff,40,0,40,0
1713312919943,SIO 46GS,A00,519819,Cook; Geoffrey W,18,0,25,7
1713312920968,SIO 109R,A00,494197,Forman; Fonna,4,0,20,16
1713312921997,SIO 121GS,A00,519827,Cook; Geoffrey W,18,0,25,7
1713312923022,SIO 132,A01,519330,Staff,38,0,40,2
1713312924048,SIO 133,A01,519397,Staff,38,0,40,2
1713312925074,SIO 139,A00,519396,Kacev; David,33,0,40,7
1713312926105,SOCI 1,A01,494199,Thorpe; Charles Robert,23,0,30,7
1713312926105,SOCI 1,A02,494200,Thorpe; Charles Robert,30,0,30,0
1713312926105,SOCI 1,A03,494201,Thorpe; Charles Robert,29,0,30,1
1713312926105,SOCI 1,A04,494202,Thorpe; Charles Robert,29,0,30,1
1713312926105,SOCI 1,A05,494203,Thorpe; Charles Robert,29,0,30,1
1713312926105,SOCI 1,A06,494204,Thorpe; Charles Robert,30,0,30,0
1713312926105,SOCI 1,A07,494205,Thorpe; Charles Robert,29,0,30,1
1713312927133,SOCI 60,A01,494207,Staff,36,0,40,4
1713312927133,SOCI 60,A02,494208,Staff,39,0,40,1
1713312928163,SOCI 100,A01,494210,Payne; Christine Anna,27,0,30,3
1713312928163,SOCI 100,A02,494211,Payne; Christine Anna,27,0,30,3
1713312929188,SOCI 109M,A00,494212,Staff,20,0,20,0
1713312930218,SOCI 110,A00,494213,Staff,35,0,40,5
1713312932271,SOCI 118E,A00,494215,Ng; Kwai,38,0,40,2
1713312933297,SOCI 125,A00,494216,Calderon-Zaks; Michael Aar,42,0,45,3
1713312934377,SOCI 126,A01,494218,Jones; Makeba,4,0,5,1
1713312935402,SOCI 131,A00,494219,Thorpe; Charles Robert,28,0,30,2
1713312937458,SOCI 135,A00,494221,Payne; Christine Anna,35,0,50,15
1713312938484,SOCI 136E,A00,626690,Ruiz; Jonathan Joseph,25,0,25,0
1713312939514,SOCI 138GS,A00,494222,Navon; Daniel,24,0,28,4
1713312941574,SOCI 145,A00,494224,Staff,42,0,45,3
1713312942610,SOCI 153,A00,494225,Staff,28,0,30,2
1713312943641,SOCI 160E,A00,494226,Ng; Kwai,33,0,40,7
1713312944668,SOCI 180,A00,494227,Staff,29,0,30,1
1713312945698,SOCI 189GS,A00,494228,Ribas Norris; Janet Vanesa,11,0,11,0
1713312946724,SOCI 190GS,A00,553232,Ribas Norris; Janet Vanesa,11,0,11,0
1713312947756,SOMI 220,A00,627178,Schneid; Stephen David,30,0,30,0
1713312948785,SYN 2,001,490768,Staff,14,0,15,1
1713312948785,SYN 2,002,490769,Staff,15,0,15,0
1713312948785,SYN 2,004,490775,Staff,0,0,0,0
1713312948785,SYN 2,003,490774,Staff,0,0,0,0
1713312948785,SYN 2,005,490776,Staff,0,0,0,0
1713312949816,SYN 2R,001,490779,Staff,13,0,15,2
1713312949816,SYN 2R,002,514635,Staff,14,0,15,1
1713312950850,SYN 100,A01,490783,Staff,15,0,20,5
1713312950850,SYN 100,B01,490787,Staff,10,0,20,10
1713312950850,SYN 100,C01,490789,Staff,13,0,20,7
1713312951876,SYN 150,A00,490817,Staff,14,0,15,1
1713312951876,SYN 150,B00,514610,Staff,15,0,15,0
1713312952905,TDAC 1,A00,492753,Walsh; Kim C.,19,0,20,1
1713312952905,TDAC 1,B00,492754,Harting; Carla Kelso,19,0,20,1
1713312952905,TDAC 1,C00,513995,Salovey; Todd,17,0,20,3
1713312953931,TDAC 101,A00,492766,Harting; Carla Kelso,17,0,20,3
1713312954958,TDAC 102,A00,492768,Basso; Beatrice,19,0,20,1
1713312955984,TDDE 111,A00,492769,Staff,25,0,25,0
1713312957013,TDDE 131,A00,492770,Staff,15,0,15,0
1713312957013,TDDE 131,B00,492771,Staff,15,0,15,0
1713312958039,TDDE 131GS,A00,523716,Guirguis; Mark C,24,0,28,4
1713312959064,TDGE 1,A01,492756,Salovey; Todd,57,0,60,3
1713312960208,TDGE 5,A01,492758,Staff,24,0,25,1
1713312961240,TDGE 10,A00,492759,Fulton; Julia,209,0,220,11
1713312962271,TDGE 11,A00,492760,Castro; Robert Jess,200,0,200,0
1713312964323,TDGE 124,A00,492772,Fulton; Julia,192,0,220,28
1713312965356,TDGE 125,A00,492773,Meyer; Ursula,40,0,50,10
1713312965356,TDGE 125,B00,492774,Staff,50,0,50,0
1713312965356,TDGE 125,C00,523565,Staff,49,0,50,1
1713312966390,TDGE 125GS,A00,523580,Guirguis; Mark C,24,0,28,4
1713312967421,TDGE 127,A00,492775,Havis; Allan,41,0,50,9
1713312968450,TDHT 101,A00,492776,Staff,35,0,35,0
1713312969476,TDMV 1,A00,492762,Caligagan; Maria T.,30,0,30,0
1713312969476,TDMV 1,B00,492763,Arcidiacono; Kristin,25,0,30,5
1713312970501,TDMV 2,A00,492764,Weinberg; Sadie,29,0,30,1
1713312971527,TDMV 3,A00,492765,Mack; Kara Shanai',39,0,40,1
1713312972553,TDMV 138,A00,492777,Mack; Kara Shanai',36,0,40,4
1713312973583,TDMV 140,A00,492778,Lima; Paulo Henrique,40,0,40,0
1713312974609,TDMV 142,A00,492779,Caligagan; Maria T.,36,0,40,4
1713312974609,TDMV 142,B00,492780,Caligagan; Tony,37,0,40,3
1713312975635,TDMV 143,A00,492781,Fyall; Daunte Edward,39,0,40,1
1713312976662,USP 1,A01,492401,Kwak; Nancy,26,0,35,9
1713312977688,USP 2,A01,492453,Hinds; Juli Beth,35,0,35,0
1713312978714,USP 3,A01,492516,Staff,29,0,35,6
1713312979738,USP 4,A00,492522,McTague; Sarah,19,0,25,6
1713312980765,USP 100,A00,492523,Staff,33,0,35,2
1713312981798,USP 101,A00,492524,Staff,13,0,15,2
1713312982822,USP 105,A00,492525,Staff,21,0,25,4
1713312983849,USP 151,A00,492526,Shenkman; Michael Thomas,33,0,35,2
1713312984874,USP 170,A00,492545,Hinds; Juli Beth,33,0,35,2
1713312985899,USP 171GS,A00,492608,Bussell; Mirle Rabinowitz,25,0,28,3
1713312986923,USP 183GS,A00,492613,Peerson; Susan,25,0,28,3
1713312987949,VIS 30,A01,490693,Yoldas; Pinar,21,0,22,1
1713312987949,VIS 30,A02,490694,Yoldas; Pinar,19,0,22,3
1713312988977,VIS 83,A00,490695,Kester; Grant,66,0,75,9
1713312990006,VIS 105D,A00,490696,Staff,22,0,25,3
1713312991029,VIS 124CN,A00,490699,Rose; Jordan M,68,0,75,7
1713312992062,VIS 125GS,A00,511221,Williams; Alena J,21,0,22,1
1713312993091,VIS 128D,A00,490700,Staff,74,0,75,1
1713312994118,VIS 151,A01,490717,Staff,33,0,34,1
1713312994118,VIS 151,A02,490766,Staff,33,0,34,1
1713312995146,VIS 154GS,A00,511972,Williams; Alena J,21,0,22,1
1713312996176,VIS 160A,A00,490767,Stone; Patricia,7,0,10,3
1713312997201,WCWP 10A,A00,490638,Staff,14,0,15,1
1713312997201,WCWP 10A,B00,490640,Staff,15,0,15,0
1713312998232,WCWP 10B,A00,490641,Staff,0,0,0,0
1713312998232,WCWP 10B,B00,490642,Staff,14,0,15,1
1713312998232,WCWP 10B,C00,490644,Staff,13,0,15,2
1713312998232,WCWP 10B,D00,490647,Staff,0,0,0,0
1713312999260,WCWP 100,A00,490655,Staff,0,0,0,0
1713312999260,WCWP 100,B00,490687,Staff,12,0,15,3
1713313001349,ANAR 153,A00,487222,Braswell; Geoffrey E.,54,0,60,6
1713313002372,ANBI 134,A00,487223,Staff,12,0,20,8
1713313003397,ANBI 143GS,A00,487224,Noel; Geoffroy Pierre Jean,20,0,24,4
1713313004422,ANBI 144GS,A00,519548,Noel; Geoffroy Pierre Jean,20,0,24,4
1713313005450,ANSC 101,A00,487225,Staff,19,0,20,1
1713313006481,ANSC 125,A00,487227,Brenner; Suzanne A,39,0,40,1
1713313008541,ANSC 146,A00,487229,Staff,36,0,40,4
1713313009566,ANSC 148,A00,487230,Olivas Hernandez; Olga Lid,39,0,40,1
1713313010601,ANSC 150,A00,504165,Sloane; Julia Kathryn,19,0,20,1
1713313011627,ANSC 180,A00,487232,Staff,13,0,15,2
1713313012654,ANSC 188,A00,627155,Staff,40,0,40,0
1713313013679,ANTH 5,A00,519529,Semendeferi; Ekaterini,15,0,15,0
1713313014704,ANTH 10,A00,487219,Staff,58,0,60,2
1713313015731,ANTH 23,A01,487221,Staff,17,0,20,3
1713313016760,ANTH 102,A00,487233,Wilder; Linnea Lorene,51,0,60,9
1713313017788,ANTH 103,A00,487234,Varma; Saiba,56,0,60,4
1713313018817,ANTH 105,A00,487235,Stewart; Alexander B,56,0,60,4
1713313019847,BENG 100,A01,516685,Taylor Amos; Alyssa C,28,0,30,2
1713313020878,BIBC 102,A01,491316,Flagg; Matthew Paul,40,0,88,48
1713313020878,BIBC 102,A02,491366,Flagg; Matthew Paul,83,0,88,5
1713313021904,BIBC 103,A01,491486,Boumechache; Miyyada,16,0,24,8
1713313021904,BIBC 103,A02,491487,Boumechache; Miyyada,24,0,24,0
1713313022930,BICD 100,A01,516882,Staff,75,0,75,0
1713313022930,BICD 100,A02,516890,Staff,70,0,75,5
1713313023956,BICD 102GS,A00,491488,Lo; Stanley M.,26,0,28,2
1713313024985,BIEB 136GS,A00,516940,Holway; David A. & Shurin; Jonathan,19,0,24,5
1713313026009,BIEB 137GS,A01,517034,Holway; David A. & Shurin; Jonathan,19,0,24,5
1713313027035,BIEB 138GS,A01,491492,Pirino; Giorgia,21,0,28,7
1713313028061,BILD 1,A01,491296,Staff,62,0,63,1
1713313028061,BILD 1,A02,491297,Staff,63,0,63,0
1713313029086,BILD 4,A01,517099,Gonzalez Gamboa; Ivonne,22,0,24,2
1713313029086,BILD 4,A02,517100,Gonzalez Gamboa; Ivonne,24,0,24,0
1713313030112,BILD 60GS,A00,491309,Lo; Stanley M.,26,0,28,2
1713313031142,BIMM 100,A01,517136,Staff,91,0,100,9
1713313032168,BIMM 110,A01,517182,Staff,71,0,100,29
1713313033196,BIMM 120,A01,517228,Pickett; Brooke Elizabeth,40,0,63,23
1713313033196,BIMM 120,A02,517240,Pickett; Brooke Elizabeth,48,0,63,15
1713313034221,BIMM 132GS,A01,491498,Pirino; Giorgia,21,0,28,7
1713313035246,BIMM 143,A01,491589,Bozinovic; Goran,18,0,40,22
1713313036272,BIPN 100,A01,491594,Armour; Jon Christopher,91,0,100,9
1713313037299,BIPN 140,A01,491602,Marino; Marc J,30,0,50,20
1713313039636,CAT 125,A00,515973,Staff,20,0,20,0
1713313040663,CAT 125GS,A00,515974,Rahimi; Babak,18,0,20,2
1713313041694,CAT 125R,A00,515980,Staff,14,0,20,6
1713313041694,CAT 125R,B00,515981,Tosun; Adriana,19,0,20,1
1713313041694,CAT 125R,C00,515987,Hyland; Tina Mae,2,0,20,18
1713313041694,CAT 125R,D00,515988,Bronstein; Phoebe Malan,18,0,20,2
1713313042722,CENG 15,A01,488699,Drews; Aaron,25,0,25,0
1713313043749,CENG 100,A00,505196,Opatkiewicz; Justin Paul,25,0,25,0
1713313044773,CGS 2A,A01,489598,Staff,33,0,35,2
1713313045798,CGS 112,A00,489599,Staff,15,0,15,0
1713313046823,CGS 119,A00,489603,Staff,10,0,10,0
1713313047848,CGS 120,A00,489604,Staff,14,0,15,1
1713313048875,CGS 150,A00,489607,Staff,15,0,15,0
1713313049903,CHEM 6A,A01,488715,Staff,98,0,100,2
1713313050928,CHEM 6B,A01,488719,Piercy; Marc Anthony,100,0,100,0
1713313051954,CHEM 6C,A01,488723,Albizati; Kim F.,94,0,100,6
1713313052983,CHEM 7L,A01,488728,Schurmeier; Kimberly,18,0,24,6
1713313052983,CHEM 7L,A02,488730,Schurmeier; Kimberly,23,0,24,1
1713313052983,CHEM 7L,A03,488734,Schurmeier; Kimberly,23,0,24,1
1713313052983,CHEM 7L,A04,488763,Schurmeier; Kimberly,23,0,24,1
1713313052983,CHEM 7L,B01,488798,Schurmeier; Kimberly,18,0,24,6
1713313052983,CHEM 7L,B02,488801,Schurmeier; Kimberly,23,0,24,1
1713313052983,CHEM 7L,B03,488808,Schurmeier; Kimberly,24,0,24,0
1713313052983,CHEM 7L,B04,488811,Schurmeier; Kimberly,24,0,24,0
1713313054013,CHEM 11,A01,488897,Stallings; Dontarie M,98,0,100,2
1713313055037,CHEM 40A,A01,488913,Albizati; Kim F.,90,0,100,10
1713313056068,CHEM 40B,A01,488920,Weizman; Haim,47,0,50,3
1713313056068,CHEM 40B,A02,488938,Weizman; Haim,46,0,50,4
1713313057094,CHEM 41A,A01,489029,Klosterman; Jeremy K,58,0,60,2
1713313058120,CHEM 41C,A01,500436,Tor; Yitzhak,55,0,60,5
1713313059148,CHEM 43A,A01,500426,Weizman; Haim,2,0,24,22
1713313059148,CHEM 43A,A02,500430,Weizman; Haim,13,0,24,11
1713313059148,CHEM 43A,B01,514041,Klosterman; Jeremy K,15,0,24,9
1713313059148,CHEM 43A,B02,514047,Klosterman; Jeremy K,23,0,24,1
1713313060174,CHEM 108,A01,489140,Jennings; Patricia A.,13,0,24,11
1713313060174,CHEM 108,A02,489142,Jennings; Patricia A.,15,0,24,9
1713313061200,CHEM 114A,A01,489147,Stallings; Dontarie M,78,0,100,22
1713313062228,CHIN 169A,A00,489171,Wang; Xiao,19,0,20,1
1713313064281,COGS 3,A01,518827,Boyle; Mary E. T.,29,0,40,11
1713313065307,COGS 11,A01,489175,Staff,28,0,30,2
1713313066333,COGS 14A,A01,518829,Staff,51,0,60,9
1713313067358,COGS 14B,A01,489177,Hoffman; Drew Ellen,69,0,75,6
1713313068389,COGS 100,A01,489181,Allen; Michael Gordon,66,0,75,9
1713313069420,COGS 101A,A01,489183,Staff,48,0,60,12
1713313070445,COGS 101B,A01,489185,Allen; Michael Gordon,13,0,30,17
1713313071472,COGS 101C,A01,526786,Staff,24,0,30,6
1713313073532,COGS 107A,A01,489189,Boyle; Mary E. T.,21,0,35,14
1713313074556,COGS 107B,A01,627144,Mooshagian; Eric Frederick,60,0,60,0
1713313075581,COGS 118A,A01,489191,Staff,0,33,40,40
1713313077637,COGS 171GS,A01,489194,Pineda; Jaime A,22,0,28,6
1713313078664,COGS 172,A01,489196,Staff,4,0,30,26
1713313079690,COGS 174GS,A01,489264,Pineda; Jaime A,22,0,28,6
1713313080716,COGS 180,A01,627150,Staff,28,0,30,2
1713313081742,COGS 186,A01,489274,Staff,2,0,30,28
1713313082766,COMM 10,A01,489276,Staff,23,0,25,2
1713313082766,COMM 10,A02,489303,Staff,23,0,25,2
1713313083795,COMM 100A,A01,489312,Staff,16,0,25,9
1713313083795,COMM 100A,A02,489313,Staff,24,0,25,1
1713313084822,COMM 106T,A00,512540,Staff,34,0,35,1
1713313085848,COMM 107,A00,489347,Staff,31,0,35,4
1713313086874,COMM 109P,A00,489358,Staff,31,0,35,4
1713313087904,COMM 132,A00,489361,McKenna; Denise,28,0,30,2
1713313088934,COMM 146,A00,489362,Halm; Gavin Patrick,27,0,30,3
1713313089963,COMM 190,A00,489363,Abuelhiga; Soraya Jill,20,0,23,3
1713313090993,CSE 8A,A50,489366,Staff,22,0,25,3
1713313090993,CSE 8A,A51,489367,Staff,24,0,25,1
1713313092022,CSE 11,A01,489398,Cao; Yingjun,79,0,100,21
1713313093048,CSE 12,A01,489487,Staff,43,0,50,7
1713313094072,CSE 20,A01,489497,Staff,48,0,50,2
1713313095098,CSE 21,A01,489517,Braun; Oliver,44,0,50,6
1713313096127,CSE 101,A01,489524,Braun; Oliver,0,15,50,50
1713313097159,CSE 105,A01,512594,Jones; Miles E,80,0,100,20
1713313097159,CSE 105,B01,512598,Jones; Miles E,61,0,100,39
1713313098209,CSE 140,A01,489538,Staff,44,0,50,6
1713313099236,CSE 141,A01,489550,Eldon; John,75,0,100,25
1713313100262,CSE 141L,A01,489571,Eldon; John,73,0,100,27
1713313101287,CSE 151A,A01,489583,Solares; Edwin A,150,0,200,50
1713313102313,CSE 175,A01,510886,Kumar; Rakesh,30,0,30,0
1713313103343,CSE 190,A00,516828,Dubnov; Shlomo,41,0,49,8
1713313104368,DOC 100D,A00,489667,Pass; Natalye Joann,21,0,25,4
1713313105395,DSC 10,A01,624268,Staff,72,0,75,3
1713313106421,DSC 20,A01,624476,Staff,50,0,50,0
1713313107447,DSC 40A,A01,624608,Staff,40,0,40,0
1713313108477,DSGN 1,A01,489179,Rill; Bryan,36,0,50,14
1713313109503,ECE 17,A01,490489,Sahay; Rajeev,18,0,30,12
1713313110533,ECE 65,A50,490492,Staff,15,0,20,5
1713313110533,ECE 65,A51,490493,Staff,20,0,20,0
1713313111561,ECON 1,A01,489715,Famulari; Melissa,69,0,70,1
1713313112587,ECON 2,A01,489717,Levkoff; Steven B.,68,0,70,2
1713313113613,ECON 3,A01,489948,Staff,70,0,70,0
1713313115668,ECON 5,A01,490103,Staff,28,0,30,2
1713313115668,ECON 5,B01,626281,Dai; Yinlin,45,0,45,0
1713313116707,ECON 100A,A01,490127,Famulari; Melissa,68,0,70,2
1713313117732,ECON 100B,A01,490129,Staff,64,0,70,6
1713313118764,ECON 109,A01,490187,Shishkin; Denis,27,0,35,8
1713313119792,ECON 110A,A01,490190,Levkoff; Steven B.,62,0,70,8
1713313120821,ECON 120A,A01,490245,Dai; Yinlin,65,0,70,5
1713313121847,ECON 120B,A01,490247,Nieto-Barthaburu; Augusto,57,0,70,13
1713313122874,ECON 120C,A01,490253,Sun; Yixiao,31,0,35,4
1713313122874,ECON 120C,B01,490255,Sun; Yixiao,34,0,35,1
1713313123899,ECON 129,A00,490256,Eckert; Fabian Paul,25,0,35,10
1713313124927,ECON 131,A00,490257,Nieto-Barthaburu; Augusto,0,0,35,35
1713313126081,ECON 138,A00,490258,Bharadwaj; Prashant,20,0,35,15
1713313126081,ECON 138,B00,490259,Bharadwaj; Prashant,17,0,35,18
1713313127109,ECON 159,A00,490260,Hendrickson; Gerald M.,0,8,0,0
1713313128140,ECON 178,A01,553995,Zhu; Ying,26,0,35,9
1713313129170,EDS 40,A01,512576,Black; Alison Michelle,20,0,20,0
1713313130195,EDS 107,A01,515848,Staff,30,0,30,0
1713313131223,EDS 110R,A01,490262,Staff,26,0,30,4
1713313132255,EDS 112,A01,490264,Chapman; Thandeka K,43,0,50,7
1713313133279,EDS 113,A00,490266,Staff,26,0,30,4
1713313134305,EDS 118,A00,490267,Warstadt; Melissa Fawn,26,0,30,4
1713313135334,EDS 124BR,A00,490268,Eguchi; Emi,8,0,25,17
1713313135334,EDS 124BR,B00,490269,Eguchi; Emi,25,0,25,0
1713313136360,EDS 126,A01,490271,Jones; Makeba,45,0,50,5
1713313137387,EDS 135,A01,490316,Staff,19,0,20,1
1713313138416,ENVR 142GS,A00,519514,Chang; Edmond Yi-Teh,28,0,28,0
1713313139446,ETHN 103,A00,490504,Staff,31,0,36,5
1713313140469,ETHN 103A,A00,490505,Man; Simeon S,5,0,9,4
1713313141499,ETHN 109,A00,490506,Staff,30,0,30,0
1713313142578,ETHN 118,A00,490507,Staff,35,0,36,1
1713313143604,ETHN 119,A00,490508,Staff,34,0,36,2
1713313144630,ETHN 121R,A00,490518,Choi; Esther Min,28,0,36,8
1713313145654,ETHN 127,A00,490528,Staff,15,0,15,0
1713313146680,ETHN 139,A00,490573,Staff,10,0,10,0
1713313147707,ETHN 150,A00,490575,Staff,15,0,15,0
1713313148732,GLBH 20,A00,491705,Elwardani; Nile Regina,38,0,40,2
1713313149759,GLBH 101,A00,491706,Staff,20,0,20,0
1713313150785,GLBH 111,A01,491708,Burgos; Jose L.,15,0,15,0
1713313151810,GLBH 146,A00,491709,Staff,11,0,20,9
1713313152862,GLBH 148,A00,491710,Olivas Hernandez; Olga Lid,14,0,20,6
1713313153901,GLBH 150,A00,491711,Sloane; Julia Kathryn,20,0,20,0
1713313154930,HIEA 131,A00,491760,Staff,29,0,32,3
1713313155957,HIEA 153,A00,491762,Staff,29,0,30,1
1713313156980,HIEU 124,A00,491811,Staff,26,0,32,6
1713313158006,HIEU 124GS,A00,491812,Markman; Kristina,28,0,28,0
1713313159037,HIEU 147,A00,491813,Staff,30,0,32,2
1713313160060,HIEU 149GS,A00,491816,Caldwell; Michael Alan,28,0,28,0
1713313161087,HILD 2C,A01,491713,Hendrickson; Gerald M.,27,0,30,3
1713313162117,HILD 7B,A01,491715,Kwak; Nancy,10,0,30,20
1713313163142,HILD 10,A01,491717,Staff,13,0,20,7
1713313164165,HILD 30GS,A00,491719,Edington; Claire Ellen,24,0,28,4
1713313165194,HINE 109,A00,491818,Shafir; Nir,28,0,32,4
1713313166219,HINE 128,A00,491821,Shafir; Nir,31,0,32,1
1713313167246,HISC 117,A00,491830,Staff,29,0,32,3
1713313168271,HIUS 103,A00,491834,Man; Simeon S,15,0,23,8
1713313169308,HIUS 108B,A00,491835,Staff,29,0,30,1
1713313170334,HIUS 141,A00,491836,Hendrickson; Gerald M.,29,0,32,3
1713313171358,HIUS 149,A00,491839,Staff,27,0,32,5
1713313172388,HUM 3,A01,512617,Crum; Matthew Stephen,45,0,50,5
1713313172388,HUM 3,A02,512618,Crum; Matthew Stephen,48,0,50,2
1713313173412,HUM 3GS,A00,512663,Markman; Kristina,0,0,0,0
1713313173412,HUM 3GS,B00,512664,Staff,0,0,0,0
1713313174436,HUM 4,A01,512620,West; Geoffrey Scott,32,0,50,18
1713313175462,HUM 4GS,A00,512666,Lyon; Antony J.,0,0,0,3
1713313176490,HUM 4R,A01,512625,Watkins; Eric,49,0,50,1
1713313177517,HUM 5,A01,512649,Zavodny; Tatiana Sophia,31,0,50,19
1713313177517,HUM 5,B01,512661,Zroka; Ryan Edward,48,0,50,2
1713313178541,INTL 190,A00,490577,Segui; Alan S,0,0,0,5
1713313179565,JAPN 20AR,A01,491267,Ross; Kayoko F,10,0,20,10
1713313180590,JAPN 180,A00,491285,Berman; Michael David,34,0,40,6
1713313181617,LATI 50,A01,502536,Kokinis; Troy Andreas,17,0,22,5
1713313181617,LATI 50,A02,502551,Kokinis; Troy Andreas,22,0,22,0
1713313181617,LATI 50,A03,502650,Kokinis; Troy Andreas,22,0,22,0
1713313181617,LATI 50,A04,502909,Kokinis; Troy Andreas,22,0,22,0
1713313182641,LATI 160,A01,502920,Kokinis; Troy Andreas,30,0,30,0
1713313183668,LIFR 1A,A00,490494,Van Moer; Vinciane G,17,0,20,3
1713313184693,LIFR 1AX,A00,490495,Van Moer; Vinciane G,17,0,20,3
1713313185723,LIFR 1B,A00,490496,Van Moer; Vinciane G,19,0,20,1
1713313186752,LIFR 1BX,A00,490497,Van Moer; Vinciane G,19,0,20,1
1713313187779,LIGN 8,A00,505198,McIntosh; Justin Daniel,136,0,150,14
1713313188804,LIGN 9GS,A00,491239,Lott; Margaret S.,18,0,20,2
1713313189833,LIGN 101,A01,505200,McIntosh; Justin Daniel,24,0,30,6
1713313190856,LIGN 120,A01,491244,Staff,24,0,30,6
1713313191880,LIGN 149GS,A00,491245,Lott; Margaret S.,18,0,20,2
1713313192905,LIGN 170,A00,491247,Staff,24,0,30,6
1713313193935,LISP 1D,A00,490498,Munoz Sanchez; Alicia,10,0,14,4
1713313193935,LISP 1D,B00,490499,Munoz Sanchez; Alicia,6,0,14,8
1713313193935,LISP 1D,C00,490500,Munoz Sanchez; Alicia,9,0,14,5
1713313193935,LISP 1D,D00,490501,Munoz Sanchez; Alicia,11,0,14,3
1713313194960,LISP 1DX,A00,490502,Munoz Sanchez; Alicia,16,0,28,12
1713313194960,LISP 1DX,B00,490503,Munoz Sanchez; Alicia,18,0,28,10
1713313197013,LTAM 110,A00,491847,Staff,23,0,25,2
1713313198038,LTCS 119,A00,491848,Staff,12,0,15,3
1713313199067,LTCS 130,A00,491849,Staff,24,0,25,1
1713313201118,LTEA 120C,A00,491852,Staff,34,0,40,6
1713313202145,LTEN 130GS,A00,491853,Lyon; Antony J.,25,0,28,3
1713313203176,LTEN 148,A00,491855,Staff,23,0,25,2
1713313204201,LTEN 159,A00,491856,Staff,21,0,25,4
1713313205227,LTEN 180,A00,491857,Staff,9,0,15,6
1713313207278,LTSP 123GS,A00,505928,Bessett; Ryan Matthew,25,0,28,3
1713313208308,LTSP 174GS,A00,506037,Bessett; Ryan Matthew,25,0,28,3
1713313210358,LTWR 102,A00,491861,Staff,11,0,15,4
1713313211387,LTWR 106,A00,491862,Staff,10,0,15,5
1713313212412,MAE 11,A00,490930,Bahadori; Mohammad Yousef,97,0,100,3
1713313213442,MAE 30A,A00,490931,Qi; Huihui,37,0,40,3
1713313214467,MAE 101A,A00,491036,Sadeghizadeh; Zahra,97,0,100,3
1713313215495,MAE 101C,A00,491037,Seshadri; Kalyanasundaram,76,0,100,24
1713313216520,MAE 113,A00,491040,Seshadri; Kalyanasundaram,66,0,80,14
1713313217546,MAE 131A,A00,491041,Ghazinejad; Maziar,39,0,40,1
1713313218571,MAE 142,A00,491053,Staff,39,0,40,1
1713313219597,MAE 143A,A00,491054,Staff,38,0,50,12
1713313220626,MAE 150,A00,491092,Truong; Phuong Thi Ngoc,23,0,35,12
1713313221653,MATH 3C,A01,494031,Pardo Guerra; Sebastian,30,0,30,0
1713313221653,MATH 3C,A02,494032,Pardo Guerra; Sebastian,29,0,30,1
1713313222680,MATH 10A,A01,494034,Staff,27,0,30,3
1713313222680,MATH 10A,A02,494035,Staff,29,0,30,1
1713313222680,MATH 10A,B01,494037,Staff,27,0,30,3
1713313222680,MATH 10A,B02,494038,Staff,29,0,30,1
1713313223710,MATH 10B,A01,494040,Habib; Yousaf,24,0,30,6
1713313223710,MATH 10B,A02,494041,Habib; Yousaf,28,0,30,2
1713313223710,MATH 10B,A03,494042,Habib; Yousaf,30,0,30,0
1713313223710,MATH 10B,A04,494043,Habib; Yousaf,30,0,30,0
1713313223710,MATH 10B,B01,494045,Habib; Yousaf,28,0,30,2
1713313223710,MATH 10B,B02,494046,Habib; Yousaf,30,0,30,0
1713313223710,MATH 10B,B03,494047,Habib; Yousaf,30,0,30,0
1713313223710,MATH 10B,B04,494048,Habib; Yousaf,30,0,30,0
1713313224738,MATH 18,A01,494050,Kemp; Todd Aahron,27,0,30,3
1713313224738,MATH 18,A02,494051,Kemp; Todd Aahron,29,0,30,1
1713313224738,MATH 18,B01,494054,Kemp; Todd Aahron,28,0,30,2
1713313224738,MATH 18,B02,494055,Kemp; Todd Aahron,29,0,30,1
1713313225762,MATH 20A,A01,494059,Suk; Andrew Hoon,30,0,30,0
1713313226797,MATH 20B,A01,494061,Briones; Jor-el Thomas Caparas,33,0,35,2
1713313226797,MATH 20B,B01,494063,Bach; Quang Tran,34,0,35,1
1713313227824,MATH 20C,A01,494065,Staff,28,0,30,2
1713313227824,MATH 20C,A02,494066,Staff,30,0,30,0
1713313227824,MATH 20C,A03,494067,Staff,30,0,30,0
1713313227824,MATH 20C,A04,494068,Staff,30,0,30,0
1713313227824,MATH 20C,B01,494070,Zhang; Ming,26,0,30,4
1713313227824,MATH 20C,B02,494071,Zhang; Ming,29,0,30,1
1713313227824,MATH 20C,B03,494072,Zhang; Ming,29,0,30,1
1713313227824,MATH 20C,B04,494073,Zhang; Ming,29,0,30,1
1713313228854,MATH 20D,A01,494075,Staff,24,0,30,6
1713313228854,MATH 20D,A02,494076,Staff,30,0,30,0
1713313229879,MATH 20E,A01,494079,Staff,25,0,30,5
1713313229879,MATH 20E,A02,494080,Staff,27,0,30,3
1713313229879,MATH 20E,B01,494082,Staff,27,0,30,3
1713313229879,MATH 20E,B02,494083,Staff,25,0,30,5
1713313230905,MATH 103A,A01,494085,Aliabadi Sr.; Mohsen,17,0,30,13
1713313230905,MATH 103A,A02,494086,Aliabadi Sr.; Mohsen,28,0,30,2
1713313230905,MATH 103A,B01,494088,Aliabadi Sr.; Mohsen,22,0,30,8
1713313230905,MATH 103A,B02,494089,Aliabadi Sr.; Mohsen,28,0,30,2
1713313231930,MATH 109,A01,494091,Staff,30,0,30,0
1713313231930,MATH 109,A02,494092,Staff,29,0,30,1
1713313231930,MATH 109,B01,494094,Staff,28,0,30,2
1713313231930,MATH 109,B02,494095,Staff,29,0,30,1
1713313232961,MATH 142A,A01,494097,Chow; Bennett,16,0,30,14
1713313232961,MATH 142A,A02,494098,Chow; Bennett,24,0,30,6
1713313232961,MATH 142A,B01,494100,Chow; Bennett,20,0,30,10
1713313232961,MATH 142A,B02,494101,Chow; Bennett,29,0,30,1
1713313235017,MATH 168A,A01,516677,Dumitriu; Ioana,16,0,35,19
1713313236042,MATH 170A,A01,516679,Dumitriu; Ioana,20,0,30,10
1713313236042,MATH 170A,A02,516680,Dumitriu; Ioana,28,0,30,2
1713313237069,MATH 193A,A01,494107,Staff,16,0,30,14
1713313237069,MATH 193A,A02,494108,Staff,23,0,30,7
1713313237069,MATH 193A,A03,494109,Staff,29,0,30,1
1713313237069,MATH 193A,A04,494110,Staff,24,0,30,6
1713313240148,MGT 16,A00,491930,McKay; Michael J,93,0,98,5
1713313241176,MGT 18,A00,491992,McKay; Michael J,97,0,98,1
1713313242200,MGT 71,A00,492003,Staff,77,0,98,21
1713313243228,MGT 103,A00,505209,Eberhard; Craig A,85,0,98,13
1713313244258,MGT 131A,A00,505210,Anderson; John Charles,91,0,98,7
1713313246363,MGT 153,A00,492077,Perols; Johan Lars,41,0,90,49
1713313249440,MGT 164,A00,492222,McKay; Mary A,94,0,98,4
1713313250467,MGT 172,A00,492245,Staff,59,0,60,1
1713313250467,MGT 172,B00,505526,Hedges; Kathleen,75,0,98,23
1713313251496,MGT 181,A00,505669,Dunn; Louis Jean,87,0,98,11
1713313252525,MMW 14,A01,494399,Staff,23,0,28,5
1713313252525,MMW 14,A02,494400,Staff,25,0,28,3
1713313252525,MMW 14,A03,494401,Staff,28,0,28,0
1713313252525,MMW 14,A04,494402,Staff,28,0,28,0
1713313252525,MMW 14,B01,494404,Carreras; Maria Victoria,13,0,28,15
1713313252525,MMW 14,B02,494405,Carreras; Maria Victoria,26,0,28,2
1713313252525,MMW 14,B03,494406,Carreras; Maria Victoria,28,0,28,0
1713313252525,MMW 14,B04,494407,Carreras; Maria Victoria,28,0,28,0
1713313253554,MMW 14GS,A00,506250,Chang; Edmond Yi-Teh,0,0,0,0
1713313254583,MMW 121R,A01,494415,Adamiak; Patrick John,14,0,28,14
1713313254583,MMW 121R,A02,494416,Adamiak; Patrick John,25,0,28,3
1713313255611,MUS 1A,A01,494113,Staff,12,0,25,13
1713313255611,MUS 1A,A02,494114,Staff,25,0,25,0
1713313256636,MUS 4,A01,494116,Staff,24,0,25,1
1713313256636,MUS 4,A02,494117,Staff,22,0,25,3
1713313257661,MUS 5R,A01,494236,Dubnov; Shlomo,11,0,25,14
1713313257661,MUS 5R,A02,494237,Dubnov; Shlomo,25,0,25,0
1713313258686,MUS 6,A01,494122,Staff,14,0,25,11
1713313258686,MUS 6,A02,494123,Staff,24,0,25,1
1713313259711,MUS 7,A01,494125,Staff,17,0,25,8
1713313259711,MUS 7,A02,494126,Staff,24,0,25,1
1713313260736,MUS 11,A01,494128,Staff,23,0,25,2
1713313260736,MUS 11,A02,494129,Staff,25,0,25,0
1713313261766,MUS 13,A01,494131,Staff,25,0,25,0
1713313261766,MUS 13,A02,494132,Staff,25,0,25,0
1713313262791,MUS 15,A01,494134,Staff,20,0,25,5
1713313262791,MUS 15,A02,494135,Staff,25,0,25,0
1713313262791,MUS 15,B01,494137,Staff,24,0,25,1
1713313263818,MUS 80,A00,494232,Staff,24,0,25,1
1713313263818,MUS 80,B00,494233,Staff,25,0,25,0
1713313263818,MUS 80,C00,494234,Staff,23,0,25,2
1713313264842,MUS 95C,A00,494141,Staff,72,0,75,3
1713313265872,MUS 114,A00,494142,Staff,41,0,50,9
1713313266904,NANO 15,A01,490636,Drews; Aaron,7,0,7,0
1713313267930,PHIL 1,A00,490578,Grush; Rick Scott,49,0,50,1
1713313268956,PHIL 10,A01,490580,Grush; Rick Scott,33,0,35,2
1713313268956,PHIL 10,A02,490586,Grush; Rick Scott,33,0,35,2
1713313269980,PHIL 27,A01,490591,Staff,24,0,25,1
1713313269980,PHIL 27,A02,490592,Staff,25,0,25,0
1713313269980,PHIL 27,A03,490593,Staff,25,0,25,0
1713313269980,PHIL 27,A04,490598,Staff,25,0,25,0
1713313271007,PHIL 32,A01,490611,Staff,20,0,20,0
1713313271007,PHIL 32,A02,490618,Staff,20,0,20,0
1713313272035,PHIL 90,A00,490624,Staff,40,0,40,0
1713313273062,PHIL 136,A00,490627,Cohen; Jonathan David,38,0,40,2
1713313274092,PHIL 155,A00,490634,Staff,64,0,70,6
1713313275119,PHYS 1A,A00,491610,Staff,246,0,250,4
1713313276143,PHYS 1AL,001,491616,Tsai; Philbert S,28,0,30,2
1713313276143,PHYS 1AL,002,491618,Tsai; Philbert S,30,0,30,0
1713313277172,PHYS 1B,A00,491623,Staff,244,0,250,6
1713313278200,PHYS 1BL,001,491626,Tsai; Philbert S,26,0,30,4
1713313278200,PHYS 1BL,002,491628,Tsai; Philbert S,28,0,30,2
1713313279228,PHYS 1C,A00,491632,Staff,222,0,245,23
1713313280253,PHYS 1CL,001,491635,Tsai; Philbert S,11,0,30,19
1713313280253,PHYS 1CL,002,491643,Tsai; Philbert S,24,0,30,6
1713313281278,PHYS 2AR,A01,491651,Meyertholen; Andrew D.,45,0,50,5
1713313282308,PHYS 2B,A01,491659,Staff,106,0,115,9
1713313283335,PHYS 2BL,A01,491685,Staff,21,0,24,3
1713313283335,PHYS 2BL,A02,491700,Staff,23,0,24,1
1713313284361,PHYS 2C,A01,505161,Staff,107,0,115,8
1713313285390,PHYS 4A,A01,491704,Grinstein; Benjamin,99,0,100,1
1713313286420,POLI 5D,A01,494144,Staff,3,0,5,2
1713313286420,POLI 5D,B01,626283,Dai; Yinlin,5,0,5,0
1713313287444,POLI 12,A00,494145,Staff,44,0,45,1
1713313288469,POLI 13R,A00,494146,Forman; Fonna,45,0,50,5
1713313289494,POLI 27,A01,494148,Staff,57,0,60,3
1713313290522,POLI 30,A00,494149,Staff,49,0,50,1
1713313291551,POLI 100DA,A00,494150,Staff,22,0,25,3
1713313293603,POLI 100I,A00,494152,Staff,28,0,30,2
1713313294629,POLI 104B,A00,494153,Smith; Glenn Chatmas,54,0,55,1
1713313295654,POLI 104F,A00,494154,Staff,28,0,30,2
1713313296683,POLI 104I,A00,494155,Smith; Glenn Chatmas,30,0,30,0
1713313297709,POLI 110C,A00,494156,Ingham; Sean,23,0,25,2
1713313298732,POLI 117R,A00,494157,Forman; Fonna,10,0,20,10
1713313299757,POLI 118,A00,494158,Ingham; Sean,22,0,25,3
1713313300785,POLI 120H,A00,494159,Fisk; David Lee,41,0,45,4
1713313301813,POLI 131CR,A00,494160,Hoston; Germaine,37,0,45,8
1713313302852,POLI 133J,A00,494161,Staff,33,0,35,2
1713313303878,POLI 135,A00,494162,Fisk; David Lee,33,0,35,2
1713313304902,POLI 140A,A00,494164,Staff,22,0,30,8
1713313305926,POLI 142I,A00,494165,Staff,30,0,30,0
1713313306956,POLI 144D,A00,494166,Staff,23,0,25,2
1713313307985,POLI 151,A00,494167,Staff,30,0,30,0
1713313309011,POLI 153,A00,494168,Staff,33,0,35,2
1713313310037,POLI 160AA,A00,494169,Staff,35,0,40,5
1713313311066,POLI 162,A00,494170,Mignozzetti; Umberto,20,0,25,5
1713313312089,POLI 171,A00,494171,Mignozzetti; Umberto,21,0,25,4
1713313313115,PSYC 1,A00,494172,Staff,97,0,100,3
1713313314139,PSYC 2,A00,494173,Moranton; Nirelia Melbina-,43,0,50,7
1713313315169,PSYC 3,A00,494174,Staff,29,0,30,1
1713313316194,PSYC 6,A00,494175,Staff,17,0,20,3
1713313317220,PSYC 60,A01,494177,Staff,39,0,45,6
1713313318247,PSYC 70,A01,505724,Geller; Emma Harlan,42,0,45,3
1713313319275,PSYC 101,A00,494180,Heyman; Gail D.,87,0,100,13
1713313320305,PSYC 105,A00,494181,Geller; Emma Harlan,63,0,90,27
1713313321332,PSYC 106,A00,494182,Dobkins; Karen R.,33,0,45,12
1713313322358,PSYC 108,A00,494183,Adrian; Julia Anna,94,0,100,6
1713313323382,PSYC 114,A01,494185,Winkielman; Piotr,2,0,30,28
1713313324411,PSYC 122,A00,494186,Moranton; Nirelia Melbina-,37,0,50,13
1713313325438,PSYC 124,A00,494187,Chapman; Eddie Nathaniel,72,0,80,8
1713313326462,PSYC 131,A00,494188,Anagnostaras; Stephan,55,0,80,25
1713313327488,PSYC 144,A00,494189,Staff,15,0,50,35
1713313328515,PSYC 154,A00,494190,Lacefield; Katharine I,132,0,180,48
1713313329540,PSYC 162,A00,494191,Wixted; John T,82,0,100,18
1713313330566,PSYC 172,A00,494192,Gorman; Michael R.,37,0,45,8
1713313331590,PSYC 178,A00,494193,Glaser; Dale,40,0,45,5
1713313332617,PSYC 193,A00,505725,Chapman; Eddie Nathaniel,20,0,20,0
1713313333642,RELI 145GS,A00,519817,Rahimi; Babak,18,0,20,2
1713313334668,SE 101A,A01,490862,Chadha; Mayank,23,0,25,2
1713313335692,SE 101C,A01,490924,Krysl; Petr,18,0,20,2
1713313336723,SE 110A,A01,490928,Staff,19,0,20,1
1713313337755,SE 130A,A00,490929,Morrison; Machel Leigh,62,0,70,8
1713313338781,SIO 1,A01,519325,Staff,39,0,40,1
1713313339807,SIO 30,A01,519327,Staff,39,0,40,1
1713313340835,SIO 40,A00,519328,Staff,40,0,40,0
1713313341862,SIO 46GS,A00,519819,Cook; Geoffrey W,18,0,25,7
1713313342888,SIO 109R,A00,494197,Forman; Fonna,4,0,20,16
1713313343911,SIO 121GS,A00,519827,Cook; Geoffrey W,18,0,25,7
1713313344941,SIO 132,A01,519330,Staff,38,0,40,2
1713313345970,SIO 133,A01,519397,Staff,38,0,40,2
1713313346996,SIO 139,A00,519396,Kacev; David,33,0,40,7
1713313348022,SOCI 1,A01,494199,Thorpe; Charles Robert,23,0,30,7
1713313348022,SOCI 1,A02,494200,Thorpe; Charles Robert,30,0,30,0
1713313348022,SOCI 1,A03,494201,Thorpe; Charles Robert,29,0,30,1
1713313348022,SOCI 1,A04,494202,Thorpe; Charles Robert,29,0,30,1
1713313348022,SOCI 1,A05,494203,Thorpe; Charles Robert,29,0,30,1
1713313348022,SOCI 1,A06,494204,Thorpe; Charles Robert,30,0,30,0
1713313348022,SOCI 1,A07,494205,Thorpe; Charles Robert,29,0,30,1
1713313349047,SOCI 60,A01,494207,Staff,36,0,40,4
1713313349047,SOCI 60,A02,494208,Staff,39,0,40,1
1713313350130,SOCI 100,A01,494210,Payne; Christine Anna,27,0,30,3
1713313350130,SOCI 100,A02,494211,Payne; Christine Anna,27,0,30,3
1713313351155,SOCI 109M,A00,494212,Staff,20,0,20,0
1713313352180,SOCI 110,A00,494213,Staff,35,0,40,5
1713313354233,SOCI 118E,A00,494215,Ng; Kwai,38,0,40,2
1713313355262,SOCI 125,A00,494216,Calderon-Zaks; Michael Aar,42,0,45,3
1713313356291,SOCI 126,A01,494218,Jones; Makeba,4,0,5,1
1713313357320,SOCI 131,A00,494219,Thorpe; Charles Robert,28,0,30,2
1713313359368,SOCI 135,A00,494221,Payne; Christine Anna,34,0,50,16
1713313360395,SOCI 136E,A00,626690,Ruiz; Jonathan Joseph,25,0,25,0
1713313361424,SOCI 138GS,A00,494222,Navon; Daniel,24,0,28,4
1713313363473,SOCI 145,A00,494224,Staff,42,0,45,3
1713313364498,SOCI 153,A00,494225,Staff,28,0,30,2
1713313365524,SOCI 160E,A00,494226,Ng; Kwai,33,0,40,7
1713313366552,SOCI 180,A00,494227,Staff,29,0,30,1
1713313367578,SOCI 189GS,A00,494228,Ribas Norris; Janet Vanesa,11,0,11,0
1713313368602,SOCI 190GS,A00,553232,Ribas Norris; Janet Vanesa,11,0,11,0
1713313369634,SOMI 220,A00,627178,Schneid; Stephen David,30,0,30,0
1713313370668,SYN 2,001,490768,Staff,14,0,15,1
1713313370668,SYN 2,002,490769,Staff,15,0,15,0
1713313370668,SYN 2,004,490775,Staff,0,0,0,0
1713313370668,SYN 2,003,490774,Staff,0,0,0,0
1713313370668,SYN 2,005,490776,Staff,0,0,0,0
1713313371695,SYN 2R,001,490779,Staff,13,0,15,2
1713313371695,SYN 2R,002,514635,Staff,14,0,15,1
1713313372727,SYN 100,A01,490783,Staff,15,0,20,5
1713313372727,SYN 100,B01,490787,Staff,10,0,20,10
1713313372727,SYN 100,C01,490789,Staff,12,0,20,8
1713313373751,SYN 150,A00,490817,Staff,14,0,15,1
1713313373751,SYN 150,B00,514610,Staff,15,0,15,0
1713313374783,TDAC 1,A00,492753,Walsh; Kim C.,19,0,20,1
1713313374783,TDAC 1,B00,492754,Harting; Carla Kelso,19,0,20,1
1713313374783,TDAC 1,C00,513995,Salovey; Todd,17,0,20,3
1713313375808,TDAC 101,A00,492766,Harting; Carla Kelso,17,0,20,3
1713313376836,TDAC 102,A00,492768,Basso; Beatrice,19,0,20,1
1713313377864,TDDE 111,A00,492769,Staff,25,0,25,0
1713313378973,TDDE 131,A00,492770,Staff,15,0,15,0
1713313378973,TDDE 131,B00,492771,Staff,15,0,15,0
1713313380001,TDDE 131GS,A00,523716,Guirguis; Mark C,24,0,28,4
1713313381027,TDGE 1,A01,492756,Salovey; Todd,57,0,60,3
1713313382056,TDGE 5,A01,492758,Staff,24,0,25,1
1713313383082,TDGE 10,A00,492759,Fulton; Julia,209,0,220,11
1713313384108,TDGE 11,A00,492760,Castro; Robert Jess,200,0,200,0
1713313386165,TDGE 124,A00,492772,Fulton; Julia,192,0,220,28
1713313387197,TDGE 125,A00,492773,Meyer; Ursula,40,0,50,10
1713313387197,TDGE 125,B00,492774,Staff,50,0,50,0
1713313387197,TDGE 125,C00,523565,Staff,49,0,50,1
1713313388224,TDGE 125GS,A00,523580,Guirguis; Mark C,24,0,28,4
1713313389250,TDGE 127,A00,492775,Havis; Allan,41,0,50,9
1713313390285,TDHT 101,A00,492776,Staff,35,0,35,0
1713313391311,TDMV 1,A00,492762,Caligagan; Maria T.,30,0,30,0
1713313391311,TDMV 1,B00,492763,Arcidiacono; Kristin,25,0,30,5
1713313392336,TDMV 2,A00,492764,Weinberg; Sadie,29,0,30,1
1713313393363,TDMV 3,A00,492765,Mack; Kara Shanai',39,0,40,1
1713313394391,TDMV 138,A00,492777,Mack; Kara Shanai',36,0,40,4
1713313395416,TDMV 140,A00,492778,Lima; Paulo Henrique,40,0,40,0
1713313396446,TDMV 142,A00,492779,Caligagan; Maria T.,36,0,40,4
1713313396446,TDMV 142,B00,492780,Caligagan; Tony,37,0,40,3
1713313397471,TDMV 143,A00,492781,Fyall; Daunte Edward,39,0,40,1
1713313398498,USP 1,A01,492401,Kwak; Nancy,26,0,35,9
1713313399529,USP 2,A01,492453,Hinds; Juli Beth,35,0,35,0
1713313400558,USP 3,A01,492516,Staff,29,0,35,6
1713313401588,USP 4,A00,492522,McTague; Sarah,19,0,25,6
1713313402617,USP 100,A00,492523,Staff,33,0,35,2
1713313403646,USP 101,A00,492524,Staff,13,0,15,2
1713313404671,USP 105,A00,492525,Staff,21,0,25,4
1713313405697,USP 151,A00,492526,Shenkman; Michael Thomas,33,0,35,2
1713313406725,USP 170,A00,492545,Hinds; Juli Beth,33,0,35,2
1713313407751,USP 171GS,A00,492608,Bussell; Mirle Rabinowitz,25,0,28,3
1713313408776,USP 183GS,A00,492613,Peerson; Susan,25,0,28,3
1713313409802,VIS 30,A01,490693,Yoldas; Pinar,21,0,22,1
1713313409802,VIS 30,A02,490694,Yoldas; Pinar,19,0,22,3
1713313410826,VIS 83,A00,490695,Kester; Grant,66,0,75,9
1713313411854,VIS 105D,A00,490696,Staff,22,0,25,3
1713313412881,VIS 124CN,A00,490699,Rose; Jordan M,68,0,75,7
1713313413904,VIS 125GS,A00,511221,Williams; Alena J,21,0,22,1
1713313414934,VIS 128D,A00,490700,Staff,74,0,75,1
1713313415963,VIS 151,A01,490717,Staff,33,0,34,1
1713313415963,VIS 151,A02,490766,Staff,33,0,34,1
1713313416988,VIS 154GS,A00,511972,Williams; Alena J,21,0,22,1
1713313418015,VIS 160A,A00,490767,Stone; Patricia,7,0,10,3
1713313419040,WCWP 10A,A00,490638,Staff,14,0,15,1
1713313419040,WCWP 10A,B00,490640,Staff,15,0,15,0
1713313420065,WCWP 10B,A00,490641,Staff,0,0,0,0
1713313420065,WCWP 10B,B00,490642,Staff,14,0,15,1
1713313420065,WCWP 10B,C00,490644,Staff,13,0,15,2
1713313420065,WCWP 10B,D00,490647,Staff,0,0,0,0
1713313421094,WCWP 100,A00,490655,Staff,0,0,0,0
1713313421094,WCWP 100,B00,490687,Staff,12,0,15,3
1713313423196,ANAR 153,A00,487222,Braswell; Geoffrey E.,54,0,60,6
1713313424221,ANBI 134,A00,487223,Staff,12,0,20,8
1713313425248,ANBI 143GS,A00,487224,Noel; Geoffroy Pierre Jean,20,0,24,4
1713313426270,ANBI 144GS,A00,519548,Noel; Geoffroy Pierre Jean,20,0,24,4
1713313427295,ANSC 101,A00,487225,Staff,19,0,20,1
1713313428324,ANSC 125,A00,487227,Brenner; Suzanne A,39,0,40,1
1713313430373,ANSC 146,A00,487229,Staff,36,0,40,4
1713313431396,ANSC 148,A00,487230,Olivas Hernandez; Olga Lid,39,0,40,1
1713313432421,ANSC 150,A00,504165,Sloane; Julia Kathryn,19,0,20,1
1713313433447,ANSC 180,A00,487232,Staff,13,0,15,2
1713313434471,ANSC 188,A00,627155,Staff,40,0,40,0
1713313435499,ANTH 5,A00,519529,Semendeferi; Ekaterini,15,0,15,0
1713313436527,ANTH 10,A00,487219,Staff,58,0,60,2
1713313437552,ANTH 23,A01,487221,Staff,17,0,20,3
1713313438583,ANTH 102,A00,487233,Wilder; Linnea Lorene,51,0,60,9
1713313439609,ANTH 103,A00,487234,Varma; Saiba,56,0,60,4
1713313440636,ANTH 105,A00,487235,Stewart; Alexander B,56,0,60,4
1713313441665,BENG 100,A01,516685,Taylor Amos; Alyssa C,28,0,30,2
1713313442699,BIBC 102,A01,491316,Flagg; Matthew Paul,37,0,88,51
1713313442699,BIBC 102,A02,491366,Flagg; Matthew Paul,83,0,88,5
1713313443723,BIBC 103,A01,491486,Boumechache; Miyyada,16,0,24,8
1713313443723,BIBC 103,A02,491487,Boumechache; Miyyada,24,0,24,0
1713313444757,BICD 100,A01,516882,Staff,75,0,75,0
1713313444757,BICD 100,A02,516890,Staff,70,0,75,5
1713313445788,BICD 102GS,A00,491488,Lo; Stanley M.,26,0,28,2
1713313446819,BIEB 136GS,A00,516940,Holway; David A. & Shurin; Jonathan,19,0,24,5
1713313447847,BIEB 137GS,A01,517034,Holway; David A. & Shurin; Jonathan,19,0,24,5
1713313448877,BIEB 138GS,A01,491492,Pirino; Giorgia,21,0,28,7
1713313449904,BILD 1,A01,491296,Staff,62,0,63,1
1713313449904,BILD 1,A02,491297,Staff,63,0,63,0
1713313450929,BILD 4,A01,517099,Gonzalez Gamboa; Ivonne,22,0,24,2
1713313450929,BILD 4,A02,517100,Gonzalez Gamboa; Ivonne,24,0,24,0
1713313451958,BILD 60GS,A00,491309,Lo; Stanley M.,26,0,28,2
1713313452986,BIMM 100,A01,517136,Staff,90,0,100,10
1713313454069,BIMM 110,A01,517182,Staff,70,0,100,30
1713313455094,BIMM 120,A01,517228,Pickett; Brooke Elizabeth,40,0,63,23
1713313455094,BIMM 120,A02,517240,Pickett; Brooke Elizabeth,48,0,63,15
1713313456120,BIMM 132GS,A01,491498,Pirino; Giorgia,21,0,28,7
1713313457144,BIMM 143,A01,491589,Bozinovic; Goran,18,0,40,22
1713313458169,BIPN 100,A01,491594,Armour; Jon Christopher,91,0,100,9
1713313459199,BIPN 140,A01,491602,Marino; Marc J,29,0,50,21
1713313461252,CAT 125,A00,515973,Staff,20,0,20,0
1713313462280,CAT 125GS,A00,515974,Rahimi; Babak,18,0,20,2
1713313463312,CAT 125R,A00,515980,Staff,14,0,20,6
1713313463312,CAT 125R,B00,515981,Tosun; Adriana,19,0,20,1
1713313463312,CAT 125R,C00,515987,Hyland; Tina Mae,2,0,20,18
1713313463312,CAT 125R,D00,515988,Bronstein; Phoebe Malan,18,0,20,2
1713313464338,CENG 15,A01,488699,Drews; Aaron,25,0,25,0
1713313465368,CENG 100,A00,505196,Opatkiewicz; Justin Paul,25,0,25,0
1713313466395,CGS 2A,A01,489598,Staff,33,0,35,2
1713313467424,CGS 112,A00,489599,Staff,15,0,15,0
1713313468449,CGS 119,A00,489603,Staff,10,0,10,0
1713313469477,CGS 120,A00,489604,Staff,14,0,15,1
1713313470504,CGS 150,A00,489607,Staff,15,0,15,0
1713313471532,CHEM 6A,A01,488715,Staff,98,0,100,2
1713313472558,CHEM 6B,A01,488719,Piercy; Marc Anthony,100,0,100,0
1713313473583,CHEM 6C,A01,488723,Albizati; Kim F.,94,0,100,6
1713313474610,CHEM 7L,A01,488728,Schurmeier; Kimberly,18,0,24,6
1713313474610,CHEM 7L,A02,488730,Schurmeier; Kimberly,23,0,24,1
1713313474610,CHEM 7L,A03,488734,Schurmeier; Kimberly,23,0,24,1
1713313474610,CHEM 7L,A04,488763,Schurmeier; Kimberly,23,0,24,1
1713313474610,CHEM 7L,B01,488798,Schurmeier; Kimberly,18,0,24,6
1713313474610,CHEM 7L,B02,488801,Schurmeier; Kimberly,23,0,24,1
1713313474610,CHEM 7L,B03,488808,Schurmeier; Kimberly,24,0,24,0
1713313474610,CHEM 7L,B04,488811,Schurmeier; Kimberly,24,0,24,0
1713313475636,CHEM 11,A01,488897,Stallings; Dontarie M,98,0,100,2
1713313476663,CHEM 40A,A01,488913,Albizati; Kim F.,90,0,100,10
1713313477689,CHEM 40B,A01,488920,Weizman; Haim,47,0,50,3
1713313477689,CHEM 40B,A02,488938,Weizman; Haim,46,0,50,4
1713313478715,CHEM 41A,A01,489029,Klosterman; Jeremy K,58,0,60,2
1713313479740,CHEM 41C,A01,500436,Tor; Yitzhak,55,0,60,5
1713313480772,CHEM 43A,A01,500426,Weizman; Haim,2,0,24,22
1713313480772,CHEM 43A,A02,500430,Weizman; Haim,13,0,24,11
1713313480772,CHEM 43A,B01,514041,Klosterman; Jeremy K,15,0,24,9
1713313480772,CHEM 43A,B02,514047,Klosterman; Jeremy K,23,0,24,1
1713313481802,CHEM 108,A01,489140,Jennings; Patricia A.,13,0,24,11
1713313481802,CHEM 108,A02,489142,Jennings; Patricia A.,15,0,24,9
1713313482829,CHEM 114A,A01,489147,Stallings; Dontarie M,78,0,100,22
1713313483856,CHIN 169A,A00,489171,Wang; Xiao,19,0,20,1
1713313485915,COGS 3,A01,518827,Boyle; Mary E. T.,29,0,40,11
1713313486940,COGS 11,A01,489175,Staff,28,0,30,2
1713313487965,COGS 14A,A01,518829,Staff,51,0,60,9
1713313488992,COGS 14B,A01,489177,Hoffman; Drew Ellen,69,0,75,6
1713313490017,COGS 100,A01,489181,Allen; Michael Gordon,66,0,75,9
1713313491045,COGS 101A,A01,489183,Staff,48,0,60,12
1713313492074,COGS 101B,A01,489185,Allen; Michael Gordon,13,0,30,17
1713313493100,COGS 101C,A01,526786,Staff,24,0,30,6
1713313495157,COGS 107A,A01,489189,Boyle; Mary E. T.,20,0,35,15
1713313496181,COGS 107B,A01,627144,Mooshagian; Eric Frederick,60,0,60,0
1713313497211,COGS 118A,A01,489191,Staff,0,33,40,40
1713313499265,COGS 171GS,A01,489194,Pineda; Jaime A,22,0,28,6
1713313500290,COGS 172,A01,489196,Staff,4,0,30,26
1713313501322,COGS 174GS,A01,489264,Pineda; Jaime A,22,0,28,6
1713313502352,COGS 180,A01,627150,Staff,28,0,30,2
1713313503380,COGS 186,A01,489274,Staff,2,0,30,28
1713313504408,COMM 10,A01,489276,Staff,23,0,25,2
1713313504408,COMM 10,A02,489303,Staff,23,0,25,2
1713313505432,COMM 100A,A01,489312,Staff,16,0,25,9
1713313505432,COMM 100A,A02,489313,Staff,24,0,25,1
1713313506457,COMM 106T,A00,512540,Staff,34,0,35,1
1713313507483,COMM 107,A00,489347,Staff,31,0,35,4
1713313508509,COMM 109P,A00,489358,Staff,31,0,35,4
1713313509537,COMM 132,A00,489361,McKenna; Denise,28,0,30,2
1713313510562,COMM 146,A00,489362,Halm; Gavin Patrick,27,0,30,3
1713313511591,COMM 190,A00,489363,Abuelhiga; Soraya Jill,20,0,23,3
1713313512620,CSE 8A,A50,489366,Staff,22,0,25,3
1713313512620,CSE 8A,A51,489367,Staff,24,0,25,1
1713313513647,CSE 11,A01,489398,Cao; Yingjun,79,0,100,21
1713313514674,CSE 12,A01,489487,Staff,43,0,50,7
1713313515707,CSE 20,A01,489497,Staff,48,0,50,2
1713313516838,CSE 21,A01,489517,Braun; Oliver,44,0,50,6
1713313517865,CSE 101,A01,489524,Braun; Oliver,0,15,50,50
1713313518892,CSE 105,A01,512594,Jones; Miles E,80,0,100,20
1713313518892,CSE 105,B01,512598,Jones; Miles E,61,0,100,39
1713313520210,CSE 140,A01,489538,Staff,44,0,50,6
1713313521241,CSE 141,A01,489550,Eldon; John,75,0,100,25
1713313522270,CSE 141L,A01,489571,Eldon; John,73,0,100,27
1713313523296,CSE 151A,A01,489583,Solares; Edwin A,149,0,200,51
1713313524324,CSE 175,A01,510886,Kumar; Rakesh,30,0,30,0
1713313525353,CSE 190,A00,516828,Dubnov; Shlomo,41,0,49,8
1713313526380,DOC 100D,A00,489667,Pass; Natalye Joann,21,0,25,4
1713313527405,DSC 10,A01,624268,Staff,72,0,75,3
1713313528433,DSC 20,A01,624476,Staff,50,0,50,0
1713313529464,DSC 40A,A01,624608,Staff,40,0,40,0
1713313530492,DSGN 1,A01,489179,Rill; Bryan,36,0,50,14
1713313531519,ECE 17,A01,490489,Sahay; Rajeev,18,0,30,12
1713313532544,ECE 65,A50,490492,Staff,15,0,20,5
1713313532544,ECE 65,A51,490493,Staff,20,0,20,0
1713313533573,ECON 1,A01,489715,Famulari; Melissa,68,0,70,2
1713313534599,ECON 2,A01,489717,Levkoff; Steven B.,68,0,70,2
1713313535633,ECON 3,A01,489948,Staff,70,0,70,0
1713313537685,ECON 5,A01,490103,Staff,28,0,30,2
1713313537685,ECON 5,B01,626281,Dai; Yinlin,45,0,45,0
1713313538712,ECON 100A,A01,490127,Famulari; Melissa,68,0,70,2
1713313539741,ECON 100B,A01,490129,Staff,64,0,70,6
1713313540768,ECON 109,A01,490187,Shishkin; Denis,27,0,35,8
1713313541863,ECON 110A,A01,490190,Levkoff; Steven B.,62,0,70,8
1713313542889,ECON 120A,A01,490245,Dai; Yinlin,65,0,70,5
1713313543915,ECON 120B,A01,490247,Nieto-Barthaburu; Augusto,56,0,70,14
1713313544940,ECON 120C,A01,490253,Sun; Yixiao,30,0,35,5
1713313544940,ECON 120C,B01,490255,Sun; Yixiao,34,0,35,1
1713313545971,ECON 129,A00,490256,Eckert; Fabian Paul,25,0,35,10
1713313547001,ECON 131,A00,490257,Nieto-Barthaburu; Augusto,0,0,35,35
1713313548029,ECON 138,A00,490258,Bharadwaj; Prashant,19,0,35,16
1713313548029,ECON 138,B00,490259,Bharadwaj; Prashant,17,0,35,18
1713313549054,ECON 159,A00,490260,Hendrickson; Gerald M.,0,8,0,0
1713313550085,ECON 178,A01,553995,Zhu; Ying,26,0,35,9
1713313551116,EDS 40,A01,512576,Black; Alison Michelle,20,0,20,0
1713313552141,EDS 107,A01,515848,Staff,30,0,30,0
1713313553169,EDS 110R,A01,490262,Staff,26,0,30,4
1713313554194,EDS 112,A01,490264,Chapman; Thandeka K,43,0,50,7
1713313555217,EDS 113,A00,490266,Staff,26,0,30,4
1713313556246,EDS 118,A00,490267,Warstadt; Melissa Fawn,26,0,30,4
1713313557272,EDS 124BR,A00,490268,Eguchi; Emi,8,0,25,17
1713313557272,EDS 124BR,B00,490269,Eguchi; Emi,25,0,25,0
1713313558372,EDS 126,A01,490271,Jones; Makeba,45,0,50,5
1713313559396,EDS 135,A01,490316,Staff,19,0,20,1
1713313560422,ENVR 142GS,A00,519514,Chang; Edmond Yi-Teh,28,0,28,0
1713313561450,ETHN 103,A00,490504,Staff,31,0,36,5
1713313562476,ETHN 103A,A00,490505,Man; Simeon S,5,0,9,4
1713313563502,ETHN 109,A00,490506,Staff,30,0,30,0
1713313564533,ETHN 118,A00,490507,Staff,35,0,36,1
1713313565556,ETHN 119,A00,490508,Staff,35,0,36,1
1713313566583,ETHN 121R,A00,490518,Choi; Esther Min,27,0,36,9
1713313567607,ETHN 127,A00,490528,Staff,15,0,15,0
1713313568633,ETHN 139,A00,490573,Staff,10,0,10,0
1713313569658,ETHN 150,A00,490575,Staff,15,0,15,0
1713313570686,GLBH 20,A00,491705,Elwardani; Nile Regina,38,0,40,2
1713313571712,GLBH 101,A00,491706,Staff,20,0,20,0
1713313572738,GLBH 111,A01,491708,Burgos; Jose L.,15,0,15,0
1713313573763,GLBH 146,A00,491709,Staff,11,0,20,9
1713313574792,GLBH 148,A00,491710,Olivas Hernandez; Olga Lid,14,0,20,6
1713313575824,GLBH 150,A00,491711,Sloane; Julia Kathryn,20,0,20,0
1713313576852,HIEA 131,A00,491760,Staff,29,0,32,3
1713313577880,HIEA 153,A00,491762,Staff,29,0,30,1
1713313578905,HIEU 124,A00,491811,Staff,26,0,32,6
1713313579934,HIEU 124GS,A00,491812,Markman; Kristina,27,0,28,1
1713313580960,HIEU 147,A00,491813,Staff,30,0,32,2
1713313581986,HIEU 149GS,A00,491816,Caldwell; Michael Alan,28,0,28,0
1713313583010,HILD 2C,A01,491713,Hendrickson; Gerald M.,27,0,30,3
1713313584035,HILD 7B,A01,491715,Kwak; Nancy,7,0,30,23
1713313585061,HILD 10,A01,491717,Staff,12,0,20,8
1713313586085,HILD 30GS,A00,491719,Edington; Claire Ellen,24,0,28,4
1713313587110,HINE 109,A00,491818,Shafir; Nir,28,0,32,4
1713313588134,HINE 128,A00,491821,Shafir; Nir,31,0,32,1
1713313589162,HISC 117,A00,491830,Staff,29,0,32,3
1713313590191,HIUS 103,A00,491834,Man; Simeon S,15,0,23,8
1713313591220,HIUS 108B,A00,491835,Staff,29,0,30,1
1713313592246,HIUS 141,A00,491836,Hendrickson; Gerald M.,29,0,32,3
1713313593273,HIUS 149,A00,491839,Staff,27,0,32,5
1713313594300,HUM 3,A01,512617,Crum; Matthew Stephen,45,0,50,5
1713313594300,HUM 3,A02,512618,Crum; Matthew Stephen,48,0,50,2
1713313595325,HUM 3GS,A00,512663,Markman; Kristina,0,0,0,1
1713313595325,HUM 3GS,B00,512664,Staff,0,0,0,0
1713313596349,HUM 4,A01,512620,West; Geoffrey Scott,32,0,50,18
1713313597373,HUM 4GS,A00,512666,Lyon; Antony J.,0,0,0,3
1713313598404,HUM 4R,A01,512625,Watkins; Eric,49,0,50,1
1713313599437,HUM 5,A01,512649,Zavodny; Tatiana Sophia,30,0,50,20
1713313599437,HUM 5,B01,512661,Zroka; Ryan Edward,48,0,50,2
1713313600463,INTL 190,A00,490577,Segui; Alan S,0,0,0,5
1713313601490,JAPN 20AR,A01,491267,Ross; Kayoko F,10,0,20,10
1713313602513,JAPN 180,A00,491285,Berman; Michael David,34,0,40,6
1713313603540,LATI 50,A01,502536,Kokinis; Troy Andreas,16,0,22,6
1713313603540,LATI 50,A02,502551,Kokinis; Troy Andreas,22,0,22,0
1713313603540,LATI 50,A03,502650,Kokinis; Troy Andreas,22,0,22,0
1713313603540,LATI 50,A04,502909,Kokinis; Troy Andreas,22,0,22,0
1713313604566,LATI 160,A01,502920,Kokinis; Troy Andreas,30,0,30,0
1713313605591,LIFR 1A,A00,490494,Van Moer; Vinciane G,17,0,20,3
1713313606618,LIFR 1AX,A00,490495,Van Moer; Vinciane G,17,0,20,3
1713313607649,LIFR 1B,A00,490496,Van Moer; Vinciane G,19,0,20,1
1713313608673,LIFR 1BX,A00,490497,Van Moer; Vinciane G,19,0,20,1
1713313609700,LIGN 8,A00,505198,McIntosh; Justin Daniel,136,0,150,14
1713313610725,LIGN 9GS,A00,491239,Lott; Margaret S.,18,0,20,2
1713313611750,LIGN 101,A01,505200,McIntosh; Justin Daniel,24,0,30,6
1713313612776,LIGN 120,A01,491244,Staff,24,0,30,6
1713313613802,LIGN 149GS,A00,491245,Lott; Margaret S.,18,0,20,2
1713313614827,LIGN 170,A00,491247,Staff,24,0,30,6
1713313615853,LISP 1D,A00,490498,Munoz Sanchez; Alicia,10,0,14,4
1713313615853,LISP 1D,B00,490499,Munoz Sanchez; Alicia,6,0,14,8
1713313615853,LISP 1D,C00,490500,Munoz Sanchez; Alicia,9,0,14,5
1713313615853,LISP 1D,D00,490501,Munoz Sanchez; Alicia,11,0,14,3
1713313616877,LISP 1DX,A00,490502,Munoz Sanchez; Alicia,16,0,28,12
1713313616877,LISP 1DX,B00,490503,Munoz Sanchez; Alicia,18,0,28,10
1713313618934,LTAM 110,A00,491847,Staff,23,0,25,2
1713313619960,LTCS 119,A00,491848,Staff,12,0,15,3
1713313620990,LTCS 130,A00,491849,Staff,24,0,25,1
1713313623038,LTEA 120C,A00,491852,Staff,34,0,40,6
1713313624068,LTEN 130GS,A00,491853,Lyon; Antony J.,25,0,28,3
1713313625097,LTEN 148,A00,491855,Staff,23,0,25,2
1713313626122,LTEN 159,A00,491856,Staff,21,0,25,4
1713313627147,LTEN 180,A00,491857,Staff,9,0,15,6
1713313629197,LTSP 123GS,A00,505928,Bessett; Ryan Matthew,24,0,28,4
1713313630224,LTSP 174GS,A00,506037,Bessett; Ryan Matthew,24,0,28,4
1713313632280,LTWR 102,A00,491861,Staff,11,0,15,4
1713313633304,LTWR 106,A00,491862,Staff,10,0,15,5
1713313634333,MAE 11,A00,490930,Bahadori; Mohammad Yousef,97,0,100,3
1713313635364,MAE 30A,A00,490931,Qi; Huihui,37,0,40,3
1713313636392,MAE 101A,A00,491036,Sadeghizadeh; Zahra,97,0,100,3
1713313637418,MAE 101C,A00,491037,Seshadri; Kalyanasundaram,76,0,100,24
1713313638446,MAE 113,A00,491040,Seshadri; Kalyanasundaram,66,0,80,14
1713313639472,MAE 131A,A00,491041,Ghazinejad; Maziar,39,0,40,1
1713313640496,MAE 142,A00,491053,Staff,39,0,40,1
1713313641520,MAE 143A,A00,491054,Staff,38,0,50,12
1713313642546,MAE 150,A00,491092,Truong; Phuong Thi Ngoc,23,0,35,12
1713313643582,MATH 3C,A01,494031,Pardo Guerra; Sebastian,30,0,30,0
1713313643582,MATH 3C,A02,494032,Pardo Guerra; Sebastian,29,0,30,1
1713313644610,MATH 10A,A01,494034,Staff,27,0,30,3
1713313644610,MATH 10A,A02,494035,Staff,29,0,30,1
1713313644610,MATH 10A,B01,494037,Staff,27,0,30,3
1713313644610,MATH 10A,B02,494038,Staff,29,0,30,1
1713313645645,MATH 10B,A01,494040,Habib; Yousaf,24,0,30,6
1713313645645,MATH 10B,A02,494041,Habib; Yousaf,28,0,30,2
1713313645645,MATH 10B,A03,494042,Habib; Yousaf,30,0,30,0
1713313645645,MATH 10B,A04,494043,Habib; Yousaf,30,0,30,0
1713313645645,MATH 10B,B01,494045,Habib; Yousaf,28,0,30,2
1713313645645,MATH 10B,B02,494046,Habib; Yousaf,30,0,30,0
1713313645645,MATH 10B,B03,494047,Habib; Yousaf,30,0,30,0
1713313645645,MATH 10B,B04,494048,Habib; Yousaf,30,0,30,0
1713313646676,MATH 18,A01,494050,Kemp; Todd Aahron,26,0,30,4
1713313646676,MATH 18,A02,494051,Kemp; Todd Aahron,29,0,30,1
1713313646676,MATH 18,B01,494054,Kemp; Todd Aahron,28,0,30,2
1713313646676,MATH 18,B02,494055,Kemp; Todd Aahron,29,0,30,1
1713313647705,MATH 20A,A01,494059,Suk; Andrew Hoon,30,0,30,0
1713313648733,MATH 20B,A01,494061,Briones; Jor-el Thomas Caparas,33,0,35,2
1713313648733,MATH 20B,B01,494063,Bach; Quang Tran,34,0,35,1
1713313649764,MATH 20C,A01,494065,Staff,28,0,30,2
1713313649764,MATH 20C,A02,494066,Staff,30,0,30,0
1713313649764,MATH 20C,A03,494067,Staff,30,0,30,0
1713313649764,MATH 20C,A04,494068,Staff,30,0,30,0
1713313649764,MATH 20C,B01,494070,Zhang; Ming,26,0,30,4
1713313649764,MATH 20C,B02,494071,Zhang; Ming,29,0,30,1
1713313649764,MATH 20C,B03,494072,Zhang; Ming,29,0,30,1
1713313649764,MATH 20C,B04,494073,Zhang; Ming,29,0,30,1
1713313650793,MATH 20D,A01,494075,Staff,24,0,30,6
1713313650793,MATH 20D,A02,494076,Staff,30,0,30,0
1713313651822,MATH 20E,A01,494079,Staff,25,0,30,5
1713313651822,MATH 20E,A02,494080,Staff,27,0,30,3
1713313651822,MATH 20E,B01,494082,Staff,27,0,30,3
1713313651822,MATH 20E,B02,494083,Staff,25,0,30,5
1713313652847,MATH 103A,A01,494085,Aliabadi Sr.; Mohsen,17,0,30,13
1713313652847,MATH 103A,A02,494086,Aliabadi Sr.; Mohsen,28,0,30,2
1713313652847,MATH 103A,B01,494088,Aliabadi Sr.; Mohsen,22,0,30,8
1713313652847,MATH 103A,B02,494089,Aliabadi Sr.; Mohsen,28,0,30,2
1713313653879,MATH 109,A01,494091,Staff,30,0,30,0
1713313653879,MATH 109,A02,494092,Staff,29,0,30,1
1713313653879,MATH 109,B01,494094,Staff,28,0,30,2
1713313653879,MATH 109,B02,494095,Staff,29,0,30,1
1713313654906,MATH 142A,A01,494097,Chow; Bennett,15,0,30,15
1713313654906,MATH 142A,A02,494098,Chow; Bennett,24,0,30,6
1713313654906,MATH 142A,B01,494100,Chow; Bennett,19,0,30,11
1713313654906,MATH 142A,B02,494101,Chow; Bennett,29,0,30,1
1713313656960,MATH 168A,A01,516677,Dumitriu; Ioana,15,0,35,20
1713313657985,MATH 170A,A01,516679,Dumitriu; Ioana,20,0,30,10
1713313657985,MATH 170A,A02,516680,Dumitriu; Ioana,28,0,30,2
1713313659015,MATH 193A,A01,494107,Staff,16,0,30,14
1713313659015,MATH 193A,A02,494108,Staff,21,0,30,9
1713313659015,MATH 193A,A03,494109,Staff,29,0,30,1
1713313659015,MATH 193A,A04,494110,Staff,22,0,30,8
1713313662149,MGT 16,A00,491930,McKay; Michael J,92,0,98,6
1713313663175,MGT 18,A00,491992,McKay; Michael J,97,0,98,1
1713313664202,MGT 71,A00,492003,Staff,77,0,98,21
1713313665231,MGT 103,A00,505209,Eberhard; Craig A,85,0,98,13
1713313666257,MGT 131A,A00,505210,Anderson; John Charles,91,0,98,7
1713313668306,MGT 153,A00,492077,Perols; Johan Lars,40,0,90,50
1713313671390,MGT 164,A00,492222,McKay; Mary A,93,0,98,5
1713313672421,MGT 172,A00,492245,Staff,59,0,60,1
1713313672421,MGT 172,B00,505526,Hedges; Kathleen,75,0,98,23
1713313673446,MGT 181,A00,505669,Dunn; Louis Jean,87,0,98,11
1713313674474,MMW 14,A01,494399,Staff,23,0,28,5
1713313674474,MMW 14,A02,494400,Staff,25,0,28,3
1713313674474,MMW 14,A03,494401,Staff,28,0,28,0
1713313674474,MMW 14,A04,494402,Staff,28,0,28,0
1713313674474,MMW 14,B01,494404,Carreras; Maria Victoria,13,0,28,15
1713313674474,MMW 14,B02,494405,Carreras; Maria Victoria,26,0,28,2
1713313674474,MMW 14,B03,494406,Carreras; Maria Victoria,28,0,28,0
1713313674474,MMW 14,B04,494407,Carreras; Maria Victoria,28,0,28,0
1713313675499,MMW 14GS,A00,506250,Chang; Edmond Yi-Teh,0,0,0,0
1713313676525,MMW 121R,A01,494415,Adamiak; Patrick John,14,0,28,14
1713313676525,MMW 121R,A02,494416,Adamiak; Patrick John,25,0,28,3
1713313677554,MUS 1A,A01,494113,Staff,12,0,25,13
1713313677554,MUS 1A,A02,494114,Staff,25,0,25,0
1713313678583,MUS 4,A01,494116,Staff,24,0,25,1
1713313678583,MUS 4,A02,494117,Staff,22,0,25,3
1713313679609,MUS 5R,A01,494236,Dubnov; Shlomo,11,0,25,14
1713313679609,MUS 5R,A02,494237,Dubnov; Shlomo,25,0,25,0
1713313680636,MUS 6,A01,494122,Staff,13,0,25,12
1713313680636,MUS 6,A02,494123,Staff,24,0,25,1
1713313681662,MUS 7,A01,494125,Staff,17,0,25,8
1713313681662,MUS 7,A02,494126,Staff,24,0,25,1
1713313682691,MUS 11,A01,494128,Staff,23,0,25,2
1713313682691,MUS 11,A02,494129,Staff,25,0,25,0
1713313683717,MUS 13,A01,494131,Staff,25,0,25,0
1713313683717,MUS 13,A02,494132,Staff,25,0,25,0
1713313684743,MUS 15,A01,494134,Staff,18,0,25,7
1713313684743,MUS 15,A02,494135,Staff,25,0,25,0
1713313684743,MUS 15,B01,494137,Staff,24,0,25,1
1713313685774,MUS 80,A00,494232,Staff,24,0,25,1
1713313685774,MUS 80,B00,494233,Staff,25,0,25,0
1713313685774,MUS 80,C00,494234,Staff,23,0,25,2
1713313686802,MUS 95C,A00,494141,Staff,72,0,75,3
1713313687828,MUS 114,A00,494142,Staff,41,0,50,9
1713313688855,NANO 15,A01,490636,Drews; Aaron,7,0,7,0
1713313689880,PHIL 1,A00,490578,Grush; Rick Scott,49,0,50,1
1713313690905,PHIL 10,A01,490580,Grush; Rick Scott,33,0,35,2
1713313690905,PHIL 10,A02,490586,Grush; Rick Scott,33,0,35,2
1713313691932,PHIL 27,A01,490591,Staff,24,0,25,1
1713313691932,PHIL 27,A02,490592,Staff,25,0,25,0
1713313691932,PHIL 27,A03,490593,Staff,25,0,25,0
1713313691932,PHIL 27,A04,490598,Staff,25,0,25,0
1713313692960,PHIL 32,A01,490611,Staff,20,0,20,0
1713313692960,PHIL 32,A02,490618,Staff,20,0,20,0
1713313693985,PHIL 90,A00,490624,Staff,40,0,40,0
1713313695012,PHIL 136,A00,490627,Cohen; Jonathan David,38,0,40,2
1713313696040,PHIL 155,A00,490634,Staff,64,0,70,6
1713313697069,PHYS 1A,A00,491610,Staff,246,0,250,4
1713313698094,PHYS 1AL,001,491616,Tsai; Philbert S,28,0,30,2
1713313698094,PHYS 1AL,002,491618,Tsai; Philbert S,30,0,30,0
1713313699121,PHYS 1B,A00,491623,Staff,244,0,250,6
1713313700147,PHYS 1BL,001,491626,Tsai; Philbert S,26,0,30,4
1713313700147,PHYS 1BL,002,491628,Tsai; Philbert S,28,0,30,2
1713313701172,PHYS 1C,A00,491632,Staff,221,0,245,24
1713313702201,PHYS 1CL,001,491635,Tsai; Philbert S,11,0,30,19
1713313702201,PHYS 1CL,002,491643,Tsai; Philbert S,24,0,30,6
1713313703230,PHYS 2AR,A01,491651,Meyertholen; Andrew D.,45,0,50,5
1713313704255,PHYS 2B,A01,491659,Staff,106,0,115,9
1713313705284,PHYS 2BL,A01,491685,Staff,21,0,24,3
1713313705284,PHYS 2BL,A02,491700,Staff,23,0,24,1
1713313706313,PHYS 2C,A01,505161,Staff,107,0,115,8
1713313707338,PHYS 4A,A01,491704,Grinstein; Benjamin,99,0,100,1
1713313708368,POLI 5D,A01,494144,Staff,3,0,5,2
1713313708368,POLI 5D,B01,626283,Dai; Yinlin,5,0,5,0
1713313709396,POLI 12,A00,494145,Staff,44,0,45,1
1713313710422,POLI 13R,A00,494146,Forman; Fonna,45,0,50,5
1713313711447,POLI 27,A01,494148,Staff,57,0,60,3
1713313712472,POLI 30,A00,494149,Staff,49,0,50,1
1713313713496,POLI 100DA,A00,494150,Staff,22,0,25,3
1713313715549,POLI 100I,A00,494152,Staff,28,0,30,2
1713313716575,POLI 104B,A00,494153,Smith; Glenn Chatmas,54,0,55,1
1713313717604,POLI 104F,A00,494154,Staff,28,0,30,2
1713313718630,POLI 104I,A00,494155,Smith; Glenn Chatmas,30,0,30,0
1713313719656,POLI 110C,A00,494156,Ingham; Sean,23,0,25,2
1713313720685,POLI 117R,A00,494157,Forman; Fonna,10,0,20,10
1713313721713,POLI 118,A00,494158,Ingham; Sean,22,0,25,3
1713313722738,POLI 120H,A00,494159,Fisk; David Lee,41,0,45,4
1713313723764,POLI 131CR,A00,494160,Hoston; Germaine,37,0,45,8
1713313724789,POLI 133J,A00,494161,Staff,33,0,35,2
1713313725817,POLI 135,A00,494162,Fisk; David Lee,33,0,35,2
1713313726842,POLI 140A,A00,494164,Staff,22,0,30,8
1713313727866,POLI 142I,A00,494165,Staff,30,0,30,0
1713313728893,POLI 144D,A00,494166,Staff,23,0,25,2
1713313729921,POLI 151,A00,494167,Staff,30,0,30,0
1713313730946,POLI 153,A00,494168,Staff,33,0,35,2
1713313731971,POLI 160AA,A00,494169,Staff,35,0,40,5
1713313732995,POLI 162,A00,494170,Mignozzetti; Umberto,20,0,25,5
1713313734020,POLI 171,A00,494171,Mignozzetti; Umberto,21,0,25,4
1713313735044,PSYC 1,A00,494172,Staff,97,0,100,3
1713313736071,PSYC 2,A00,494173,Moranton; Nirelia Melbina-,43,0,50,7
1713313737099,PSYC 3,A00,494174,Staff,29,0,30,1
1713313738123,PSYC 6,A00,494175,Staff,17,0,20,3
1713313739149,PSYC 60,A01,494177,Staff,39,0,45,6
1713313740175,PSYC 70,A01,505724,Geller; Emma Harlan,42,0,45,3
1713313741201,PSYC 101,A00,494180,Heyman; Gail D.,87,0,100,13
1713313742232,PSYC 105,A00,494181,Geller; Emma Harlan,63,0,90,27
1713313743261,PSYC 106,A00,494182,Dobkins; Karen R.,32,0,45,13
1713313744292,PSYC 108,A00,494183,Adrian; Julia Anna,93,0,100,7
1713313745317,PSYC 114,A01,494185,Winkielman; Piotr,1,0,30,29
1713313746340,PSYC 122,A00,494186,Moranton; Nirelia Melbina-,37,0,50,13
1713313747367,PSYC 124,A00,494187,Chapman; Eddie Nathaniel,72,0,80,8
1713313748393,PSYC 131,A00,494188,Anagnostaras; Stephan,55,0,80,25
1713313749418,PSYC 144,A00,494189,Staff,14,0,50,36
1713313750442,PSYC 154,A00,494190,Lacefield; Katharine I,132,0,180,48
1713313751471,PSYC 162,A00,494191,Wixted; John T,82,0,100,18
1713313752498,PSYC 172,A00,494192,Gorman; Michael R.,37,0,45,8
1713313753524,PSYC 178,A00,494193,Glaser; Dale,40,0,45,5
1713313754551,PSYC 193,A00,505725,Chapman; Eddie Nathaniel,20,0,20,0
1713313755580,RELI 145GS,A00,519817,Rahimi; Babak,18,0,20,2
1713313756609,SE 101A,A01,490862,Chadha; Mayank,23,0,25,2
1713313757639,SE 101C,A01,490924,Krysl; Petr,18,0,20,2
1713313758668,SE 110A,A01,490928,Staff,19,0,20,1
1713313759694,SE 130A,A00,490929,Morrison; Machel Leigh,62,0,70,8
1713313760722,SIO 1,A01,519325,Staff,39,0,40,1
1713313761750,SIO 30,A01,519327,Staff,39,0,40,1
1713313762774,SIO 40,A00,519328,Staff,40,0,40,0
1713313763803,SIO 46GS,A00,519819,Cook; Geoffrey W,18,0,25,7
1713313764829,SIO 109R,A00,494197,Forman; Fonna,4,0,20,16
1713313765910,SIO 121GS,A00,519827,Cook; Geoffrey W,18,0,25,7
1713313766939,SIO 132,A01,519330,Staff,38,0,40,2
1713313767962,SIO 133,A01,519397,Staff,38,0,40,2
1713313768989,SIO 139,A00,519396,Kacev; David,33,0,40,7
1713313770021,SOCI 1,A01,494199,Thorpe; Charles Robert,23,0,30,7
1713313770021,SOCI 1,A02,494200,Thorpe; Charles Robert,30,0,30,0
1713313770021,SOCI 1,A03,494201,Thorpe; Charles Robert,29,0,30,1
1713313770021,SOCI 1,A04,494202,Thorpe; Charles Robert,29,0,30,1
1713313770021,SOCI 1,A05,494203,Thorpe; Charles Robert,29,0,30,1
1713313770021,SOCI 1,A06,494204,Thorpe; Charles Robert,30,0,30,0
1713313770021,SOCI 1,A07,494205,Thorpe; Charles Robert,29,0,30,1
1713313771047,SOCI 60,A01,494207,Staff,36,0,40,4
1713313771047,SOCI 60,A02,494208,Staff,39,0,40,1
1713313772080,SOCI 100,A01,494210,Payne; Christine Anna,27,0,30,3
1713313772080,SOCI 100,A02,494211,Payne; Christine Anna,27,0,30,3
1713313773106,SOCI 109M,A00,494212,Staff,20,0,20,0
1713313774129,SOCI 110,A00,494213,Staff,35,0,40,5
1713313776189,SOCI 118E,A00,494215,Ng; Kwai,38,0,40,2
1713313777215,SOCI 125,A00,494216,Calderon-Zaks; Michael Aar,42,0,45,3
1713313778242,SOCI 126,A01,494218,Jones; Makeba,4,0,5,1
1713313779271,SOCI 131,A00,494219,Thorpe; Charles Robert,28,0,30,2
1713313781322,SOCI 135,A00,494221,Payne; Christine Anna,34,0,50,16
1713313782347,SOCI 136E,A00,626690,Ruiz; Jonathan Joseph,25,0,25,0
1713313783371,SOCI 138GS,A00,494222,Navon; Daniel,24,0,28,4
1713313785420,SOCI 145,A00,494224,Staff,42,0,45,3
1713313786449,SOCI 153,A00,494225,Staff,28,0,30,2
1713313787473,SOCI 160E,A00,494226,Ng; Kwai,33,0,40,7
1713313788498,SOCI 180,A00,494227,Staff,29,0,30,1
1713313789525,SOCI 189GS,A00,494228,Ribas Norris; Janet Vanesa,11,0,11,0
1713313790551,SOCI 190GS,A00,553232,Ribas Norris; Janet Vanesa,11,0,11,0
1713313791582,SOMI 220,A00,627178,Schneid; Stephen David,30,0,30,0
1713313792611,SYN 2,001,490768,Staff,14,0,15,1
1713313792611,SYN 2,002,490769,Staff,15,0,15,0
1713313792611,SYN 2,004,490775,Staff,0,0,0,0
1713313792611,SYN 2,003,490774,Staff,0,0,0,0
1713313792611,SYN 2,005,490776,Staff,0,0,0,0
1713313793638,SYN 2R,001,490779,Staff,13,0,15,2
1713313793638,SYN 2R,002,514635,Staff,14,0,15,1
1713313794667,SYN 100,A01,490783,Staff,15,0,20,5
1713313794667,SYN 100,B01,490787,Staff,10,0,20,10
1713313794667,SYN 100,C01,490789,Staff,12,0,20,8
1713313795693,SYN 150,A00,490817,Staff,14,0,15,1
1713313795693,SYN 150,B00,514610,Staff,15,0,15,0
1713313796720,TDAC 1,A00,492753,Walsh; Kim C.,19,0,20,1
1713313796720,TDAC 1,B00,492754,Harting; Carla Kelso,19,0,20,1
1713313796720,TDAC 1,C00,513995,Salovey; Todd,17,0,20,3
1713313797748,TDAC 101,A00,492766,Harting; Carla Kelso,17,0,20,3
1713313798774,TDAC 102,A00,492768,Basso; Beatrice,19,0,20,1
1713313799798,TDDE 111,A00,492769,Staff,25,0,25,0
1713313800828,TDDE 131,A00,492770,Staff,15,0,15,0
1713313800828,TDDE 131,B00,492771,Staff,15,0,15,0
1713313801854,TDDE 131GS,A00,523716,Guirguis; Mark C,24,0,28,4
1713313802877,TDGE 1,A01,492756,Salovey; Todd,57,0,60,3
1713313803905,TDGE 5,A01,492758,Staff,24,0,25,1
1713313804935,TDGE 10,A00,492759,Fulton; Julia,209,0,220,11
1713313805965,TDGE 11,A00,492760,Castro; Robert Jess,200,0,200,0
1713313808015,TDGE 124,A00,492772,Fulton; Julia,192,0,220,28
1713313809049,TDGE 125,A00,492773,Meyer; Ursula,40,0,50,10
1713313809049,TDGE 125,B00,492774,Staff,50,0,50,0
1713313809049,TDGE 125,C00,523565,Staff,49,0,50,1
1713313810077,TDGE 125GS,A00,523580,Guirguis; Mark C,24,0,28,4
1713313811102,TDGE 127,A00,492775,Havis; Allan,41,0,50,9
1713313812127,TDHT 101,A00,492776,Staff,35,0,35,0
1713313813158,TDMV 1,A00,492762,Caligagan; Maria T.,30,0,30,0
1713313813158,TDMV 1,B00,492763,Arcidiacono; Kristin,25,0,30,5
1713313814182,TDMV 2,A00,492764,Weinberg; Sadie,29,0,30,1
1713313815211,TDMV 3,A00,492765,Mack; Kara Shanai',39,0,40,1
1713313816241,TDMV 138,A00,492777,Mack; Kara Shanai',36,0,40,4
1713313817267,TDMV 140,A00,492778,Lima; Paulo Henrique,40,0,40,0
1713313818293,TDMV 142,A00,492779,Caligagan; Maria T.,36,0,40,4
1713313818293,TDMV 142,B00,492780,Caligagan; Tony,37,0,40,3
1713313819321,TDMV 143,A00,492781,Fyall; Daunte Edward,39,0,40,1
1713313820350,USP 1,A01,492401,Kwak; Nancy,26,0,35,9
1713313821376,USP 2,A01,492453,Hinds; Juli Beth,35,0,35,0
1713313822400,USP 3,A01,492516,Staff,29,0,35,6
1713313823429,USP 4,A00,492522,McTague; Sarah,19,0,25,6
1713313824452,USP 100,A00,492523,Staff,33,0,35,2
1713313825477,USP 101,A00,492524,Staff,13,0,15,2
1713313826506,USP 105,A00,492525,Staff,21,0,25,4
1713313827534,USP 151,A00,492526,Shenkman; Michael Thomas,33,0,35,2
1713313828559,USP 170,A00,492545,Hinds; Juli Beth,33,0,35,2
1713313829584,USP 171GS,A00,492608,Bussell; Mirle Rabinowitz,25,0,28,3
1713313830612,USP 183GS,A00,492613,Peerson; Susan,25,0,28,3
1713313831642,VIS 30,A01,490693,Yoldas; Pinar,21,0,22,1
1713313831642,VIS 30,A02,490694,Yoldas; Pinar,19,0,22,3
1713313832666,VIS 83,A00,490695,Kester; Grant,66,0,75,9
1713313833694,VIS 105D,A00,490696,Staff,22,0,25,3
1713313834718,VIS 124CN,A00,490699,Rose; Jordan M,68,0,75,7
1713313835747,VIS 125GS,A00,511221,Williams; Alena J,21,0,22,1
1713313836773,VIS 128D,A00,490700,Staff,74,0,75,1
1713313837799,VIS 151,A01,490717,Staff,33,0,34,1
1713313837799,VIS 151,A02,490766,Staff,33,0,34,1
1713313838824,VIS 154GS,A00,511972,Williams; Alena J,21,0,22,1
1713313839849,VIS 160A,A00,490767,Stone; Patricia,7,0,10,3
1713313840874,WCWP 10A,A00,490638,Staff,14,0,15,1
1713313840874,WCWP 10A,B00,490640,Staff,15,0,15,0
1713313841898,WCWP 10B,A00,490641,Staff,0,0,0,0
1713313841898,WCWP 10B,B00,490642,Staff,14,0,15,1
1713313841898,WCWP 10B,C00,490644,Staff,13,0,15,2
1713313841898,WCWP 10B,D00,490647,Staff,0,0,0,0
1713313842922,WCWP 100,A00,490655,Staff,0,0,0,0
1713313842922,WCWP 100,B00,490687,Staff,12,0,15,3
1713313845013,ANAR 153,A00,487222,Braswell; Geoffrey E.,54,0,60,6
1713313846038,ANBI 134,A00,487223,Staff,12,0,20,8
1713313847062,ANBI 143GS,A00,487224,Noel; Geoffroy Pierre Jean,20,0,24,4
1713313848087,ANBI 144GS,A00,519548,Noel; Geoffroy Pierre Jean,20,0,24,4
1713313849115,ANSC 101,A00,487225,Staff,19,0,20,1
1713313850166,ANSC 125,A00,487227,Brenner; Suzanne A,39,0,40,1
1713313852219,ANSC 146,A00,487229,Staff,36,0,40,4
1713313853244,ANSC 148,A00,487230,Olivas Hernandez; Olga Lid,39,0,40,1
1713313854269,ANSC 150,A00,504165,Sloane; Julia Kathryn,19,0,20,1
1713313855295,ANSC 180,A00,487232,Staff,13,0,15,2
1713313856321,ANSC 188,A00,627155,Staff,40,0,40,0
1713313857347,ANTH 5,A00,519529,Semendeferi; Ekaterini,15,0,15,0
1713313858373,ANTH 10,A00,487219,Staff,58,0,60,2
1713313859402,ANTH 23,A01,487221,Staff,17,0,20,3
1713313860428,ANTH 102,A00,487233,Wilder; Linnea Lorene,51,0,60,9
1713313861454,ANTH 103,A00,487234,Varma; Saiba,56,0,60,4
1713313862484,ANTH 105,A00,487235,Stewart; Alexander B,56,0,60,4
1713313863509,BENG 100,A01,516685,Taylor Amos; Alyssa C,28,0,30,2
1713313864536,BIBC 102,A01,491316,Flagg; Matthew Paul,37,0,88,51
1713313864536,BIBC 102,A02,491366,Flagg; Matthew Paul,83,0,88,5
1713313865567,BIBC 103,A01,491486,Boumechache; Miyyada,16,0,24,8
1713313865567,BIBC 103,A02,491487,Boumechache; Miyyada,24,0,24,0
1713313866593,BICD 100,A01,516882,Staff,75,0,75,0
1713313866593,BICD 100,A02,516890,Staff,70,0,75,5
1713313867618,BICD 102GS,A00,491488,Lo; Stanley M.,26,0,28,2
1713313868648,BIEB 136GS,A00,516940,Holway; David A. & Shurin; Jonathan,19,0,24,5
1713313869729,BIEB 137GS,A01,517034,Holway; David A. & Shurin; Jonathan,19,0,24,5
1713313870757,BIEB 138GS,A01,491492,Pirino; Giorgia,21,0,28,7
1713313871783,BILD 1,A01,491296,Staff,62,0,63,1
1713313871783,BILD 1,A02,491297,Staff,63,0,63,0
1713313872815,BILD 4,A01,517099,Gonzalez Gamboa; Ivonne,22,0,24,2
1713313872815,BILD 4,A02,517100,Gonzalez Gamboa; Ivonne,24,0,24,0
1713313873840,BILD 60GS,A00,491309,Lo; Stanley M.,26,0,28,2
1713313874872,BIMM 100,A01,517136,Staff,90,0,100,10
1713313875906,BIMM 110,A01,517182,Staff,69,0,100,31
1713313876937,BIMM 120,A01,517228,Pickett; Brooke Elizabeth,39,0,63,24
1713313876937,BIMM 120,A02,517240,Pickett; Brooke Elizabeth,48,0,63,15
1713313877962,BIMM 132GS,A01,491498,Pirino; Giorgia,21,0,28,7
1713313878989,BIMM 143,A01,491589,Bozinovic; Goran,18,0,40,22
1713313880015,BIPN 100,A01,491594,Armour; Jon Christopher,91,0,100,9
1713313881041,BIPN 140,A01,491602,Marino; Marc J,29,0,50,21
1713313883127,CAT 125,A00,515973,Staff,20,0,20,0
1713313884155,CAT 125GS,A00,515974,Rahimi; Babak,18,0,20,2
1713313885186,CAT 125R,A00,515980,Staff,14,0,20,6
1713313885186,CAT 125R,B00,515981,Tosun; Adriana,19,0,20,1
1713313885186,CAT 125R,C00,515987,Hyland; Tina Mae,2,0,20,18
1713313885186,CAT 125R,D00,515988,Bronstein; Phoebe Malan,18,0,20,2
1713313886216,CENG 15,A01,488699,Drews; Aaron,25,0,25,0
1713313887244,CENG 100,A00,505196,Opatkiewicz; Justin Paul,25,0,25,0
1713313888269,CGS 2A,A01,489598,Staff,33,0,35,2
1713313889294,CGS 112,A00,489599,Staff,15,0,15,0
1713313890318,CGS 119,A00,489603,Staff,10,0,10,0
1713313891346,CGS 120,A00,489604,Staff,14,0,15,1
1713313892370,CGS 150,A00,489607,Staff,15,0,15,0
1713313893398,CHEM 6A,A01,488715,Staff,98,0,100,2
1713313894423,CHEM 6B,A01,488719,Piercy; Marc Anthony,100,0,100,0
1713313895451,CHEM 6C,A01,488723,Albizati; Kim F.,94,0,100,6
1713313896484,CHEM 7L,A01,488728,Schurmeier; Kimberly,18,0,24,6
1713313896484,CHEM 7L,A02,488730,Schurmeier; Kimberly,23,0,24,1
1713313896484,CHEM 7L,A03,488734,Schurmeier; Kimberly,23,0,24,1
1713313896484,CHEM 7L,A04,488763,Schurmeier; Kimberly,23,0,24,1
1713313896484,CHEM 7L,B01,488798,Schurmeier; Kimberly,18,0,24,6
1713313896484,CHEM 7L,B02,488801,Schurmeier; Kimberly,23,0,24,1
1713313896484,CHEM 7L,B03,488808,Schurmeier; Kimberly,24,0,24,0
1713313896484,CHEM 7L,B04,488811,Schurmeier; Kimberly,24,0,24,0
1713313897512,CHEM 11,A01,488897,Stallings; Dontarie M,98,0,100,2
1713313898537,CHEM 40A,A01,488913,Albizati; Kim F.,90,0,100,10
1713313899563,CHEM 40B,A01,488920,Weizman; Haim,47,0,50,3
1713313899563,CHEM 40B,A02,488938,Weizman; Haim,46,0,50,4
1713313900589,CHEM 41A,A01,489029,Klosterman; Jeremy K,58,0,60,2
1713313901615,CHEM 41C,A01,500436,Tor; Yitzhak,55,0,60,5
1713313902641,CHEM 43A,A01,500426,Weizman; Haim,2,0,24,22
1713313902641,CHEM 43A,A02,500430,Weizman; Haim,13,0,24,11
1713313902641,CHEM 43A,B01,514041,Klosterman; Jeremy K,15,0,24,9
1713313902641,CHEM 43A,B02,514047,Klosterman; Jeremy K,23,0,24,1
1713313903667,CHEM 108,A01,489140,Jennings; Patricia A.,13,0,24,11
1713313903667,CHEM 108,A02,489142,Jennings; Patricia A.,15,0,24,9
1713313904694,CHEM 114A,A01,489147,Stallings; Dontarie M,78,0,100,22
1713313905719,CHIN 169A,A00,489171,Wang; Xiao,19,0,20,1
1713313907770,COGS 3,A01,518827,Boyle; Mary E. T.,29,0,40,11
1713313908800,COGS 11,A01,489175,Staff,28,0,30,2
1713313909827,COGS 14A,A01,518829,Staff,51,0,60,9
1713313910852,COGS 14B,A01,489177,Hoffman; Drew Ellen,69,0,75,6
1713313911882,COGS 100,A01,489181,Allen; Michael Gordon,66,0,75,9
1713313912908,COGS 101A,A01,489183,Staff,48,0,60,12
1713313913936,COGS 101B,A01,489185,Allen; Michael Gordon,12,0,30,18
1713313914963,COGS 101C,A01,526786,Staff,24,0,30,6
1713313917014,COGS 107A,A01,489189,Boyle; Mary E. T.,20,0,35,15
1713313918045,COGS 107B,A01,627144,Mooshagian; Eric Frederick,60,0,60,0
1713313919071,COGS 118A,A01,489191,Staff,0,33,40,40
1713313921125,COGS 171GS,A01,489194,Pineda; Jaime A,22,0,28,6
1713313922152,COGS 172,A01,489196,Staff,4,0,30,26
1713313923178,COGS 174GS,A01,489264,Pineda; Jaime A,22,0,28,6
1713313924201,COGS 180,A01,627150,Staff,28,0,30,2
1713313925228,COGS 186,A01,489274,Staff,2,0,30,28
1713313926254,COMM 10,A01,489276,Staff,23,0,25,2
1713313926254,COMM 10,A02,489303,Staff,23,0,25,2
1713313927279,COMM 100A,A01,489312,Staff,16,0,25,9
1713313927279,COMM 100A,A02,489313,Staff,24,0,25,1
1713313928305,COMM 106T,A00,512540,Staff,34,0,35,1
1713313929329,COMM 107,A00,489347,Staff,31,0,35,4
1713313930357,COMM 109P,A00,489358,Staff,31,0,35,4
1713313931384,COMM 132,A00,489361,McKenna; Denise,28,0,30,2
1713313932413,COMM 146,A00,489362,Halm; Gavin Patrick,27,0,30,3
1713313933441,COMM 190,A00,489363,Abuelhiga; Soraya Jill,20,0,23,3
1713313934473,CSE 8A,A50,489366,Staff,22,0,25,3
1713313934473,CSE 8A,A51,489367,Staff,24,0,25,1
1713313935501,CSE 11,A01,489398,Cao; Yingjun,79,0,100,21
1713313936530,CSE 12,A01,489487,Staff,43,0,50,7
1713313937554,CSE 20,A01,489497,Staff,48,0,50,2
1713313938583,CSE 21,A01,489517,Braun; Oliver,44,0,50,6
1713313939611,CSE 101,A01,489524,Braun; Oliver,0,15,50,50
1713313940637,CSE 105,A01,512594,Jones; Miles E,80,0,100,20
1713313940637,CSE 105,B01,512598,Jones; Miles E,61,0,100,39
1713313941662,CSE 140,A01,489538,Staff,44,0,50,6
1713313942689,CSE 141,A01,489550,Eldon; John,75,0,100,25
1713313943715,CSE 141L,A01,489571,Eldon; John,73,0,100,27
1713313944746,CSE 151A,A01,489583,Solares; Edwin A,149,0,200,51
1713313945775,CSE 175,A01,510886,Kumar; Rakesh,30,0,30,0
1713313946806,CSE 190,A00,516828,Dubnov; Shlomo,41,0,49,8
1713313947830,DOC 100D,A00,489667,Pass; Natalye Joann,21,0,25,4
1713313948859,DSC 10,A01,624268,Staff,72,0,75,3
1713313949884,DSC 20,A01,624476,Staff,50,0,50,0
1713313950912,DSC 40A,A01,624608,Staff,40,0,40,0
1713313951937,DSGN 1,A01,489179,Rill; Bryan,36,0,50,14
1713313952962,ECE 17,A01,490489,Sahay; Rajeev,18,0,30,12
1713313953987,ECE 65,A50,490492,Staff,15,0,20,5
1713313953987,ECE 65,A51,490493,Staff,20,0,20,0
1713313955014,ECON 1,A01,489715,Famulari; Melissa,68,0,70,2
1713313956039,ECON 2,A01,489717,Levkoff; Steven B.,68,0,70,2
1713313957067,ECON 3,A01,489948,Staff,70,0,70,0
1713313959358,ECON 5,A01,490103,Staff,28,0,30,2
1713313959358,ECON 5,B01,626281,Dai; Yinlin,45,0,45,0
1713313960388,ECON 100A,A01,490127,Famulari; Melissa,68,0,70,2
1713313961417,ECON 100B,A01,490129,Staff,64,0,70,6
1713313962440,ECON 109,A01,490187,Shishkin; Denis,27,0,35,8
1713313963468,ECON 110A,A01,490190,Levkoff; Steven B.,62,0,70,8
1713313964494,ECON 120A,A01,490245,Dai; Yinlin,65,0,70,5
1713313965521,ECON 120B,A01,490247,Nieto-Barthaburu; Augusto,55,0,70,15
1713313966549,ECON 120C,A01,490253,Sun; Yixiao,30,0,35,5
1713313966549,ECON 120C,B01,490255,Sun; Yixiao,34,0,35,1
1713313967575,ECON 129,A00,490256,Eckert; Fabian Paul,25,0,35,10
1713313968602,ECON 131,A00,490257,Nieto-Barthaburu; Augusto,0,0,35,35
1713313969631,ECON 138,A00,490258,Bharadwaj; Prashant,19,0,35,16
1713313969631,ECON 138,B00,490259,Bharadwaj; Prashant,17,0,35,18
1713313970661,ECON 159,A00,490260,Hendrickson; Gerald M.,0,8,0,0
1713313971687,ECON 178,A01,553995,Zhu; Ying,26,0,35,9
1713313972719,EDS 40,A01,512576,Black; Alison Michelle,20,0,20,0
1713313973801,EDS 107,A01,515848,Staff,30,0,30,0
1713313974830,EDS 110R,A01,490262,Staff,26,0,30,4
1713313975856,EDS 112,A01,490264,Chapman; Thandeka K,43,0,50,7
1713313976882,EDS 113,A00,490266,Staff,26,0,30,4
1713313977911,EDS 118,A00,490267,Warstadt; Melissa Fawn,25,0,30,5
1713313978939,EDS 124BR,A00,490268,Eguchi; Emi,8,0,25,17
1713313978939,EDS 124BR,B00,490269,Eguchi; Emi,25,0,25,0
1713313979969,EDS 126,A01,490271,Jones; Makeba,44,0,50,6
1713313980994,EDS 135,A01,490316,Staff,19,0,20,1
1713313982024,ENVR 142GS,A00,519514,Chang; Edmond Yi-Teh,28,0,28,0
1713313983049,ETHN 103,A00,490504,Staff,31,0,36,5
1713313984076,ETHN 103A,A00,490505,Man; Simeon S,5,0,9,4
1713313985101,ETHN 109,A00,490506,Staff,30,0,30,0
1713313986125,ETHN 118,A00,490507,Staff,35,0,36,1
1713313987151,ETHN 119,A00,490508,Staff,34,0,36,2
1713313988176,ETHN 121R,A00,490518,Choi; Esther Min,27,0,36,9
1713313989203,ETHN 127,A00,490528,Staff,15,0,15,0
1713313990229,ETHN 139,A00,490573,Staff,10,0,10,0
1713313991253,ETHN 150,A00,490575,Staff,15,0,15,0
1713313992281,GLBH 20,A00,491705,Elwardani; Nile Regina,38,0,40,2
1713313993305,GLBH 101,A00,491706,Staff,20,0,20,0
1713313994335,GLBH 111,A01,491708,Burgos; Jose L.,15,0,15,0
1713313995359,GLBH 146,A00,491709,Staff,11,0,20,9
1713313996388,GLBH 148,A00,491710,Olivas Hernandez; Olga Lid,14,0,20,6
1713313997415,GLBH 150,A00,491711,Sloane; Julia Kathryn,20,0,20,0
1713313998442,HIEA 131,A00,491760,Staff,29,0,32,3
1713313999468,HIEA 153,A00,491762,Staff,29,0,30,1
1713314000494,HIEU 124,A00,491811,Staff,26,0,32,6
1713314001521,HIEU 124GS,A00,491812,Markman; Kristina,27,0,28,1
1713314002546,HIEU 147,A00,491813,Staff,30,0,32,2
1713314003576,HIEU 149GS,A00,491816,Caldwell; Michael Alan,28,0,28,0
1713314004602,HILD 2C,A01,491713,Hendrickson; Gerald M.,27,0,30,3
1713314005631,HILD 7B,A01,491715,Kwak; Nancy,7,0,30,23
1713314006655,HILD 10,A01,491717,Staff,12,0,20,8
1713314007681,HILD 30GS,A00,491719,Edington; Claire Ellen,24,0,28,4
1713314008709,HINE 109,A00,491818,Shafir; Nir,28,0,32,4
1713314009733,HINE 128,A00,491821,Shafir; Nir,31,0,32,1
1713314010760,HISC 117,A00,491830,Staff,29,0,32,3
1713314011785,HIUS 103,A00,491834,Man; Simeon S,15,0,23,8
1713314012814,HIUS 108B,A00,491835,Staff,29,0,30,1
1713314013840,HIUS 141,A00,491836,Hendrickson; Gerald M.,29,0,32,3
1713314014864,HIUS 149,A00,491839,Staff,27,0,32,5
1713314015890,HUM 3,A01,512617,Crum; Matthew Stephen,45,0,50,5
1713314015890,HUM 3,A02,512618,Crum; Matthew Stephen,48,0,50,2
1713314016915,HUM 3GS,A00,512663,Markman; Kristina,0,0,0,1
1713314016915,HUM 3GS,B00,512664,Staff,0,0,0,0
1713314017941,HUM 4,A01,512620,West; Geoffrey Scott,31,0,50,19
1713314018968,HUM 4GS,A00,512666,Lyon; Antony J.,0,0,0,3
1713314019996,HUM 4R,A01,512625,Watkins; Eric,49,0,50,1
1713314021021,HUM 5,A01,512649,Zavodny; Tatiana Sophia,30,0,50,20
1713314021021,HUM 5,B01,512661,Zroka; Ryan Edward,48,0,50,2
1713314022051,INTL 190,A00,490577,Segui; Alan S,0,0,0,5
1713314023077,JAPN 20AR,A01,491267,Ross; Kayoko F,10,0,20,10
1713314024103,JAPN 180,A00,491285,Berman; Michael David,34,0,40,6
1713314025130,LATI 50,A01,502536,Kokinis; Troy Andreas,16,0,22,6
1713314025130,LATI 50,A02,502551,Kokinis; Troy Andreas,22,0,22,0
1713314025130,LATI 50,A03,502650,Kokinis; Troy Andreas,22,0,22,0
1713314025130,LATI 50,A04,502909,Kokinis; Troy Andreas,22,0,22,0
1713314026157,LATI 160,A01,502920,Kokinis; Troy Andreas,30,0,30,0
1713314027183,LIFR 1A,A00,490494,Van Moer; Vinciane G,17,0,20,3
1713314028212,LIFR 1AX,A00,490495,Van Moer; Vinciane G,17,0,20,3
1713314029239,LIFR 1B,A00,490496,Van Moer; Vinciane G,19,0,20,1
1713314030265,LIFR 1BX,A00,490497,Van Moer; Vinciane G,19,0,20,1
1713314031292,LIGN 8,A00,505198,McIntosh; Justin Daniel,136,0,150,14
1713314032317,LIGN 9GS,A00,491239,Lott; Margaret S.,18,0,20,2
1713314033342,LIGN 101,A01,505200,McIntosh; Justin Daniel,24,0,30,6
1713314034366,LIGN 120,A01,491244,Staff,24,0,30,6
1713314035393,LIGN 149GS,A00,491245,Lott; Margaret S.,18,0,20,2
1713314036421,LIGN 170,A00,491247,Staff,24,0,30,6
1713314037447,LISP 1D,A00,490498,Munoz Sanchez; Alicia,10,0,14,4
1713314037447,LISP 1D,B00,490499,Munoz Sanchez; Alicia,6,0,14,8
1713314037447,LISP 1D,C00,490500,Munoz Sanchez; Alicia,8,0,14,6
1713314037447,LISP 1D,D00,490501,Munoz Sanchez; Alicia,10,0,14,4
1713314038475,LISP 1DX,A00,490502,Munoz Sanchez; Alicia,15,0,28,13
1713314038475,LISP 1DX,B00,490503,Munoz Sanchez; Alicia,17,0,28,11
1713314040528,LTAM 110,A00,491847,Staff,23,0,25,2
1713314041563,LTCS 119,A00,491848,Staff,12,0,15,3
1713314042587,LTCS 130,A00,491849,Staff,24,0,25,1
1713314044638,LTEA 120C,A00,491852,Staff,34,0,40,6
1713314045667,LTEN 130GS,A00,491853,Lyon; Antony J.,25,0,28,3
1713314046692,LTEN 148,A00,491855,Staff,23,0,25,2
1713314047721,LTEN 159,A00,491856,Staff,21,0,25,4
1713314048749,LTEN 180,A00,491857,Staff,9,0,15,6
1713314050802,LTSP 123GS,A00,505928,Bessett; Ryan Matthew,24,0,28,4
1713314051831,LTSP 174GS,A00,506037,Bessett; Ryan Matthew,24,0,28,4
1713314053885,LTWR 102,A00,491861,Staff,11,0,15,4
1713314054910,LTWR 106,A00,491862,Staff,10,0,15,5
1713314055941,MAE 11,A00,490930,Bahadori; Mohammad Yousef,97,0,100,3
1713314056971,MAE 30A,A00,490931,Qi; Huihui,37,0,40,3
1713314057997,MAE 101A,A00,491036,Sadeghizadeh; Zahra,97,0,100,3
1713314059028,MAE 101C,A00,491037,Seshadri; Kalyanasundaram,76,0,100,24
1713314060056,MAE 113,A00,491040,Seshadri; Kalyanasundaram,66,0,80,14
1713314061081,MAE 131A,A00,491041,Ghazinejad; Maziar,39,0,40,1
1713314062111,MAE 142,A00,491053,Staff,39,0,40,1
1713314063136,MAE 143A,A00,491054,Staff,38,0,50,12
1713314064164,MAE 150,A00,491092,Truong; Phuong Thi Ngoc,23,0,35,12
1713314065195,MATH 3C,A01,494031,Pardo Guerra; Sebastian,30,0,30,0
1713314065195,MATH 3C,A02,494032,Pardo Guerra; Sebastian,29,0,30,1
1713314066226,MATH 10A,A01,494034,Staff,27,0,30,3
1713314066226,MATH 10A,A02,494035,Staff,29,0,30,1
1713314066226,MATH 10A,B01,494037,Staff,27,0,30,3
1713314066226,MATH 10A,B02,494038,Staff,29,0,30,1
1713314067254,MATH 10B,A01,494040,Habib; Yousaf,24,0,30,6
1713314067254,MATH 10B,A02,494041,Habib; Yousaf,28,0,30,2
1713314067254,MATH 10B,A03,494042,Habib; Yousaf,30,0,30,0
1713314067254,MATH 10B,A04,494043,Habib; Yousaf,30,0,30,0
1713314067254,MATH 10B,B01,494045,Habib; Yousaf,28,0,30,2
1713314067254,MATH 10B,B02,494046,Habib; Yousaf,30,0,30,0
1713314067254,MATH 10B,B03,494047,Habib; Yousaf,30,0,30,0
1713314067254,MATH 10B,B04,494048,Habib; Yousaf,30,0,30,0
1713314068282,MATH 18,A01,494050,Kemp; Todd Aahron,26,0,30,4
1713314068282,MATH 18,A02,494051,Kemp; Todd Aahron,29,0,30,1
1713314068282,MATH 18,B01,494054,Kemp; Todd Aahron,28,0,30,2
1713314068282,MATH 18,B02,494055,Kemp; Todd Aahron,29,0,30,1
1713314069307,MATH 20A,A01,494059,Suk; Andrew Hoon,30,0,30,0
1713314070333,MATH 20B,A01,494061,Briones; Jor-el Thomas Caparas,33,0,35,2
1713314070333,MATH 20B,B01,494063,Bach; Quang Tran,34,0,35,1
1713314071360,MATH 20C,A01,494065,Staff,28,0,30,2
1713314071360,MATH 20C,A02,494066,Staff,30,0,30,0
1713314071360,MATH 20C,A03,494067,Staff,30,0,30,0
1713314071360,MATH 20C,A04,494068,Staff,30,0,30,0
1713314071360,MATH 20C,B01,494070,Zhang; Ming,26,0,30,4
1713314071360,MATH 20C,B02,494071,Zhang; Ming,29,0,30,1
1713314071360,MATH 20C,B03,494072,Zhang; Ming,29,0,30,1
1713314071360,MATH 20C,B04,494073,Zhang; Ming,29,0,30,1
1713314072387,MATH 20D,A01,494075,Staff,24,0,30,6
1713314072387,MATH 20D,A02,494076,Staff,30,0,30,0
1713314073415,MATH 20E,A01,494079,Staff,25,0,30,5
1713314073415,MATH 20E,A02,494080,Staff,27,0,30,3
1713314073415,MATH 20E,B01,494082,Staff,27,0,30,3
1713314073415,MATH 20E,B02,494083,Staff,25,0,30,5
1713314074446,MATH 103A,A01,494085,Aliabadi Sr.; Mohsen,17,0,30,13
1713314074446,MATH 103A,A02,494086,Aliabadi Sr.; Mohsen,28,0,30,2
1713314074446,MATH 103A,B01,494088,Aliabadi Sr.; Mohsen,22,0,30,8
1713314074446,MATH 103A,B02,494089,Aliabadi Sr.; Mohsen,28,0,30,2
1713314075472,MATH 109,A01,494091,Staff,30,0,30,0
1713314075472,MATH 109,A02,494092,Staff,29,0,30,1
1713314075472,MATH 109,B01,494094,Staff,28,0,30,2
1713314075472,MATH 109,B02,494095,Staff,29,0,30,1
1713314076499,MATH 142A,A01,494097,Chow; Bennett,15,0,30,15
1713314076499,MATH 142A,A02,494098,Chow; Bennett,24,0,30,6
1713314076499,MATH 142A,B01,494100,Chow; Bennett,19,0,30,11
1713314076499,MATH 142A,B02,494101,Chow; Bennett,29,0,30,1
1713314078609,MATH 168A,A01,516677,Dumitriu; Ioana,15,0,35,20
1713314079634,MATH 170A,A01,516679,Dumitriu; Ioana,20,0,30,10
1713314079634,MATH 170A,A02,516680,Dumitriu; Ioana,28,0,30,2
1713314080660,MATH 193A,A01,494107,Staff,16,0,30,14
1713314080660,MATH 193A,A02,494108,Staff,21,0,30,9
1713314080660,MATH 193A,A03,494109,Staff,29,0,30,1
1713314080660,MATH 193A,A04,494110,Staff,22,0,30,8
1713314083741,MGT 16,A00,491930,McKay; Michael J,92,0,98,6
1713314084768,MGT 18,A00,491992,McKay; Michael J,97,0,98,1
1713314085793,MGT 71,A00,492003,Staff,76,0,98,22
1713314086822,MGT 103,A00,505209,Eberhard; Craig A,85,0,98,13
1713314087847,MGT 131A,A00,505210,Anderson; John Charles,91,0,98,7
1713314089901,MGT 153,A00,492077,Perols; Johan Lars,39,0,90,51
1713314092983,MGT 164,A00,492222,McKay; Mary A,93,0,98,5
1713314094011,MGT 172,A00,492245,Staff,59,0,60,1
1713314094011,MGT 172,B00,505526,Hedges; Kathleen,75,0,98,23
1713314095041,MGT 181,A00,505669,Dunn; Louis Jean,86,0,98,12
1713314096068,MMW 14,A01,494399,Staff,23,0,28,5
1713314096068,MMW 14,A02,494400,Staff,25,0,28,3
1713314096068,MMW 14,A03,494401,Staff,28,0,28,0
1713314096068,MMW 14,A04,494402,Staff,28,0,28,0
1713314096068,MMW 14,B01,494404,Carreras; Maria Victoria,13,0,28,15
1713314096068,MMW 14,B02,494405,Carreras; Maria Victoria,26,0,28,2
1713314096068,MMW 14,B03,494406,Carreras; Maria Victoria,28,0,28,0
1713314096068,MMW 14,B04,494407,Carreras; Maria Victoria,28,0,28,0
1713314097094,MMW 14GS,A00,506250,Chang; Edmond Yi-Teh,0,0,0,0
1713314098122,MMW 121R,A01,494415,Adamiak; Patrick John,14,0,28,14
1713314098122,MMW 121R,A02,494416,Adamiak; Patrick John,24,0,28,4
1713314099148,MUS 1A,A01,494113,Staff,12,0,25,13
1713314099148,MUS 1A,A02,494114,Staff,25,0,25,0
1713314100177,MUS 4,A01,494116,Staff,24,0,25,1
1713314100177,MUS 4,A02,494117,Staff,22,0,25,3
1713314101206,MUS 5R,A01,494236,Dubnov; Shlomo,11,0,25,14
1713314101206,MUS 5R,A02,494237,Dubnov; Shlomo,25,0,25,0
1713314102230,MUS 6,A01,494122,Staff,13,0,25,12
1713314102230,MUS 6,A02,494123,Staff,24,0,25,1
1713314103260,MUS 7,A01,494125,Staff,17,0,25,8
1713314103260,MUS 7,A02,494126,Staff,24,0,25,1
1713314104284,MUS 11,A01,494128,Staff,23,0,25,2
1713314104284,MUS 11,A02,494129,Staff,25,0,25,0
1713314105314,MUS 13,A01,494131,Staff,25,0,25,0
1713314105314,MUS 13,A02,494132,Staff,25,0,25,0
1713314106343,MUS 15,A01,494134,Staff,18,0,25,7
1713314106343,MUS 15,A02,494135,Staff,25,0,25,0
1713314106343,MUS 15,B01,494137,Staff,24,0,25,1
1713314107369,MUS 80,A00,494232,Staff,24,0,25,1
1713314107369,MUS 80,B00,494233,Staff,25,0,25,0
1713314107369,MUS 80,C00,494234,Staff,23,0,25,2
1713314108395,MUS 95C,A00,494141,Staff,72,0,75,3
1713314109418,MUS 114,A00,494142,Staff,41,0,50,9
1713314110445,NANO 15,A01,490636,Drews; Aaron,7,0,7,0
1713314111470,PHIL 1,A00,490578,Grush; Rick Scott,49,0,50,1
1713314112499,PHIL 10,A01,490580,Grush; Rick Scott,33,0,35,2
1713314112499,PHIL 10,A02,490586,Grush; Rick Scott,33,0,35,2
1713314113523,PHIL 27,A01,490591,Staff,24,0,25,1
1713314113523,PHIL 27,A02,490592,Staff,25,0,25,0
1713314113523,PHIL 27,A03,490593,Staff,25,0,25,0
1713314113523,PHIL 27,A04,490598,Staff,25,0,25,0
1713314114551,PHIL 32,A01,490611,Staff,20,0,20,0
1713314114551,PHIL 32,A02,490618,Staff,20,0,20,0
1713314115575,PHIL 90,A00,490624,Staff,40,0,40,0
1713314116599,PHIL 136,A00,490627,Cohen; Jonathan David,38,0,40,2
1713314117623,PHIL 155,A00,490634,Staff,64,0,70,6
1713314118726,PHYS 1A,A00,491610,Staff,246,0,250,4
1713314119752,PHYS 1AL,001,491616,Tsai; Philbert S,28,0,30,2
1713314119752,PHYS 1AL,002,491618,Tsai; Philbert S,30,0,30,0
1713314120780,PHYS 1B,A00,491623,Staff,244,0,250,6
1713314121809,PHYS 1BL,001,491626,Tsai; Philbert S,26,0,30,4
1713314121809,PHYS 1BL,002,491628,Tsai; Philbert S,28,0,30,2
1713314122834,PHYS 1C,A00,491632,Staff,220,0,245,25
1713314123857,PHYS 1CL,001,491635,Tsai; Philbert S,11,0,30,19
1713314123857,PHYS 1CL,002,491643,Tsai; Philbert S,24,0,30,6
1713314124883,PHYS 2AR,A01,491651,Meyertholen; Andrew D.,44,0,50,6
1713314126038,PHYS 2B,A01,491659,Staff,106,0,115,9
1713314127067,PHYS 2BL,A01,491685,Staff,21,0,24,3
1713314127067,PHYS 2BL,A02,491700,Staff,23,0,24,1
1713314128091,PHYS 2C,A01,505161,Staff,107,0,115,8
1713314129116,PHYS 4A,A01,491704,Grinstein; Benjamin,99,0,100,1
1713314130146,POLI 5D,A01,494144,Staff,3,0,5,2
1713314130146,POLI 5D,B01,626283,Dai; Yinlin,5,0,5,0
1713314131171,POLI 12,A00,494145,Staff,44,0,45,1
1713314132198,POLI 13R,A00,494146,Forman; Fonna,45,0,50,5
1713314133221,POLI 27,A01,494148,Staff,57,0,60,3
1713314134247,POLI 30,A00,494149,Staff,49,0,50,1
1713314135272,POLI 100DA,A00,494150,Staff,22,0,25,3
1713314137323,POLI 100I,A00,494152,Staff,28,0,30,2
1713314138355,POLI 104B,A00,494153,Smith; Glenn Chatmas,54,0,55,1
1713314139380,POLI 104F,A00,494154,Staff,28,0,30,2
1713314140409,POLI 104I,A00,494155,Smith; Glenn Chatmas,30,0,30,0
1713314141435,POLI 110C,A00,494156,Ingham; Sean,23,0,25,2
1713314142463,POLI 117R,A00,494157,Forman; Fonna,10,0,20,10
1713314143489,POLI 118,A00,494158,Ingham; Sean,22,0,25,3
1713314144514,POLI 120H,A00,494159,Fisk; David Lee,41,0,45,4
1713314145543,POLI 131CR,A00,494160,Hoston; Germaine,37,0,45,8
1713314146567,POLI 133J,A00,494161,Staff,33,0,35,2
1713314147592,POLI 135,A00,494162,Fisk; David Lee,33,0,35,2
1713314148621,POLI 140A,A00,494164,Staff,22,0,30,8
1713314149646,POLI 142I,A00,494165,Staff,30,0,30,0
1713314150675,POLI 144D,A00,494166,Staff,23,0,25,2
1713314151701,POLI 151,A00,494167,Staff,30,0,30,0
1713314152728,POLI 153,A00,494168,Staff,33,0,35,2
1713314153754,POLI 160AA,A00,494169,Staff,35,0,40,5
1713314154783,POLI 162,A00,494170,Mignozzetti; Umberto,20,0,25,5
1713314155809,POLI 171,A00,494171,Mignozzetti; Umberto,21,0,25,4
1713314156833,PSYC 1,A00,494172,Staff,97,0,100,3
1713314157859,PSYC 2,A00,494173,Moranton; Nirelia Melbina-,43,0,50,7
1713314158885,PSYC 3,A00,494174,Staff,29,0,30,1
1713314159912,PSYC 6,A00,494175,Staff,17,0,20,3
1713314160937,PSYC 60,A01,494177,Staff,39,0,45,6
1713314161963,PSYC 70,A01,505724,Geller; Emma Harlan,42,0,45,3
1713314162990,PSYC 101,A00,494180,Heyman; Gail D.,87,0,100,13
1713314164018,PSYC 105,A00,494181,Geller; Emma Harlan,63,0,90,27
1713314165047,PSYC 106,A00,494182,Dobkins; Karen R.,32,0,45,13
1713314166077,PSYC 108,A00,494183,Adrian; Julia Anna,93,0,100,7
1713314167103,PSYC 114,A01,494185,Winkielman; Piotr,0,0,30,30
1713314168132,PSYC 122,A00,494186,Moranton; Nirelia Melbina-,37,0,50,13
1713314169159,PSYC 124,A00,494187,Chapman; Eddie Nathaniel,72,0,80,8
1713314170187,PSYC 131,A00,494188,Anagnostaras; Stephan,55,0,80,25
1713314171213,PSYC 144,A00,494189,Staff,13,0,50,37
1713314172244,PSYC 154,A00,494190,Lacefield; Katharine I,132,0,180,48
1713314173276,PSYC 162,A00,494191,Wixted; John T,82,0,100,18
1713314174303,PSYC 172,A00,494192,Gorman; Michael R.,37,0,45,8
1713314175328,PSYC 178,A00,494193,Glaser; Dale,40,0,45,5
1713314176353,PSYC 193,A00,505725,Chapman; Eddie Nathaniel,20,0,20,0
1713314177388,RELI 145GS,A00,519817,Rahimi; Babak,18,0,20,2
1713314178415,SE 101A,A01,490862,Chadha; Mayank,23,0,25,2
1713314179442,SE 101C,A01,490924,Krysl; Petr,18,0,20,2
1713314180472,SE 110A,A01,490928,Staff,19,0,20,1
1713314181560,SE 130A,A00,490929,Morrison; Machel Leigh,62,0,70,8
1713314182586,SIO 1,A01,519325,Staff,39,0,40,1
1713314183612,SIO 30,A01,519327,Staff,39,0,40,1
1713314184640,SIO 40,A00,519328,Staff,40,0,40,0
1713314185669,SIO 46GS,A00,519819,Cook; Geoffrey W,18,0,25,7
1713314186693,SIO 109R,A00,494197,Forman; Fonna,4,0,20,16
1713314187719,SIO 121GS,A00,519827,Cook; Geoffrey W,18,0,25,7
1713314188742,SIO 132,A01,519330,Staff,38,0,40,2
1713314189770,SIO 133,A01,519397,Staff,38,0,40,2
1713314190796,SIO 139,A00,519396,Kacev; David,33,0,40,7
1713314191822,SOCI 1,A01,494199,Thorpe; Charles Robert,23,0,30,7
1713314191822,SOCI 1,A02,494200,Thorpe; Charles Robert,30,0,30,0
1713314191822,SOCI 1,A03,494201,Thorpe; Charles Robert,29,0,30,1
1713314191822,SOCI 1,A04,494202,Thorpe; Charles Robert,29,0,30,1
1713314191822,SOCI 1,A05,494203,Thorpe; Charles Robert,29,0,30,1
1713314191822,SOCI 1,A06,494204,Thorpe; Charles Robert,30,0,30,0
1713314191822,SOCI 1,A07,494205,Thorpe; Charles Robert,29,0,30,1
1713314192847,SOCI 60,A01,494207,Staff,36,0,40,4
1713314192847,SOCI 60,A02,494208,Staff,39,0,40,1
1713314193875,SOCI 100,A01,494210,Payne; Christine Anna,27,0,30,3
1713314193875,SOCI 100,A02,494211,Payne; Christine Anna,27,0,30,3
1713314194900,SOCI 109M,A00,494212,Staff,20,0,20,0
1713314195923,SOCI 110,A00,494213,Staff,35,0,40,5
1713314197976,SOCI 118E,A00,494215,Ng; Kwai,38,0,40,2
1713314199001,SOCI 125,A00,494216,Calderon-Zaks; Michael Aar,42,0,45,3
1713314200027,SOCI 126,A01,494218,Jones; Makeba,4,0,5,1
1713314201053,SOCI 131,A00,494219,Thorpe; Charles Robert,28,0,30,2
1713314203110,SOCI 135,A00,494221,Payne; Christine Anna,34,0,50,16
1713314204136,SOCI 136E,A00,626690,Ruiz; Jonathan Joseph,25,0,25,0
1713314205162,SOCI 138GS,A00,494222,Navon; Daniel,24,0,28,4
1713314207212,SOCI 145,A00,494224,Staff,42,0,45,3
1713314208236,SOCI 153,A00,494225,Staff,28,0,30,2
1713314209261,SOCI 160E,A00,494226,Ng; Kwai,33,0,40,7
1713314210285,SOCI 180,A00,494227,Staff,29,0,30,1
1713314211314,SOCI 189GS,A00,494228,Ribas Norris; Janet Vanesa,11,0,11,0
1713314212338,SOCI 190GS,A00,553232,Ribas Norris; Janet Vanesa,11,0,11,0
1713314213370,SOMI 220,A00,627178,Schneid; Stephen David,30,0,30,0
1713314214396,SYN 2,001,490768,Staff,14,0,15,1
1713314214396,SYN 2,002,490769,Staff,15,0,15,0
1713314214396,SYN 2,004,490775,Staff,0,0,0,0
1713314214396,SYN 2,003,490774,Staff,0,0,0,0
1713314214396,SYN 2,005,490776,Staff,0,0,0,0
1713314215421,SYN 2R,001,490779,Staff,12,0,15,3
1713314215421,SYN 2R,002,514635,Staff,14,0,15,1
1713314216446,SYN 100,A01,490783,Staff,15,0,20,5
1713314216446,SYN 100,B01,490787,Staff,10,0,20,10
1713314216446,SYN 100,C01,490789,Staff,12,0,20,8
1713314217475,SYN 150,A00,490817,Staff,14,0,15,1
1713314217475,SYN 150,B00,514610,Staff,15,0,15,0
1713314218502,TDAC 1,A00,492753,Walsh; Kim C.,19,0,20,1
1713314218502,TDAC 1,B00,492754,Harting; Carla Kelso,19,0,20,1
1713314218502,TDAC 1,C00,513995,Salovey; Todd,17,0,20,3
1713314219532,TDAC 101,A00,492766,Harting; Carla Kelso,17,0,20,3
1713314220558,TDAC 102,A00,492768,Basso; Beatrice,19,0,20,1
1713314221584,TDDE 111,A00,492769,Staff,25,0,25,0
1713314222720,TDDE 131,A00,492770,Staff,15,0,15,0
1713314222720,TDDE 131,B00,492771,Staff,15,0,15,0
1713314223745,TDDE 131GS,A00,523716,Guirguis; Mark C,24,0,28,4
1713314224776,TDGE 1,A01,492756,Salovey; Todd,57,0,60,3
1713314225805,TDGE 5,A01,492758,Staff,24,0,25,1
1713314226834,TDGE 10,A00,492759,Fulton; Julia,209,0,220,11
1713314227860,TDGE 11,A00,492760,Castro; Robert Jess,199,0,200,1
1713314229916,TDGE 124,A00,492772,Fulton; Julia,192,0,220,28
1713314230943,TDGE 125,A00,492773,Meyer; Ursula,40,0,50,10
1713314230943,TDGE 125,B00,492774,Staff,50,0,50,0
1713314230943,TDGE 125,C00,523565,Staff,49,0,50,1
1713314231971,TDGE 125GS,A00,523580,Guirguis; Mark C,24,0,28,4
1713314232997,TDGE 127,A00,492775,Havis; Allan,41,0,50,9
1713314234024,TDHT 101,A00,492776,Staff,35,0,35,0
1713314235052,TDMV 1,A00,492762,Caligagan; Maria T.,30,0,30,0
1713314235052,TDMV 1,B00,492763,Arcidiacono; Kristin,25,0,30,5
1713314236077,TDMV 2,A00,492764,Weinberg; Sadie,29,0,30,1
1713314237104,TDMV 3,A00,492765,Mack; Kara Shanai',39,0,40,1
1713314238133,TDMV 138,A00,492777,Mack; Kara Shanai',36,0,40,4
1713314239160,TDMV 140,A00,492778,Lima; Paulo Henrique,40,0,40,0
1713314240192,TDMV 142,A00,492779,Caligagan; Maria T.,36,0,40,4
1713314240192,TDMV 142,B00,492780,Caligagan; Tony,37,0,40,3
1713314241217,TDMV 143,A00,492781,Fyall; Daunte Edward,39,0,40,1
1713314242243,USP 1,A01,492401,Kwak; Nancy,26,0,35,9
1713314243271,USP 2,A01,492453,Hinds; Juli Beth,35,0,35,0
1713314244301,USP 3,A01,492516,Staff,29,0,35,6
1713314245329,USP 4,A00,492522,McTague; Sarah,19,0,25,6
1713314246415,USP 100,A00,492523,Staff,33,0,35,2
1713314247441,USP 101,A00,492524,Staff,13,0,15,2
1713314248466,USP 105,A00,492525,Staff,21,0,25,4
1713314249488,USP 151,A00,492526,Shenkman; Michael Thomas,33,0,35,2
1713314250513,USP 170,A00,492545,Hinds; Juli Beth,33,0,35,2
1713314251539,USP 171GS,A00,492608,Bussell; Mirle Rabinowitz,25,0,28,3
1713314252568,USP 183GS,A00,492613,Peerson; Susan,25,0,28,3
1713314253594,VIS 30,A01,490693,Yoldas; Pinar,21,0,22,1
1713314253594,VIS 30,A02,490694,Yoldas; Pinar,19,0,22,3
1713314254619,VIS 83,A00,490695,Kester; Grant,66,0,75,9
1713314255644,VIS 105D,A00,490696,Staff,22,0,25,3
1713314256668,VIS 124CN,A00,490699,Rose; Jordan M,68,0,75,7
1713314257695,VIS 125GS,A00,511221,Williams; Alena J,21,0,22,1
1713314258719,VIS 128D,A00,490700,Staff,74,0,75,1
1713314259747,VIS 151,A01,490717,Staff,33,0,34,1
1713314259747,VIS 151,A02,490766,Staff,33,0,34,1
1713314260774,VIS 154GS,A00,511972,Williams; Alena J,21,0,22,1
1713314261799,VIS 160A,A00,490767,Stone; Patricia,7,0,10,3
1713314262828,WCWP 10A,A00,490638,Staff,14,0,15,1
1713314262828,WCWP 10A,B00,490640,Staff,15,0,15,0
1713314263859,WCWP 10B,A00,490641,Staff,0,0,0,0
1713314263859,WCWP 10B,B00,490642,Staff,14,0,15,1
1713314263859,WCWP 10B,C00,490644,Staff,13,0,15,2
1713314263859,WCWP 10B,D00,490647,Staff,0,0,0,0
1713314264889,WCWP 100,A00,490655,Staff,0,0,0,0
1713314264889,WCWP 100,B00,490687,Staff,12,0,15,3
1713314267003,ANAR 153,A00,487222,Braswell; Geoffrey E.,54,0,60,6
1713314268033,ANBI 134,A00,487223,Staff,12,0,20,8
1713314269057,ANBI 143GS,A00,487224,Noel; Geoffroy Pierre Jean,20,0,24,4
1713314270085,ANBI 144GS,A00,519548,Noel; Geoffroy Pierre Jean,20,0,24,4
1713314271111,ANSC 101,A00,487225,Staff,19,0,20,1
1713314272136,ANSC 125,A00,487227,Brenner; Suzanne A,39,0,40,1
1713314274184,ANSC 146,A00,487229,Staff,36,0,40,4
1713314275223,ANSC 148,A00,487230,Olivas Hernandez; Olga Lid,39,0,40,1
1713314276254,ANSC 150,A00,504165,Sloane; Julia Kathryn,19,0,20,1
1713314277312,ANSC 180,A00,487232,Staff,13,0,15,2
1713314278341,ANSC 188,A00,627155,Staff,40,0,40,0
1713314279367,ANTH 5,A00,519529,Semendeferi; Ekaterini,15,0,15,0
1713314280391,ANTH 10,A00,487219,Staff,58,0,60,2
1713314281417,ANTH 23,A01,487221,Staff,17,0,20,3
1713314282445,ANTH 102,A00,487233,Wilder; Linnea Lorene,51,0,60,9
1713314283473,ANTH 103,A00,487234,Varma; Saiba,56,0,60,4
1713314284500,ANTH 105,A00,487235,Stewart; Alexander B,56,0,60,4
1713314285580,BENG 100,A01,516685,Taylor Amos; Alyssa C,28,0,30,2
1713314286610,BIBC 102,A01,491316,Flagg; Matthew Paul,37,0,88,51
1713314286610,BIBC 102,A02,491366,Flagg; Matthew Paul,83,0,88,5
1713314287635,BIBC 103,A01,491486,Boumechache; Miyyada,16,0,24,8
1713314287635,BIBC 103,A02,491487,Boumechache; Miyyada,24,0,24,0
1713314288663,BICD 100,A01,516882,Staff,75,0,75,0
1713314288663,BICD 100,A02,516890,Staff,70,0,75,5
1713314289691,BICD 102GS,A00,491488,Lo; Stanley M.,26,0,28,2
1713314290717,BIEB 136GS,A00,516940,Holway; David A. & Shurin; Jonathan,19,0,24,5
1713314291744,BIEB 137GS,A01,517034,Holway; David A. & Shurin; Jonathan,19,0,24,5
1713314292770,BIEB 138GS,A01,491492,Pirino; Giorgia,21,0,28,7
1713314293795,BILD 1,A01,491296,Staff,62,0,63,1
1713314293795,BILD 1,A02,491297,Staff,63,0,63,0
1713314294823,BILD 4,A01,517099,Gonzalez Gamboa; Ivonne,22,0,24,2
1713314294823,BILD 4,A02,517100,Gonzalez Gamboa; Ivonne,24,0,24,0
1713314295848,BILD 60GS,A00,491309,Lo; Stanley M.,26,0,28,2
1713314296873,BIMM 100,A01,517136,Staff,90,0,100,10
1713314297900,BIMM 110,A01,517182,Staff,69,0,100,31
1713314298924,BIMM 120,A01,517228,Pickett; Brooke Elizabeth,39,0,63,24
1713314298924,BIMM 120,A02,517240,Pickett; Brooke Elizabeth,48,0,63,15
1713314299949,BIMM 132GS,A01,491498,Pirino; Giorgia,21,0,28,7
1713314300976,BIMM 143,A01,491589,Bozinovic; Goran,18,0,40,22
1713314302007,BIPN 100,A01,491594,Armour; Jon Christopher,91,0,100,9
1713314303036,BIPN 140,A01,491602,Marino; Marc J,29,0,50,21
1713314305093,CAT 125,A00,515973,Staff,20,0,20,0
1713314306120,CAT 125GS,A00,515974,Rahimi; Babak,18,0,20,2
1713314307146,CAT 125R,A00,515980,Staff,14,0,20,6
1713314307146,CAT 125R,B00,515981,Tosun; Adriana,19,0,20,1
1713314307146,CAT 125R,C00,515987,Hyland; Tina Mae,2,0,20,18
1713314307146,CAT 125R,D00,515988,Bronstein; Phoebe Malan,18,0,20,2
1713314308174,CENG 15,A01,488699,Drews; Aaron,25,0,25,0
1713314309200,CENG 100,A00,505196,Opatkiewicz; Justin Paul,25,0,25,0
1713314310226,CGS 2A,A01,489598,Staff,33,0,35,2
1713314311251,CGS 112,A00,489599,Staff,15,0,15,0
1713314312276,CGS 119,A00,489603,Staff,10,0,10,0
1713314313301,CGS 120,A00,489604,Staff,14,0,15,1
1713314314326,CGS 150,A00,489607,Staff,15,0,15,0
1713314315355,CHEM 6A,A01,488715,Staff,98,0,100,2
1713314316384,CHEM 6B,A01,488719,Piercy; Marc Anthony,100,0,100,0
1713314317409,CHEM 6C,A01,488723,Albizati; Kim F.,94,0,100,6
1713314318438,CHEM 7L,A01,488728,Schurmeier; Kimberly,18,0,24,6
1713314318438,CHEM 7L,A02,488730,Schurmeier; Kimberly,23,0,24,1
1713314318438,CHEM 7L,A03,488734,Schurmeier; Kimberly,23,0,24,1
1713314318438,CHEM 7L,A04,488763,Schurmeier; Kimberly,23,0,24,1
1713314318438,CHEM 7L,B01,488798,Schurmeier; Kimberly,18,0,24,6
1713314318438,CHEM 7L,B02,488801,Schurmeier; Kimberly,23,0,24,1
1713314318438,CHEM 7L,B03,488808,Schurmeier; Kimberly,24,0,24,0
1713314318438,CHEM 7L,B04,488811,Schurmeier; Kimberly,24,0,24,0
1713314319463,CHEM 11,A01,488897,Stallings; Dontarie M,98,0,100,2
1713314320487,CHEM 40A,A01,488913,Albizati; Kim F.,90,0,100,10
1713314321513,CHEM 40B,A01,488920,Weizman; Haim,46,0,50,4
1713314321513,CHEM 40B,A02,488938,Weizman; Haim,46,0,50,4
1713314322544,CHEM 41A,A01,489029,Klosterman; Jeremy K,58,0,60,2
1713314323569,CHEM 41C,A01,500436,Tor; Yitzhak,55,0,60,5
1713314324597,CHEM 43A,A01,500426,Weizman; Haim,2,0,24,22
1713314324597,CHEM 43A,A02,500430,Weizman; Haim,13,0,24,11
1713314324597,CHEM 43A,B01,514041,Klosterman; Jeremy K,15,0,24,9
1713314324597,CHEM 43A,B02,514047,Klosterman; Jeremy K,23,0,24,1
1713314325628,CHEM 108,A01,489140,Jennings; Patricia A.,13,0,24,11
1713314325628,CHEM 108,A02,489142,Jennings; Patricia A.,15,0,24,9
1713314326653,CHEM 114A,A01,489147,Stallings; Dontarie M,78,0,100,22
1713314327679,CHIN 169A,A00,489171,Wang; Xiao,19,0,20,1
1713314329733,COGS 3,A01,518827,Boyle; Mary E. T.,29,0,40,11
1713314330761,COGS 11,A01,489175,Staff,28,0,30,2
1713314331785,COGS 14A,A01,518829,Staff,51,0,60,9
1713314332811,COGS 14B,A01,489177,Hoffman; Drew Ellen,69,0,75,6
1713314333841,COGS 100,A01,489181,Allen; Michael Gordon,66,0,75,9
1713314334867,COGS 101A,A01,489183,Staff,48,0,60,12
1713314335891,COGS 101B,A01,489185,Allen; Michael Gordon,12,0,30,18
1713314336920,COGS 101C,A01,526786,Staff,24,0,30,6
1713314338977,COGS 107A,A01,489189,Boyle; Mary E. T.,20,0,35,15
1713314340003,COGS 107B,A01,627144,Mooshagian; Eric Frederick,60,0,60,0
1713314341027,COGS 118A,A01,489191,Staff,0,34,40,40
1713314343084,COGS 171GS,A01,489194,Pineda; Jaime A,22,0,28,6
1713314344109,COGS 172,A01,489196,Staff,3,0,30,27
1713314345132,COGS 174GS,A01,489264,Pineda; Jaime A,22,0,28,6
1713314346161,COGS 180,A01,627150,Staff,28,0,30,2
1713314347187,COGS 186,A01,489274,Staff,1,0,30,29
1713314348214,COMM 10,A01,489276,Staff,23,0,25,2
1713314348214,COMM 10,A02,489303,Staff,23,0,25,2
1713314349238,COMM 100A,A01,489312,Staff,16,0,25,9
1713314349238,COMM 100A,A02,489313,Staff,24,0,25,1
1713314350267,COMM 106T,A00,512540,Staff,34,0,35,1
1713314351296,COMM 107,A00,489347,Staff,31,0,35,4
1713314352322,COMM 109P,A00,489358,Staff,31,0,35,4
1713314353348,COMM 132,A00,489361,McKenna; Denise,28,0,30,2
1713314354374,COMM 146,A00,489362,Halm; Gavin Patrick,27,0,30,3
1713314355397,COMM 190,A00,489363,Abuelhiga; Soraya Jill,20,0,23,3
1713314356424,CSE 8A,A50,489366,Staff,22,0,25,3
1713314356424,CSE 8A,A51,489367,Staff,24,0,25,1
1713314357454,CSE 11,A01,489398,Cao; Yingjun,79,0,100,21
1713314358482,CSE 12,A01,489487,Staff,43,0,50,7
1713314359510,CSE 20,A01,489497,Staff,48,0,50,2
1713314360535,CSE 21,A01,489517,Braun; Oliver,44,0,50,6
1713314361561,CSE 101,A01,489524,Braun; Oliver,0,15,50,50
1713314362587,CSE 105,A01,512594,Jones; Miles E,79,0,100,21
1713314362587,CSE 105,B01,512598,Jones; Miles E,61,0,100,39
1713314363613,CSE 140,A01,489538,Staff,44,0,50,6
1713314364640,CSE 141,A01,489550,Eldon; John,75,0,100,25
1713314365666,CSE 141L,A01,489571,Eldon; John,73,0,100,27
1713314366692,CSE 151A,A01,489583,Solares; Edwin A,149,0,200,51
1713314367718,CSE 175,A01,510886,Kumar; Rakesh,30,0,30,0
1713314368801,CSE 190,A00,516828,Dubnov; Shlomo,41,0,49,8
1713314369832,DOC 100D,A00,489667,Pass; Natalye Joann,21,0,25,4
1713314370858,DSC 10,A01,624268,Staff,72,0,75,3
1713314371883,DSC 20,A01,624476,Staff,50,0,50,0
1713314372908,DSC 40A,A01,624608,Staff,39,0,40,1
1713314373939,DSGN 1,A01,489179,Rill; Bryan,36,0,50,14
1713314374971,ECE 17,A01,490489,Sahay; Rajeev,18,0,30,12
1713314375997,ECE 65,A50,490492,Staff,15,0,20,5
1713314375997,ECE 65,A51,490493,Staff,20,0,20,0
1713314377026,ECON 1,A01,489715,Famulari; Melissa,68,0,70,2
1713314378058,ECON 2,A01,489717,Levkoff; Steven B.,68,0,70,2
1713314379085,ECON 3,A01,489948,Staff,70,0,70,0
1713314381143,ECON 5,A01,490103,Staff,28,0,30,2
1713314381143,ECON 5,B01,626281,Dai; Yinlin,45,0,45,0
1713314382171,ECON 100A,A01,490127,Famulari; Melissa,68,0,70,2
1713314383195,ECON 100B,A01,490129,Staff,64,0,70,6
1713314384221,ECON 109,A01,490187,Shishkin; Denis,27,0,35,8
1713314385245,ECON 110A,A01,490190,Levkoff; Steven B.,62,0,70,8
1713314386275,ECON 120A,A01,490245,Dai; Yinlin,65,0,70,5
1713314387305,ECON 120B,A01,490247,Nieto-Barthaburu; Augusto,55,0,70,15
1713314388330,ECON 120C,A01,490253,Sun; Yixiao,30,0,35,5
1713314388330,ECON 120C,B01,490255,Sun; Yixiao,34,0,35,1
1713314389413,ECON 129,A00,490256,Eckert; Fabian Paul,25,0,35,10
1713314390438,ECON 131,A00,490257,Nieto-Barthaburu; Augusto,0,0,35,35
1713314391464,ECON 138,A00,490258,Bharadwaj; Prashant,19,0,35,16
1713314391464,ECON 138,B00,490259,Bharadwaj; Prashant,17,0,35,18
1713314392493,ECON 159,A00,490260,Hendrickson; Gerald M.,0,8,0,0
1713314393521,ECON 178,A01,553995,Zhu; Ying,26,0,35,9
1713314394553,EDS 40,A01,512576,Black; Alison Michelle,20,0,20,0
1713314395579,EDS 107,A01,515848,Staff,30,0,30,0
1713314396604,EDS 110R,A01,490262,Staff,26,0,30,4
1713314397630,EDS 112,A01,490264,Chapman; Thandeka K,43,0,50,7
1713314398657,EDS 113,A00,490266,Staff,26,0,30,4
1713314399687,EDS 118,A00,490267,Warstadt; Melissa Fawn,25,0,30,5
1713314400717,EDS 124BR,A00,490268,Eguchi; Emi,7,0,25,18
1713314400717,EDS 124BR,B00,490269,Eguchi; Emi,25,0,25,0
1713314401747,EDS 126,A01,490271,Jones; Makeba,44,0,50,6
1713314402773,EDS 135,A01,490316,Staff,19,0,20,1
1713314403799,ENVR 142GS,A00,519514,Chang; Edmond Yi-Teh,28,0,28,0
1713314404824,ETHN 103,A00,490504,Staff,31,0,36,5
1713314405853,ETHN 103A,A00,490505,Man; Simeon S,5,0,9,4
1713314406878,ETHN 109,A00,490506,Staff,30,0,30,0
1713314407904,ETHN 118,A00,490507,Staff,35,0,36,1
1713314408930,ETHN 119,A00,490508,Staff,34,0,36,2
1713314409959,ETHN 121R,A00,490518,Choi; Esther Min,27,0,36,9
1713314410985,ETHN 127,A00,490528,Staff,15,0,15,0
1713314412014,ETHN 139,A00,490573,Staff,10,0,10,0
1713314413039,ETHN 150,A00,490575,Staff,15,0,15,0
1713314414071,GLBH 20,A00,491705,Elwardani; Nile Regina,38,0,40,2
1713314415097,GLBH 101,A00,491706,Staff,20,0,20,0
1713314416126,GLBH 111,A01,491708,Burgos; Jose L.,15,0,15,0
1713314417151,GLBH 146,A00,491709,Staff,11,0,20,9
1713314418181,GLBH 148,A00,491710,Olivas Hernandez; Olga Lid,14,0,20,6
1713314419212,GLBH 150,A00,491711,Sloane; Julia Kathryn,20,0,20,0
1713314420237,HIEA 131,A00,491760,Staff,29,0,32,3
1713314421262,HIEA 153,A00,491762,Staff,29,0,30,1
1713314422289,HIEU 124,A00,491811,Staff,26,0,32,6
1713314423314,HIEU 124GS,A00,491812,Markman; Kristina,27,0,28,1
1713314424343,HIEU 147,A00,491813,Staff,30,0,32,2
1713314425375,HIEU 149GS,A00,491816,Caldwell; Michael Alan,28,0,28,0
1713314426401,HILD 2C,A01,491713,Hendrickson; Gerald M.,27,0,30,3
1713314427430,HILD 7B,A01,491715,Kwak; Nancy,6,0,30,24
1713314428458,HILD 10,A01,491717,Staff,13,0,20,7
1713314429483,HILD 30GS,A00,491719,Edington; Claire Ellen,24,0,28,4
1713314430508,HINE 109,A00,491818,Shafir; Nir,28,0,32,4
1713314431535,HINE 128,A00,491821,Shafir; Nir,31,0,32,1
1713314432560,HISC 117,A00,491830,Staff,29,0,32,3
1713314433586,HIUS 103,A00,491834,Man; Simeon S,15,0,23,8
1713314434618,HIUS 108B,A00,491835,Staff,29,0,30,1
1713314435642,HIUS 141,A00,491836,Hendrickson; Gerald M.,29,0,32,3
1713314436667,HIUS 149,A00,491839,Staff,27,0,32,5
1713314437694,HUM 3,A01,512617,Crum; Matthew Stephen,45,0,50,5
1713314437694,HUM 3,A02,512618,Crum; Matthew Stephen,48,0,50,2
1713314438719,HUM 3GS,A00,512663,Markman; Kristina,0,0,0,1
1713314438719,HUM 3GS,B00,512664,Staff,0,0,0,0
1713314439744,HUM 4,A01,512620,West; Geoffrey Scott,31,0,50,19
1713314440767,HUM 4GS,A00,512666,Lyon; Antony J.,0,0,0,3
1713314441795,HUM 4R,A01,512625,Watkins; Eric,49,0,50,1
1713314442821,HUM 5,A01,512649,Zavodny; Tatiana Sophia,30,0,50,20
1713314442821,HUM 5,B01,512661,Zroka; Ryan Edward,48,0,50,2
1713314443848,INTL 190,A00,490577,Segui; Alan S,0,0,0,5
1713314444878,JAPN 20AR,A01,491267,Ross; Kayoko F,10,0,20,10
1713314445904,JAPN 180,A00,491285,Berman; Michael David,34,0,40,6
1713314446935,LATI 50,A01,502536,Kokinis; Troy Andreas,16,0,22,6
1713314446935,LATI 50,A02,502551,Kokinis; Troy Andreas,22,0,22,0
1713314446935,LATI 50,A03,502650,Kokinis; Troy Andreas,22,0,22,0
1713314446935,LATI 50,A04,502909,Kokinis; Troy Andreas,22,0,22,0
1713314447959,LATI 160,A01,502920,Kokinis; Troy Andreas,30,0,30,0
1713314448987,LIFR 1A,A00,490494,Van Moer; Vinciane G,17,0,20,3
1713314450013,LIFR 1AX,A00,490495,Van Moer; Vinciane G,17,0,20,3
1713314451038,LIFR 1B,A00,490496,Van Moer; Vinciane G,18,0,20,2
1713314452067,LIFR 1BX,A00,490497,Van Moer; Vinciane G,18,0,20,2
1713314453091,LIGN 8,A00,505198,McIntosh; Justin Daniel,136,0,150,14
1713314454118,LIGN 9GS,A00,491239,Lott; Margaret S.,18,0,20,2
1713314455148,LIGN 101,A01,505200,McIntosh; Justin Daniel,24,0,30,6
1713314456173,LIGN 120,A01,491244,Staff,24,0,30,6
1713314457198,LIGN 149GS,A00,491245,Lott; Margaret S.,18,0,20,2
1713314458222,LIGN 170,A00,491247,Staff,24,0,30,6
1713314459247,LISP 1D,A00,490498,Munoz Sanchez; Alicia,10,0,14,4
1713314459247,LISP 1D,B00,490499,Munoz Sanchez; Alicia,6,0,14,8
1713314459247,LISP 1D,C00,490500,Munoz Sanchez; Alicia,8,0,14,6
1713314459247,LISP 1D,D00,490501,Munoz Sanchez; Alicia,10,0,14,4
1713314460275,LISP 1DX,A00,490502,Munoz Sanchez; Alicia,15,0,28,13
1713314460275,LISP 1DX,B00,490503,Munoz Sanchez; Alicia,17,0,28,11
1713314462325,LTAM 110,A00,491847,Staff,23,0,25,2
1713314463358,LTCS 119,A00,491848,Staff,12,0,15,3
1713314464389,LTCS 130,A00,491849,Staff,24,0,25,1
1713314466442,LTEA 120C,A00,491852,Staff,34,0,40,6
1713314467465,LTEN 130GS,A00,491853,Lyon; Antony J.,25,0,28,3
1713314468489,LTEN 148,A00,491855,Staff,23,0,25,2
1713314469514,LTEN 159,A00,491856,Staff,21,0,25,4
1713314470547,LTEN 180,A00,491857,Staff,9,0,15,6
1713314472602,LTSP 123GS,A00,505928,Bessett; Ryan Matthew,24,0,28,4
1713314473627,LTSP 174GS,A00,506037,Bessett; Ryan Matthew,24,0,28,4
1713314475676,LTWR 102,A00,491861,Staff,11,0,15,4
1713314476701,LTWR 106,A00,491862,Staff,10,0,15,5
1713314477726,MAE 11,A00,490930,Bahadori; Mohammad Yousef,97,0,100,3
1713314478756,MAE 30A,A00,490931,Qi; Huihui,37,0,40,3
1713314479781,MAE 101A,A00,491036,Sadeghizadeh; Zahra,97,0,100,3
1713314480808,MAE 101C,A00,491037,Seshadri; Kalyanasundaram,76,0,100,24
1713314481833,MAE 113,A00,491040,Seshadri; Kalyanasundaram,66,0,80,14
1713314482857,MAE 131A,A00,491041,Ghazinejad; Maziar,39,0,40,1
1713314483886,MAE 142,A00,491053,Staff,39,0,40,1
1713314484911,MAE 143A,A00,491054,Staff,38,0,50,12
1713314485936,MAE 150,A00,491092,Truong; Phuong Thi Ngoc,23,0,35,12
1713314486962,MATH 3C,A01,494031,Pardo Guerra; Sebastian,30,0,30,0
1713314486962,MATH 3C,A02,494032,Pardo Guerra; Sebastian,29,0,30,1
1713314487989,MATH 10A,A01,494034,Staff,27,0,30,3
1713314487989,MATH 10A,A02,494035,Staff,29,0,30,1
1713314487989,MATH 10A,B01,494037,Staff,27,0,30,3
1713314487989,MATH 10A,B02,494038,Staff,29,0,30,1
1713314489018,MATH 10B,A01,494040,Habib; Yousaf,24,0,30,6
1713314489018,MATH 10B,A02,494041,Habib; Yousaf,28,0,30,2
1713314489018,MATH 10B,A03,494042,Habib; Yousaf,30,0,30,0
1713314489018,MATH 10B,A04,494043,Habib; Yousaf,30,0,30,0
1713314489018,MATH 10B,B01,494045,Habib; Yousaf,28,0,30,2
1713314489018,MATH 10B,B02,494046,Habib; Yousaf,30,0,30,0
1713314489018,MATH 10B,B03,494047,Habib; Yousaf,30,0,30,0
1713314489018,MATH 10B,B04,494048,Habib; Yousaf,30,0,30,0
1713314490045,MATH 18,A01,494050,Kemp; Todd Aahron,25,0,30,5
1713314490045,MATH 18,A02,494051,Kemp; Todd Aahron,29,0,30,1
1713314490045,MATH 18,B01,494054,Kemp; Todd Aahron,28,0,30,2
1713314490045,MATH 18,B02,494055,Kemp; Todd Aahron,29,0,30,1
1713314491073,MATH 20A,A01,494059,Suk; Andrew Hoon,30,0,30,0
1713314492105,MATH 20B,A01,494061,Briones; Jor-el Thomas Caparas,33,0,35,2
1713314492105,MATH 20B,B01,494063,Bach; Quang Tran,34,0,35,1
1713314493187,MATH 20C,A01,494065,Staff,28,0,30,2
1713314493187,MATH 20C,A02,494066,Staff,30,0,30,0
1713314493187,MATH 20C,A03,494067,Staff,30,0,30,0
1713314493187,MATH 20C,A04,494068,Staff,30,0,30,0
1713314493187,MATH 20C,B01,494070,Zhang; Ming,26,0,30,4
1713314493187,MATH 20C,B02,494071,Zhang; Ming,29,0,30,1
1713314493187,MATH 20C,B03,494072,Zhang; Ming,29,0,30,1
1713314493187,MATH 20C,B04,494073,Zhang; Ming,29,0,30,1
1713314494215,MATH 20D,A01,494075,Staff,24,0,30,6
1713314494215,MATH 20D,A02,494076,Staff,30,0,30,0
1713314495244,MATH 20E,A01,494079,Staff,25,0,30,5
1713314495244,MATH 20E,A02,494080,Staff,27,0,30,3
1713314495244,MATH 20E,B01,494082,Staff,27,0,30,3
1713314495244,MATH 20E,B02,494083,Staff,25,0,30,5
1713314496276,MATH 103A,A01,494085,Aliabadi Sr.; Mohsen,17,0,30,13
1713314496276,MATH 103A,A02,494086,Aliabadi Sr.; Mohsen,28,0,30,2
1713314496276,MATH 103A,B01,494088,Aliabadi Sr.; Mohsen,22,0,30,8
1713314496276,MATH 103A,B02,494089,Aliabadi Sr.; Mohsen,28,0,30,2
1713314497307,MATH 109,A01,494091,Staff,30,0,30,0
1713314497307,MATH 109,A02,494092,Staff,29,0,30,1
1713314497307,MATH 109,B01,494094,Staff,28,0,30,2
1713314497307,MATH 109,B02,494095,Staff,29,0,30,1
1713314498334,MATH 142A,A01,494097,Chow; Bennett,15,0,30,15
1713314498334,MATH 142A,A02,494098,Chow; Bennett,24,0,30,6
1713314498334,MATH 142A,B01,494100,Chow; Bennett,19,0,30,11
1713314498334,MATH 142A,B02,494101,Chow; Bennett,29,0,30,1
1713314500388,MATH 168A,A01,516677,Dumitriu; Ioana,15,0,35,20
1713314501417,MATH 170A,A01,516679,Dumitriu; Ioana,20,0,30,10
1713314501417,MATH 170A,A02,516680,Dumitriu; Ioana,28,0,30,2
1713314502442,MATH 193A,A01,494107,Staff,16,0,30,14
1713314502442,MATH 193A,A02,494108,Staff,21,0,30,9
1713314502442,MATH 193A,A03,494109,Staff,29,0,30,1
1713314502442,MATH 193A,A04,494110,Staff,22,0,30,8
1713314505519,MGT 16,A00,491930,McKay; Michael J,92,0,98,6
1713314506547,MGT 18,A00,491992,McKay; Michael J,97,0,98,1
1713314507572,MGT 71,A00,492003,Staff,76,0,98,22
1713314508600,MGT 103,A00,505209,Eberhard; Craig A,85,0,98,13
1713314509630,MGT 131A,A00,505210,Anderson; John Charles,91,0,98,7
1713314511691,MGT 153,A00,492077,Perols; Johan Lars,37,0,90,53
1713314514767,MGT 164,A00,492222,McKay; Mary A,93,0,98,5
1713314516052,MGT 172,A00,492245,Staff,59,0,60,1
1713314516052,MGT 172,B00,505526,Hedges; Kathleen,75,0,98,23
1713314517078,MGT 181,A00,505669,Dunn; Louis Jean,85,0,98,13
1713314518105,MMW 14,A01,494399,Staff,23,0,28,5
1713314518105,MMW 14,A02,494400,Staff,25,0,28,3
1713314518105,MMW 14,A03,494401,Staff,28,0,28,0
1713314518105,MMW 14,A04,494402,Staff,28,0,28,0
1713314518105,MMW 14,B01,494404,Carreras; Maria Victoria,13,0,28,15
1713314518105,MMW 14,B02,494405,Carreras; Maria Victoria,26,0,28,2
1713314518105,MMW 14,B03,494406,Carreras; Maria Victoria,28,0,28,0
1713314518105,MMW 14,B04,494407,Carreras; Maria Victoria,28,0,28,0
1713314519133,MMW 14GS,A00,506250,Chang; Edmond Yi-Teh,0,0,0,0
1713314520160,MMW 121R,A01,494415,Adamiak; Patrick John,14,0,28,14
1713314520160,MMW 121R,A02,494416,Adamiak; Patrick John,24,0,28,4
1713314521186,MUS 1A,A01,494113,Staff,12,0,25,13
1713314521186,MUS 1A,A02,494114,Staff,25,0,25,0
1713314522216,MUS 4,A01,494116,Staff,24,0,25,1
1713314522216,MUS 4,A02,494117,Staff,22,0,25,3
1713314523245,MUS 5R,A01,494236,Dubnov; Shlomo,10,0,25,15
1713314523245,MUS 5R,A02,494237,Dubnov; Shlomo,25,0,25,0
1713314524276,MUS 6,A01,494122,Staff,13,0,25,12
1713314524276,MUS 6,A02,494123,Staff,24,0,25,1
1713314525301,MUS 7,A01,494125,Staff,17,0,25,8
1713314525301,MUS 7,A02,494126,Staff,24,0,25,1
1713314526328,MUS 11,A01,494128,Staff,23,0,25,2
1713314526328,MUS 11,A02,494129,Staff,25,0,25,0
1713314527354,MUS 13,A01,494131,Staff,25,0,25,0
1713314527354,MUS 13,A02,494132,Staff,25,0,25,0
1713314528381,MUS 15,A01,494134,Staff,18,0,25,7
1713314528381,MUS 15,A02,494135,Staff,25,0,25,0
1713314528381,MUS 15,B01,494137,Staff,24,0,25,1
1713314529405,MUS 80,A00,494232,Staff,24,0,25,1
1713314529405,MUS 80,B00,494233,Staff,25,0,25,0
1713314529405,MUS 80,C00,494234,Staff,23,0,25,2
1713314530431,MUS 95C,A00,494141,Staff,72,0,75,3
1713314531460,MUS 114,A00,494142,Staff,41,0,50,9
1713314532485,NANO 15,A01,490636,Drews; Aaron,7,0,7,0
1713314533513,PHIL 1,A00,490578,Grush; Rick Scott,49,0,50,1
1713314534542,PHIL 10,A01,490580,Grush; Rick Scott,33,0,35,2
1713314534542,PHIL 10,A02,490586,Grush; Rick Scott,33,0,35,2
1713314535572,PHIL 27,A01,490591,Staff,24,0,25,1
1713314535572,PHIL 27,A02,490592,Staff,25,0,25,0
1713314535572,PHIL 27,A03,490593,Staff,25,0,25,0
1713314535572,PHIL 27,A04,490598,Staff,25,0,25,0
1713314536601,PHIL 32,A01,490611,Staff,20,0,20,0
1713314536601,PHIL 32,A02,490618,Staff,20,0,20,0
1713314537630,PHIL 90,A00,490624,Staff,40,0,40,0
1713314538656,PHIL 136,A00,490627,Cohen; Jonathan David,38,0,40,2
1713314539683,PHIL 155,A00,490634,Staff,64,0,70,6
1713314540710,PHYS 1A,A00,491610,Staff,246,0,250,4
1713314541736,PHYS 1AL,001,491616,Tsai; Philbert S,28,0,30,2
1713314541736,PHYS 1AL,002,491618,Tsai; Philbert S,30,0,30,0
1713314542764,PHYS 1B,A00,491623,Staff,244,0,250,6
1713314543788,PHYS 1BL,001,491626,Tsai; Philbert S,26,0,30,4
1713314543788,PHYS 1BL,002,491628,Tsai; Philbert S,28,0,30,2
1713314544817,PHYS 1C,A00,491632,Staff,220,0,245,25
1713314545844,PHYS 1CL,001,491635,Tsai; Philbert S,10,0,30,20
1713314545844,PHYS 1CL,002,491643,Tsai; Philbert S,24,0,30,6
1713314546876,PHYS 2AR,A01,491651,Meyertholen; Andrew D.,44,0,50,6
1713314547903,PHYS 2B,A01,491659,Staff,106,0,115,9
1713314548927,PHYS 2BL,A01,491685,Staff,21,0,24,3
1713314548927,PHYS 2BL,A02,491700,Staff,23,0,24,1
1713314549953,PHYS 2C,A01,505161,Staff,107,0,115,8
1713314550982,PHYS 4A,A01,491704,Grinstein; Benjamin,99,0,100,1
1713314552014,POLI 5D,A01,494144,Staff,3,0,5,2
1713314552014,POLI 5D,B01,626283,Dai; Yinlin,5,0,5,0
1713314553040,POLI 12,A00,494145,Staff,44,0,45,1
1713314554071,POLI 13R,A00,494146,Forman; Fonna,45,0,50,5
1713314555099,POLI 27,A01,494148,Staff,57,0,60,3
1713314556128,POLI 30,A00,494149,Staff,49,0,50,1
1713314557157,POLI 100DA,A00,494150,Staff,22,0,25,3
1713314559212,POLI 100I,A00,494152,Staff,28,0,30,2
1713314560238,POLI 104B,A00,494153,Smith; Glenn Chatmas,54,0,55,1
1713314561264,POLI 104F,A00,494154,Staff,28,0,30,2
1713314562292,POLI 104I,A00,494155,Smith; Glenn Chatmas,30,0,30,0
1713314563323,POLI 110C,A00,494156,Ingham; Sean,23,0,25,2
1713314564353,POLI 117R,A00,494157,Forman; Fonna,10,0,20,10
1713314565382,POLI 118,A00,494158,Ingham; Sean,22,0,25,3
1713314566409,POLI 120H,A00,494159,Fisk; David Lee,41,0,45,4
1713314567436,POLI 131CR,A00,494160,Hoston; Germaine,37,0,45,8
1713314568458,POLI 133J,A00,494161,Staff,33,0,35,2
1713314569483,POLI 135,A00,494162,Fisk; David Lee,33,0,35,2
1713314570510,POLI 140A,A00,494164,Staff,22,0,30,8
1713314571533,POLI 142I,A00,494165,Staff,30,0,30,0
1713314572562,POLI 144D,A00,494166,Staff,23,0,25,2
1713314573588,POLI 151,A00,494167,Staff,30,0,30,0
1713314574615,POLI 153,A00,494168,Staff,33,0,35,2
1713314575640,POLI 160AA,A00,494169,Staff,35,0,40,5
1713314576670,POLI 162,A00,494170,Mignozzetti; Umberto,20,0,25,5
1713314577694,POLI 171,A00,494171,Mignozzetti; Umberto,21,0,25,4
1713314578723,PSYC 1,A00,494172,Staff,97,0,100,3
1713314579748,PSYC 2,A00,494173,Moranton; Nirelia Melbina-,43,0,50,7
1713314580777,PSYC 3,A00,494174,Staff,29,0,30,1
1713314581804,PSYC 6,A00,494175,Staff,17,0,20,3
1713314582830,PSYC 60,A01,494177,Staff,39,0,45,6
1713314583858,PSYC 70,A01,505724,Geller; Emma Harlan,42,0,45,3
1713314584883,PSYC 101,A00,494180,Heyman; Gail D.,87,0,100,13
1713314585913,PSYC 105,A00,494181,Geller; Emma Harlan,63,0,90,27
1713314586939,PSYC 106,A00,494182,Dobkins; Karen R.,32,0,45,13
1713314587964,PSYC 108,A00,494183,Adrian; Julia Anna,93,0,100,7
1713314588994,PSYC 114,A01,494185,Winkielman; Piotr,0,0,30,30
1713314590019,PSYC 122,A00,494186,Moranton; Nirelia Melbina-,37,0,50,13
1713314591048,PSYC 124,A00,494187,Chapman; Eddie Nathaniel,72,0,80,8
1713314592074,PSYC 131,A00,494188,Anagnostaras; Stephan,53,0,80,27
1713314593097,PSYC 144,A00,494189,Staff,13,0,50,37
1713314594125,PSYC 154,A00,494190,Lacefield; Katharine I,131,0,180,49
1713314595151,PSYC 162,A00,494191,Wixted; John T,81,0,100,19
1713314596177,PSYC 172,A00,494192,Gorman; Michael R.,37,0,45,8
1713314597256,PSYC 178,A00,494193,Glaser; Dale,40,0,45,5
1713314598284,PSYC 193,A00,505725,Chapman; Eddie Nathaniel,20,0,20,0
1713314599316,RELI 145GS,A00,519817,Rahimi; Babak,18,0,20,2
1713314600347,SE 101A,A01,490862,Chadha; Mayank,23,0,25,2
1713314601377,SE 101C,A01,490924,Krysl; Petr,18,0,20,2
1713314602405,SE 110A,A01,490928,Staff,19,0,20,1
1713314603434,SE 130A,A00,490929,Morrison; Machel Leigh,60,0,70,10
1713314604459,SIO 1,A01,519325,Staff,39,0,40,1
1713314605487,SIO 30,A01,519327,Staff,39,0,40,1
1713314606512,SIO 40,A00,519328,Staff,40,0,40,0
1713314607539,SIO 46GS,A00,519819,Cook; Geoffrey W,18,0,25,7
1713314608569,SIO 109R,A00,494197,Forman; Fonna,4,0,20,16
1713314609596,SIO 121GS,A00,519827,Cook; Geoffrey W,18,0,25,7
1713314610621,SIO 132,A01,519330,Staff,38,0,40,2
1713314611648,SIO 133,A01,519397,Staff,38,0,40,2
1713314612679,SIO 139,A00,519396,Kacev; David,32,0,40,8
1713314613703,SOCI 1,A01,494199,Thorpe; Charles Robert,23,0,30,7
1713314613703,SOCI 1,A02,494200,Thorpe; Charles Robert,30,0,30,0
1713314613703,SOCI 1,A03,494201,Thorpe; Charles Robert,29,0,30,1
1713314613703,SOCI 1,A04,494202,Thorpe; Charles Robert,29,0,30,1
1713314613703,SOCI 1,A05,494203,Thorpe; Charles Robert,29,0,30,1
1713314613703,SOCI 1,A06,494204,Thorpe; Charles Robert,30,0,30,0
1713314613703,SOCI 1,A07,494205,Thorpe; Charles Robert,29,0,30,1
1713314614732,SOCI 60,A01,494207,Staff,36,0,40,4
1713314614732,SOCI 60,A02,494208,Staff,39,0,40,1
1713314615759,SOCI 100,A01,494210,Payne; Christine Anna,27,0,30,3
1713314615759,SOCI 100,A02,494211,Payne; Christine Anna,27,0,30,3
1713314616784,SOCI 109M,A00,494212,Staff,20,0,20,0
1713314617810,SOCI 110,A00,494213,Staff,35,0,40,5
1713314619863,SOCI 118E,A00,494215,Ng; Kwai,38,0,40,2
1713314620888,SOCI 125,A00,494216,Calderon-Zaks; Michael Aar,42,0,45,3
1713314621916,SOCI 126,A01,494218,Jones; Makeba,4,0,5,1
1713314622946,SOCI 131,A00,494219,Thorpe; Charles Robert,28,0,30,2
1713314625006,SOCI 135,A00,494221,Payne; Christine Anna,34,0,50,16
1713314626030,SOCI 136E,A00,626690,Ruiz; Jonathan Joseph,25,0,25,0
1713314627060,SOCI 138GS,A00,494222,Navon; Daniel,24,0,28,4
1713314629113,SOCI 145,A00,494224,Staff,42,0,45,3
1713314630139,SOCI 153,A00,494225,Staff,28,0,30,2
1713314631165,SOCI 160E,A00,494226,Ng; Kwai,32,0,40,8
1713314632192,SOCI 180,A00,494227,Staff,29,0,30,1
1713314633222,SOCI 189GS,A00,494228,Ribas Norris; Janet Vanesa,11,0,11,0
1713314634250,SOCI 190GS,A00,553232,Ribas Norris; Janet Vanesa,11,0,11,0
1713314635276,SOMI 220,A00,627178,Schneid; Stephen David,30,0,30,0
1713314636306,SYN 2,001,490768,Staff,14,0,15,1
1713314636306,SYN 2,002,490769,Staff,15,0,15,0
1713314636306,SYN 2,004,490775,Staff,0,0,0,0
1713314636306,SYN 2,003,490774,Staff,0,0,0,0
1713314636306,SYN 2,005,490776,Staff,0,0,0,0
1713314637331,SYN 2R,001,490779,Staff,12,0,15,3
1713314637331,SYN 2R,002,514635,Staff,14,0,15,1
1713314638356,SYN 100,A01,490783,Staff,15,0,20,5
1713314638356,SYN 100,B01,490787,Staff,10,0,20,10
1713314638356,SYN 100,C01,490789,Staff,12,0,20,8
1713314639381,SYN 150,A00,490817,Staff,14,0,15,1
1713314639381,SYN 150,B00,514610,Staff,15,0,15,0
1713314640414,TDAC 1,A00,492753,Walsh; Kim C.,19,0,20,1
1713314640414,TDAC 1,B00,492754,Harting; Carla Kelso,19,0,20,1
1713314640414,TDAC 1,C00,513995,Salovey; Todd,17,0,20,3
1713314641440,TDAC 101,A00,492766,Harting; Carla Kelso,17,0,20,3
1713314642471,TDAC 102,A00,492768,Basso; Beatrice,19,0,20,1
1713314643498,TDDE 111,A00,492769,Staff,25,0,25,0
1713314644528,TDDE 131,A00,492770,Staff,15,0,15,0
1713314644528,TDDE 131,B00,492771,Staff,15,0,15,0
1713314645556,TDDE 131GS,A00,523716,Guirguis; Mark C,24,0,28,4
1713314646583,TDGE 1,A01,492756,Salovey; Todd,57,0,60,3
1713314647608,TDGE 5,A01,492758,Staff,24,0,25,1
1713314648635,TDGE 10,A00,492759,Fulton; Julia,209,0,220,11
1713314649660,TDGE 11,A00,492760,Castro; Robert Jess,199,0,200,1
1713314651720,TDGE 124,A00,492772,Fulton; Julia,192,0,220,28
1713314652752,TDGE 125,A00,492773,Meyer; Ursula,40,0,50,10
1713314652752,TDGE 125,B00,492774,Staff,50,0,50,0
1713314652752,TDGE 125,C00,523565,Staff,49,0,50,1
1713314653782,TDGE 125GS,A00,523580,Guirguis; Mark C,24,0,28,4
1713314654807,TDGE 127,A00,492775,Havis; Allan,41,0,50,9
1713314655834,TDHT 101,A00,492776,Staff,35,0,35,0
1713314656863,TDMV 1,A00,492762,Caligagan; Maria T.,30,0,30,0
1713314656863,TDMV 1,B00,492763,Arcidiacono; Kristin,25,0,30,5
1713314657892,TDMV 2,A00,492764,Weinberg; Sadie,29,0,30,1
1713314658923,TDMV 3,A00,492765,Mack; Kara Shanai',39,0,40,1
1713314659947,TDMV 138,A00,492777,Mack; Kara Shanai',36,0,40,4
1713314660974,TDMV 140,A00,492778,Lima; Paulo Henrique,40,0,40,0
1713314662001,TDMV 142,A00,492779,Caligagan; Maria T.,36,0,40,4
1713314662001,TDMV 142,B00,492780,Caligagan; Tony,37,0,40,3
1713314663027,TDMV 143,A00,492781,Fyall; Daunte Edward,39,0,40,1
1713314664056,USP 1,A01,492401,Kwak; Nancy,26,0,35,9
1713314665085,USP 2,A01,492453,Hinds; Juli Beth,35,0,35,0
1713314666110,USP 3,A01,492516,Staff,29,0,35,6
1713314667138,USP 4,A00,492522,McTague; Sarah,19,0,25,6
1713314668164,USP 100,A00,492523,Staff,33,0,35,2
1713314669188,USP 101,A00,492524,Staff,13,0,15,2
1713314670213,USP 105,A00,492525,Staff,21,0,25,4
1713314671242,USP 151,A00,492526,Shenkman; Michael Thomas,33,0,35,2
1713314672272,USP 170,A00,492545,Hinds; Juli Beth,33,0,35,2
1713314673304,USP 171GS,A00,492608,Bussell; Mirle Rabinowitz,25,0,28,3
1713314674333,USP 183GS,A00,492613,Peerson; Susan,25,0,28,3
1713314675357,VIS 30,A01,490693,Yoldas; Pinar,21,0,22,1
1713314675357,VIS 30,A02,490694,Yoldas; Pinar,19,0,22,3
1713314676384,VIS 83,A00,490695,Kester; Grant,66,0,75,9
1713314677506,VIS 105D,A00,490696,Staff,22,0,25,3
1713314678530,VIS 124CN,A00,490699,Rose; Jordan M,68,0,75,7
1713314679558,VIS 125GS,A00,511221,Williams; Alena J,21,0,22,1
1713314680587,VIS 128D,A00,490700,Staff,74,0,75,1
1713314681611,VIS 151,A01,490717,Staff,33,0,34,1
1713314681611,VIS 151,A02,490766,Staff,33,0,34,1
1713314682636,VIS 154GS,A00,511972,Williams; Alena J,21,0,22,1
1713314683667,VIS 160A,A00,490767,Stone; Patricia,7,0,10,3
1713314684695,WCWP 10A,A00,490638,Staff,14,0,15,1
1713314684695,WCWP 10A,B00,490640,Staff,15,0,15,0
1713314685724,WCWP 10B,A00,490641,Staff,0,0,0,0
1713314685724,WCWP 10B,B00,490642,Staff,14,0,15,1
1713314685724,WCWP 10B,C00,490644,Staff,13,0,15,2
1713314685724,WCWP 10B,D00,490647,Staff,0,0,0,0
1713314686753,WCWP 100,A00,490655,Staff,0,0,0,0
1713314686753,WCWP 100,B00,490687,Staff,11,0,15,4
1713314688886,ANAR 153,A00,487222,Braswell; Geoffrey E.,54,0,60,6
1713314689911,ANBI 134,A00,487223,Staff,12,0,20,8
1713314690936,ANBI 143GS,A00,487224,Noel; Geoffroy Pierre Jean,20,0,24,4
1713314691960,ANBI 144GS,A00,519548,Noel; Geoffroy Pierre Jean,20,0,24,4
1713314692987,ANSC 101,A00,487225,Staff,19,0,20,1
1713314694014,ANSC 125,A00,487227,Brenner; Suzanne A,39,0,40,1
1713314696064,ANSC 146,A00,487229,Staff,36,0,40,4
1713314697109,ANSC 148,A00,487230,Olivas Hernandez; Olga Lid,39,0,40,1
1713314698137,ANSC 150,A00,504165,Sloane; Julia Kathryn,19,0,20,1
1713314699166,ANSC 180,A00,487232,Staff,13,0,15,2
1713314700193,ANSC 188,A00,627155,Staff,40,0,40,0
1713314701296,ANTH 5,A00,519529,Semendeferi; Ekaterini,15,0,15,0
1713314702324,ANTH 10,A00,487219,Staff,58,0,60,2
1713314703351,ANTH 23,A01,487221,Staff,17,0,20,3
1713314704381,ANTH 102,A00,487233,Wilder; Linnea Lorene,51,0,60,9
1713314705406,ANTH 103,A00,487234,Varma; Saiba,56,0,60,4
1713314706430,ANTH 105,A00,487235,Stewart; Alexander B,56,0,60,4
1713314707454,BENG 100,A01,516685,Taylor Amos; Alyssa C,28,0,30,2
1713314708479,BIBC 102,A01,491316,Flagg; Matthew Paul,36,0,88,52
1713314708479,BIBC 102,A02,491366,Flagg; Matthew Paul,83,0,88,5
1713314709505,BIBC 103,A01,491486,Boumechache; Miyyada,16,0,24,8
1713314709505,BIBC 103,A02,491487,Boumechache; Miyyada,24,0,24,0
1713314710539,BICD 100,A01,516882,Staff,75,0,75,0
1713314710539,BICD 100,A02,516890,Staff,70,0,75,5
1713314711567,BICD 102GS,A00,491488,Lo; Stanley M.,26,0,28,2
1713314712593,BIEB 136GS,A00,516940,Holway; David A. & Shurin; Jonathan,19,0,24,5
1713314713618,BIEB 137GS,A01,517034,Holway; David A. & Shurin; Jonathan,19,0,24,5
1713314714644,BIEB 138GS,A01,491492,Pirino; Giorgia,21,0,28,7
1713314715674,BILD 1,A01,491296,Staff,62,0,63,1
1713314715674,BILD 1,A02,491297,Staff,63,0,63,0
1713314716700,BILD 4,A01,517099,Gonzalez Gamboa; Ivonne,22,0,24,2
1713314716700,BILD 4,A02,517100,Gonzalez Gamboa; Ivonne,24,0,24,0
1713314717726,BILD 60GS,A00,491309,Lo; Stanley M.,26,0,28,2
1713314718756,BIMM 100,A01,517136,Staff,89,0,100,11
1713314719781,BIMM 110,A01,517182,Staff,69,0,100,31
1713314720807,BIMM 120,A01,517228,Pickett; Brooke Elizabeth,38,0,63,25
1713314720807,BIMM 120,A02,517240,Pickett; Brooke Elizabeth,48,0,63,15
1713314721835,BIMM 132GS,A01,491498,Pirino; Giorgia,21,0,28,7
1713314722860,BIMM 143,A01,491589,Bozinovic; Goran,17,0,40,23
1713314723891,BIPN 100,A01,491594,Armour; Jon Christopher,91,0,100,9
1713314724920,BIPN 140,A01,491602,Marino; Marc J,29,0,50,21
1713314726977,CAT 125,A00,515973,Staff,19,0,20,1
1713314728003,CAT 125GS,A00,515974,Rahimi; Babak,18,0,20,2
1713314729031,CAT 125R,A00,515980,Staff,14,0,20,6
1713314729031,CAT 125R,B00,515981,Tosun; Adriana,19,0,20,1
1713314729031,CAT 125R,C00,515987,Hyland; Tina Mae,2,0,20,18
1713314729031,CAT 125R,D00,515988,Bronstein; Phoebe Malan,18,0,20,2
1713314730061,CENG 15,A01,488699,Drews; Aaron,25,0,25,0
1713314731087,CENG 100,A00,505196,Opatkiewicz; Justin Paul,25,0,25,0
1713314732112,CGS 2A,A01,489598,Staff,33,0,35,2
1713314733140,CGS 112,A00,489599,Staff,15,0,15,0
1713314734167,CGS 119,A00,489603,Staff,10,0,10,0
1713314735197,CGS 120,A00,489604,Staff,14,0,15,1
1713314736220,CGS 150,A00,489607,Staff,15,0,15,0
1713314737246,CHEM 6A,A01,488715,Staff,98,0,100,2
1713314738276,CHEM 6B,A01,488719,Piercy; Marc Anthony,100,0,100,0
1713314739300,CHEM 6C,A01,488723,Albizati; Kim F.,94,0,100,6
1713314740336,CHEM 7L,A01,488728,Schurmeier; Kimberly,18,0,24,6
1713314740336,CHEM 7L,A02,488730,Schurmeier; Kimberly,23,0,24,1
1713314740336,CHEM 7L,A03,488734,Schurmeier; Kimberly,23,0,24,1
1713314740336,CHEM 7L,A04,488763,Schurmeier; Kimberly,23,0,24,1
1713314740336,CHEM 7L,B01,488798,Schurmeier; Kimberly,18,0,24,6
1713314740336,CHEM 7L,B02,488801,Schurmeier; Kimberly,23,0,24,1
1713314740336,CHEM 7L,B03,488808,Schurmeier; Kimberly,24,0,24,0
1713314740336,CHEM 7L,B04,488811,Schurmeier; Kimberly,24,0,24,0
1713314741364,CHEM 11,A01,488897,Stallings; Dontarie M,98,0,100,2
1713314742391,CHEM 40A,A01,488913,Albizati; Kim F.,90,0,100,10
1713314743417,CHEM 40B,A01,488920,Weizman; Haim,46,0,50,4
1713314743417,CHEM 40B,A02,488938,Weizman; Haim,46,0,50,4
1713314744442,CHEM 41A,A01,489029,Klosterman; Jeremy K,58,0,60,2
1713314745467,CHEM 41C,A01,500436,Tor; Yitzhak,55,0,60,5
1713314746500,CHEM 43A,A01,500426,Weizman; Haim,2,0,24,22
1713314746500,CHEM 43A,A02,500430,Weizman; Haim,13,0,24,11
1713314746500,CHEM 43A,B01,514041,Klosterman; Jeremy K,15,0,24,9
1713314746500,CHEM 43A,B02,514047,Klosterman; Jeremy K,23,0,24,1
1713314747532,CHEM 108,A01,489140,Jennings; Patricia A.,13,0,24,11
1713314747532,CHEM 108,A02,489142,Jennings; Patricia A.,15,0,24,9
1713314748559,CHEM 114A,A01,489147,Stallings; Dontarie M,78,0,100,22
1713314749590,CHIN 169A,A00,489171,Wang; Xiao,19,0,20,1
1713314751645,COGS 3,A01,518827,Boyle; Mary E. T.,29,0,40,11
1713314752669,COGS 11,A01,489175,Staff,28,0,30,2
1713314753699,COGS 14A,A01,518829,Staff,51,0,60,9
1713314754730,COGS 14B,A01,489177,Hoffman; Drew Ellen,69,0,75,6
1713314755761,COGS 100,A01,489181,Allen; Michael Gordon,66,0,75,9
1713314756785,COGS 101A,A01,489183,Staff,48,0,60,12
1713314757812,COGS 101B,A01,489185,Allen; Michael Gordon,12,0,30,18
1713314758837,COGS 101C,A01,526786,Staff,24,0,30,6
1713314760894,COGS 107A,A01,489189,Boyle; Mary E. T.,19,0,35,16
1713314761920,COGS 107B,A01,627144,Mooshagian; Eric Frederick,60,0,60,0
1713314762948,COGS 118A,A01,489191,Staff,0,35,40,40
1713314765000,COGS 171GS,A01,489194,Pineda; Jaime A,22,0,28,6
1713314766028,COGS 172,A01,489196,Staff,3,0,30,27
1713314767056,COGS 174GS,A01,489264,Pineda; Jaime A,22,0,28,6
1713314768086,COGS 180,A01,627150,Staff,28,0,30,2
1713314769111,COGS 186,A01,489274,Staff,1,0,30,29
1713314770139,COMM 10,A01,489276,Staff,23,0,25,2
1713314770139,COMM 10,A02,489303,Staff,23,0,25,2
1713314771168,COMM 100A,A01,489312,Staff,16,0,25,9
1713314771168,COMM 100A,A02,489313,Staff,24,0,25,1
1713314772193,COMM 106T,A00,512540,Staff,34,0,35,1
1713314773221,COMM 107,A00,489347,Staff,31,0,35,4
1713314774247,COMM 109P,A00,489358,Staff,31,0,35,4
1713314775271,COMM 132,A00,489361,McKenna; Denise,28,0,30,2
1713314776296,COMM 146,A00,489362,Halm; Gavin Patrick,27,0,30,3
1713314777323,COMM 190,A00,489363,Abuelhiga; Soraya Jill,20,0,23,3
1713314778351,CSE 8A,A50,489366,Staff,22,0,25,3
1713314778351,CSE 8A,A51,489367,Staff,24,0,25,1
1713314779379,CSE 11,A01,489398,Cao; Yingjun,79,0,100,21
1713314780405,CSE 12,A01,489487,Staff,43,0,50,7
1713314781430,CSE 20,A01,489497,Staff,48,0,50,2
1713314782458,CSE 21,A01,489517,Braun; Oliver,43,0,50,7
1713314783487,CSE 101,A01,489524,Braun; Oliver,0,16,50,50
1713314784516,CSE 105,A01,512594,Jones; Miles E,78,0,100,22
1713314784516,CSE 105,B01,512598,Jones; Miles E,60,0,100,40
1713314785544,CSE 140,A01,489538,Staff,44,0,50,6
1713314786571,CSE 141,A01,489550,Eldon; John,75,0,100,25
1713314787602,CSE 141L,A01,489571,Eldon; John,73,0,100,27
1713314788629,CSE 151A,A01,489583,Solares; Edwin A,148,0,200,52
1713314789659,CSE 175,A01,510886,Kumar; Rakesh,30,0,30,0
1713314790689,CSE 190,A00,516828,Dubnov; Shlomo,40,0,49,9
1713314791718,DOC 100D,A00,489667,Pass; Natalye Joann,21,0,25,4
1713314792743,DSC 10,A01,624268,Staff,72,0,75,3
1713314793768,DSC 20,A01,624476,Staff,50,0,50,0
1713314794794,DSC 40A,A01,624608,Staff,39,0,40,1
1713314795819,DSGN 1,A01,489179,Rill; Bryan,36,0,50,14
1713314796846,ECE 17,A01,490489,Sahay; Rajeev,18,0,30,12
1713314797872,ECE 65,A50,490492,Staff,15,0,20,5
1713314797872,ECE 65,A51,490493,Staff,20,0,20,0
1713314798900,ECON 1,A01,489715,Famulari; Melissa,68,0,70,2
1713314799930,ECON 2,A01,489717,Levkoff; Steven B.,68,0,70,2
1713314800956,ECON 3,A01,489948,Staff,70,0,70,0
1713314803018,ECON 5,A01,490103,Staff,28,0,30,2
1713314803018,ECON 5,B01,626281,Dai; Yinlin,45,0,45,0
1713314804043,ECON 100A,A01,490127,Famulari; Melissa,67,0,70,3
1713314805129,ECON 100B,A01,490129,Staff,64,0,70,6
1713314806158,ECON 109,A01,490187,Shishkin; Denis,27,0,35,8
1713314807183,ECON 110A,A01,490190,Levkoff; Steven B.,62,0,70,8
1713314808211,ECON 120A,A01,490245,Dai; Yinlin,64,0,70,6
1713314809243,ECON 120B,A01,490247,Nieto-Barthaburu; Augusto,55,0,70,15
1713314810273,ECON 120C,A01,490253,Sun; Yixiao,30,0,35,5
1713314810273,ECON 120C,B01,490255,Sun; Yixiao,34,0,35,1
1713314811300,ECON 129,A00,490256,Eckert; Fabian Paul,25,0,35,10
1713314812327,ECON 131,A00,490257,Nieto-Barthaburu; Augusto,0,1,35,35
1713314813358,ECON 138,A00,490258,Bharadwaj; Prashant,19,0,35,16
1713314813358,ECON 138,B00,490259,Bharadwaj; Prashant,17,0,35,18
1713314814382,ECON 159,A00,490260,Hendrickson; Gerald M.,0,8,0,0
1713314815411,ECON 178,A01,553995,Zhu; Ying,26,0,35,9
1713314816439,EDS 40,A01,512576,Black; Alison Michelle,20,0,20,0
1713314817468,EDS 107,A01,515848,Staff,30,0,30,0
1713314818493,EDS 110R,A01,490262,Staff,26,0,30,4
1713314819518,EDS 112,A01,490264,Chapman; Thandeka K,42,0,50,8
1713314820543,EDS 113,A00,490266,Staff,26,0,30,4
1713314821571,EDS 118,A00,490267,Warstadt; Melissa Fawn,24,0,30,6
1713314822599,EDS 124BR,A00,490268,Eguchi; Emi,7,0,25,18
1713314822599,EDS 124BR,B00,490269,Eguchi; Emi,25,0,25,0
1713314823631,EDS 126,A01,490271,Jones; Makeba,44,0,50,6
1713314824661,EDS 135,A01,490316,Staff,19,0,20,1
1713314825689,ENVR 142GS,A00,519514,Chang; Edmond Yi-Teh,28,0,28,0
1713314826714,ETHN 103,A00,490504,Staff,31,0,36,5
1713314827741,ETHN 103A,A00,490505,Man; Simeon S,5,0,9,4
1713314828769,ETHN 109,A00,490506,Staff,30,0,30,0
1713314829795,ETHN 118,A00,490507,Staff,35,0,36,1
1713314830823,ETHN 119,A00,490508,Staff,34,0,36,2
1713314831848,ETHN 121R,A00,490518,Choi; Esther Min,26,0,36,10
1713314832873,ETHN 127,A00,490528,Staff,15,0,15,0
1713314833903,ETHN 139,A00,490573,Staff,10,0,10,0
1713314834927,ETHN 150,A00,490575,Staff,15,0,15,0
1713314835955,GLBH 20,A00,491705,Elwardani; Nile Regina,38,0,40,2
1713314836983,GLBH 101,A00,491706,Staff,20,0,20,0
1713314838011,GLBH 111,A01,491708,Burgos; Jose L.,15,0,15,0
1713314839035,GLBH 146,A00,491709,Staff,11,0,20,9
1713314840060,GLBH 148,A00,491710,Olivas Hernandez; Olga Lid,14,0,20,6
1713314841090,GLBH 150,A00,491711,Sloane; Julia Kathryn,20,0,20,0
1713314842114,HIEA 131,A00,491760,Staff,29,0,32,3
1713314843139,HIEA 153,A00,491762,Staff,29,0,30,1
1713314844166,HIEU 124,A00,491811,Staff,26,0,32,6
1713314845195,HIEU 124GS,A00,491812,Markman; Kristina,27,0,28,1
1713314846220,HIEU 147,A00,491813,Staff,30,0,32,2
1713314847248,HIEU 149GS,A00,491816,Caldwell; Michael Alan,28,0,28,0
1713314848279,HILD 2C,A01,491713,Hendrickson; Gerald M.,27,0,30,3
1713314849305,HILD 7B,A01,491715,Kwak; Nancy,6,0,30,24
1713314850328,HILD 10,A01,491717,Staff,13,0,20,7
1713314851357,HILD 30GS,A00,491719,Edington; Claire Ellen,24,0,28,4
1713314852382,HINE 109,A00,491818,Shafir; Nir,28,0,32,4
1713314853410,HINE 128,A00,491821,Shafir; Nir,31,0,32,1
1713314854437,HISC 117,A00,491830,Staff,29,0,32,3
1713314855463,HIUS 103,A00,491834,Man; Simeon S,15,0,23,8
1713314856490,HIUS 108B,A00,491835,Staff,29,0,30,1
1713314857519,HIUS 141,A00,491836,Hendrickson; Gerald M.,29,0,32,3
1713314858545,HIUS 149,A00,491839,Staff,28,0,32,4
1713314859570,HUM 3,A01,512617,Crum; Matthew Stephen,45,0,50,5
1713314859570,HUM 3,A02,512618,Crum; Matthew Stephen,48,0,50,2
1713314860599,HUM 3GS,A00,512663,Markman; Kristina,0,0,0,1
1713314860599,HUM 3GS,B00,512664,Staff,0,0,0,0
1713314861630,HUM 4,A01,512620,West; Geoffrey Scott,31,0,50,19
1713314862655,HUM 4GS,A00,512666,Lyon; Antony J.,0,0,0,3
1713314863680,HUM 4R,A01,512625,Watkins; Eric,49,0,50,1
1713314864709,HUM 5,A01,512649,Zavodny; Tatiana Sophia,30,0,50,20
1713314864709,HUM 5,B01,512661,Zroka; Ryan Edward,48,0,50,2
1713314865734,INTL 190,A00,490577,Segui; Alan S,0,0,0,5
1713314866760,JAPN 20AR,A01,491267,Ross; Kayoko F,9,0,20,11
1713314867787,JAPN 180,A00,491285,Berman; Michael David,34,0,40,6
1713314868818,LATI 50,A01,502536,Kokinis; Troy Andreas,16,0,22,6
1713314868818,LATI 50,A02,502551,Kokinis; Troy Andreas,22,0,22,0
1713314868818,LATI 50,A03,502650,Kokinis; Troy Andreas,22,0,22,0
1713314868818,LATI 50,A04,502909,Kokinis; Troy Andreas,22,0,22,0
1713314869846,LATI 160,A01,502920,Kokinis; Troy Andreas,30,0,30,0
1713314870878,LIFR 1A,A00,490494,Van Moer; Vinciane G,17,0,20,3
1713314871909,LIFR 1AX,A00,490495,Van Moer; Vinciane G,17,0,20,3
1713314872934,LIFR 1B,A00,490496,Van Moer; Vinciane G,18,0,20,2
1713314873959,LIFR 1BX,A00,490497,Van Moer; Vinciane G,18,0,20,2
1713314874983,LIGN 8,A00,505198,McIntosh; Justin Daniel,136,0,150,14
1713314876010,LIGN 9GS,A00,491239,Lott; Margaret S.,18,0,20,2
1713314877039,LIGN 101,A01,505200,McIntosh; Justin Daniel,24,0,30,6
1713314878063,LIGN 120,A01,491244,Staff,24,0,30,6
1713314879091,LIGN 149GS,A00,491245,Lott; Margaret S.,18,0,20,2
1713314880120,LIGN 170,A00,491247,Staff,24,0,30,6
1713314881152,LISP 1D,A00,490498,Munoz Sanchez; Alicia,10,0,14,4
1713314881152,LISP 1D,B00,490499,Munoz Sanchez; Alicia,6,0,14,8
1713314881152,LISP 1D,C00,490500,Munoz Sanchez; Alicia,8,0,14,6
1713314881152,LISP 1D,D00,490501,Munoz Sanchez; Alicia,10,0,14,4
1713314882176,LISP 1DX,A00,490502,Munoz Sanchez; Alicia,15,0,28,13
1713314882176,LISP 1DX,B00,490503,Munoz Sanchez; Alicia,17,0,28,11
1713314884230,LTAM 110,A00,491847,Staff,23,0,25,2
1713314885255,LTCS 119,A00,491848,Staff,12,0,15,3
1713314886286,LTCS 130,A00,491849,Staff,24,0,25,1
1713314888340,LTEA 120C,A00,491852,Staff,34,0,40,6
1713314889364,LTEN 130GS,A00,491853,Lyon; Antony J.,25,0,28,3
1713314890388,LTEN 148,A00,491855,Staff,23,0,25,2
1713314891417,LTEN 159,A00,491856,Staff,21,0,25,4
1713314892446,LTEN 180,A00,491857,Staff,9,0,15,6
1713314894502,LTSP 123GS,A00,505928,Bessett; Ryan Matthew,24,0,28,4
1713314895529,LTSP 174GS,A00,506037,Bessett; Ryan Matthew,24,0,28,4
1713314897582,LTWR 102,A00,491861,Staff,11,0,15,4
1713314898607,LTWR 106,A00,491862,Staff,10,0,15,5
1713314899633,MAE 11,A00,490930,Bahadori; Mohammad Yousef,97,0,100,3
1713314900662,MAE 30A,A00,490931,Qi; Huihui,37,0,40,3
1713314901687,MAE 101A,A00,491036,Sadeghizadeh; Zahra,97,0,100,3
1713314902712,MAE 101C,A00,491037,Seshadri; Kalyanasundaram,76,0,100,24
1713314903741,MAE 113,A00,491040,Seshadri; Kalyanasundaram,66,0,80,14
1713314904765,MAE 131A,A00,491041,Ghazinejad; Maziar,39,0,40,1
1713314905791,MAE 142,A00,491053,Staff,39,0,40,1
1713314906816,MAE 143A,A00,491054,Staff,38,0,50,12
1713314907840,MAE 150,A00,491092,Truong; Phuong Thi Ngoc,23,0,35,12
1713314908922,MATH 3C,A01,494031,Pardo Guerra; Sebastian,30,0,30,0
1713314908922,MATH 3C,A02,494032,Pardo Guerra; Sebastian,29,0,30,1
1713314909948,MATH 10A,A01,494034,Staff,27,0,30,3
1713314909948,MATH 10A,A02,494035,Staff,28,0,30,2
1713314909948,MATH 10A,B01,494037,Staff,27,0,30,3
1713314909948,MATH 10A,B02,494038,Staff,29,0,30,1
1713314910984,MATH 10B,A01,494040,Habib; Yousaf,24,0,30,6
1713314910984,MATH 10B,A02,494041,Habib; Yousaf,28,0,30,2
1713314910984,MATH 10B,A03,494042,Habib; Yousaf,30,0,30,0
1713314910984,MATH 10B,A04,494043,Habib; Yousaf,30,0,30,0
1713314910984,MATH 10B,B01,494045,Habib; Yousaf,28,0,30,2
1713314910984,MATH 10B,B02,494046,Habib; Yousaf,30,0,30,0
1713314910984,MATH 10B,B03,494047,Habib; Yousaf,30,0,30,0
1713314910984,MATH 10B,B04,494048,Habib; Yousaf,30,0,30,0
1713314912019,MATH 18,A01,494050,Kemp; Todd Aahron,25,0,30,5
1713314912019,MATH 18,A02,494051,Kemp; Todd Aahron,29,0,30,1
1713314912019,MATH 18,B01,494054,Kemp; Todd Aahron,28,0,30,2
1713314912019,MATH 18,B02,494055,Kemp; Todd Aahron,29,0,30,1
1713314913047,MATH 20A,A01,494059,Suk; Andrew Hoon,30,0,30,0
1713314914073,MATH 20B,A01,494061,Briones; Jor-el Thomas Caparas,33,0,35,2
1713314914073,MATH 20B,B01,494063,Bach; Quang Tran,34,0,35,1
1713314915104,MATH 20C,A01,494065,Staff,28,0,30,2
1713314915104,MATH 20C,A02,494066,Staff,30,0,30,0
1713314915104,MATH 20C,A03,494067,Staff,30,0,30,0
1713314915104,MATH 20C,A04,494068,Staff,30,0,30,0
1713314915104,MATH 20C,B01,494070,Zhang; Ming,26,0,30,4
1713314915104,MATH 20C,B02,494071,Zhang; Ming,29,0,30,1
1713314915104,MATH 20C,B03,494072,Zhang; Ming,29,0,30,1
1713314915104,MATH 20C,B04,494073,Zhang; Ming,29,0,30,1
1713314916129,MATH 20D,A01,494075,Staff,24,0,30,6
1713314916129,MATH 20D,A02,494076,Staff,30,0,30,0
1713314917155,MATH 20E,A01,494079,Staff,25,0,30,5
1713314917155,MATH 20E,A02,494080,Staff,27,0,30,3
1713314917155,MATH 20E,B01,494082,Staff,27,0,30,3
1713314917155,MATH 20E,B02,494083,Staff,25,0,30,5
1713314918182,MATH 103A,A01,494085,Aliabadi Sr.; Mohsen,17,0,30,13
1713314918182,MATH 103A,A02,494086,Aliabadi Sr.; Mohsen,28,0,30,2
1713314918182,MATH 103A,B01,494088,Aliabadi Sr.; Mohsen,22,0,30,8
1713314918182,MATH 103A,B02,494089,Aliabadi Sr.; Mohsen,28,0,30,2
1713314919213,MATH 109,A01,494091,Staff,30,0,30,0
1713314919213,MATH 109,A02,494092,Staff,29,0,30,1
1713314919213,MATH 109,B01,494094,Staff,28,0,30,2
1713314919213,MATH 109,B02,494095,Staff,29,0,30,1
1713314920240,MATH 142A,A01,494097,Chow; Bennett,15,0,30,15
1713314920240,MATH 142A,A02,494098,Chow; Bennett,24,0,30,6
1713314920240,MATH 142A,B01,494100,Chow; Bennett,19,0,30,11
1713314920240,MATH 142A,B02,494101,Chow; Bennett,29,0,30,1
1713314922296,MATH 168A,A01,516677,Dumitriu; Ioana,15,0,35,20
1713314923322,MATH 170A,A01,516679,Dumitriu; Ioana,20,0,30,10
1713314923322,MATH 170A,A02,516680,Dumitriu; Ioana,28,0,30,2
1713314924353,MATH 193A,A01,494107,Staff,16,0,30,14
1713314924353,MATH 193A,A02,494108,Staff,21,0,30,9
1713314924353,MATH 193A,A03,494109,Staff,29,0,30,1
1713314924353,MATH 193A,A04,494110,Staff,22,0,30,8
1713314927430,MGT 16,A00,491930,McKay; Michael J,92,0,98,6
1713314928456,MGT 18,A00,491992,McKay; Michael J,97,0,98,1
1713314929480,MGT 71,A00,492003,Staff,76,0,98,22
1713314930505,MGT 103,A00,505209,Eberhard; Craig A,85,0,98,13
1713314931536,MGT 131A,A00,505210,Anderson; John Charles,91,0,98,7
1713314933589,MGT 153,A00,492077,Perols; Johan Lars,36,0,90,54
1713314936669,MGT 164,A00,492222,McKay; Mary A,93,0,98,5
1713314937696,MGT 172,A00,492245,Staff,59,0,60,1
1713314937696,MGT 172,B00,505526,Hedges; Kathleen,75,0,98,23
1713314938724,MGT 181,A00,505669,Dunn; Louis Jean,85,0,98,13
1713314939750,MMW 14,A01,494399,Staff,23,0,28,5
1713314939750,MMW 14,A02,494400,Staff,25,0,28,3
1713314939750,MMW 14,A03,494401,Staff,28,0,28,0
1713314939750,MMW 14,A04,494402,Staff,28,0,28,0
1713314939750,MMW 14,B01,494404,Carreras; Maria Victoria,13,0,28,15
1713314939750,MMW 14,B02,494405,Carreras; Maria Victoria,26,0,28,2
1713314939750,MMW 14,B03,494406,Carreras; Maria Victoria,28,0,28,0
1713314939750,MMW 14,B04,494407,Carreras; Maria Victoria,28,0,28,0
1713314940777,MMW 14GS,A00,506250,Chang; Edmond Yi-Teh,0,0,0,0
1713314941805,MMW 121R,A01,494415,Adamiak; Patrick John,14,0,28,14
1713314941805,MMW 121R,A02,494416,Adamiak; Patrick John,24,0,28,4
1713314942830,MUS 1A,A01,494113,Staff,12,0,25,13
1713314942830,MUS 1A,A02,494114,Staff,25,0,25,0
1713314943873,MUS 4,A01,494116,Staff,24,0,25,1
1713314943873,MUS 4,A02,494117,Staff,22,0,25,3
1713314944904,MUS 5R,A01,494236,Dubnov; Shlomo,10,0,25,15
1713314944904,MUS 5R,A02,494237,Dubnov; Shlomo,25,0,25,0
1713314945930,MUS 6,A01,494122,Staff,13,0,25,12
1713314945930,MUS 6,A02,494123,Staff,24,0,25,1
1713314946955,MUS 7,A01,494125,Staff,17,0,25,8
1713314946955,MUS 7,A02,494126,Staff,24,0,25,1
1713314947980,MUS 11,A01,494128,Staff,23,0,25,2
1713314947980,MUS 11,A02,494129,Staff,25,0,25,0
1713314949005,MUS 13,A01,494131,Staff,25,0,25,0
1713314949005,MUS 13,A02,494132,Staff,25,0,25,0
1713314950030,MUS 15,A01,494134,Staff,18,0,25,7
1713314950030,MUS 15,A02,494135,Staff,25,0,25,0
1713314950030,MUS 15,B01,494137,Staff,24,0,25,1
1713314951059,MUS 80,A00,494232,Staff,24,0,25,1
1713314951059,MUS 80,B00,494233,Staff,25,0,25,0
1713314951059,MUS 80,C00,494234,Staff,23,0,25,2
1713314952084,MUS 95C,A00,494141,Staff,72,0,75,3
1713314953131,MUS 114,A00,494142,Staff,41,0,50,9
1713314954158,NANO 15,A01,490636,Drews; Aaron,7,0,7,0
1713314955189,PHIL 1,A00,490578,Grush; Rick Scott,49,0,50,1
1713314956214,PHIL 10,A01,490580,Grush; Rick Scott,33,0,35,2
1713314956214,PHIL 10,A02,490586,Grush; Rick Scott,33,0,35,2
1713314957238,PHIL 27,A01,490591,Staff,24,0,25,1
1713314957238,PHIL 27,A02,490592,Staff,25,0,25,0
1713314957238,PHIL 27,A03,490593,Staff,25,0,25,0
1713314957238,PHIL 27,A04,490598,Staff,25,0,25,0
1713314958267,PHIL 32,A01,490611,Staff,20,0,20,0
1713314958267,PHIL 32,A02,490618,Staff,20,0,20,0
1713314959311,PHIL 90,A00,490624,Staff,40,0,40,0
1713314960337,PHIL 136,A00,490627,Cohen; Jonathan David,38,0,40,2
1713314961364,PHIL 155,A00,490634,Staff,64,0,70,6
1713314962393,PHYS 1A,A00,491610,Staff,246,0,250,4
1713314963419,PHYS 1AL,001,491616,Tsai; Philbert S,28,0,30,2
1713314963419,PHYS 1AL,002,491618,Tsai; Philbert S,30,0,30,0
1713314964444,PHYS 1B,A00,491623,Staff,244,0,250,6
1713314965474,PHYS 1BL,001,491626,Tsai; Philbert S,26,0,30,4
1713314965474,PHYS 1BL,002,491628,Tsai; Philbert S,28,0,30,2
1713314966499,PHYS 1C,A00,491632,Staff,220,0,245,25
1713314967527,PHYS 1CL,001,491635,Tsai; Philbert S,11,0,30,19
1713314967527,PHYS 1CL,002,491643,Tsai; Philbert S,24,0,30,6
1713314968552,PHYS 2AR,A01,491651,Meyertholen; Andrew D.,44,0,50,6
1713314969578,PHYS 2B,A01,491659,Staff,106,0,115,9
1713314970611,PHYS 2BL,A01,491685,Staff,21,0,24,3
1713314970611,PHYS 2BL,A02,491700,Staff,23,0,24,1
1713314971639,PHYS 2C,A01,505161,Staff,107,0,115,8
1713314972668,PHYS 4A,A01,491704,Grinstein; Benjamin,99,0,100,1
1713314973696,POLI 5D,A01,494144,Staff,3,0,5,2
1713314973696,POLI 5D,B01,626283,Dai; Yinlin,5,0,5,0
1713314974723,POLI 12,A00,494145,Staff,44,0,45,1
1713314975752,POLI 13R,A00,494146,Forman; Fonna,45,0,50,5
1713314976783,POLI 27,A01,494148,Staff,57,0,60,3
1713314977810,POLI 30,A00,494149,Staff,49,0,50,1
1713314978835,POLI 100DA,A00,494150,Staff,21,0,25,4
1713314980889,POLI 100I,A00,494152,Staff,28,0,30,2
1713314981918,POLI 104B,A00,494153,Smith; Glenn Chatmas,54,0,55,1
1713314982950,POLI 104F,A00,494154,Staff,28,0,30,2
1713314983975,POLI 104I,A00,494155,Smith; Glenn Chatmas,30,0,30,0
1713314985002,POLI 110C,A00,494156,Ingham; Sean,23,0,25,2
1713314986027,POLI 117R,A00,494157,Forman; Fonna,10,0,20,10
1713314987057,POLI 118,A00,494158,Ingham; Sean,22,0,25,3
1713314988088,POLI 120H,A00,494159,Fisk; David Lee,41,0,45,4
1713314989113,POLI 131CR,A00,494160,Hoston; Germaine,37,0,45,8
1713314990139,POLI 133J,A00,494161,Staff,33,0,35,2
1713314991165,POLI 135,A00,494162,Fisk; David Lee,33,0,35,2
1713314992192,POLI 140A,A00,494164,Staff,21,0,30,9
1713314993216,POLI 142I,A00,494165,Staff,30,0,30,0
1713314994244,POLI 144D,A00,494166,Staff,23,0,25,2
1713314995268,POLI 151,A00,494167,Staff,30,0,30,0
1713314996292,POLI 153,A00,494168,Staff,33,0,35,2
1713314997315,POLI 160AA,A00,494169,Staff,35,0,40,5
1713314998352,POLI 162,A00,494170,Mignozzetti; Umberto,20,0,25,5
1713314999376,POLI 171,A00,494171,Mignozzetti; Umberto,21,0,25,4
1713315000410,PSYC 1,A00,494172,Staff,97,0,100,3
1713315001436,PSYC 2,A00,494173,Moranton; Nirelia Melbina-,43,0,50,7
1713315002461,PSYC 3,A00,494174,Staff,29,0,30,1
1713315003488,PSYC 6,A00,494175,Staff,17,0,20,3
1713315004514,PSYC 60,A01,494177,Staff,39,0,45,6
1713315005544,PSYC 70,A01,505724,Geller; Emma Harlan,42,0,45,3
1713315006568,PSYC 101,A00,494180,Heyman; Gail D.,87,0,100,13
1713315007597,PSYC 105,A00,494181,Geller; Emma Harlan,63,0,90,27
1713315008628,PSYC 106,A00,494182,Dobkins; Karen R.,31,0,45,14
1713315009653,PSYC 108,A00,494183,Adrian; Julia Anna,92,0,100,8
1713315010679,PSYC 114,A01,494185,Winkielman; Piotr,0,0,30,30
1713315011704,PSYC 122,A00,494186,Moranton; Nirelia Melbina-,37,0,50,13
1713315012786,PSYC 124,A00,494187,Chapman; Eddie Nathaniel,72,0,80,8
1713315013812,PSYC 131,A00,494188,Anagnostaras; Stephan,53,0,80,27
1713315014835,PSYC 144,A00,494189,Staff,13,0,50,37
1713315015862,PSYC 154,A00,494190,Lacefield; Katharine I,131,0,180,49
1713315016886,PSYC 162,A00,494191,Wixted; John T,81,0,100,19
1713315017913,PSYC 172,A00,494192,Gorman; Michael R.,37,0,45,8
1713315018939,PSYC 178,A00,494193,Glaser; Dale,40,0,45,5
1713315019970,PSYC 193,A00,505725,Chapman; Eddie Nathaniel,20,0,20,0
1713315020995,RELI 145GS,A00,519817,Rahimi; Babak,18,0,20,2
1713315022022,SE 101A,A01,490862,Chadha; Mayank,23,0,25,2
1713315023046,SE 101C,A01,490924,Krysl; Petr,18,0,20,2
1713315024074,SE 110A,A01,490928,Staff,19,0,20,1
1713315025100,SE 130A,A00,490929,Morrison; Machel Leigh,60,0,70,10
1713315026125,SIO 1,A01,519325,Staff,39,0,40,1
1713315027150,SIO 30,A01,519327,Staff,39,0,40,1
1713315028175,SIO 40,A00,519328,Staff,40,0,40,0
1713315029199,SIO 46GS,A00,519819,Cook; Geoffrey W,18,0,25,7
1713315030228,SIO 109R,A00,494197,Forman; Fonna,4,0,20,16
1713315031253,SIO 121GS,A00,519827,Cook; Geoffrey W,18,0,25,7
1713315032278,SIO 132,A01,519330,Staff,38,0,40,2
1713315033305,SIO 133,A01,519397,Staff,38,0,40,2
1713315034331,SIO 139,A00,519396,Kacev; David,32,0,40,8
1713315035356,SOCI 1,A01,494199,Thorpe; Charles Robert,23,0,30,7
1713315035356,SOCI 1,A02,494200,Thorpe; Charles Robert,30,0,30,0
1713315035356,SOCI 1,A03,494201,Thorpe; Charles Robert,29,0,30,1
1713315035356,SOCI 1,A04,494202,Thorpe; Charles Robert,29,0,30,1
1713315035356,SOCI 1,A05,494203,Thorpe; Charles Robert,29,0,30,1
1713315035356,SOCI 1,A06,494204,Thorpe; Charles Robert,30,0,30,0
1713315035356,SOCI 1,A07,494205,Thorpe; Charles Robert,29,0,30,1
1713315036383,SOCI 60,A01,494207,Staff,36,0,40,4
1713315036383,SOCI 60,A02,494208,Staff,39,0,40,1
1713315037411,SOCI 100,A01,494210,Payne; Christine Anna,27,0,30,3
1713315037411,SOCI 100,A02,494211,Payne; Christine Anna,27,0,30,3
1713315038437,SOCI 109M,A00,494212,Staff,20,0,20,0
1713315039464,SOCI 110,A00,494213,Staff,35,0,40,5
1713315041515,SOCI 118E,A00,494215,Ng; Kwai,38,0,40,2
1713315042542,SOCI 125,A00,494216,Calderon-Zaks; Michael Aar,42,0,45,3
1713315043567,SOCI 126,A01,494218,Jones; Makeba,4,0,5,1
1713315044592,SOCI 131,A00,494219,Thorpe; Charles Robert,28,0,30,2
1713315046642,SOCI 135,A00,494221,Payne; Christine Anna,34,0,50,16
1713315047668,SOCI 136E,A00,626690,Ruiz; Jonathan Joseph,25,0,25,0
1713315048693,SOCI 138GS,A00,494222,Navon; Daniel,24,0,28,4
1713315050751,SOCI 145,A00,494224,Staff,42,0,45,3
1713315051779,SOCI 153,A00,494225,Staff,28,0,30,2
1713315052804,SOCI 160E,A00,494226,Ng; Kwai,32,0,40,8
1713315053833,SOCI 180,A00,494227,Staff,29,0,30,1
1713315054859,SOCI 189GS,A00,494228,Ribas Norris; Janet Vanesa,11,0,11,0
1713315055884,SOCI 190GS,A00,553232,Ribas Norris; Janet Vanesa,11,0,11,0
1713315056914,SOMI 220,A00,627178,Schneid; Stephen David,30,0,30,0
1713315057941,SYN 2,001,490768,Staff,14,0,15,1
1713315057941,SYN 2,002,490769,Staff,15,0,15,0
1713315057941,SYN 2,004,490775,Staff,0,0,0,0
1713315057941,SYN 2,003,490774,Staff,0,0,0,0
1713315057941,SYN 2,005,490776,Staff,0,0,0,0
1713315058968,SYN 2R,001,490779,Staff,12,0,15,3
1713315058968,SYN 2R,002,514635,Staff,14,0,15,1
1713315059992,SYN 100,A01,490783,Staff,15,0,20,5
1713315059992,SYN 100,B01,490787,Staff,10,0,20,10
1713315059992,SYN 100,C01,490789,Staff,12,0,20,8
1713315061026,SYN 150,A00,490817,Staff,14,0,15,1
1713315061026,SYN 150,B00,514610,Staff,15,0,15,0
1713315062053,TDAC 1,A00,492753,Walsh; Kim C.,19,0,20,1
1713315062053,TDAC 1,B00,492754,Harting; Carla Kelso,19,0,20,1
1713315062053,TDAC 1,C00,513995,Salovey; Todd,16,0,20,4
1713315063080,TDAC 101,A00,492766,Harting; Carla Kelso,17,0,20,3
1713315064106,TDAC 102,A00,492768,Basso; Beatrice,19,0,20,1
1713315065132,TDDE 111,A00,492769,Staff,25,0,25,0
1713315066160,TDDE 131,A00,492770,Staff,15,0,15,0
1713315066160,TDDE 131,B00,492771,Staff,15,0,15,0
1713315067194,TDDE 131GS,A00,523716,Guirguis; Mark C,24,0,28,4
1713315068221,TDGE 1,A01,492756,Salovey; Todd,57,0,60,3
1713315069247,TDGE 5,A01,492758,Staff,24,0,25,1
1713315070274,TDGE 10,A00,492759,Fulton; Julia,208,0,220,12
1713315071303,TDGE 11,A00,492760,Castro; Robert Jess,199,0,200,1
1713315073357,TDGE 124,A00,492772,Fulton; Julia,192,0,220,28
1713315074387,TDGE 125,A00,492773,Meyer; Ursula,40,0,50,10
1713315074387,TDGE 125,B00,492774,Staff,50,0,50,0
1713315074387,TDGE 125,C00,523565,Staff,49,0,50,1
1713315075411,TDGE 125GS,A00,523580,Guirguis; Mark C,24,0,28,4
1713315076439,TDGE 127,A00,492775,Havis; Allan,41,0,50,9
1713315077468,TDHT 101,A00,492776,Staff,35,0,35,0
1713315078494,TDMV 1,A00,492762,Caligagan; Maria T.,30,0,30,0
1713315078494,TDMV 1,B00,492763,Arcidiacono; Kristin,25,0,30,5
1713315079576,TDMV 2,A00,492764,Weinberg; Sadie,29,0,30,1
1713315080606,TDMV 3,A00,492765,Mack; Kara Shanai',39,0,40,1
1713315081635,TDMV 138,A00,492777,Mack; Kara Shanai',36,0,40,4
1713315082663,TDMV 140,A00,492778,Lima; Paulo Henrique,40,0,40,0
1713315083697,TDMV 142,A00,492779,Caligagan; Maria T.,36,0,40,4
1713315083697,TDMV 142,B00,492780,Caligagan; Tony,37,0,40,3
1713315084725,TDMV 143,A00,492781,Fyall; Daunte Edward,39,0,40,1
1713315085750,USP 1,A01,492401,Kwak; Nancy,26,0,35,9
1713315086780,USP 2,A01,492453,Hinds; Juli Beth,35,0,35,0
1713315087808,USP 3,A01,492516,Staff,29,0,35,6
1713315088832,USP 4,A00,492522,McTague; Sarah,19,0,25,6
1713315089856,USP 100,A00,492523,Staff,33,0,35,2
1713315090887,USP 101,A00,492524,Staff,13,0,15,2
1713315091916,USP 105,A00,492525,Staff,21,0,25,4
1713315092945,USP 151,A00,492526,Shenkman; Michael Thomas,33,0,35,2
1713315093971,USP 170,A00,492545,Hinds; Juli Beth,33,0,35,2
1713315094997,USP 171GS,A00,492608,Bussell; Mirle Rabinowitz,25,0,28,3
1713315096027,USP 183GS,A00,492613,Peerson; Susan,25,0,28,3
1713315097059,VIS 30,A01,490693,Yoldas; Pinar,21,0,22,1
1713315097059,VIS 30,A02,490694,Yoldas; Pinar,19,0,22,3
1713315098089,VIS 83,A00,490695,Kester; Grant,66,0,75,9
1713315099114,VIS 105D,A00,490696,Staff,22,0,25,3
1713315100144,VIS 124CN,A00,490699,Rose; Jordan M,68,0,75,7
1713315101169,VIS 125GS,A00,511221,Williams; Alena J,21,0,22,1
1713315102199,VIS 128D,A00,490700,Staff,74,0,75,1
1713315103225,VIS 151,A01,490717,Staff,33,0,34,1
1713315103225,VIS 151,A02,490766,Staff,33,0,34,1
1713315104257,VIS 154GS,A00,511972,Williams; Alena J,21,0,22,1
1713315105283,VIS 160A,A00,490767,Stone; Patricia,7,0,10,3
1713315106308,WCWP 10A,A00,490638,Staff,14,0,15,1
1713315106308,WCWP 10A,B00,490640,Staff,15,0,15,0
1713315107339,WCWP 10B,A00,490641,Staff,0,0,0,0
1713315107339,WCWP 10B,B00,490642,Staff,14,0,15,1
1713315107339,WCWP 10B,C00,490644,Staff,13,0,15,2
1713315107339,WCWP 10B,D00,490647,Staff,0,0,0,0
1713315108363,WCWP 100,A00,490655,Staff,0,0,0,0
1713315108363,WCWP 100,B00,490687,Staff,11,0,15,4
1713315110491,ANAR 153,A00,487222,Braswell; Geoffrey E.,54,0,60,6
1713315111517,ANBI 134,A00,487223,Staff,11,0,20,9
1713315112547,ANBI 143GS,A00,487224,Noel; Geoffroy Pierre Jean,20,0,24,4
1713315113573,ANBI 144GS,A00,519548,Noel; Geoffroy Pierre Jean,20,0,24,4
1713315114599,ANSC 101,A00,487225,Staff,19,0,20,1
1713315115625,ANSC 125,A00,487227,Brenner; Suzanne A,39,0,40,1
1713315117736,ANSC 146,A00,487229,Staff,36,0,40,4
1713315118763,ANSC 148,A00,487230,Olivas Hernandez; Olga Lid,39,0,40,1
1713315119789,ANSC 150,A00,504165,Sloane; Julia Kathryn,19,0,20,1
1713315120814,ANSC 180,A00,487232,Staff,13,0,15,2
1713315121841,ANSC 188,A00,627155,Staff,40,0,40,0
1713315122874,ANTH 5,A00,519529,Semendeferi; Ekaterini,15,0,15,0
1713315123901,ANTH 10,A00,487219,Staff,58,0,60,2
1713315124930,ANTH 23,A01,487221,Staff,17,0,20,3
1713315125962,ANTH 102,A00,487233,Wilder; Linnea Lorene,51,0,60,9
1713315126993,ANTH 103,A00,487234,Varma; Saiba,56,0,60,4
1713315128020,ANTH 105,A00,487235,Stewart; Alexander B,55,0,60,5
1713315129045,BENG 100,A01,516685,Taylor Amos; Alyssa C,28,0,30,2
1713315130073,BIBC 102,A01,491316,Flagg; Matthew Paul,34,0,88,54
1713315130073,BIBC 102,A02,491366,Flagg; Matthew Paul,83,0,88,5
1713315131098,BIBC 103,A01,491486,Boumechache; Miyyada,16,0,24,8
1713315131098,BIBC 103,A02,491487,Boumechache; Miyyada,24,0,24,0
1713315132125,BICD 100,A01,516882,Staff,75,0,75,0
1713315132125,BICD 100,A02,516890,Staff,70,0,75,5
1713315133149,BICD 102GS,A00,491488,Lo; Stanley M.,26,0,28,2
1713315134175,BIEB 136GS,A00,516940,Holway; David A. & Shurin; Jonathan,19,0,24,5
1713315135201,BIEB 137GS,A01,517034,Holway; David A. & Shurin; Jonathan,19,0,24,5
1713315136231,BIEB 138GS,A01,491492,Pirino; Giorgia,21,0,28,7
1713315137256,BILD 1,A01,491296,Staff,62,0,63,1
1713315137256,BILD 1,A02,491297,Staff,63,0,63,0
1713315138284,BILD 4,A01,517099,Gonzalez Gamboa; Ivonne,22,0,24,2
1713315138284,BILD 4,A02,517100,Gonzalez Gamboa; Ivonne,24,0,24,0
1713315139314,BILD 60GS,A00,491309,Lo; Stanley M.,26,0,28,2
1713315140339,BIMM 100,A01,517136,Staff,89,0,100,11
1713315141365,BIMM 110,A01,517182,Staff,68,0,100,32
1713315142396,BIMM 120,A01,517228,Pickett; Brooke Elizabeth,38,0,63,25
1713315142396,BIMM 120,A02,517240,Pickett; Brooke Elizabeth,48,0,63,15
1713315143428,BIMM 132GS,A01,491498,Pirino; Giorgia,21,0,28,7
1713315144454,BIMM 143,A01,491589,Bozinovic; Goran,17,0,40,23
1713315145482,BIPN 100,A01,491594,Armour; Jon Christopher,91,0,100,9
1713315146508,BIPN 140,A01,491602,Marino; Marc J,28,0,50,22
1713315148558,CAT 125,A00,515973,Staff,19,0,20,1
1713315149583,CAT 125GS,A00,515974,Rahimi; Babak,18,0,20,2
1713315150612,CAT 125R,A00,515980,Staff,14,0,20,6
1713315150612,CAT 125R,B00,515981,Tosun; Adriana,19,0,20,1
1713315150612,CAT 125R,C00,515987,Hyland; Tina Mae,1,0,20,19
1713315150612,CAT 125R,D00,515988,Bronstein; Phoebe Malan,18,0,20,2
1713315151637,CENG 15,A01,488699,Drews; Aaron,25,0,25,0
1713315152664,CENG 100,A00,505196,Opatkiewicz; Justin Paul,25,0,25,0
1713315153690,CGS 2A,A01,489598,Staff,33,0,35,2
1713315154715,CGS 112,A00,489599,Staff,15,0,15,0
1713315155740,CGS 119,A00,489603,Staff,10,0,10,0
1713315156767,CGS 120,A00,489604,Staff,14,0,15,1
1713315157792,CGS 150,A00,489607,Staff,15,0,15,0
1713315158819,CHEM 6A,A01,488715,Staff,98,0,100,2
1713315159844,CHEM 6B,A01,488719,Piercy; Marc Anthony,100,0,100,0
1713315160871,CHEM 6C,A01,488723,Albizati; Kim F.,94,0,100,6
1713315161899,CHEM 7L,A01,488728,Schurmeier; Kimberly,18,0,24,6
1713315161899,CHEM 7L,A02,488730,Schurmeier; Kimberly,23,0,24,1
1713315161899,CHEM 7L,A03,488734,Schurmeier; Kimberly,23,0,24,1
1713315161899,CHEM 7L,A04,488763,Schurmeier; Kimberly,23,0,24,1
1713315161899,CHEM 7L,B01,488798,Schurmeier; Kimberly,17,0,24,7
1713315161899,CHEM 7L,B02,488801,Schurmeier; Kimberly,23,0,24,1
1713315161899,CHEM 7L,B03,488808,Schurmeier; Kimberly,24,0,24,0
1713315161899,CHEM 7L,B04,488811,Schurmeier; Kimberly,24,0,24,0
1713315162931,CHEM 11,A01,488897,Stallings; Dontarie M,98,0,100,2
1713315163960,CHEM 40A,A01,488913,Albizati; Kim F.,90,0,100,10
1713315164991,CHEM 40B,A01,488920,Weizman; Haim,46,0,50,4
1713315164991,CHEM 40B,A02,488938,Weizman; Haim,46,0,50,4
1713315166018,CHEM 41A,A01,489029,Klosterman; Jeremy K,58,0,60,2
1713315167048,CHEM 41C,A01,500436,Tor; Yitzhak,55,0,60,5
1713315168081,CHEM 43A,A01,500426,Weizman; Haim,2,0,24,22
1713315168081,CHEM 43A,A02,500430,Weizman; Haim,13,0,24,11
1713315168081,CHEM 43A,B01,514041,Klosterman; Jeremy K,15,0,24,9
1713315168081,CHEM 43A,B02,514047,Klosterman; Jeremy K,23,0,24,1
1713315169111,CHEM 108,A01,489140,Jennings; Patricia A.,12,0,24,12
1713315169111,CHEM 108,A02,489142,Jennings; Patricia A.,15,0,24,9
1713315170143,CHEM 114A,A01,489147,Stallings; Dontarie M,77,0,100,23
1713315171168,CHIN 169A,A00,489171,Wang; Xiao,19,0,20,1
1713315173217,COGS 3,A01,518827,Boyle; Mary E. T.,29,0,40,11
1713315174244,COGS 11,A01,489175,Staff,28,0,30,2
1713315175271,COGS 14A,A01,518829,Staff,51,0,60,9
1713315176296,COGS 14B,A01,489177,Hoffman; Drew Ellen,67,0,75,8
1713315177320,COGS 100,A01,489181,Allen; Michael Gordon,66,0,75,9
1713315178345,COGS 101A,A01,489183,Staff,48,0,60,12
1713315179370,COGS 101B,A01,489185,Allen; Michael Gordon,12,0,30,18
1713315180396,COGS 101C,A01,526786,Staff,24,0,30,6
1713315182452,COGS 107A,A01,489189,Boyle; Mary E. T.,19,0,35,16
1713315183484,COGS 107B,A01,627144,Mooshagian; Eric Frederick,60,0,60,0
1713315184516,COGS 118A,A01,489191,Staff,0,35,40,40
1713315186570,COGS 171GS,A01,489194,Pineda; Jaime A,22,0,28,6
1713315187594,COGS 172,A01,489196,Staff,3,0,30,27
1713315188618,COGS 174GS,A01,489264,Pineda; Jaime A,22,0,28,6
1713315189643,COGS 180,A01,627150,Staff,28,0,30,2
1713315190668,COGS 186,A01,489274,Staff,1,0,30,29
1713315191698,COMM 10,A01,489276,Staff,23,0,25,2
1713315191698,COMM 10,A02,489303,Staff,23,0,25,2
1713315192722,COMM 100A,A01,489312,Staff,16,0,25,9
1713315192722,COMM 100A,A02,489313,Staff,24,0,25,1
1713315193748,COMM 106T,A00,512540,Staff,34,0,35,1
1713315194776,COMM 107,A00,489347,Staff,31,0,35,4
1713315195804,COMM 109P,A00,489358,Staff,31,0,35,4
1713315196828,COMM 132,A00,489361,McKenna; Denise,28,0,30,2
1713315197854,COMM 146,A00,489362,Halm; Gavin Patrick,27,0,30,3
1713315198883,COMM 190,A00,489363,Abuelhiga; Soraya Jill,20,0,23,3
1713315199913,CSE 8A,A50,489366,Staff,22,0,25,3
1713315199913,CSE 8A,A51,489367,Staff,24,0,25,1
1713315200941,CSE 11,A01,489398,Cao; Yingjun,79,0,100,21
1713315201969,CSE 12,A01,489487,Staff,43,0,50,7
1713315202991,CSE 20,A01,489497,Staff,48,0,50,2
1713315204021,CSE 21,A01,489517,Braun; Oliver,43,0,50,7
1713315205047,CSE 101,A01,489524,Braun; Oliver,0,16,50,50
1713315206071,CSE 105,A01,512594,Jones; Miles E,78,0,100,22
1713315206071,CSE 105,B01,512598,Jones; Miles E,59,0,100,41
1713315207102,CSE 140,A01,489538,Staff,44,0,50,6
1713315208126,CSE 141,A01,489550,Eldon; John,75,0,100,25
1713315209152,CSE 141L,A01,489571,Eldon; John,73,0,100,27
1713315210176,CSE 151A,A01,489583,Solares; Edwin A,148,0,200,52
1713315211205,CSE 175,A01,510886,Kumar; Rakesh,30,0,30,0
1713315212228,CSE 190,A00,516828,Dubnov; Shlomo,40,0,49,9
1713315213255,DOC 100D,A00,489667,Pass; Natalye Joann,21,0,25,4
1713315214285,DSC 10,A01,624268,Staff,72,0,75,3
1713315215315,DSC 20,A01,624476,Staff,50,0,50,0
1713315216343,DSC 40A,A01,624608,Staff,39,0,40,1
1713315217368,DSGN 1,A01,489179,Rill; Bryan,36,0,50,14
1713315218398,ECE 17,A01,490489,Sahay; Rajeev,18,0,30,12
1713315219425,ECE 65,A50,490492,Staff,15,0,20,5
1713315219425,ECE 65,A51,490493,Staff,20,0,20,0
1713315220509,ECON 1,A01,489715,Famulari; Melissa,68,0,70,2
1713315221534,ECON 2,A01,489717,Levkoff; Steven B.,68,0,70,2
1713315222564,ECON 3,A01,489948,Staff,70,0,70,0
1713315224616,ECON 5,A01,490103,Staff,28,0,30,2
1713315224616,ECON 5,B01,626281,Dai; Yinlin,45,0,45,0
1713315225643,ECON 100A,A01,490127,Famulari; Melissa,66,0,70,4
1713315226668,ECON 100B,A01,490129,Staff,64,0,70,6
1713315227697,ECON 109,A01,490187,Shishkin; Denis,27,0,35,8
1713315228720,ECON 110A,A01,490190,Levkoff; Steven B.,61,0,70,9
1713315229746,ECON 120A,A01,490245,Dai; Yinlin,63,0,70,7
1713315230775,ECON 120B,A01,490247,Nieto-Barthaburu; Augusto,55,0,70,15
1713315231808,ECON 120C,A01,490253,Sun; Yixiao,30,0,35,5
1713315231808,ECON 120C,B01,490255,Sun; Yixiao,34,0,35,1
1713315232834,ECON 129,A00,490256,Eckert; Fabian Paul,25,0,35,10
1713315233870,ECON 131,A00,490257,Nieto-Barthaburu; Augusto,0,1,35,35
1713315234902,ECON 138,A00,490258,Bharadwaj; Prashant,19,0,35,16
1713315234902,ECON 138,B00,490259,Bharadwaj; Prashant,17,0,35,18
1713315235928,ECON 159,A00,490260,Hendrickson; Gerald M.,0,8,0,0
1713315236953,ECON 178,A01,553995,Zhu; Ying,26,0,35,9
1713315237984,EDS 40,A01,512576,Black; Alison Michelle,20,0,20,0
1713315239009,EDS 107,A01,515848,Staff,30,0,30,0
1713315240033,EDS 110R,A01,490262,Staff,26,0,30,4
1713315241059,EDS 112,A01,490264,Chapman; Thandeka K,42,0,50,8
1713315242083,EDS 113,A00,490266,Staff,26,0,30,4
1713315243108,EDS 118,A00,490267,Warstadt; Melissa Fawn,24,0,30,6
1713315244132,EDS 124BR,A00,490268,Eguchi; Emi,7,0,25,18
1713315244132,EDS 124BR,B00,490269,Eguchi; Emi,25,0,25,0
1713315245161,EDS 126,A01,490271,Jones; Makeba,44,0,50,6
1713315246187,EDS 135,A01,490316,Staff,19,0,20,1
1713315247216,ENVR 142GS,A00,519514,Chang; Edmond Yi-Teh,28,0,28,0
1713315248243,ETHN 103,A00,490504,Staff,31,0,36,5
1713315249271,ETHN 103A,A00,490505,Man; Simeon S,5,0,9,4
1713315250300,ETHN 109,A00,490506,Staff,30,0,30,0
1713315251329,ETHN 118,A00,490507,Staff,35,0,36,1
1713315252357,ETHN 119,A00,490508,Staff,34,0,36,2
1713315253381,ETHN 121R,A00,490518,Choi; Esther Min,25,0,36,11
1713315254405,ETHN 127,A00,490528,Staff,15,0,15,0
1713315255431,ETHN 139,A00,490573,Staff,10,0,10,0
1713315256459,ETHN 150,A00,490575,Staff,15,0,15,0
1713315257484,GLBH 20,A00,491705,Elwardani; Nile Regina,38,0,40,2
1713315258508,GLBH 101,A00,491706,Staff,20,0,20,0
1713315259538,GLBH 111,A01,491708,Burgos; Jose L.,15,0,15,0
1713315260563,GLBH 146,A00,491709,Staff,11,0,20,9
1713315261590,GLBH 148,A00,491710,Olivas Hernandez; Olga Lid,14,0,20,6
1713315262616,GLBH 150,A00,491711,Sloane; Julia Kathryn,20,0,20,0
1713315263644,HIEA 131,A00,491760,Staff,29,0,32,3
1713315264673,HIEA 153,A00,491762,Staff,29,0,30,1
1713315265699,HIEU 124,A00,491811,Staff,26,0,32,6
1713315266724,HIEU 124GS,A00,491812,Markman; Kristina,27,0,28,1
1713315267752,HIEU 147,A00,491813,Staff,30,0,32,2
1713315268777,HIEU 149GS,A00,491816,Caldwell; Michael Alan,28,0,28,0
1713315269806,HILD 2C,A01,491713,Hendrickson; Gerald M.,27,0,30,3
1713315270835,HILD 7B,A01,491715,Kwak; Nancy,6,0,30,24
1713315271861,HILD 10,A01,491717,Staff,13,0,20,7
1713315272886,HILD 30GS,A00,491719,Edington; Claire Ellen,24,0,28,4
1713315273908,HINE 109,A00,491818,Shafir; Nir,28,0,32,4
1713315274932,HINE 128,A00,491821,Shafir; Nir,31,0,32,1
1713315275960,HISC 117,A00,491830,Staff,29,0,32,3
1713315276986,HIUS 103,A00,491834,Man; Simeon S,15,0,23,8
1713315278013,HIUS 108B,A00,491835,Staff,29,0,30,1
1713315279039,HIUS 141,A00,491836,Hendrickson; Gerald M.,29,0,32,3
1713315280065,HIUS 149,A00,491839,Staff,27,0,32,5
1713315281092,HUM 3,A01,512617,Crum; Matthew Stephen,45,0,50,5
1713315281092,HUM 3,A02,512618,Crum; Matthew Stephen,48,0,50,2
1713315282119,HUM 3GS,A00,512663,Markman; Kristina,0,0,0,1
1713315282119,HUM 3GS,B00,512664,Staff,0,0,0,0
1713315283150,HUM 4,A01,512620,West; Geoffrey Scott,31,0,50,19
1713315284178,HUM 4GS,A00,512666,Lyon; Antony J.,0,0,0,3
1713315285204,HUM 4R,A01,512625,Watkins; Eric,49,0,50,1
1713315286229,HUM 5,A01,512649,Zavodny; Tatiana Sophia,29,0,50,21
1713315286229,HUM 5,B01,512661,Zroka; Ryan Edward,48,0,50,2
1713315287262,INTL 190,A00,490577,Segui; Alan S,0,0,0,5
1713315288291,JAPN 20AR,A01,491267,Ross; Kayoko F,9,0,20,11
1713315289316,JAPN 180,A00,491285,Berman; Michael David,34,0,40,6
1713315290343,LATI 50,A01,502536,Kokinis; Troy Andreas,16,0,22,6
1713315290343,LATI 50,A02,502551,Kokinis; Troy Andreas,22,0,22,0
1713315290343,LATI 50,A03,502650,Kokinis; Troy Andreas,22,0,22,0
1713315290343,LATI 50,A04,502909,Kokinis; Troy Andreas,22,0,22,0
1713315291369,LATI 160,A01,502920,Kokinis; Troy Andreas,30,0,30,0
1713315292393,LIFR 1A,A00,490494,Van Moer; Vinciane G,17,0,20,3
1713315293418,LIFR 1AX,A00,490495,Van Moer; Vinciane G,17,0,20,3
1713315294442,LIFR 1B,A00,490496,Van Moer; Vinciane G,18,0,20,2
1713315295467,LIFR 1BX,A00,490497,Van Moer; Vinciane G,18,0,20,2
1713315296491,LIGN 8,A00,505198,McIntosh; Justin Daniel,136,0,150,14
1713315297521,LIGN 9GS,A00,491239,Lott; Margaret S.,18,0,20,2
1713315298546,LIGN 101,A01,505200,McIntosh; Justin Daniel,24,0,30,6
1713315299571,LIGN 120,A01,491244,Staff,24,0,30,6
1713315300595,LIGN 149GS,A00,491245,Lott; Margaret S.,18,0,20,2
1713315301621,LIGN 170,A00,491247,Staff,24,0,30,6
1713315302646,LISP 1D,A00,490498,Munoz Sanchez; Alicia,10,0,14,4
1713315302646,LISP 1D,B00,490499,Munoz Sanchez; Alicia,6,0,14,8
1713315302646,LISP 1D,C00,490500,Munoz Sanchez; Alicia,8,0,14,6
1713315302646,LISP 1D,D00,490501,Munoz Sanchez; Alicia,10,0,14,4
1713315303671,LISP 1DX,A00,490502,Munoz Sanchez; Alicia,15,0,28,13
1713315303671,LISP 1DX,B00,490503,Munoz Sanchez; Alicia,17,0,28,11
1713315305719,LTAM 110,A00,491847,Staff,23,0,25,2
1713315306744,LTCS 119,A00,491848,Staff,12,0,15,3
1713315307771,LTCS 130,A00,491849,Staff,24,0,25,1
1713315309824,LTEA 120C,A00,491852,Staff,34,0,40,6
1713315310850,LTEN 130GS,A00,491853,Lyon; Antony J.,25,0,28,3
1713315311879,LTEN 148,A00,491855,Staff,23,0,25,2
1713315312905,LTEN 159,A00,491856,Staff,21,0,25,4
1713315313931,LTEN 180,A00,491857,Staff,9,0,15,6
1713315315988,LTSP 123GS,A00,505928,Bessett; Ryan Matthew,24,0,28,4
1713315317013,LTSP 174GS,A00,506037,Bessett; Ryan Matthew,24,0,28,4
1713315319067,LTWR 102,A00,491861,Staff,11,0,15,4
1713315320095,LTWR 106,A00,491862,Staff,10,0,15,5
1713315321124,MAE 11,A00,490930,Bahadori; Mohammad Yousef,97,0,100,3
1713315322154,MAE 30A,A00,490931,Qi; Huihui,37,0,40,3
1713315323183,MAE 101A,A00,491036,Sadeghizadeh; Zahra,97,0,100,3
1713315324262,MAE 101C,A00,491037,Seshadri; Kalyanasundaram,76,0,100,24
1713315325287,MAE 113,A00,491040,Seshadri; Kalyanasundaram,66,0,80,14
1713315326315,MAE 131A,A00,491041,Ghazinejad; Maziar,39,0,40,1
1713315327344,MAE 142,A00,491053,Staff,39,0,40,1
1713315328367,MAE 143A,A00,491054,Staff,38,0,50,12
1713315329393,MAE 150,A00,491092,Truong; Phuong Thi Ngoc,23,0,35,12
1713315330423,MATH 3C,A01,494031,Pardo Guerra; Sebastian,30,0,30,0
1713315330423,MATH 3C,A02,494032,Pardo Guerra; Sebastian,29,0,30,1
1713315331453,MATH 10A,A01,494034,Staff,27,0,30,3
1713315331453,MATH 10A,A02,494035,Staff,28,0,30,2
1713315331453,MATH 10A,B01,494037,Staff,27,0,30,3
1713315331453,MATH 10A,B02,494038,Staff,29,0,30,1
1713315332481,MATH 10B,A01,494040,Habib; Yousaf,24,0,30,6
1713315332481,MATH 10B,A02,494041,Habib; Yousaf,28,0,30,2
1713315332481,MATH 10B,A03,494042,Habib; Yousaf,30,0,30,0
1713315332481,MATH 10B,A04,494043,Habib; Yousaf,30,0,30,0
1713315332481,MATH 10B,B01,494045,Habib; Yousaf,28,0,30,2
1713315332481,MATH 10B,B02,494046,Habib; Yousaf,30,0,30,0
1713315332481,MATH 10B,B03,494047,Habib; Yousaf,30,0,30,0
1713315332481,MATH 10B,B04,494048,Habib; Yousaf,30,0,30,0
1713315333514,MATH 18,A01,494050,Kemp; Todd Aahron,25,0,30,5
1713315333514,MATH 18,A02,494051,Kemp; Todd Aahron,29,0,30,1
1713315333514,MATH 18,B01,494054,Kemp; Todd Aahron,28,0,30,2
1713315333514,MATH 18,B02,494055,Kemp; Todd Aahron,29,0,30,1
1713315334539,MATH 20A,A01,494059,Suk; Andrew Hoon,30,0,30,0
1713315335565,MATH 20B,A01,494061,Briones; Jor-el Thomas Caparas,33,0,35,2
1713315335565,MATH 20B,B01,494063,Bach; Quang Tran,34,0,35,1
1713315336593,MATH 20C,A01,494065,Staff,28,0,30,2
1713315336593,MATH 20C,A02,494066,Staff,30,0,30,0
1713315336593,MATH 20C,A03,494067,Staff,30,0,30,0
1713315336593,MATH 20C,A04,494068,Staff,30,0,30,0
1713315336593,MATH 20C,B01,494070,Zhang; Ming,26,0,30,4
1713315336593,MATH 20C,B02,494071,Zhang; Ming,28,0,30,2
1713315336593,MATH 20C,B03,494072,Zhang; Ming,29,0,30,1
1713315336593,MATH 20C,B04,494073,Zhang; Ming,29,0,30,1
1713315337621,MATH 20D,A01,494075,Staff,23,0,30,7
1713315337621,MATH 20D,A02,494076,Staff,30,0,30,0
1713315338650,MATH 20E,A01,494079,Staff,25,0,30,5
1713315338650,MATH 20E,A02,494080,Staff,27,0,30,3
1713315338650,MATH 20E,B01,494082,Staff,27,0,30,3
1713315338650,MATH 20E,B02,494083,Staff,25,0,30,5
1713315339683,MATH 103A,A01,494085,Aliabadi Sr.; Mohsen,17,0,30,13
1713315339683,MATH 103A,A02,494086,Aliabadi Sr.; Mohsen,28,0,30,2
1713315339683,MATH 103A,B01,494088,Aliabadi Sr.; Mohsen,22,0,30,8
1713315339683,MATH 103A,B02,494089,Aliabadi Sr.; Mohsen,28,0,30,2
1713315340710,MATH 109,A01,494091,Staff,30,0,30,0
1713315340710,MATH 109,A02,494092,Staff,29,0,30,1
1713315340710,MATH 109,B01,494094,Staff,28,0,30,2
1713315340710,MATH 109,B02,494095,Staff,29,0,30,1
1713315341737,MATH 142A,A01,494097,Chow; Bennett,15,0,30,15
1713315341737,MATH 142A,A02,494098,Chow; Bennett,24,0,30,6
1713315341737,MATH 142A,B01,494100,Chow; Bennett,19,0,30,11
1713315341737,MATH 142A,B02,494101,Chow; Bennett,29,0,30,1
1713315343788,MATH 168A,A01,516677,Dumitriu; Ioana,15,0,35,20
1713315344815,MATH 170A,A01,516679,Dumitriu; Ioana,20,0,30,10
1713315344815,MATH 170A,A02,516680,Dumitriu; Ioana,28,0,30,2
1713315345841,MATH 193A,A01,494107,Staff,16,0,30,14
1713315345841,MATH 193A,A02,494108,Staff,21,0,30,9
1713315345841,MATH 193A,A03,494109,Staff,29,0,30,1
1713315345841,MATH 193A,A04,494110,Staff,22,0,30,8
1713315348918,MGT 16,A00,491930,McKay; Michael J,92,0,98,6
1713315349944,MGT 18,A00,491992,McKay; Michael J,97,0,98,1
1713315350968,MGT 71,A00,492003,Staff,76,0,98,22
1713315351994,MGT 103,A00,505209,Eberhard; Craig A,85,0,98,13
1713315353023,MGT 131A,A00,505210,Anderson; John Charles,90,0,98,8
1713315355077,MGT 153,A00,492077,Perols; Johan Lars,35,0,90,55
1713315358154,MGT 164,A00,492222,McKay; Mary A,93,0,98,5
1713315359185,MGT 172,A00,492245,Staff,59,0,60,1
1713315359185,MGT 172,B00,505526,Hedges; Kathleen,75,0,98,23
1713315360210,MGT 181,A00,505669,Dunn; Louis Jean,85,0,98,13
1713315361238,MMW 14,A01,494399,Staff,23,0,28,5
1713315361238,MMW 14,A02,494400,Staff,25,0,28,3
1713315361238,MMW 14,A03,494401,Staff,28,0,28,0
1713315361238,MMW 14,A04,494402,Staff,28,0,28,0
1713315361238,MMW 14,B01,494404,Carreras; Maria Victoria,13,0,28,15
1713315361238,MMW 14,B02,494405,Carreras; Maria Victoria,26,0,28,2
1713315361238,MMW 14,B03,494406,Carreras; Maria Victoria,28,0,28,0
1713315361238,MMW 14,B04,494407,Carreras; Maria Victoria,28,0,28,0
1713315362266,MMW 14GS,A00,506250,Chang; Edmond Yi-Teh,0,0,0,0
1713315363293,MMW 121R,A01,494415,Adamiak; Patrick John,14,0,28,14
1713315363293,MMW 121R,A02,494416,Adamiak; Patrick John,24,0,28,4
1713315364322,MUS 1A,A01,494113,Staff,12,0,25,13
1713315364322,MUS 1A,A02,494114,Staff,25,0,25,0
1713315365346,MUS 4,A01,494116,Staff,24,0,25,1
1713315365346,MUS 4,A02,494117,Staff,22,0,25,3
1713315366377,MUS 5R,A01,494236,Dubnov; Shlomo,10,0,25,15
1713315366377,MUS 5R,A02,494237,Dubnov; Shlomo,25,0,25,0
1713315367406,MUS 6,A01,494122,Staff,13,0,25,12
1713315367406,MUS 6,A02,494123,Staff,24,0,25,1
1713315368435,MUS 7,A01,494125,Staff,17,0,25,8
1713315368435,MUS 7,A02,494126,Staff,24,0,25,1
1713315369458,MUS 11,A01,494128,Staff,23,0,25,2
1713315369458,MUS 11,A02,494129,Staff,24,0,25,1
1713315370486,MUS 13,A01,494131,Staff,25,0,25,0
1713315370486,MUS 13,A02,494132,Staff,25,0,25,0
1713315371513,MUS 15,A01,494134,Staff,18,0,25,7
1713315371513,MUS 15,A02,494135,Staff,25,0,25,0
1713315371513,MUS 15,B01,494137,Staff,24,0,25,1
1713315372539,MUS 80,A00,494232,Staff,24,0,25,1
1713315372539,MUS 80,B00,494233,Staff,25,0,25,0
1713315372539,MUS 80,C00,494234,Staff,23,0,25,2
1713315373567,MUS 95C,A00,494141,Staff,72,0,75,3
1713315374595,MUS 114,A00,494142,Staff,41,0,50,9
1713315375627,NANO 15,A01,490636,Drews; Aaron,7,0,7,0
1713315376658,PHIL 1,A00,490578,Grush; Rick Scott,49,0,50,1
1713315377687,PHIL 10,A01,490580,Grush; Rick Scott,33,0,35,2
1713315377687,PHIL 10,A02,490586,Grush; Rick Scott,33,0,35,2
1713315378717,PHIL 27,A01,490591,Staff,24,0,25,1
1713315378717,PHIL 27,A02,490592,Staff,25,0,25,0
1713315378717,PHIL 27,A03,490593,Staff,25,0,25,0
1713315378717,PHIL 27,A04,490598,Staff,25,0,25,0
1713315379744,PHIL 32,A01,490611,Staff,20,0,20,0
1713315379744,PHIL 32,A02,490618,Staff,20,0,20,0
1713315380772,PHIL 90,A00,490624,Staff,40,0,40,0
1713315381801,PHIL 136,A00,490627,Cohen; Jonathan David,38,0,40,2
1713315382828,PHIL 155,A00,490634,Staff,64,0,70,6
1713315383863,PHYS 1A,A00,491610,Staff,246,0,250,4
1713315384890,PHYS 1AL,001,491616,Tsai; Philbert S,28,0,30,2
1713315384890,PHYS 1AL,002,491618,Tsai; Philbert S,30,0,30,0
1713315385914,PHYS 1B,A00,491623,Staff,244,0,250,6
1713315386944,PHYS 1BL,001,491626,Tsai; Philbert S,25,0,30,5
1713315386944,PHYS 1BL,002,491628,Tsai; Philbert S,28,0,30,2
1713315387972,PHYS 1C,A00,491632,Staff,220,0,245,25
1713315388998,PHYS 1CL,001,491635,Tsai; Philbert S,10,0,30,20
1713315388998,PHYS 1CL,002,491643,Tsai; Philbert S,24,0,30,6
1713315390026,PHYS 2AR,A01,491651,Meyertholen; Andrew D.,44,0,50,6
1713315391051,PHYS 2B,A01,491659,Staff,106,0,115,9
1713315392075,PHYS 2BL,A01,491685,Staff,21,0,24,3
1713315392075,PHYS 2BL,A02,491700,Staff,23,0,24,1
1713315393103,PHYS 2C,A01,505161,Staff,107,0,115,8
1713315394130,PHYS 4A,A01,491704,Grinstein; Benjamin,99,0,100,1
1713315395160,POLI 5D,A01,494144,Staff,3,0,5,2
1713315395160,POLI 5D,B01,626283,Dai; Yinlin,5,0,5,0
1713315396188,POLI 12,A00,494145,Staff,44,0,45,1
1713315397214,POLI 13R,A00,494146,Forman; Fonna,45,0,50,5
1713315398238,POLI 27,A01,494148,Staff,57,0,60,3
1713315399266,POLI 30,A00,494149,Staff,49,0,50,1
1713315400292,POLI 100DA,A00,494150,Staff,21,0,25,4
1713315402346,POLI 100I,A00,494152,Staff,28,0,30,2
1713315403370,POLI 104B,A00,494153,Smith; Glenn Chatmas,54,0,55,1
1713315404547,POLI 104F,A00,494154,Staff,28,0,30,2
1713315405571,POLI 104I,A00,494155,Smith; Glenn Chatmas,30,0,30,0
1713315406598,POLI 110C,A00,494156,Ingham; Sean,23,0,25,2
1713315407625,POLI 117R,A00,494157,Forman; Fonna,10,0,20,10
1713315408651,POLI 118,A00,494158,Ingham; Sean,22,0,25,3
1713315409678,POLI 120H,A00,494159,Fisk; David Lee,41,0,45,4
1713315410703,POLI 131CR,A00,494160,Hoston; Germaine,37,0,45,8
1713315411729,POLI 133J,A00,494161,Staff,33,0,35,2
1713315412754,POLI 135,A00,494162,Fisk; David Lee,33,0,35,2
1713315413781,POLI 140A,A00,494164,Staff,21,0,30,9
1713315414806,POLI 142I,A00,494165,Staff,30,0,30,0
1713315415830,POLI 144D,A00,494166,Staff,23,0,25,2
1713315416855,POLI 151,A00,494167,Staff,30,0,30,0
1713315417879,POLI 153,A00,494168,Staff,33,0,35,2
1713315418907,POLI 160AA,A00,494169,Staff,35,0,40,5
1713315419940,POLI 162,A00,494170,Mignozzetti; Umberto,20,0,25,5
1713315420969,POLI 171,A00,494171,Mignozzetti; Umberto,21,0,25,4
1713315421995,PSYC 1,A00,494172,Staff,97,0,100,3
1713315423019,PSYC 2,A00,494173,Moranton; Nirelia Melbina-,43,0,50,7
1713315424043,PSYC 3,A00,494174,Staff,29,0,30,1
1713315425071,PSYC 6,A00,494175,Staff,17,0,20,3
1713315426101,PSYC 60,A01,494177,Staff,39,0,45,6
1713315427128,PSYC 70,A01,505724,Geller; Emma Harlan,42,0,45,3
1713315428212,PSYC 101,A00,494180,Heyman; Gail D.,87,0,100,13
1713315429239,PSYC 105,A00,494181,Geller; Emma Harlan,61,0,90,29
1713315430265,PSYC 106,A00,494182,Dobkins; Karen R.,30,0,45,15
1713315431291,PSYC 108,A00,494183,Adrian; Julia Anna,92,0,100,8
1713315432317,PSYC 114,A01,494185,Winkielman; Piotr,0,0,30,30
1713315433343,PSYC 122,A00,494186,Moranton; Nirelia Melbina-,37,0,50,13
1713315434369,PSYC 124,A00,494187,Chapman; Eddie Nathaniel,72,0,80,8
1713315435399,PSYC 131,A00,494188,Anagnostaras; Stephan,52,0,80,28
1713315436424,PSYC 144,A00,494189,Staff,12,0,50,38
1713315437449,PSYC 154,A00,494190,Lacefield; Katharine I,129,0,180,51
1713315438475,PSYC 162,A00,494191,Wixted; John T,81,0,100,19
1713315439500,PSYC 172,A00,494192,Gorman; Michael R.,37,0,45,8
1713315440526,PSYC 178,A00,494193,Glaser; Dale,40,0,45,5
1713315441552,PSYC 193,A00,505725,Chapman; Eddie Nathaniel,20,0,20,0
1713315442579,RELI 145GS,A00,519817,Rahimi; Babak,18,0,20,2
1713315443606,SE 101A,A01,490862,Chadha; Mayank,23,0,25,2
1713315444631,SE 101C,A01,490924,Krysl; Petr,18,0,20,2
1713315445660,SE 110A,A01,490928,Staff,19,0,20,1
1713315446685,SE 130A,A00,490929,Morrison; Machel Leigh,60,0,70,10
1713315447711,SIO 1,A01,519325,Staff,39,0,40,1
1713315448739,SIO 30,A01,519327,Staff,39,0,40,1
1713315449766,SIO 40,A00,519328,Staff,40,0,40,0
1713315450792,SIO 46GS,A00,519819,Cook; Geoffrey W,18,0,25,7
1713315451818,SIO 109R,A00,494197,Forman; Fonna,4,0,20,16
1713315452843,SIO 121GS,A00,519827,Cook; Geoffrey W,18,0,25,7
1713315453872,SIO 132,A01,519330,Staff,38,0,40,2
1713315454902,SIO 133,A01,519397,Staff,37,0,40,3
1713315455929,SIO 139,A00,519396,Kacev; David,32,0,40,8
1713315456956,SOCI 1,A01,494199,Thorpe; Charles Robert,23,0,30,7
1713315456956,SOCI 1,A02,494200,Thorpe; Charles Robert,30,0,30,0
1713315456956,SOCI 1,A03,494201,Thorpe; Charles Robert,29,0,30,1
1713315456956,SOCI 1,A04,494202,Thorpe; Charles Robert,29,0,30,1
1713315456956,SOCI 1,A05,494203,Thorpe; Charles Robert,29,0,30,1
1713315456956,SOCI 1,A06,494204,Thorpe; Charles Robert,30,0,30,0
1713315456956,SOCI 1,A07,494205,Thorpe; Charles Robert,29,0,30,1
1713315457982,SOCI 60,A01,494207,Staff,35,0,40,5
1713315457982,SOCI 60,A02,494208,Staff,39,0,40,1
1713315459008,SOCI 100,A01,494210,Payne; Christine Anna,27,0,30,3
1713315459008,SOCI 100,A02,494211,Payne; Christine Anna,27,0,30,3
1713315460037,SOCI 109M,A00,494212,Staff,20,0,20,0
1713315461061,SOCI 110,A00,494213,Staff,35,0,40,5
1713315463117,SOCI 118E,A00,494215,Ng; Kwai,38,0,40,2
1713315464142,SOCI 125,A00,494216,Calderon-Zaks; Michael Aar,42,0,45,3
1713315465173,SOCI 126,A01,494218,Jones; Makeba,3,0,5,2
1713315466199,SOCI 131,A00,494219,Thorpe; Charles Robert,28,0,30,2
1713315468253,SOCI 135,A00,494221,Payne; Christine Anna,34,0,50,16
1713315469279,SOCI 136E,A00,626690,Ruiz; Jonathan Joseph,25,0,25,0
1713315470305,SOCI 138GS,A00,494222,Navon; Daniel,24,0,28,4
1713315472352,SOCI 145,A00,494224,Staff,42,0,45,3
1713315473378,SOCI 153,A00,494225,Staff,28,0,30,2
1713315474401,SOCI 160E,A00,494226,Ng; Kwai,32,0,40,8
1713315475428,SOCI 180,A00,494227,Staff,29,0,30,1
1713315476459,SOCI 189GS,A00,494228,Ribas Norris; Janet Vanesa,11,0,11,0
1713315477484,SOCI 190GS,A00,553232,Ribas Norris; Janet Vanesa,11,0,11,0
1713315478512,SOMI 220,A00,627178,Schneid; Stephen David,30,0,30,0
1713315479539,SYN 2,001,490768,Staff,14,0,15,1
1713315479539,SYN 2,002,490769,Staff,15,0,15,0
1713315479539,SYN 2,004,490775,Staff,0,0,0,0
1713315479539,SYN 2,003,490774,Staff,0,0,0,0
1713315479539,SYN 2,005,490776,Staff,0,0,0,0
1713315480565,SYN 2R,001,490779,Staff,12,0,15,3
1713315480565,SYN 2R,002,514635,Staff,14,0,15,1
1713315481591,SYN 100,A01,490783,Staff,15,0,20,5
1713315481591,SYN 100,B01,490787,Staff,10,0,20,10
1713315481591,SYN 100,C01,490789,Staff,12,0,20,8
1713315482617,SYN 150,A00,490817,Staff,14,0,15,1
1713315482617,SYN 150,B00,514610,Staff,15,0,15,0
1713315483645,TDAC 1,A00,492753,Walsh; Kim C.,19,0,20,1
1713315483645,TDAC 1,B00,492754,Harting; Carla Kelso,19,0,20,1
1713315483645,TDAC 1,C00,513995,Salovey; Todd,16,0,20,4
1713315484675,TDAC 101,A00,492766,Harting; Carla Kelso,17,0,20,3
1713315485704,TDAC 102,A00,492768,Basso; Beatrice,19,0,20,1
1713315486729,TDDE 111,A00,492769,Staff,25,0,25,0
1713315487855,TDDE 131,A00,492770,Staff,15,0,15,0
1713315487855,TDDE 131,B00,492771,Staff,15,0,15,0
1713315488880,TDDE 131GS,A00,523716,Guirguis; Mark C,24,0,28,4
1713315489906,TDGE 1,A01,492756,Salovey; Todd,57,0,60,3
1713315490932,TDGE 5,A01,492758,Staff,24,0,25,1
1713315491960,TDGE 10,A00,492759,Fulton; Julia,208,0,220,12
1713315492988,TDGE 11,A00,492760,Castro; Robert Jess,199,0,200,1
1713315495039,TDGE 124,A00,492772,Fulton; Julia,192,0,220,28
1713315496066,TDGE 125,A00,492773,Meyer; Ursula,40,0,50,10
1713315496066,TDGE 125,B00,492774,Staff,50,0,50,0
1713315496066,TDGE 125,C00,523565,Staff,49,0,50,1
1713315497096,TDGE 125GS,A00,523580,Guirguis; Mark C,24,0,28,4
1713315498170,TDGE 127,A00,492775,Havis; Allan,41,0,50,9
1713315499195,TDHT 101,A00,492776,Staff,35,0,35,0
1713315500228,TDMV 1,A00,492762,Caligagan; Maria T.,30,0,30,0
1713315500228,TDMV 1,B00,492763,Arcidiacono; Kristin,25,0,30,5
1713315501257,TDMV 2,A00,492764,Weinberg; Sadie,29,0,30,1
1713315502286,TDMV 3,A00,492765,Mack; Kara Shanai',39,0,40,1
1713315503311,TDMV 138,A00,492777,Mack; Kara Shanai',35,0,40,5
1713315504336,TDMV 140,A00,492778,Lima; Paulo Henrique,40,0,40,0
1713315505361,TDMV 142,A00,492779,Caligagan; Maria T.,36,0,40,4
1713315505361,TDMV 142,B00,492780,Caligagan; Tony,37,0,40,3
1713315506389,TDMV 143,A00,492781,Fyall; Daunte Edward,39,0,40,1
1713315507415,USP 1,A01,492401,Kwak; Nancy,26,0,35,9
1713315508445,USP 2,A01,492453,Hinds; Juli Beth,35,0,35,0
1713315509475,USP 3,A01,492516,Staff,29,0,35,6
1713315510499,USP 4,A00,492522,McTague; Sarah,19,0,25,6
1713315511528,USP 100,A00,492523,Staff,33,0,35,2
1713315512556,USP 101,A00,492524,Staff,13,0,15,2
1713315513582,USP 105,A00,492525,Staff,21,0,25,4
1713315514606,USP 151,A00,492526,Shenkman; Michael Thomas,33,0,35,2
1713315515632,USP 170,A00,492545,Hinds; Juli Beth,33,0,35,2
1713315516657,USP 171GS,A00,492608,Bussell; Mirle Rabinowitz,25,0,28,3
1713315517682,USP 183GS,A00,492613,Peerson; Susan,25,0,28,3
1713315518709,VIS 30,A01,490693,Yoldas; Pinar,21,0,22,1
1713315518709,VIS 30,A02,490694,Yoldas; Pinar,19,0,22,3
1713315519739,VIS 83,A00,490695,Kester; Grant,66,0,75,9
1713315520766,VIS 105D,A00,490696,Staff,22,0,25,3
1713315521791,VIS 124CN,A00,490699,Rose; Jordan M,68,0,75,7
1713315522817,VIS 125GS,A00,511221,Williams; Alena J,21,0,22,1
1713315523842,VIS 128D,A00,490700,Staff,74,0,75,1
1713315524875,VIS 151,A01,490717,Staff,33,0,34,1
1713315524875,VIS 151,A02,490766,Staff,33,0,34,1
1713315525905,VIS 154GS,A00,511972,Williams; Alena J,21,0,22,1
1713315526931,VIS 160A,A00,490767,Stone; Patricia,7,0,10,3
1713315527957,WCWP 10A,A00,490638,Staff,14,0,15,1
1713315527957,WCWP 10A,B00,490640,Staff,15,0,15,0
1713315528982,WCWP 10B,A00,490641,Staff,0,0,0,0
1713315528982,WCWP 10B,B00,490642,Staff,14,0,15,1
1713315528982,WCWP 10B,C00,490644,Staff,13,0,15,2
1713315528982,WCWP 10B,D00,490647,Staff,0,0,0,0
1713315530006,WCWP 100,A00,490655,Staff,0,0,0,0
1713315530006,WCWP 100,B00,490687,Staff,11,0,15,4
1713315532129,ANAR 153,A00,487222,Braswell; Geoffrey E.,54,0,60,6
1713315533154,ANBI 134,A00,487223,Staff,11,0,20,9
1713315534181,ANBI 143GS,A00,487224,Noel; Geoffroy Pierre Jean,20,0,24,4
1713315535208,ANBI 144GS,A00,519548,Noel; Geoffroy Pierre Jean,20,0,24,4
1713315536236,ANSC 101,A00,487225,Staff,19,0,20,1
1713315537261,ANSC 125,A00,487227,Brenner; Suzanne A,39,0,40,1
1713315539312,ANSC 146,A00,487229,Staff,36,0,40,4
1713315540336,ANSC 148,A00,487230,Olivas Hernandez; Olga Lid,39,0,40,1
1713315541364,ANSC 150,A00,504165,Sloane; Julia Kathryn,19,0,20,1
1713315542392,ANSC 180,A00,487232,Staff,13,0,15,2
1713315543416,ANSC 188,A00,627155,Staff,40,0,40,0
1713315544445,ANTH 5,A00,519529,Semendeferi; Ekaterini,15,0,15,0
1713315545470,ANTH 10,A00,487219,Staff,58,0,60,2
1713315546497,ANTH 23,A01,487221,Staff,17,0,20,3
1713315547523,ANTH 102,A00,487233,Wilder; Linnea Lorene,51,0,60,9
1713315548548,ANTH 103,A00,487234,Varma; Saiba,56,0,60,4
1713315549575,ANTH 105,A00,487235,Stewart; Alexander B,55,0,60,5
1713315550601,BENG 100,A01,516685,Taylor Amos; Alyssa C,28,0,30,2
1713315551632,BIBC 102,A01,491316,Flagg; Matthew Paul,34,0,88,54
1713315551632,BIBC 102,A02,491366,Flagg; Matthew Paul,83,0,88,5
1713315552664,BIBC 103,A01,491486,Boumechache; Miyyada,16,0,24,8
1713315552664,BIBC 103,A02,491487,Boumechache; Miyyada,24,0,24,0
1713315553691,BICD 100,A01,516882,Staff,75,0,75,0
1713315553691,BICD 100,A02,516890,Staff,70,0,75,5
1713315554720,BICD 102GS,A00,491488,Lo; Stanley M.,26,0,28,2
1713315555748,BIEB 136GS,A00,516940,Holway; David A. & Shurin; Jonathan,19,0,24,5
1713315556772,BIEB 137GS,A01,517034,Holway; David A. & Shurin; Jonathan,19,0,24,5
1713315557801,BIEB 138GS,A01,491492,Pirino; Giorgia,21,0,28,7
1713315558832,BILD 1,A01,491296,Staff,62,0,63,1
1713315558832,BILD 1,A02,491297,Staff,63,0,63,0
1713315559859,BILD 4,A01,517099,Gonzalez Gamboa; Ivonne,22,0,24,2
1713315559859,BILD 4,A02,517100,Gonzalez Gamboa; Ivonne,24,0,24,0
1713315560884,BILD 60GS,A00,491309,Lo; Stanley M.,26,0,28,2
1713315561913,BIMM 100,A01,517136,Staff,89,0,100,11
1713315562940,BIMM 110,A01,517182,Staff,67,0,100,33
1713315563971,BIMM 120,A01,517228,Pickett; Brooke Elizabeth,38,0,63,25
1713315563971,BIMM 120,A02,517240,Pickett; Brooke Elizabeth,48,0,63,15
1713315564998,BIMM 132GS,A01,491498,Pirino; Giorgia,21,0,28,7
1713315566028,BIMM 143,A01,491589,Bozinovic; Goran,17,0,40,23
1713315567057,BIPN 100,A01,491594,Armour; Jon Christopher,91,0,100,9
1713315568086,BIPN 140,A01,491602,Marino; Marc J,28,0,50,22
1713315570142,CAT 125,A00,515973,Staff,19,0,20,1
1713315571170,CAT 125GS,A00,515974,Rahimi; Babak,18,0,20,2
1713315572200,CAT 125R,A00,515980,Staff,14,0,20,6
1713315572200,CAT 125R,B00,515981,Tosun; Adriana,19,0,20,1
1713315572200,CAT 125R,C00,515987,Hyland; Tina Mae,1,0,20,19
1713315572200,CAT 125R,D00,515988,Bronstein; Phoebe Malan,18,0,20,2
1713315573228,CENG 15,A01,488699,Drews; Aaron,25,0,25,0
1713315574256,CENG 100,A00,505196,Opatkiewicz; Justin Paul,25,0,25,0
1713315575407,CGS 2A,A01,489598,Staff,33,0,35,2
1713315576436,CGS 112,A00,489599,Staff,15,0,15,0
1713315577462,CGS 119,A00,489603,Staff,10,0,10,0
1713315578487,CGS 120,A00,489604,Staff,14,0,15,1
1713315579514,CGS 150,A00,489607,Staff,15,0,15,0
1713315580543,CHEM 6A,A01,488715,Staff,98,0,100,2
1713315581575,CHEM 6B,A01,488719,Piercy; Marc Anthony,100,0,100,0
1713315582604,CHEM 6C,A01,488723,Albizati; Kim F.,94,0,100,6
1713315583632,CHEM 7L,A01,488728,Schurmeier; Kimberly,18,0,24,6
1713315583632,CHEM 7L,A02,488730,Schurmeier; Kimberly,23,0,24,1
1713315583632,CHEM 7L,A03,488734,Schurmeier; Kimberly,23,0,24,1
1713315583632,CHEM 7L,A04,488763,Schurmeier; Kimberly,23,0,24,1
1713315583632,CHEM 7L,B01,488798,Schurmeier; Kimberly,17,0,24,7
1713315583632,CHEM 7L,B02,488801,Schurmeier; Kimberly,23,0,24,1
1713315583632,CHEM 7L,B03,488808,Schurmeier; Kimberly,24,0,24,0
1713315583632,CHEM 7L,B04,488811,Schurmeier; Kimberly,24,0,24,0
1713315584658,CHEM 11,A01,488897,Stallings; Dontarie M,98,0,100,2
1713315585682,CHEM 40A,A01,488913,Albizati; Kim F.,90,0,100,10
1713315586708,CHEM 40B,A01,488920,Weizman; Haim,46,0,50,4
1713315586708,CHEM 40B,A02,488938,Weizman; Haim,46,0,50,4
1713315587737,CHEM 41A,A01,489029,Klosterman; Jeremy K,58,0,60,2
1713315588767,CHEM 41C,A01,500436,Tor; Yitzhak,55,0,60,5
1713315589793,CHEM 43A,A01,500426,Weizman; Haim,2,0,24,22
1713315589793,CHEM 43A,A02,500430,Weizman; Haim,13,0,24,11
1713315589793,CHEM 43A,B01,514041,Klosterman; Jeremy K,15,0,24,9
1713315589793,CHEM 43A,B02,514047,Klosterman; Jeremy K,23,0,24,1
1713315590822,CHEM 108,A01,489140,Jennings; Patricia A.,12,0,24,12
1713315590822,CHEM 108,A02,489142,Jennings; Patricia A.,15,0,24,9
1713315591853,CHEM 114A,A01,489147,Stallings; Dontarie M,77,0,100,23
1713315592882,CHIN 169A,A00,489171,Wang; Xiao,19,0,20,1
1713315594938,COGS 3,A01,518827,Boyle; Mary E. T.,29,0,40,11
1713315595966,COGS 11,A01,489175,Staff,28,0,30,2
1713315596992,COGS 14A,A01,518829,Staff,51,0,60,9
1713315598019,COGS 14B,A01,489177,Hoffman; Drew Ellen,67,0,75,8
1713315599049,COGS 100,A01,489181,Allen; Michael Gordon,66,0,75,9
1713315600095,COGS 101A,A01,489183,Staff,48,0,60,12
1713315601124,COGS 101B,A01,489185,Allen; Michael Gordon,12,0,30,18
1713315602153,COGS 101C,A01,526786,Staff,24,0,30,6
1713315604215,COGS 107A,A01,489189,Boyle; Mary E. T.,19,0,35,16
1713315605246,COGS 107B,A01,627144,Mooshagian; Eric Frederick,60,0,60,0
1713315606273,COGS 118A,A01,489191,Staff,0,35,40,40
1713315608328,COGS 171GS,A01,489194,Pineda; Jaime A,22,0,28,6
1713315609352,COGS 172,A01,489196,Staff,3,0,30,27
1713315610375,COGS 174GS,A01,489264,Pineda; Jaime A,22,0,28,6
1713315611400,COGS 180,A01,627150,Staff,28,0,30,2
1713315612426,COGS 186,A01,489274,Staff,1,0,30,29
1713315613450,COMM 10,A01,489276,Staff,23,0,25,2
1713315613450,COMM 10,A02,489303,Staff,23,0,25,2
1713315614475,COMM 100A,A01,489312,Staff,16,0,25,9
1713315614475,COMM 100A,A02,489313,Staff,24,0,25,1
1713315615506,COMM 106T,A00,512540,Staff,34,0,35,1
1713315616531,COMM 107,A00,489347,Staff,31,0,35,4
1713315617556,COMM 109P,A00,489358,Staff,31,0,35,4
1713315618583,COMM 132,A00,489361,McKenna; Denise,28,0,30,2
1713315619613,COMM 146,A00,489362,Halm; Gavin Patrick,27,0,30,3
1713315620645,COMM 190,A00,489363,Abuelhiga; Soraya Jill,20,0,23,3
1713315621672,CSE 8A,A50,489366,Staff,22,0,25,3
1713315621672,CSE 8A,A51,489367,Staff,24,0,25,1
1713315622701,CSE 11,A01,489398,Cao; Yingjun,79,0,100,21
1713315623727,CSE 12,A01,489487,Staff,43,0,50,7
1713315624750,CSE 20,A01,489497,Staff,48,0,50,2
1713315625778,CSE 21,A01,489517,Braun; Oliver,43,0,50,7
1713315626802,CSE 101,A01,489524,Braun; Oliver,0,16,50,50
1713315627833,CSE 105,A01,512594,Jones; Miles E,79,0,100,21
1713315627833,CSE 105,B01,512598,Jones; Miles E,59,0,100,41
1713315628858,CSE 140,A01,489538,Staff,44,0,50,6
1713315629886,CSE 141,A01,489550,Eldon; John,74,0,100,26
1713315630911,CSE 141L,A01,489571,Eldon; John,72,0,100,28
1713315631940,CSE 151A,A01,489583,Solares; Edwin A,148,0,200,52
1713315632969,CSE 175,A01,510886,Kumar; Rakesh,30,0,30,0
1713315633995,CSE 190,A00,516828,Dubnov; Shlomo,40,0,49,9
1713315635026,DOC 100D,A00,489667,Pass; Natalye Joann,21,0,25,4
1713315636111,DSC 10,A01,624268,Staff,72,0,75,3
1713315637135,DSC 20,A01,624476,Staff,50,0,50,0
1713315638161,DSC 40A,A01,624608,Staff,39,0,40,1
1713315639191,DSGN 1,A01,489179,Rill; Bryan,36,0,50,14
1713315640217,ECE 17,A01,490489,Sahay; Rajeev,18,0,30,12
1713315641246,ECE 65,A50,490492,Staff,15,0,20,5
1713315641246,ECE 65,A51,490493,Staff,20,0,20,0
1713315642270,ECON 1,A01,489715,Famulari; Melissa,68,0,70,2
1713315643296,ECON 2,A01,489717,Levkoff; Steven B.,68,0,70,2
1713315644320,ECON 3,A01,489948,Staff,70,0,70,0
1713315646377,ECON 5,A01,490103,Staff,28,0,30,2
1713315646377,ECON 5,B01,626281,Dai; Yinlin,45,0,45,0
1713315647406,ECON 100A,A01,490127,Famulari; Melissa,66,0,70,4
1713315648432,ECON 100B,A01,490129,Staff,64,0,70,6
1713315649458,ECON 109,A01,490187,Shishkin; Denis,27,0,35,8
1713315650482,ECON 110A,A01,490190,Levkoff; Steven B.,61,0,70,9
1713315651506,ECON 120A,A01,490245,Dai; Yinlin,63,0,70,7
1713315652531,ECON 120B,A01,490247,Nieto-Barthaburu; Augusto,55,0,70,15
1713315653558,ECON 120C,A01,490253,Sun; Yixiao,30,0,35,5
1713315653558,ECON 120C,B01,490255,Sun; Yixiao,34,0,35,1
1713315654586,ECON 129,A00,490256,Eckert; Fabian Paul,25,0,35,10
1713315655609,ECON 131,A00,490257,Nieto-Barthaburu; Augusto,0,1,35,35
1713315656635,ECON 138,A00,490258,Bharadwaj; Prashant,19,0,35,16
1713315656635,ECON 138,B00,490259,Bharadwaj; Prashant,17,0,35,18
1713315657661,ECON 159,A00,490260,Hendrickson; Gerald M.,0,8,0,0
1713315658691,ECON 178,A01,553995,Zhu; Ying,26,0,35,9
1713315659720,EDS 40,A01,512576,Black; Alison Michelle,20,0,20,0
1713315660748,EDS 107,A01,515848,Staff,30,0,30,0
1713315661773,EDS 110R,A01,490262,Staff,26,0,30,4
1713315662799,EDS 112,A01,490264,Chapman; Thandeka K,42,0,50,8
1713315663824,EDS 113,A00,490266,Staff,26,0,30,4
1713315664853,EDS 118,A00,490267,Warstadt; Melissa Fawn,23,0,30,7
1713315665883,EDS 124BR,A00,490268,Eguchi; Emi,7,0,25,18
1713315665883,EDS 124BR,B00,490269,Eguchi; Emi,25,0,25,0
1713315666912,EDS 126,A01,490271,Jones; Makeba,44,0,50,6
1713315667939,EDS 135,A01,490316,Staff,19,0,20,1
1713315668970,ENVR 142GS,A00,519514,Chang; Edmond Yi-Teh,28,0,28,0
1713315669995,ETHN 103,A00,490504,Staff,31,0,36,5
1713315671024,ETHN 103A,A00,490505,Man; Simeon S,5,0,9,4
1713315672049,ETHN 109,A00,490506,Staff,30,0,30,0
1713315673077,ETHN 118,A00,490507,Staff,35,0,36,1
1713315674105,ETHN 119,A00,490508,Staff,34,0,36,2
1713315675135,ETHN 121R,A00,490518,Choi; Esther Min,25,0,36,11
1713315676165,ETHN 127,A00,490528,Staff,15,0,15,0
1713315677192,ETHN 139,A00,490573,Staff,10,0,10,0
1713315678229,ETHN 150,A00,490575,Staff,15,0,15,0
1713315679257,GLBH 20,A00,491705,Elwardani; Nile Regina,38,0,40,2
1713315680285,GLBH 101,A00,491706,Staff,20,0,20,0
1713315681308,GLBH 111,A01,491708,Burgos; Jose L.,15,0,15,0
1713315682332,GLBH 146,A00,491709,Staff,11,0,20,9
1713315683358,GLBH 148,A00,491710,Olivas Hernandez; Olga Lid,14,0,20,6
1713315684388,GLBH 150,A00,491711,Sloane; Julia Kathryn,20,0,20,0
1713315685413,HIEA 131,A00,491760,Staff,29,0,32,3
1713315686439,HIEA 153,A00,491762,Staff,29,0,30,1
1713315687465,HIEU 124,A00,491811,Staff,26,0,32,6
1713315688490,HIEU 124GS,A00,491812,Markman; Kristina,27,0,28,1
1713315689517,HIEU 147,A00,491813,Staff,30,0,32,2
1713315690543,HIEU 149GS,A00,491816,Caldwell; Michael Alan,28,0,28,0
1713315691575,HILD 2C,A01,491713,Hendrickson; Gerald M.,27,0,30,3
1713315692605,HILD 7B,A01,491715,Kwak; Nancy,6,0,30,24
1713315693630,HILD 10,A01,491717,Staff,13,0,20,7
1713315694654,HILD 30GS,A00,491719,Edington; Claire Ellen,24,0,28,4
1713315695678,HINE 109,A00,491818,Shafir; Nir,28,0,32,4
1713315696701,HINE 128,A00,491821,Shafir; Nir,31,0,32,1
1713315697728,HISC 117,A00,491830,Staff,29,0,32,3
1713315698758,HIUS 103,A00,491834,Man; Simeon S,15,0,23,8
1713315699783,HIUS 108B,A00,491835,Staff,29,0,30,1
1713315700808,HIUS 141,A00,491836,Hendrickson; Gerald M.,29,0,32,3
1713315701834,HIUS 149,A00,491839,Staff,27,0,32,5
1713315702858,HUM 3,A01,512617,Crum; Matthew Stephen,45,0,50,5
1713315702858,HUM 3,A02,512618,Crum; Matthew Stephen,48,0,50,2
1713315703893,HUM 3GS,A00,512663,Markman; Kristina,0,0,0,1
1713315703893,HUM 3GS,B00,512664,Staff,0,0,0,0
1713315704919,HUM 4,A01,512620,West; Geoffrey Scott,31,0,50,19
1713315705942,HUM 4GS,A00,512666,Lyon; Antony J.,0,0,0,3
1713315706968,HUM 4R,A01,512625,Watkins; Eric,49,0,50,1
1713315707995,HUM 5,A01,512649,Zavodny; Tatiana Sophia,29,0,50,21
1713315707995,HUM 5,B01,512661,Zroka; Ryan Edward,48,0,50,2
1713315709025,INTL 190,A00,490577,Segui; Alan S,0,0,0,5
1713315710052,JAPN 20AR,A01,491267,Ross; Kayoko F,9,0,20,11
1713315711078,JAPN 180,A00,491285,Berman; Michael David,34,0,40,6
1713315712109,LATI 50,A01,502536,Kokinis; Troy Andreas,16,0,22,6
1713315712109,LATI 50,A02,502551,Kokinis; Troy Andreas,22,0,22,0
1713315712109,LATI 50,A03,502650,Kokinis; Troy Andreas,22,0,22,0
1713315712109,LATI 50,A04,502909,Kokinis; Troy Andreas,22,0,22,0
1713315713138,LATI 160,A01,502920,Kokinis; Troy Andreas,30,0,30,0
1713315714167,LIFR 1A,A00,490494,Van Moer; Vinciane G,17,0,20,3
1713315715195,LIFR 1AX,A00,490495,Van Moer; Vinciane G,17,0,20,3
1713315716221,LIFR 1B,A00,490496,Van Moer; Vinciane G,18,0,20,2
1713315717250,LIFR 1BX,A00,490497,Van Moer; Vinciane G,18,0,20,2
1713315718280,LIGN 8,A00,505198,McIntosh; Justin Daniel,136,0,150,14
1713315719304,LIGN 9GS,A00,491239,Lott; Margaret S.,18,0,20,2
1713315720329,LIGN 101,A01,505200,McIntosh; Justin Daniel,24,0,30,6
1713315721355,LIGN 120,A01,491244,Staff,24,0,30,6
1713315722384,LIGN 149GS,A00,491245,Lott; Margaret S.,18,0,20,2
1713315723410,LIGN 170,A00,491247,Staff,24,0,30,6
1713315724439,LISP 1D,A00,490498,Munoz Sanchez; Alicia,10,0,14,4
1713315724439,LISP 1D,B00,490499,Munoz Sanchez; Alicia,6,0,14,8
1713315724439,LISP 1D,C00,490500,Munoz Sanchez; Alicia,8,0,14,6
1713315724439,LISP 1D,D00,490501,Munoz Sanchez; Alicia,10,0,14,4
1713315725465,LISP 1DX,A00,490502,Munoz Sanchez; Alicia,15,0,28,13
1713315725465,LISP 1DX,B00,490503,Munoz Sanchez; Alicia,17,0,28,11
1713315727520,LTAM 110,A00,491847,Staff,23,0,25,2
1713315728544,LTCS 119,A00,491848,Staff,12,0,15,3
1713315729570,LTCS 130,A00,491849,Staff,24,0,25,1
1713315731624,LTEA 120C,A00,491852,Staff,34,0,40,6
1713315732654,LTEN 130GS,A00,491853,Lyon; Antony J.,25,0,28,3
1713315733680,LTEN 148,A00,491855,Staff,23,0,25,2
1713315734705,LTEN 159,A00,491856,Staff,21,0,25,4
1713315735730,LTEN 180,A00,491857,Staff,9,0,15,6
1713315737780,LTSP 123GS,A00,505928,Bessett; Ryan Matthew,24,0,28,4
1713315738806,LTSP 174GS,A00,506037,Bessett; Ryan Matthew,24,0,28,4
1713315740921,LTWR 102,A00,491861,Staff,11,0,15,4
1713315741952,LTWR 106,A00,491862,Staff,10,0,15,5
1713315742982,MAE 11,A00,490930,Bahadori; Mohammad Yousef,97,0,100,3
1713315744009,MAE 30A,A00,490931,Qi; Huihui,37,0,40,3
1713315745034,MAE 101A,A00,491036,Sadeghizadeh; Zahra,97,0,100,3
1713315746059,MAE 101C,A00,491037,Seshadri; Kalyanasundaram,76,0,100,24
1713315747088,MAE 113,A00,491040,Seshadri; Kalyanasundaram,66,0,80,14
1713315748118,MAE 131A,A00,491041,Ghazinejad; Maziar,39,0,40,1
1713315749143,MAE 142,A00,491053,Staff,39,0,40,1
1713315750167,MAE 143A,A00,491054,Staff,38,0,50,12
1713315751198,MAE 150,A00,491092,Truong; Phuong Thi Ngoc,23,0,35,12
1713315752230,MATH 3C,A01,494031,Pardo Guerra; Sebastian,30,0,30,0
1713315752230,MATH 3C,A02,494032,Pardo Guerra; Sebastian,29,0,30,1
1713315753258,MATH 10A,A01,494034,Staff,27,0,30,3
1713315753258,MATH 10A,A02,494035,Staff,28,0,30,2
1713315753258,MATH 10A,B01,494037,Staff,27,0,30,3
1713315753258,MATH 10A,B02,494038,Staff,29,0,30,1
1713315754293,MATH 10B,A01,494040,Habib; Yousaf,23,0,30,7
1713315754293,MATH 10B,A02,494041,Habib; Yousaf,28,0,30,2
1713315754293,MATH 10B,A03,494042,Habib; Yousaf,30,0,30,0
1713315754293,MATH 10B,A04,494043,Habib; Yousaf,30,0,30,0
1713315754293,MATH 10B,B01,494045,Habib; Yousaf,28,0,30,2
1713315754293,MATH 10B,B02,494046,Habib; Yousaf,30,0,30,0
1713315754293,MATH 10B,B03,494047,Habib; Yousaf,30,0,30,0
1713315754293,MATH 10B,B04,494048,Habib; Yousaf,30,0,30,0
1713315755319,MATH 18,A01,494050,Kemp; Todd Aahron,25,0,30,5
1713315755319,MATH 18,A02,494051,Kemp; Todd Aahron,29,0,30,1
1713315755319,MATH 18,B01,494054,Kemp; Todd Aahron,28,0,30,2
1713315755319,MATH 18,B02,494055,Kemp; Todd Aahron,29,0,30,1
1713315756347,MATH 20A,A01,494059,Suk; Andrew Hoon,30,0,30,0
1713315757376,MATH 20B,A01,494061,Briones; Jor-el Thomas Caparas,33,0,35,2
1713315757376,MATH 20B,B01,494063,Bach; Quang Tran,34,0,35,1
1713315758406,MATH 20C,A01,494065,Staff,28,0,30,2
1713315758406,MATH 20C,A02,494066,Staff,30,0,30,0
1713315758406,MATH 20C,A03,494067,Staff,30,0,30,0
1713315758406,MATH 20C,A04,494068,Staff,30,0,30,0
1713315758406,MATH 20C,B01,494070,Zhang; Ming,26,0,30,4
1713315758406,MATH 20C,B02,494071,Zhang; Ming,28,0,30,2
1713315758406,MATH 20C,B03,494072,Zhang; Ming,29,0,30,1
1713315758406,MATH 20C,B04,494073,Zhang; Ming,29,0,30,1
1713315759429,MATH 20D,A01,494075,Staff,23,0,30,7
1713315759429,MATH 20D,A02,494076,Staff,30,0,30,0
1713315760455,MATH 20E,A01,494079,Staff,25,0,30,5
1713315760455,MATH 20E,A02,494080,Staff,27,0,30,3
1713315760455,MATH 20E,B01,494082,Staff,27,0,30,3
1713315760455,MATH 20E,B02,494083,Staff,25,0,30,5
1713315761482,MATH 103A,A01,494085,Aliabadi Sr.; Mohsen,17,0,30,13
1713315761482,MATH 103A,A02,494086,Aliabadi Sr.; Mohsen,28,0,30,2
1713315761482,MATH 103A,B01,494088,Aliabadi Sr.; Mohsen,22,0,30,8
1713315761482,MATH 103A,B02,494089,Aliabadi Sr.; Mohsen,28,0,30,2
1713315762508,MATH 109,A01,494091,Staff,30,0,30,0
1713315762508,MATH 109,A02,494092,Staff,29,0,30,1
1713315762508,MATH 109,B01,494094,Staff,28,0,30,2
1713315762508,MATH 109,B02,494095,Staff,29,0,30,1
1713315764041,MATH 142A,A01,494097,Chow; Bennett,16,0,30,14
1713315764041,MATH 142A,A02,494098,Chow; Bennett,24,0,30,6
1713315764041,MATH 142A,B01,494100,Chow; Bennett,19,0,30,11
1713315764041,MATH 142A,B02,494101,Chow; Bennett,29,0,30,1
1713315766093,MATH 168A,A01,516677,Dumitriu; Ioana,15,0,35,20
1713315767118,MATH 170A,A01,516679,Dumitriu; Ioana,20,0,30,10
1713315767118,MATH 170A,A02,516680,Dumitriu; Ioana,28,0,30,2
1713315768145,MATH 193A,A01,494107,Staff,15,0,30,15
1713315768145,MATH 193A,A02,494108,Staff,21,0,30,9
1713315768145,MATH 193A,A03,494109,Staff,29,0,30,1
1713315768145,MATH 193A,A04,494110,Staff,22,0,30,8
1713315771231,MGT 16,A00,491930,McKay; Michael J,92,0,98,6
1713315772260,MGT 18,A00,491992,McKay; Michael J,97,0,98,1
1713315773287,MGT 71,A00,492003,Staff,75,0,98,23
1713315774311,MGT 103,A00,505209,Eberhard; Craig A,85,0,98,13
1713315775340,MGT 131A,A00,505210,Anderson; John Charles,90,0,98,8
1713315777390,MGT 153,A00,492077,Perols; Johan Lars,34,0,90,56
1713315780474,MGT 164,A00,492222,McKay; Mary A,93,0,98,5
1713315781506,MGT 172,A00,492245,Staff,59,0,60,1
1713315781506,MGT 172,B00,505526,Hedges; Kathleen,75,0,98,23
1713315782530,MGT 181,A00,505669,Dunn; Louis Jean,85,0,98,13
1713315783561,MMW 14,A01,494399,Staff,23,0,28,5
1713315783561,MMW 14,A02,494400,Staff,25,0,28,3
1713315783561,MMW 14,A03,494401,Staff,28,0,28,0
1713315783561,MMW 14,A04,494402,Staff,28,0,28,0
1713315783561,MMW 14,B01,494404,Carreras; Maria Victoria,13,0,28,15
1713315783561,MMW 14,B02,494405,Carreras; Maria Victoria,26,0,28,2
1713315783561,MMW 14,B03,494406,Carreras; Maria Victoria,28,0,28,0
1713315783561,MMW 14,B04,494407,Carreras; Maria Victoria,28,0,28,0
1713315784587,MMW 14GS,A00,506250,Chang; Edmond Yi-Teh,0,0,0,0
1713315785613,MMW 121R,A01,494415,Adamiak; Patrick John,13,0,28,15
1713315785613,MMW 121R,A02,494416,Adamiak; Patrick John,24,0,28,4
1713315786643,MUS 1A,A01,494113,Staff,12,0,25,13
1713315786643,MUS 1A,A02,494114,Staff,25,0,25,0
1713315787672,MUS 4,A01,494116,Staff,24,0,25,1
1713315787672,MUS 4,A02,494117,Staff,22,0,25,3
1713315788703,MUS 5R,A01,494236,Dubnov; Shlomo,10,0,25,15
1713315788703,MUS 5R,A02,494237,Dubnov; Shlomo,25,0,25,0
1713315789729,MUS 6,A01,494122,Staff,13,0,25,12
1713315789729,MUS 6,A02,494123,Staff,24,0,25,1
1713315790755,MUS 7,A01,494125,Staff,17,0,25,8
1713315790755,MUS 7,A02,494126,Staff,24,0,25,1
1713315791779,MUS 11,A01,494128,Staff,23,0,25,2
1713315791779,MUS 11,A02,494129,Staff,24,0,25,1
1713315792804,MUS 13,A01,494131,Staff,25,0,25,0
1713315792804,MUS 13,A02,494132,Staff,25,0,25,0
1713315793835,MUS 15,A01,494134,Staff,18,0,25,7
1713315793835,MUS 15,A02,494135,Staff,25,0,25,0
1713315793835,MUS 15,B01,494137,Staff,24,0,25,1
1713315794864,MUS 80,A00,494232,Staff,24,0,25,1
1713315794864,MUS 80,B00,494233,Staff,25,0,25,0
1713315794864,MUS 80,C00,494234,Staff,23,0,25,2
1713315795889,MUS 95C,A00,494141,Staff,72,0,75,3
1713315796914,MUS 114,A00,494142,Staff,41,0,50,9
1713315797945,NANO 15,A01,490636,Drews; Aaron,7,0,7,0
1713315798970,PHIL 1,A00,490578,Grush; Rick Scott,49,0,50,1
1713315800002,PHIL 10,A01,490580,Grush; Rick Scott,33,0,35,2
1713315800002,PHIL 10,A02,490586,Grush; Rick Scott,33,0,35,2
1713315801026,PHIL 27,A01,490591,Staff,23,0,25,2
1713315801026,PHIL 27,A02,490592,Staff,25,0,25,0
1713315801026,PHIL 27,A03,490593,Staff,25,0,25,0
1713315801026,PHIL 27,A04,490598,Staff,25,0,25,0
1713315802051,PHIL 32,A01,490611,Staff,20,0,20,0
1713315802051,PHIL 32,A02,490618,Staff,20,0,20,0
1713315803077,PHIL 90,A00,490624,Staff,40,0,40,0
1713315804103,PHIL 136,A00,490627,Cohen; Jonathan David,38,0,40,2
1713315805130,PHIL 155,A00,490634,Staff,64,0,70,6
1713315806161,PHYS 1A,A00,491610,Staff,246,0,250,4
1713315807190,PHYS 1AL,001,491616,Tsai; Philbert S,28,0,30,2
1713315807190,PHYS 1AL,002,491618,Tsai; Philbert S,30,0,30,0
1713315808222,PHYS 1B,A00,491623,Staff,244,0,250,6
1713315809250,PHYS 1BL,001,491626,Tsai; Philbert S,26,0,30,4
1713315809250,PHYS 1BL,002,491628,Tsai; Philbert S,27,0,30,3
1713315810279,PHYS 1C,A00,491632,Staff,220,0,245,25
1713315811307,PHYS 1CL,001,491635,Tsai; Philbert S,10,0,30,20
1713315811307,PHYS 1CL,002,491643,Tsai; Philbert S,24,0,30,6
1713315812338,PHYS 2AR,A01,491651,Meyertholen; Andrew D.,44,0,50,6
1713315813369,PHYS 2B,A01,491659,Staff,106,0,115,9
1713315814395,PHYS 2BL,A01,491685,Staff,21,0,24,3
1713315814395,PHYS 2BL,A02,491700,Staff,23,0,24,1
1713315815421,PHYS 2C,A01,505161,Staff,107,0,115,8
1713315816446,PHYS 4A,A01,491704,Grinstein; Benjamin,99,0,100,1
1713315817474,POLI 5D,A01,494144,Staff,3,0,5,2
1713315817474,POLI 5D,B01,626283,Dai; Yinlin,5,0,5,0
1713315818500,POLI 12,A00,494145,Staff,44,0,45,1
1713315819527,POLI 13R,A00,494146,Forman; Fonna,45,0,50,5
1713315820556,POLI 27,A01,494148,Staff,57,0,60,3
1713315821582,POLI 30,A00,494149,Staff,49,0,50,1
1713315822612,POLI 100DA,A00,494150,Staff,21,0,25,4
1713315824671,POLI 100I,A00,494152,Staff,28,0,30,2
1713315825698,POLI 104B,A00,494153,Smith; Glenn Chatmas,54,0,55,1
1713315826723,POLI 104F,A00,494154,Staff,28,0,30,2
1713315827747,POLI 104I,A00,494155,Smith; Glenn Chatmas,30,0,30,0
1713315828775,POLI 110C,A00,494156,Ingham; Sean,23,0,25,2
1713315829804,POLI 117R,A00,494157,Forman; Fonna,10,0,20,10
1713315830829,POLI 118,A00,494158,Ingham; Sean,22,0,25,3
1713315831855,POLI 120H,A00,494159,Fisk; David Lee,41,0,45,4
1713315832885,POLI 131CR,A00,494160,Hoston; Germaine,36,0,45,9
1713315833911,POLI 133J,A00,494161,Staff,33,0,35,2
1713315834937,POLI 135,A00,494162,Fisk; David Lee,33,0,35,2
1713315835962,POLI 140A,A00,494164,Staff,21,0,30,9
1713315836988,POLI 142I,A00,494165,Staff,30,0,30,0
1713315838016,POLI 144D,A00,494166,Staff,23,0,25,2
1713315839043,POLI 151,A00,494167,Staff,30,0,30,0
1713315840067,POLI 153,A00,494168,Staff,33,0,35,2
1713315841093,POLI 160AA,A00,494169,Staff,35,0,40,5
1713315842118,POLI 162,A00,494170,Mignozzetti; Umberto,20,0,25,5
1713315843144,POLI 171,A00,494171,Mignozzetti; Umberto,21,0,25,4
1713315844229,PSYC 1,A00,494172,Staff,97,0,100,3
1713315845253,PSYC 2,A00,494173,Moranton; Nirelia Melbina-,43,0,50,7
1713315846279,PSYC 3,A00,494174,Staff,29,0,30,1
1713315847306,PSYC 6,A00,494175,Staff,17,0,20,3
1713315848361,PSYC 60,A01,494177,Staff,39,0,45,6
1713315849387,PSYC 70,A01,505724,Geller; Emma Harlan,42,0,45,3
1713315850413,PSYC 101,A00,494180,Heyman; Gail D.,87,0,100,13
1713315851439,PSYC 105,A00,494181,Geller; Emma Harlan,61,0,90,29
1713315852465,PSYC 106,A00,494182,Dobkins; Karen R.,30,0,45,15
1713315853493,PSYC 108,A00,494183,Adrian; Julia Anna,91,0,100,9
1713315854519,PSYC 114,A01,494185,Winkielman; Piotr,0,0,30,30
1713315855546,PSYC 122,A00,494186,Moranton; Nirelia Melbina-,37,0,50,13
1713315856576,PSYC 124,A00,494187,Chapman; Eddie Nathaniel,72,0,80,8
1713315857601,PSYC 131,A00,494188,Anagnostaras; Stephan,52,0,80,28
1713315858629,PSYC 144,A00,494189,Staff,12,0,50,38
1713315859654,PSYC 154,A00,494190,Lacefield; Katharine I,129,0,180,51
1713315860679,PSYC 162,A00,494191,Wixted; John T,81,0,100,19
1713315861704,PSYC 172,A00,494192,Gorman; Michael R.,37,0,45,8
1713315862732,PSYC 178,A00,494193,Glaser; Dale,40,0,45,5
1713315863761,PSYC 193,A00,505725,Chapman; Eddie Nathaniel,20,0,20,0
1713315864785,RELI 145GS,A00,519817,Rahimi; Babak,18,0,20,2
1713315865814,SE 101A,A01,490862,Chadha; Mayank,23,0,25,2
1713315866845,SE 101C,A01,490924,Krysl; Petr,18,0,20,2
1713315867877,SE 110A,A01,490928,Staff,19,0,20,1
1713315868902,SE 130A,A00,490929,Morrison; Machel Leigh,60,0,70,10
1713315869933,SIO 1,A01,519325,Staff,39,0,40,1
1713315870957,SIO 30,A01,519327,Staff,39,0,40,1
1713315871981,SIO 40,A00,519328,Staff,40,0,40,0
1713315873007,SIO 46GS,A00,519819,Cook; Geoffrey W,18,0,25,7
1713315874031,SIO 109R,A00,494197,Forman; Fonna,4,0,20,16
1713315875061,SIO 121GS,A00,519827,Cook; Geoffrey W,18,0,25,7
1713315876086,SIO 132,A01,519330,Staff,38,0,40,2
1713315877111,SIO 133,A01,519397,Staff,37,0,40,3
1713315878138,SIO 139,A00,519396,Kacev; David,32,0,40,8
1713315879165,SOCI 1,A01,494199,Thorpe; Charles Robert,23,0,30,7
1713315879165,SOCI 1,A02,494200,Thorpe; Charles Robert,30,0,30,0
1713315879165,SOCI 1,A03,494201,Thorpe; Charles Robert,29,0,30,1
1713315879165,SOCI 1,A04,494202,Thorpe; Charles Robert,29,0,30,1
1713315879165,SOCI 1,A05,494203,Thorpe; Charles Robert,29,0,30,1
1713315879165,SOCI 1,A06,494204,Thorpe; Charles Robert,30,0,30,0
1713315879165,SOCI 1,A07,494205,Thorpe; Charles Robert,29,0,30,1
1713315880194,SOCI 60,A01,494207,Staff,35,0,40,5
1713315880194,SOCI 60,A02,494208,Staff,39,0,40,1
1713315881222,SOCI 100,A01,494210,Payne; Christine Anna,27,0,30,3
1713315881222,SOCI 100,A02,494211,Payne; Christine Anna,27,0,30,3
1713315882246,SOCI 109M,A00,494212,Staff,20,0,20,0
1713315883270,SOCI 110,A00,494213,Staff,35,0,40,5
1713315885324,SOCI 118E,A00,494215,Ng; Kwai,38,0,40,2
1713315886349,SOCI 125,A00,494216,Calderon-Zaks; Michael Aar,42,0,45,3
1713315887375,SOCI 126,A01,494218,Jones; Makeba,3,0,5,2
1713315888400,SOCI 131,A00,494219,Thorpe; Charles Robert,28,0,30,2
1713315890450,SOCI 135,A00,494221,Payne; Christine Anna,34,0,50,16
1713315891477,SOCI 136E,A00,626690,Ruiz; Jonathan Joseph,25,0,25,0
1713315892502,SOCI 138GS,A00,494222,Navon; Daniel,24,0,28,4
1713315894554,SOCI 145,A00,494224,Staff,42,0,45,3
1713315895580,SOCI 153,A00,494225,Staff,28,0,30,2
1713315896605,SOCI 160E,A00,494226,Ng; Kwai,32,0,40,8
1713315897631,SOCI 180,A00,494227,Staff,29,0,30,1
1713315898660,SOCI 189GS,A00,494228,Ribas Norris; Janet Vanesa,11,0,11,0
1713315899685,SOCI 190GS,A00,553232,Ribas Norris; Janet Vanesa,11,0,11,0
1713315900710,SOMI 220,A00,627178,Schneid; Stephen David,30,0,30,0
1713315901742,SYN 2,001,490768,Staff,14,0,15,1
1713315901742,SYN 2,002,490769,Staff,15,0,15,0
1713315901742,SYN 2,004,490775,Staff,0,0,0,0
1713315901742,SYN 2,003,490774,Staff,0,0,0,0
1713315901742,SYN 2,005,490776,Staff,0,0,0,0
1713315902768,SYN 2R,001,490779,Staff,12,0,15,3
1713315902768,SYN 2R,002,514635,Staff,14,0,15,1
1713315903801,SYN 100,A01,490783,Staff,15,0,20,5
1713315903801,SYN 100,B01,490787,Staff,10,0,20,10
1713315903801,SYN 100,C01,490789,Staff,12,0,20,8
1713315904830,SYN 150,A00,490817,Staff,14,0,15,1
1713315904830,SYN 150,B00,514610,Staff,15,0,15,0
1713315905858,TDAC 1,A00,492753,Walsh; Kim C.,19,0,20,1
1713315905858,TDAC 1,B00,492754,Harting; Carla Kelso,19,0,20,1
1713315905858,TDAC 1,C00,513995,Salovey; Todd,16,0,20,4
1713315906884,TDAC 101,A00,492766,Harting; Carla Kelso,17,0,20,3
1713315907913,TDAC 102,A00,492768,Basso; Beatrice,19,0,20,1
1713315908937,TDDE 111,A00,492769,Staff,25,0,25,0
1713315909967,TDDE 131,A00,492770,Staff,15,0,15,0
1713315909967,TDDE 131,B00,492771,Staff,15,0,15,0
1713315910992,TDDE 131GS,A00,523716,Guirguis; Mark C,24,0,28,4
1713315912023,TDGE 1,A01,492756,Salovey; Todd,57,0,60,3
1713315913046,TDGE 5,A01,492758,Staff,24,0,25,1
1713315914071,TDGE 10,A00,492759,Fulton; Julia,208,0,220,12
1713315915098,TDGE 11,A00,492760,Castro; Robert Jess,199,0,200,1
1713315917153,TDGE 124,A00,492772,Fulton; Julia,192,0,220,28
1713315918187,TDGE 125,A00,492773,Meyer; Ursula,40,0,50,10
1713315918187,TDGE 125,B00,492774,Staff,50,0,50,0
1713315918187,TDGE 125,C00,523565,Staff,49,0,50,1
1713315919212,TDGE 125GS,A00,523580,Guirguis; Mark C,24,0,28,4
1713315920241,TDGE 127,A00,492775,Havis; Allan,41,0,50,9
1713315921270,TDHT 101,A00,492776,Staff,35,0,35,0
1713315922295,TDMV 1,A00,492762,Caligagan; Maria T.,30,0,30,0
1713315922295,TDMV 1,B00,492763,Arcidiacono; Kristin,25,0,30,5
1713315923323,TDMV 2,A00,492764,Weinberg; Sadie,29,0,30,1
1713315924353,TDMV 3,A00,492765,Mack; Kara Shanai',39,0,40,1
1713315925380,TDMV 138,A00,492777,Mack; Kara Shanai',35,0,40,5
1713315926405,TDMV 140,A00,492778,Lima; Paulo Henrique,40,0,40,0
1713315927438,TDMV 142,A00,492779,Caligagan; Maria T.,36,0,40,4
1713315927438,TDMV 142,B00,492780,Caligagan; Tony,37,0,40,3
1713315928465,TDMV 143,A00,492781,Fyall; Daunte Edward,39,0,40,1
1713315929493,USP 1,A01,492401,Kwak; Nancy,26,0,35,9
1713315930522,USP 2,A01,492453,Hinds; Juli Beth,35,0,35,0
1713315931554,USP 3,A01,492516,Staff,29,0,35,6
1713315932577,USP 4,A00,492522,McTague; Sarah,19,0,25,6
1713315933607,USP 100,A00,492523,Staff,33,0,35,2
1713315934635,USP 101,A00,492524,Staff,13,0,15,2
1713315935659,USP 105,A00,492525,Staff,21,0,25,4
1713315936684,USP 151,A00,492526,Shenkman; Michael Thomas,33,0,35,2
1713315937709,USP 170,A00,492545,Hinds; Juli Beth,33,0,35,2
1713315938742,USP 171GS,A00,492608,Bussell; Mirle Rabinowitz,24,0,28,4
1713315939768,USP 183GS,A00,492613,Peerson; Susan,24,0,28,4
1713315940794,VIS 30,A01,490693,Yoldas; Pinar,21,0,22,1
1713315940794,VIS 30,A02,490694,Yoldas; Pinar,19,0,22,3
1713315941821,VIS 83,A00,490695,Kester; Grant,66,0,75,9
1713315942845,VIS 105D,A00,490696,Staff,22,0,25,3
1713315943872,VIS 124CN,A00,490699,Rose; Jordan M,68,0,75,7
1713315944897,VIS 125GS,A00,511221,Williams; Alena J,21,0,22,1
1713315945928,VIS 128D,A00,490700,Staff,74,0,75,1
1713315946959,VIS 151,A01,490717,Staff,33,0,34,1
1713315946959,VIS 151,A02,490766,Staff,33,0,34,1
1713315948043,VIS 154GS,A00,511972,Williams; Alena J,21,0,22,1
1713315949077,VIS 160A,A00,490767,Stone; Patricia,7,0,10,3
1713315950101,WCWP 10A,A00,490638,Staff,14,0,15,1
1713315950101,WCWP 10A,B00,490640,Staff,15,0,15,0
1713315951129,WCWP 10B,A00,490641,Staff,0,0,0,0
1713315951129,WCWP 10B,B00,490642,Staff,14,0,15,1
1713315951129,WCWP 10B,C00,490644,Staff,13,0,15,2
1713315951129,WCWP 10B,D00,490647,Staff,0,0,0,0
1713315952158,WCWP 100,A00,490655,Staff,0,0,0,0
1713315952158,WCWP 100,B00,490687,Staff,11,0,15,4
1713315954445,ANAR 153,A00,487222,Braswell; Geoffrey E.,54,0,60,6
1713315955471,ANBI 134,A00,487223,Staff,10,0,20,10
1713315956499,ANBI 143GS,A00,487224,Noel; Geoffroy Pierre Jean,20,0,24,4
1713315957526,ANBI 144GS,A00,519548,Noel; Geoffroy Pierre Jean,20,0,24,4
1713315958554,ANSC 101,A00,487225,Staff,19,0,20,1
1713315959585,ANSC 125,A00,487227,Brenner; Suzanne A,39,0,40,1
1713315961644,ANSC 146,A00,487229,Staff,36,0,40,4
1713315962670,ANSC 148,A00,487230,Olivas Hernandez; Olga Lid,39,0,40,1
1713315963695,ANSC 150,A00,504165,Sloane; Julia Kathryn,19,0,20,1
1713315964724,ANSC 180,A00,487232,Staff,13,0,15,2
1713315965752,ANSC 188,A00,627155,Staff,40,0,40,0
1713315966780,ANTH 5,A00,519529,Semendeferi; Ekaterini,15,0,15,0
1713315967805,ANTH 10,A00,487219,Staff,58,0,60,2
1713315968833,ANTH 23,A01,487221,Staff,17,0,20,3
1713315969858,ANTH 102,A00,487233,Wilder; Linnea Lorene,51,0,60,9
1713315970887,ANTH 103,A00,487234,Varma; Saiba,56,0,60,4
1713315971912,ANTH 105,A00,487235,Stewart; Alexander B,55,0,60,5
1713315972938,BENG 100,A01,516685,Taylor Amos; Alyssa C,28,0,30,2
1713315973971,BIBC 102,A01,491316,Flagg; Matthew Paul,33,0,88,55
1713315973971,BIBC 102,A02,491366,Flagg; Matthew Paul,83,0,88,5
1713315974997,BIBC 103,A01,491486,Boumechache; Miyyada,16,0,24,8
1713315974997,BIBC 103,A02,491487,Boumechache; Miyyada,24,0,24,0
1713315976024,BICD 100,A01,516882,Staff,75,0,75,0
1713315976024,BICD 100,A02,516890,Staff,70,0,75,5
1713315977051,BICD 102GS,A00,491488,Lo; Stanley M.,26,0,28,2
1713315978078,BIEB 136GS,A00,516940,Holway; David A. & Shurin; Jonathan,19,0,24,5
1713315979102,BIEB 137GS,A01,517034,Holway; David A. & Shurin; Jonathan,19,0,24,5
1713315980132,BIEB 138GS,A01,491492,Pirino; Giorgia,21,0,28,7
1713315981159,BILD 1,A01,491296,Staff,62,0,63,1
1713315981159,BILD 1,A02,491297,Staff,63,0,63,0
1713315982186,BILD 4,A01,517099,Gonzalez Gamboa; Ivonne,22,0,24,2
1713315982186,BILD 4,A02,517100,Gonzalez Gamboa; Ivonne,24,0,24,0
1713315983212,BILD 60GS,A00,491309,Lo; Stanley M.,26,0,28,2
1713315984241,BIMM 100,A01,517136,Staff,88,0,100,12
1713315985266,BIMM 110,A01,517182,Staff,67,0,100,33
1713315986297,BIMM 120,A01,517228,Pickett; Brooke Elizabeth,37,0,63,26
1713315986297,BIMM 120,A02,517240,Pickett; Brooke Elizabeth,48,0,63,15
1713315987327,BIMM 132GS,A01,491498,Pirino; Giorgia,21,0,28,7
1713315988358,BIMM 143,A01,491589,Bozinovic; Goran,17,0,40,23
1713315989390,BIPN 100,A01,491594,Armour; Jon Christopher,90,0,100,10
1713315990419,BIPN 140,A01,491602,Marino; Marc J,28,0,50,22
1713315992471,CAT 125,A00,515973,Staff,19,0,20,1
1713315993501,CAT 125GS,A00,515974,Rahimi; Babak,18,0,20,2
1713315994542,CAT 125R,A00,515980,Staff,14,0,20,6
1713315994542,CAT 125R,B00,515981,Tosun; Adriana,19,0,20,1
1713315994542,CAT 125R,C00,515987,Hyland; Tina Mae,1,0,20,19
1713315994542,CAT 125R,D00,515988,Bronstein; Phoebe Malan,18,0,20,2
1713316005746,CENG 15,A01,488699,Drews; Aaron,25,0,25,0
1713316006779,CENG 100,A00,505196,Opatkiewicz; Justin Paul,25,0,25,0
1713316007812,CGS 2A,A01,489598,Staff,33,0,35,2
1713316008843,CGS 112,A00,489599,Staff,15,0,15,0
1713316009871,CGS 119,A00,489603,Staff,10,0,10,0
1713316010896,CGS 120,A00,489604,Staff,14,0,15,1
1713316011920,CGS 150,A00,489607,Staff,15,0,15,0
1713316012952,CHEM 6A,A01,488715,Staff,98,0,100,2
1713316013981,CHEM 6B,A01,488719,Piercy; Marc Anthony,100,0,100,0
1713316015005,CHEM 6C,A01,488723,Albizati; Kim F.,94,0,100,6
1713316016035,CHEM 7L,A01,488728,Schurmeier; Kimberly,18,0,24,6
1713316016035,CHEM 7L,A02,488730,Schurmeier; Kimberly,23,0,24,1
1713316016035,CHEM 7L,A03,488734,Schurmeier; Kimberly,23,0,24,1
1713316016035,CHEM 7L,A04,488763,Schurmeier; Kimberly,23,0,24,1
1713316016035,CHEM 7L,B01,488798,Schurmeier; Kimberly,17,0,24,7
1713316016035,CHEM 7L,B02,488801,Schurmeier; Kimberly,23,0,24,1
1713316016035,CHEM 7L,B03,488808,Schurmeier; Kimberly,24,0,24,0
1713316016035,CHEM 7L,B04,488811,Schurmeier; Kimberly,24,0,24,0
1713316017064,CHEM 11,A01,488897,Stallings; Dontarie M,97,0,100,3
1713316018098,CHEM 40A,A01,488913,Albizati; Kim F.,90,0,100,10
1713316019125,CHEM 40B,A01,488920,Weizman; Haim,46,0,50,4
1713316019125,CHEM 40B,A02,488938,Weizman; Haim,46,0,50,4
1713316020155,CHEM 41A,A01,489029,Klosterman; Jeremy K,58,0,60,2
1713316021181,CHEM 41C,A01,500436,Tor; Yitzhak,55,0,60,5
1713316022214,CHEM 43A,A01,500426,Weizman; Haim,2,0,24,22
1713316022214,CHEM 43A,A02,500430,Weizman; Haim,13,0,24,11
1713316022214,CHEM 43A,B01,514041,Klosterman; Jeremy K,15,0,24,9
1713316022214,CHEM 43A,B02,514047,Klosterman; Jeremy K,23,0,24,1
1713316023242,CHEM 108,A01,489140,Jennings; Patricia A.,11,0,24,13
1713316023242,CHEM 108,A02,489142,Jennings; Patricia A.,14,0,24,10
1713316024270,CHEM 114A,A01,489147,Stallings; Dontarie M,77,0,100,23
1713316025295,CHIN 169A,A00,489171,Wang; Xiao,19,0,20,1
1713316027344,COGS 3,A01,518827,Boyle; Mary E. T.,29,0,40,11
1713316028373,COGS 11,A01,489175,Staff,28,0,30,2
1713316029412,COGS 14A,A01,518829,Staff,51,0,60,9
1713316030442,COGS 14B,A01,489177,Hoffman; Drew Ellen,67,0,75,8
1713316031467,COGS 100,A01,489181,Allen; Michael Gordon,66,0,75,9
1713316032493,COGS 101A,A01,489183,Staff,48,0,60,12
1713316033524,COGS 101B,A01,489185,Allen; Michael Gordon,12,0,30,18
1713316034552,COGS 101C,A01,526786,Staff,24,0,30,6
1713316036603,COGS 107A,A01,489189,Boyle; Mary E. T.,19,0,35,16
1713316037629,COGS 107B,A01,627144,Mooshagian; Eric Frederick,60,0,60,0
1713316038656,COGS 118A,A01,489191,Staff,0,35,40,40
1713316040713,COGS 171GS,A01,489194,Pineda; Jaime A,22,0,28,6
1713316041738,COGS 172,A01,489196,Staff,3,0,30,27
1713316042763,COGS 174GS,A01,489264,Pineda; Jaime A,22,0,28,6
1713316043791,COGS 180,A01,627150,Staff,28,0,30,2
1713316044818,COGS 186,A01,489274,Staff,1,0,30,29
1713316045845,COMM 10,A01,489276,Staff,23,0,25,2
1713316045845,COMM 10,A02,489303,Staff,23,0,25,2
1713316046874,COMM 100A,A01,489312,Staff,16,0,25,9
1713316046874,COMM 100A,A02,489313,Staff,24,0,25,1
1713316047899,COMM 106T,A00,512540,Staff,34,0,35,1
1713316048924,COMM 107,A00,489347,Staff,31,0,35,4
1713316049951,COMM 109P,A00,489358,Staff,31,0,35,4
1713316050976,COMM 132,A00,489361,McKenna; Denise,28,0,30,2
1713316052006,COMM 146,A00,489362,Halm; Gavin Patrick,27,0,30,3
1713316053035,COMM 190,A00,489363,Abuelhiga; Soraya Jill,20,0,23,3
1713316054062,CSE 8A,A50,489366,Staff,22,0,25,3
1713316054062,CSE 8A,A51,489367,Staff,24,0,25,1
1713316055089,CSE 11,A01,489398,Cao; Yingjun,79,0,100,21
1713316056119,CSE 12,A01,489487,Staff,43,0,50,7
1713316057145,CSE 20,A01,489497,Staff,48,0,50,2
1713316058173,CSE 21,A01,489517,Braun; Oliver,43,0,50,7
1713316059197,CSE 101,A01,489524,Braun; Oliver,0,17,50,50
1713316060229,CSE 105,A01,512594,Jones; Miles E,79,0,100,21
1713316060229,CSE 105,B01,512598,Jones; Miles E,58,0,100,42
1713316061255,CSE 140,A01,489538,Staff,44,0,50,6
1713316062337,CSE 141,A01,489550,Eldon; John,74,0,100,26
1713316063368,CSE 141L,A01,489571,Eldon; John,72,0,100,28
1713316064394,CSE 151A,A01,489583,Solares; Edwin A,148,0,200,52
1713316065420,CSE 175,A01,510886,Kumar; Rakesh,30,0,30,0
1713316066450,CSE 190,A00,516828,Dubnov; Shlomo,40,0,49,9
1713316067481,DOC 100D,A00,489667,Pass; Natalye Joann,20,0,25,5
1713316068519,DSC 10,A01,624268,Staff,72,0,75,3
1713316069544,DSC 20,A01,624476,Staff,50,0,50,0
1713316070570,DSC 40A,A01,624608,Staff,39,0,40,1
1713316071602,DSGN 1,A01,489179,Rill; Bryan,36,0,50,14
1713316072632,ECE 17,A01,490489,Sahay; Rajeev,18,0,30,12
1713316073661,ECE 65,A50,490492,Staff,15,0,20,5
1713316073661,ECE 65,A51,490493,Staff,20,0,20,0
1713316074688,ECON 1,A01,489715,Famulari; Melissa,68,0,70,2
1713316075718,ECON 2,A01,489717,Levkoff; Steven B.,68,0,70,2
1713316076743,ECON 3,A01,489948,Staff,70,0,70,0
1713316078796,ECON 5,A01,490103,Staff,28,0,30,2
1713316078796,ECON 5,B01,626281,Dai; Yinlin,45,0,45,0
1713316079826,ECON 100A,A01,490127,Famulari; Melissa,66,0,70,4
1713316080850,ECON 100B,A01,490129,Staff,64,0,70,6
1713316081879,ECON 109,A01,490187,Shishkin; Denis,27,0,35,8
1713316082906,ECON 110A,A01,490190,Levkoff; Steven B.,61,0,70,9
1713316083936,ECON 120A,A01,490245,Dai; Yinlin,63,0,70,7
1713316084960,ECON 120B,A01,490247,Nieto-Barthaburu; Augusto,55,0,70,15
1713316085991,ECON 120C,A01,490253,Sun; Yixiao,30,0,35,5
1713316085991,ECON 120C,B01,490255,Sun; Yixiao,34,0,35,1
1713316087016,ECON 129,A00,490256,Eckert; Fabian Paul,25,0,35,10
1713316088044,ECON 131,A00,490257,Nieto-Barthaburu; Augusto,0,2,35,35
1713316089071,ECON 138,A00,490258,Bharadwaj; Prashant,18,0,35,17
1713316089071,ECON 138,B00,490259,Bharadwaj; Prashant,17,0,35,18
1713316090095,ECON 159,A00,490260,Hendrickson; Gerald M.,0,8,0,0
1713316091128,ECON 178,A01,553995,Zhu; Ying,26,0,35,9
1713316092155,EDS 40,A01,512576,Black; Alison Michelle,20,0,20,0
1713316093180,EDS 107,A01,515848,Staff,30,0,30,0
1713316094281,EDS 110R,A01,490262,Staff,26,0,30,4
1713316095306,EDS 112,A01,490264,Chapman; Thandeka K,42,0,50,8
1713316096334,EDS 113,A00,490266,Staff,26,0,30,4
1713316097359,EDS 118,A00,490267,Warstadt; Melissa Fawn,23,0,30,7
1713316098389,EDS 124BR,A00,490268,Eguchi; Emi,7,0,25,18
1713316098389,EDS 124BR,B00,490269,Eguchi; Emi,25,0,25,0
1713316099418,EDS 126,A01,490271,Jones; Makeba,44,0,50,6
1713316100442,EDS 135,A01,490316,Staff,19,0,20,1
1713316101468,ENVR 142GS,A00,519514,Chang; Edmond Yi-Teh,28,0,28,0
1713316102492,ETHN 103,A00,490504,Staff,31,0,36,5
1713316103518,ETHN 103A,A00,490505,Man; Simeon S,5,0,9,4
1713316104543,ETHN 109,A00,490506,Staff,30,0,30,0
1713316105572,ETHN 118,A00,490507,Staff,35,0,36,1
1713316106597,ETHN 119,A00,490508,Staff,34,0,36,2
1713316107626,ETHN 121R,A00,490518,Choi; Esther Min,25,0,36,11
1713316108652,ETHN 127,A00,490528,Staff,15,0,15,0
1713316109676,ETHN 139,A00,490573,Staff,10,0,10,0
1713316110699,ETHN 150,A00,490575,Staff,15,0,15,0
1713316111726,GLBH 20,A00,491705,Elwardani; Nile Regina,38,0,40,2
1713316112749,GLBH 101,A00,491706,Staff,20,0,20,0
1713316113777,GLBH 111,A01,491708,Burgos; Jose L.,15,0,15,0
1713316114803,GLBH 146,A00,491709,Staff,11,0,20,9
1713316115828,GLBH 148,A00,491710,Olivas Hernandez; Olga Lid,14,0,20,6
1713316116854,GLBH 150,A00,491711,Sloane; Julia Kathryn,20,0,20,0
1713316117881,HIEA 131,A00,491760,Staff,29,0,32,3
1713316118907,HIEA 153,A00,491762,Staff,29,0,30,1
1713316119931,HIEU 124,A00,491811,Staff,26,0,32,6
1713316120958,HIEU 124GS,A00,491812,Markman; Kristina,27,0,28,1
1713316121984,HIEU 147,A00,491813,Staff,30,0,32,2
1713316123012,HIEU 149GS,A00,491816,Caldwell; Michael Alan,28,0,28,0
1713316124039,HILD 2C,A01,491713,Hendrickson; Gerald M.,27,0,30,3
1713316125064,HILD 7B,A01,491715,Kwak; Nancy,6,0,30,24
1713316126092,HILD 10,A01,491717,Staff,13,0,20,7
1713316127121,HILD 30GS,A00,491719,Edington; Claire Ellen,24,0,28,4
1713316128146,HINE 109,A00,491818,Shafir; Nir,28,0,32,4
1713316129174,HINE 128,A00,491821,Shafir; Nir,31,0,32,1
1713316130199,HISC 117,A00,491830,Staff,29,0,32,3
1713316131223,HIUS 103,A00,491834,Man; Simeon S,15,0,23,8
1713316132250,HIUS 108B,A00,491835,Staff,29,0,30,1
1713316133276,HIUS 141,A00,491836,Hendrickson; Gerald M.,29,0,32,3
1713316134303,HIUS 149,A00,491839,Staff,27,0,32,5
1713316135330,HUM 3,A01,512617,Crum; Matthew Stephen,45,0,50,5
1713316135330,HUM 3,A02,512618,Crum; Matthew Stephen,48,0,50,2
1713316136358,HUM 3GS,A00,512663,Markman; Kristina,0,0,0,1
1713316136358,HUM 3GS,B00,512664,Staff,0,0,0,0
1713316137386,HUM 4,A01,512620,West; Geoffrey Scott,31,0,50,19
1713316138416,HUM 4GS,A00,512666,Lyon; Antony J.,0,0,0,3
1713316139448,HUM 4R,A01,512625,Watkins; Eric,49,0,50,1
1713316140472,HUM 5,A01,512649,Zavodny; Tatiana Sophia,29,0,50,21
1713316140472,HUM 5,B01,512661,Zroka; Ryan Edward,48,0,50,2
1713316141502,INTL 190,A00,490577,Segui; Alan S,0,0,0,5
1713316142530,JAPN 20AR,A01,491267,Ross; Kayoko F,9,0,20,11
1713316143554,JAPN 180,A00,491285,Berman; Michael David,34,0,40,6
1713316144581,LATI 50,A01,502536,Kokinis; Troy Andreas,16,0,22,6
1713316144581,LATI 50,A02,502551,Kokinis; Troy Andreas,22,0,22,0
1713316144581,LATI 50,A03,502650,Kokinis; Troy Andreas,22,0,22,0
1713316144581,LATI 50,A04,502909,Kokinis; Troy Andreas,22,0,22,0
1713316145607,LATI 160,A01,502920,Kokinis; Troy Andreas,30,0,30,0
1713316146635,LIFR 1A,A00,490494,Van Moer; Vinciane G,17,0,20,3
1713316147661,LIFR 1AX,A00,490495,Van Moer; Vinciane G,17,0,20,3
1713316148685,LIFR 1B,A00,490496,Van Moer; Vinciane G,18,0,20,2
1713316149709,LIFR 1BX,A00,490497,Van Moer; Vinciane G,18,0,20,2
1713316150739,LIGN 8,A00,505198,McIntosh; Justin Daniel,136,0,150,14
1713316151764,LIGN 9GS,A00,491239,Lott; Margaret S.,18,0,20,2
1713316152789,LIGN 101,A01,505200,McIntosh; Justin Daniel,24,0,30,6
1713316153815,LIGN 120,A01,491244,Staff,24,0,30,6
1713316154842,LIGN 149GS,A00,491245,Lott; Margaret S.,18,0,20,2
1713316155867,LIGN 170,A00,491247,Staff,24,0,30,6
1713316156895,LISP 1D,A00,490498,Munoz Sanchez; Alicia,10,0,14,4
1713316156895,LISP 1D,B00,490499,Munoz Sanchez; Alicia,6,0,14,8
1713316156895,LISP 1D,C00,490500,Munoz Sanchez; Alicia,8,0,14,6
1713316156895,LISP 1D,D00,490501,Munoz Sanchez; Alicia,10,0,14,4
1713316157920,LISP 1DX,A00,490502,Munoz Sanchez; Alicia,15,0,28,13
1713316157920,LISP 1DX,B00,490503,Munoz Sanchez; Alicia,17,0,28,11
1713316159970,LTAM 110,A00,491847,Staff,23,0,25,2
1713316160993,LTCS 119,A00,491848,Staff,12,0,15,3
1713316162018,LTCS 130,A00,491849,Staff,24,0,25,1
1713316164067,LTEA 120C,A00,491852,Staff,34,0,40,6
1713316165099,LTEN 130GS,A00,491853,Lyon; Antony J.,25,0,28,3
1713316166178,LTEN 148,A00,491855,Staff,23,0,25,2
1713316167205,LTEN 159,A00,491856,Staff,21,0,25,4
1713316168231,LTEN 180,A00,491857,Staff,9,0,15,6
1713316170287,LTSP 123GS,A00,505928,Bessett; Ryan Matthew,24,0,28,4
1713316171311,LTSP 174GS,A00,506037,Bessett; Ryan Matthew,24,0,28,4
1713316173365,LTWR 102,A00,491861,Staff,11,0,15,4
1713316174392,LTWR 106,A00,491862,Staff,10,0,15,5
1713316175418,MAE 11,A00,490930,Bahadori; Mohammad Yousef,97,0,100,3
1713316176445,MAE 30A,A00,490931,Qi; Huihui,37,0,40,3
1713316177474,MAE 101A,A00,491036,Sadeghizadeh; Zahra,97,0,100,3
1713316178504,MAE 101C,A00,491037,Seshadri; Kalyanasundaram,76,0,100,24
1713316179532,MAE 113,A00,491040,Seshadri; Kalyanasundaram,66,0,80,14
1713316180565,MAE 131A,A00,491041,Ghazinejad; Maziar,39,0,40,1
1713316181592,MAE 142,A00,491053,Staff,39,0,40,1
1713316182616,MAE 143A,A00,491054,Staff,37,0,50,13
1713316183645,MAE 150,A00,491092,Truong; Phuong Thi Ngoc,23,0,35,12
1713316184675,MATH 3C,A01,494031,Pardo Guerra; Sebastian,30,0,30,0
1713316184675,MATH 3C,A02,494032,Pardo Guerra; Sebastian,29,0,30,1
1713316185698,MATH 10A,A01,494034,Staff,27,0,30,3
1713316185698,MATH 10A,A02,494035,Staff,28,0,30,2
1713316185698,MATH 10A,B01,494037,Staff,27,0,30,3
1713316185698,MATH 10A,B02,494038,Staff,29,0,30,1
1713316186727,MATH 10B,A01,494040,Habib; Yousaf,23,0,30,7
1713316186727,MATH 10B,A02,494041,Habib; Yousaf,28,0,30,2
1713316186727,MATH 10B,A03,494042,Habib; Yousaf,30,0,30,0
1713316186727,MATH 10B,A04,494043,Habib; Yousaf,30,0,30,0
1713316186727,MATH 10B,B01,494045,Habib; Yousaf,28,0,30,2
1713316186727,MATH 10B,B02,494046,Habib; Yousaf,30,0,30,0
1713316186727,MATH 10B,B03,494047,Habib; Yousaf,30,0,30,0
1713316186727,MATH 10B,B04,494048,Habib; Yousaf,30,0,30,0
1713316187753,MATH 18,A01,494050,Kemp; Todd Aahron,25,0,30,5
1713316187753,MATH 18,A02,494051,Kemp; Todd Aahron,29,0,30,1
1713316187753,MATH 18,B01,494054,Kemp; Todd Aahron,28,0,30,2
1713316187753,MATH 18,B02,494055,Kemp; Todd Aahron,29,0,30,1
1713316188778,MATH 20A,A01,494059,Suk; Andrew Hoon,30,0,30,0
1713316189806,MATH 20B,A01,494061,Briones; Jor-el Thomas Caparas,33,0,35,2
1713316189806,MATH 20B,B01,494063,Bach; Quang Tran,34,0,35,1
1713316190838,MATH 20C,A01,494065,Staff,28,0,30,2
1713316190838,MATH 20C,A02,494066,Staff,30,0,30,0
1713316190838,MATH 20C,A03,494067,Staff,30,0,30,0
1713316190838,MATH 20C,A04,494068,Staff,30,0,30,0
1713316190838,MATH 20C,B01,494070,Zhang; Ming,26,0,30,4
1713316190838,MATH 20C,B02,494071,Zhang; Ming,28,0,30,2
1713316190838,MATH 20C,B03,494072,Zhang; Ming,29,0,30,1
1713316190838,MATH 20C,B04,494073,Zhang; Ming,29,0,30,1
1713316191868,MATH 20D,A01,494075,Staff,22,0,30,8
1713316191868,MATH 20D,A02,494076,Staff,30,0,30,0
1713316192894,MATH 20E,A01,494079,Staff,24,0,30,6
1713316192894,MATH 20E,A02,494080,Staff,27,0,30,3
1713316192894,MATH 20E,B01,494082,Staff,27,0,30,3
1713316192894,MATH 20E,B02,494083,Staff,25,0,30,5
1713316193922,MATH 103A,A01,494085,Aliabadi Sr.; Mohsen,16,0,30,14
1713316193922,MATH 103A,A02,494086,Aliabadi Sr.; Mohsen,28,0,30,2
1713316193922,MATH 103A,B01,494088,Aliabadi Sr.; Mohsen,22,0,30,8
1713316193922,MATH 103A,B02,494089,Aliabadi Sr.; Mohsen,28,0,30,2
1713316194947,MATH 109,A01,494091,Staff,30,0,30,0
1713316194947,MATH 109,A02,494092,Staff,29,0,30,1
1713316194947,MATH 109,B01,494094,Staff,28,0,30,2
1713316194947,MATH 109,B02,494095,Staff,29,0,30,1
1713316195980,MATH 142A,A01,494097,Chow; Bennett,16,0,30,14
1713316195980,MATH 142A,A02,494098,Chow; Bennett,24,0,30,6
1713316195980,MATH 142A,B01,494100,Chow; Bennett,19,0,30,11
1713316195980,MATH 142A,B02,494101,Chow; Bennett,29,0,30,1
1713316198037,MATH 168A,A01,516677,Dumitriu; Ioana,15,0,35,20
1713316199067,MATH 170A,A01,516679,Dumitriu; Ioana,20,0,30,10
1713316199067,MATH 170A,A02,516680,Dumitriu; Ioana,28,0,30,2
1713316200094,MATH 193A,A01,494107,Staff,15,0,30,15
1713316200094,MATH 193A,A02,494108,Staff,21,0,30,9
1713316200094,MATH 193A,A03,494109,Staff,29,0,30,1
1713316200094,MATH 193A,A04,494110,Staff,22,0,30,8
1713316203177,MGT 16,A00,491930,McKay; Michael J,92,0,98,6
1713316204202,MGT 18,A00,491992,McKay; Michael J,97,0,98,1
1713316205229,MGT 71,A00,492003,Staff,75,0,98,23
1713316206261,MGT 103,A00,505209,Eberhard; Craig A,85,0,98,13
1713316207287,MGT 131A,A00,505210,Anderson; John Charles,90,0,98,8
1713316209343,MGT 153,A00,492077,Perols; Johan Lars,34,0,90,56
1713316212423,MGT 164,A00,492222,McKay; Mary A,93,0,98,5
1713316213449,MGT 172,A00,492245,Staff,59,0,60,1
1713316213449,MGT 172,B00,505526,Hedges; Kathleen,75,0,98,23
1713316214475,MGT 181,A00,505669,Dunn; Louis Jean,85,0,98,13
1713316215502,MMW 14,A01,494399,Staff,23,0,28,5
1713316215502,MMW 14,A02,494400,Staff,25,0,28,3
1713316215502,MMW 14,A03,494401,Staff,28,0,28,0
1713316215502,MMW 14,A04,494402,Staff,28,0,28,0
1713316215502,MMW 14,B01,494404,Carreras; Maria Victoria,13,0,28,15
1713316215502,MMW 14,B02,494405,Carreras; Maria Victoria,26,0,28,2
1713316215502,MMW 14,B03,494406,Carreras; Maria Victoria,28,0,28,0
1713316215502,MMW 14,B04,494407,Carreras; Maria Victoria,28,0,28,0
1713316216530,MMW 14GS,A00,506250,Chang; Edmond Yi-Teh,0,0,0,0
1713316217556,MMW 121R,A01,494415,Adamiak; Patrick John,13,0,28,15
1713316217556,MMW 121R,A02,494416,Adamiak; Patrick John,24,0,28,4
1713316218583,MUS 1A,A01,494113,Staff,12,0,25,13
1713316218583,MUS 1A,A02,494114,Staff,25,0,25,0
1713316219610,MUS 4,A01,494116,Staff,24,0,25,1
1713316219610,MUS 4,A02,494117,Staff,22,0,25,3
1713316220640,MUS 5R,A01,494236,Dubnov; Shlomo,10,0,25,15
1713316220640,MUS 5R,A02,494237,Dubnov; Shlomo,25,0,25,0
1713316221666,MUS 6,A01,494122,Staff,13,0,25,12
1713316221666,MUS 6,A02,494123,Staff,24,0,25,1
1713316222692,MUS 7,A01,494125,Staff,17,0,25,8
1713316222692,MUS 7,A02,494126,Staff,24,0,25,1
1713316223720,MUS 11,A01,494128,Staff,23,0,25,2
1713316223720,MUS 11,A02,494129,Staff,24,0,25,1
1713316224749,MUS 13,A01,494131,Staff,25,0,25,0
1713316224749,MUS 13,A02,494132,Staff,25,0,25,0
1713316225779,MUS 15,A01,494134,Staff,18,0,25,7
1713316225779,MUS 15,A02,494135,Staff,25,0,25,0
1713316225779,MUS 15,B01,494137,Staff,24,0,25,1
1713316226808,MUS 80,A00,494232,Staff,24,0,25,1
1713316226808,MUS 80,B00,494233,Staff,25,0,25,0
1713316226808,MUS 80,C00,494234,Staff,23,0,25,2
1713316227832,MUS 95C,A00,494141,Staff,72,0,75,3
1713316228858,MUS 114,A00,494142,Staff,41,0,50,9
1713316229884,NANO 15,A01,490636,Drews; Aaron,7,0,7,0
1713316230908,PHIL 1,A00,490578,Grush; Rick Scott,49,0,50,1
1713316231934,PHIL 10,A01,490580,Grush; Rick Scott,33,0,35,2
1713316231934,PHIL 10,A02,490586,Grush; Rick Scott,33,0,35,2
1713316232958,PHIL 27,A01,490591,Staff,23,0,25,2
1713316232958,PHIL 27,A02,490592,Staff,25,0,25,0
1713316232958,PHIL 27,A03,490593,Staff,25,0,25,0
1713316232958,PHIL 27,A04,490598,Staff,25,0,25,0
1713316233986,PHIL 32,A01,490611,Staff,20,0,20,0
1713316233986,PHIL 32,A02,490618,Staff,20,0,20,0
1713316235010,PHIL 90,A00,490624,Staff,40,0,40,0
1713316236040,PHIL 136,A00,490627,Cohen; Jonathan David,38,0,40,2
1713316237066,PHIL 155,A00,490634,Staff,64,0,70,6
1713316238096,PHYS 1A,A00,491610,Staff,246,0,250,4
1713316239122,PHYS 1AL,001,491616,Tsai; Philbert S,28,0,30,2
1713316239122,PHYS 1AL,002,491618,Tsai; Philbert S,30,0,30,0
1713316240148,PHYS 1B,A00,491623,Staff,244,0,250,6
1713316241172,PHYS 1BL,001,491626,Tsai; Philbert S,26,0,30,4
1713316241172,PHYS 1BL,002,491628,Tsai; Philbert S,27,0,30,3
1713316242200,PHYS 1C,A00,491632,Staff,220,0,245,25
1713316243224,PHYS 1CL,001,491635,Tsai; Philbert S,10,0,30,20
1713316243224,PHYS 1CL,002,491643,Tsai; Philbert S,24,0,30,6
1713316244255,PHYS 2AR,A01,491651,Meyertholen; Andrew D.,44,0,50,6
1713316245283,PHYS 2B,A01,491659,Staff,106,0,115,9
1713316246307,PHYS 2BL,A01,491685,Staff,21,0,24,3
1713316246307,PHYS 2BL,A02,491700,Staff,23,0,24,1
1713316247333,PHYS 2C,A01,505161,Staff,106,0,115,9
1713316248361,PHYS 4A,A01,491704,Grinstein; Benjamin,99,0,100,1
1713316249387,POLI 5D,A01,494144,Staff,3,0,5,2
1713316249387,POLI 5D,B01,626283,Dai; Yinlin,5,0,5,0
1713316250411,POLI 12,A00,494145,Staff,44,0,45,1
1713316251436,POLI 13R,A00,494146,Forman; Fonna,45,0,50,5
1713316252461,POLI 27,A01,494148,Staff,57,0,60,3
1713316253486,POLI 30,A00,494149,Staff,49,0,50,1
1713316254515,POLI 100DA,A00,494150,Staff,21,0,25,4
1713316256572,POLI 100I,A00,494152,Staff,28,0,30,2
1713316257598,POLI 104B,A00,494153,Smith; Glenn Chatmas,54,0,55,1
1713316258640,POLI 104F,A00,494154,Staff,28,0,30,2
1713316259668,POLI 104I,A00,494155,Smith; Glenn Chatmas,30,0,30,0
1713316260698,POLI 110C,A00,494156,Ingham; Sean,23,0,25,2
1713316261724,POLI 117R,A00,494157,Forman; Fonna,10,0,20,10
1713316262749,POLI 118,A00,494158,Ingham; Sean,22,0,25,3
1713316263773,POLI 120H,A00,494159,Fisk; David Lee,41,0,45,4
1713316264804,POLI 131CR,A00,494160,Hoston; Germaine,36,0,45,9
1713316265831,POLI 133J,A00,494161,Staff,33,0,35,2
1713316266856,POLI 135,A00,494162,Fisk; David Lee,33,0,35,2
1713316267881,POLI 140A,A00,494164,Staff,21,0,30,9
1713316268908,POLI 142I,A00,494165,Staff,30,0,30,0
1713316270006,POLI 144D,A00,494166,Staff,23,0,25,2
1713316271034,POLI 151,A00,494167,Staff,30,0,30,0
1713316272059,POLI 153,A00,494168,Staff,33,0,35,2
1713316273086,POLI 160AA,A00,494169,Staff,35,0,40,5
1713316274110,POLI 162,A00,494170,Mignozzetti; Umberto,20,0,25,5
1713316275138,POLI 171,A00,494171,Mignozzetti; Umberto,21,0,25,4
1713316276166,PSYC 1,A00,494172,Staff,97,0,100,3
1713316277192,PSYC 2,A00,494173,Moranton; Nirelia Melbina-,43,0,50,7
1713316278220,PSYC 3,A00,494174,Staff,29,0,30,1
1713316279245,PSYC 6,A00,494175,Staff,17,0,20,3
1713316280270,PSYC 60,A01,494177,Staff,39,0,45,6
1713316281296,PSYC 70,A01,505724,Geller; Emma Harlan,42,0,45,3
1713316282321,PSYC 101,A00,494180,Heyman; Gail D.,87,0,100,13
1713316283349,PSYC 105,A00,494181,Geller; Emma Harlan,61,0,90,29
1713316284373,PSYC 106,A00,494182,Dobkins; Karen R.,30,0,45,15
1713316285402,PSYC 108,A00,494183,Adrian; Julia Anna,91,0,100,9
1713316286429,PSYC 114,A01,494185,Winkielman; Piotr,0,0,30,30
1713316287454,PSYC 122,A00,494186,Moranton; Nirelia Melbina-,37,0,50,13
1713316288480,PSYC 124,A00,494187,Chapman; Eddie Nathaniel,72,0,80,8
1713316289504,PSYC 131,A00,494188,Anagnostaras; Stephan,52,0,80,28
1713316290735,PSYC 144,A00,494189,Staff,13,0,50,37
1713316291760,PSYC 154,A00,494190,Lacefield; Katharine I,128,0,180,52
1713316292786,PSYC 162,A00,494191,Wixted; John T,80,0,100,20
1713316293815,PSYC 172,A00,494192,Gorman; Michael R.,37,0,45,8
1713316294840,PSYC 178,A00,494193,Glaser; Dale,40,0,45,5
1713316295865,PSYC 193,A00,505725,Chapman; Eddie Nathaniel,20,0,20,0
1713316296890,RELI 145GS,A00,519817,Rahimi; Babak,18,0,20,2
1713316297914,SE 101A,A01,490862,Chadha; Mayank,23,0,25,2
1713316298940,SE 101C,A01,490924,Krysl; Petr,18,0,20,2
1713316299965,SE 110A,A01,490928,Staff,19,0,20,1
1713316300991,SE 130A,A00,490929,Morrison; Machel Leigh,60,0,70,10
1713316302016,SIO 1,A01,519325,Staff,39,0,40,1
1713316303045,SIO 30,A01,519327,Staff,39,0,40,1
1713316304069,SIO 40,A00,519328,Staff,40,0,40,0
1713316305094,SIO 46GS,A00,519819,Cook; Geoffrey W,18,0,25,7
1713316306122,SIO 109R,A00,494197,Forman; Fonna,4,0,20,16
1713316307149,SIO 121GS,A00,519827,Cook; Geoffrey W,18,0,25,7
1713316308179,SIO 132,A01,519330,Staff,38,0,40,2
1713316309209,SIO 133,A01,519397,Staff,37,0,40,3
1713316310241,SIO 139,A00,519396,Kacev; David,31,0,40,9
1713316311268,SOCI 1,A01,494199,Thorpe; Charles Robert,23,0,30,7
1713316311268,SOCI 1,A02,494200,Thorpe; Charles Robert,30,0,30,0
1713316311268,SOCI 1,A03,494201,Thorpe; Charles Robert,29,0,30,1
1713316311268,SOCI 1,A04,494202,Thorpe; Charles Robert,29,0,30,1
1713316311268,SOCI 1,A05,494203,Thorpe; Charles Robert,29,0,30,1
1713316311268,SOCI 1,A06,494204,Thorpe; Charles Robert,30,0,30,0
1713316311268,SOCI 1,A07,494205,Thorpe; Charles Robert,29,0,30,1
1713316312298,SOCI 60,A01,494207,Staff,35,0,40,5
1713316312298,SOCI 60,A02,494208,Staff,39,0,40,1
1713316313325,SOCI 100,A01,494210,Payne; Christine Anna,27,0,30,3
1713316313325,SOCI 100,A02,494211,Payne; Christine Anna,27,0,30,3
1713316314350,SOCI 109M,A00,494212,Staff,20,0,20,0
1713316315373,SOCI 110,A00,494213,Staff,35,0,40,5
1713316317425,SOCI 118E,A00,494215,Ng; Kwai,38,0,40,2
1713316318452,SOCI 125,A00,494216,Calderon-Zaks; Michael Aar,42,0,45,3
1713316319479,SOCI 126,A01,494218,Jones; Makeba,3,0,5,2
1713316320504,SOCI 131,A00,494219,Thorpe; Charles Robert,28,0,30,2
1713316322557,SOCI 135,A00,494221,Payne; Christine Anna,34,0,50,16
1713316323583,SOCI 136E,A00,626690,Ruiz; Jonathan Joseph,25,0,25,0
1713316324611,SOCI 138GS,A00,494222,Navon; Daniel,24,0,28,4
1713316326665,SOCI 145,A00,494224,Staff,42,0,45,3
1713316327690,SOCI 153,A00,494225,Staff,28,0,30,2
1713316328725,SOCI 160E,A00,494226,Ng; Kwai,32,0,40,8
1713316329749,SOCI 180,A00,494227,Staff,29,0,30,1
1713316330774,SOCI 189GS,A00,494228,Ribas Norris; Janet Vanesa,11,0,11,0
1713316331802,SOCI 190GS,A00,553232,Ribas Norris; Janet Vanesa,11,0,11,0
1713316332828,SOMI 220,A00,627178,Schneid; Stephen David,30,0,30,0
1713316333859,SYN 2,001,490768,Staff,14,0,15,1
1713316333859,SYN 2,002,490769,Staff,15,0,15,0
1713316333859,SYN 2,004,490775,Staff,0,0,0,0
1713316333859,SYN 2,003,490774,Staff,0,0,0,0
1713316333859,SYN 2,005,490776,Staff,0,0,0,0
1713316334888,SYN 2R,001,490779,Staff,12,0,15,3
1713316334888,SYN 2R,002,514635,Staff,14,0,15,1
1713316335913,SYN 100,A01,490783,Staff,15,0,20,5
1713316335913,SYN 100,B01,490787,Staff,10,0,20,10
1713316335913,SYN 100,C01,490789,Staff,12,0,20,8
1713316336939,SYN 150,A00,490817,Staff,14,0,15,1
1713316336939,SYN 150,B00,514610,Staff,15,0,15,0
1713316337975,TDAC 1,A00,492753,Walsh; Kim C.,19,0,20,1
1713316337975,TDAC 1,B00,492754,Harting; Carla Kelso,19,0,20,1
1713316337975,TDAC 1,C00,513995,Salovey; Todd,16,0,20,4
1713316339004,TDAC 101,A00,492766,Harting; Carla Kelso,17,0,20,3
1713316340034,TDAC 102,A00,492768,Basso; Beatrice,19,0,20,1
1713316341062,TDDE 111,A00,492769,Staff,25,0,25,0
1713316342092,TDDE 131,A00,492770,Staff,15,0,15,0
1713316342092,TDDE 131,B00,492771,Staff,15,0,15,0
1713316343116,TDDE 131GS,A00,523716,Guirguis; Mark C,24,0,28,4
1713316344141,TDGE 1,A01,492756,Salovey; Todd,57,0,60,3
1713316345165,TDGE 5,A01,492758,Staff,24,0,25,1
1713316346193,TDGE 10,A00,492759,Fulton; Julia,208,0,220,12
1713316347217,TDGE 11,A00,492760,Castro; Robert Jess,199,0,200,1
1713316349269,TDGE 124,A00,492772,Fulton; Julia,192,0,220,28
1713316350300,TDGE 125,A00,492773,Meyer; Ursula,40,0,50,10
1713316350300,TDGE 125,B00,492774,Staff,49,0,50,1
1713316350300,TDGE 125,C00,523565,Staff,49,0,50,1
1713316351324,TDGE 125GS,A00,523580,Guirguis; Mark C,24,0,28,4
1713316352352,TDGE 127,A00,492775,Havis; Allan,40,0,50,10
1713316353378,TDHT 101,A00,492776,Staff,35,0,35,0
1713316354405,TDMV 1,A00,492762,Caligagan; Maria T.,30,0,30,0
1713316354405,TDMV 1,B00,492763,Arcidiacono; Kristin,25,0,30,5
1713316355431,TDMV 2,A00,492764,Weinberg; Sadie,29,0,30,1
1713316356456,TDMV 3,A00,492765,Mack; Kara Shanai',39,0,40,1
1713316357481,TDMV 138,A00,492777,Mack; Kara Shanai',35,0,40,5
1713316358507,TDMV 140,A00,492778,Lima; Paulo Henrique,40,0,40,0
1713316359535,TDMV 142,A00,492779,Caligagan; Maria T.,36,0,40,4
1713316359535,TDMV 142,B00,492780,Caligagan; Tony,37,0,40,3
1713316360560,TDMV 143,A00,492781,Fyall; Daunte Edward,39,0,40,1
1713316361592,USP 1,A01,492401,Kwak; Nancy,26,0,35,9
1713316362617,USP 2,A01,492453,Hinds; Juli Beth,35,0,35,0
1713316363646,USP 3,A01,492516,Staff,29,0,35,6
1713316364671,USP 4,A00,492522,McTague; Sarah,19,0,25,6
1713316365700,USP 100,A00,492523,Staff,33,0,35,2
1713316366724,USP 101,A00,492524,Staff,13,0,15,2
1713316367749,USP 105,A00,492525,Staff,21,0,25,4
1713316368774,USP 151,A00,492526,Shenkman; Michael Thomas,33,0,35,2
1713316369804,USP 170,A00,492545,Hinds; Juli Beth,33,0,35,2
1713316370833,USP 171GS,A00,492608,Bussell; Mirle Rabinowitz,24,0,28,4
1713316371863,USP 183GS,A00,492613,Peerson; Susan,24,0,28,4
1713316372889,VIS 30,A01,490693,Yoldas; Pinar,21,0,22,1
1713316372889,VIS 30,A02,490694,Yoldas; Pinar,18,0,22,4
1713316373970,VIS 83,A00,490695,Kester; Grant,66,0,75,9
1713316374995,VIS 105D,A00,490696,Staff,22,0,25,3
1713316376021,VIS 124CN,A00,490699,Rose; Jordan M,68,0,75,7
1713316377047,VIS 125GS,A00,511221,Williams; Alena J,21,0,22,1
1713316378074,VIS 128D,A00,490700,Staff,74,0,75,1
1713316379101,VIS 151,A01,490717,Staff,33,0,34,1
1713316379101,VIS 151,A02,490766,Staff,33,0,34,1
1713316380129,VIS 154GS,A00,511972,Williams; Alena J,21,0,22,1
1713316381155,VIS 160A,A00,490767,Stone; Patricia,7,0,10,3
1713316382184,WCWP 10A,A00,490638,Staff,14,0,15,1
1713316382184,WCWP 10A,B00,490640,Staff,15,0,15,0
1713316383214,WCWP 10B,A00,490641,Staff,0,0,0,0
1713316383214,WCWP 10B,B00,490642,Staff,14,0,15,1
1713316383214,WCWP 10B,C00,490644,Staff,13,0,15,2
1713316383214,WCWP 10B,D00,490647,Staff,0,0,0,0
1713316384240,WCWP 100,A00,490655,Staff,0,0,0,0
1713316384240,WCWP 100,B00,490687,Staff,11,0,15,4
1713316386349,ANAR 153,A00,487222,Braswell; Geoffrey E.,54,0,60,6
1713316387375,ANBI 134,A00,487223,Staff,10,0,20,10
1713316388401,ANBI 143GS,A00,487224,Noel; Geoffroy Pierre Jean,20,0,24,4
1713316389431,ANBI 144GS,A00,519548,Noel; Geoffroy Pierre Jean,20,0,24,4
1713316390457,ANSC 101,A00,487225,Staff,19,0,20,1
1713316391487,ANSC 125,A00,487227,Brenner; Suzanne A,39,0,40,1
1713316393538,ANSC 146,A00,487229,Staff,36,0,40,4
1713316394564,ANSC 148,A00,487230,Olivas Hernandez; Olga Lid,39,0,40,1
1713316395593,ANSC 150,A00,504165,Sloane; Julia Kathryn,19,0,20,1
1713316396621,ANSC 180,A00,487232,Staff,13,0,15,2
1713316397652,ANSC 188,A00,627155,Staff,39,0,40,1
1713316398677,ANTH 5,A00,519529,Semendeferi; Ekaterini,15,0,15,0
1713316399704,ANTH 10,A00,487219,Staff,58,0,60,2
1713316400729,ANTH 23,A01,487221,Staff,17,0,20,3
1713316401758,ANTH 102,A00,487233,Wilder; Linnea Lorene,51,0,60,9
1713316402783,ANTH 103,A00,487234,Varma; Saiba,56,0,60,4
1713316403812,ANTH 105,A00,487235,Stewart; Alexander B,55,0,60,5
1713316404837,BENG 100,A01,516685,Taylor Amos; Alyssa C,28,0,30,2
1713316405865,BIBC 102,A01,491316,Flagg; Matthew Paul,31,0,88,57
1713316405865,BIBC 102,A02,491366,Flagg; Matthew Paul,83,0,88,5
1713316406892,BIBC 103,A01,491486,Boumechache; Miyyada,16,0,24,8
1713316406892,BIBC 103,A02,491487,Boumechache; Miyyada,24,0,24,0
1713316407916,BICD 100,A01,516882,Staff,75,0,75,0
1713316407916,BICD 100,A02,516890,Staff,70,0,75,5
1713316408941,BICD 102GS,A00,491488,Lo; Stanley M.,26,0,28,2
1713316409970,BIEB 136GS,A00,516940,Holway; David A. & Shurin; Jonathan,19,0,24,5
1713316410994,BIEB 137GS,A01,517034,Holway; David A. & Shurin; Jonathan,19,0,24,5
1713316412017,BIEB 138GS,A01,491492,Pirino; Giorgia,21,0,28,7
1713316413042,BILD 1,A01,491296,Staff,62,0,63,1
1713316413042,BILD 1,A02,491297,Staff,63,0,63,0
1713316414068,BILD 4,A01,517099,Gonzalez Gamboa; Ivonne,22,0,24,2
1713316414068,BILD 4,A02,517100,Gonzalez Gamboa; Ivonne,24,0,24,0
1713316415093,BILD 60GS,A00,491309,Lo; Stanley M.,26,0,28,2
1713316416118,BIMM 100,A01,517136,Staff,88,0,100,12
1713316417143,BIMM 110,A01,517182,Staff,66,0,100,34
1713316418174,BIMM 120,A01,517228,Pickett; Brooke Elizabeth,37,0,63,26
1713316418174,BIMM 120,A02,517240,Pickett; Brooke Elizabeth,48,0,63,15
1713316419198,BIMM 132GS,A01,491498,Pirino; Giorgia,21,0,28,7
1713316420222,BIMM 143,A01,491589,Bozinovic; Goran,17,0,40,23
1713316421248,BIPN 100,A01,491594,Armour; Jon Christopher,90,0,100,10
1713316422279,BIPN 140,A01,491602,Marino; Marc J,28,0,50,22
1713316424336,CAT 125,A00,515973,Staff,19,0,20,1
1713316425363,CAT 125GS,A00,515974,Rahimi; Babak,18,0,20,2
1713316426396,CAT 125R,A00,515980,Staff,14,0,20,6
1713316426396,CAT 125R,B00,515981,Tosun; Adriana,19,0,20,1
1713316426396,CAT 125R,C00,515987,Hyland; Tina Mae,1,0,20,19
1713316426396,CAT 125R,D00,515988,Bronstein; Phoebe Malan,18,0,20,2
1713316427423,CENG 15,A01,488699,Drews; Aaron,25,0,25,0
1713316428448,CENG 100,A00,505196,Opatkiewicz; Justin Paul,25,0,25,0
1713316429477,CGS 2A,A01,489598,Staff,33,0,35,2
1713316430502,CGS 112,A00,489599,Staff,15,0,15,0
1713316431527,CGS 119,A00,489603,Staff,10,0,10,0
1713316432552,CGS 120,A00,489604,Staff,14,0,15,1
1713316433580,CGS 150,A00,489607,Staff,15,0,15,0
1713316434606,CHEM 6A,A01,488715,Staff,98,0,100,2
1713316435631,CHEM 6B,A01,488719,Piercy; Marc Anthony,100,0,100,0
1713316436657,CHEM 6C,A01,488723,Albizati; Kim F.,94,0,100,6
1713316437686,CHEM 7L,A01,488728,Schurmeier; Kimberly,18,0,24,6
1713316437686,CHEM 7L,A02,488730,Schurmeier; Kimberly,23,0,24,1
1713316437686,CHEM 7L,A03,488734,Schurmeier; Kimberly,23,0,24,1
1713316437686,CHEM 7L,A04,488763,Schurmeier; Kimberly,23,0,24,1
1713316437686,CHEM 7L,B01,488798,Schurmeier; Kimberly,17,0,24,7
1713316437686,CHEM 7L,B02,488801,Schurmeier; Kimberly,23,0,24,1
1713316437686,CHEM 7L,B03,488808,Schurmeier; Kimberly,24,0,24,0
1713316437686,CHEM 7L,B04,488811,Schurmeier; Kimberly,24,0,24,0
1713316438717,CHEM 11,A01,488897,Stallings; Dontarie M,97,0,100,3
1713316439743,CHEM 40A,A01,488913,Albizati; Kim F.,90,0,100,10
1713316440770,CHEM 40B,A01,488920,Weizman; Haim,46,0,50,4
1713316440770,CHEM 40B,A02,488938,Weizman; Haim,46,0,50,4
1713316441804,CHEM 41A,A01,489029,Klosterman; Jeremy K,58,0,60,2
1713316442832,CHEM 41C,A01,500436,Tor; Yitzhak,55,0,60,5
1713316443862,CHEM 43A,A01,500426,Weizman; Haim,2,0,24,22
1713316443862,CHEM 43A,A02,500430,Weizman; Haim,13,0,24,11
1713316443862,CHEM 43A,B01,514041,Klosterman; Jeremy K,15,0,24,9
1713316443862,CHEM 43A,B02,514047,Klosterman; Jeremy K,23,0,24,1
1713316444891,CHEM 108,A01,489140,Jennings; Patricia A.,11,0,24,13
1713316444891,CHEM 108,A02,489142,Jennings; Patricia A.,14,0,24,10
1713316445917,CHEM 114A,A01,489147,Stallings; Dontarie M,77,0,100,23
1713316446948,CHIN 169A,A00,489171,Wang; Xiao,19,0,20,1
1713316449001,COGS 3,A01,518827,Boyle; Mary E. T.,29,0,40,11
1713316450026,COGS 11,A01,489175,Staff,28,0,30,2
1713316451052,COGS 14A,A01,518829,Staff,51,0,60,9
1713316452079,COGS 14B,A01,489177,Hoffman; Drew Ellen,67,0,75,8
1713316453105,COGS 100,A01,489181,Allen; Michael Gordon,65,0,75,10
1713316454130,COGS 101A,A01,489183,Staff,48,0,60,12
1713316455154,COGS 101B,A01,489185,Allen; Michael Gordon,11,0,30,19
1713316456179,COGS 101C,A01,526786,Staff,24,0,30,6
1713316458233,COGS 107A,A01,489189,Boyle; Mary E. T.,19,0,35,16
1713316459257,COGS 107B,A01,627144,Mooshagian; Eric Frederick,60,0,60,0
1713316460285,COGS 118A,A01,489191,Staff,0,37,40,40
1713316462336,COGS 171GS,A01,489194,Pineda; Jaime A,22,0,28,6
1713316463366,COGS 172,A01,489196,Staff,3,0,30,27
1713316464391,COGS 174GS,A01,489264,Pineda; Jaime A,22,0,28,6
1713316465419,COGS 180,A01,627150,Staff,28,0,30,2
1713316466448,COGS 186,A01,489274,Staff,0,0,30,30
1713316467471,COMM 10,A01,489276,Staff,23,0,25,2
1713316467471,COMM 10,A02,489303,Staff,23,0,25,2
1713316468498,COMM 100A,A01,489312,Staff,16,0,25,9
1713316468498,COMM 100A,A02,489313,Staff,24,0,25,1
1713316469523,COMM 106T,A00,512540,Staff,34,0,35,1
1713316470551,COMM 107,A00,489347,Staff,31,0,35,4
1713316471576,COMM 109P,A00,489358,Staff,31,0,35,4
1713316472602,COMM 132,A00,489361,McKenna; Denise,28,0,30,2
1713316473627,COMM 146,A00,489362,Halm; Gavin Patrick,27,0,30,3
1713316474653,COMM 190,A00,489363,Abuelhiga; Soraya Jill,20,0,23,3
1713316475680,CSE 8A,A50,489366,Staff,22,0,25,3
1713316475680,CSE 8A,A51,489367,Staff,24,0,25,1
1713316476708,CSE 11,A01,489398,Cao; Yingjun,79,0,100,21
1713316477786,CSE 12,A01,489487,Staff,43,0,50,7
1713316478810,CSE 20,A01,489497,Staff,48,0,50,2
1713316479838,CSE 21,A01,489517,Braun; Oliver,43,0,50,7
1713316480866,CSE 101,A01,489524,Braun; Oliver,0,17,50,50
1713316481890,CSE 105,A01,512594,Jones; Miles E,79,0,100,21
1713316481890,CSE 105,B01,512598,Jones; Miles E,58,0,100,42
1713316482918,CSE 140,A01,489538,Staff,44,0,50,6
1713316483944,CSE 141,A01,489550,Eldon; John,74,0,100,26
1713316484970,CSE 141L,A01,489571,Eldon; John,72,0,100,28
1713316486000,CSE 151A,A01,489583,Solares; Edwin A,147,0,200,53
1713316487030,CSE 175,A01,510886,Kumar; Rakesh,30,0,30,0
1713316488053,CSE 190,A00,516828,Dubnov; Shlomo,40,0,49,9
1713316489080,DOC 100D,A00,489667,Pass; Natalye Joann,20,0,25,5
1713316490110,DSC 10,A01,624268,Staff,72,0,75,3
1713316491135,DSC 20,A01,624476,Staff,50,0,50,0
1713316492159,DSC 40A,A01,624608,Staff,39,0,40,1
1713316493188,DSGN 1,A01,489179,Rill; Bryan,36,0,50,14
1713316494214,ECE 17,A01,490489,Sahay; Rajeev,18,0,30,12
1713316495239,ECE 65,A50,490492,Staff,15,0,20,5
1713316495239,ECE 65,A51,490493,Staff,20,0,20,0
1713316496264,ECON 1,A01,489715,Famulari; Melissa,68,0,70,2
1713316497294,ECON 2,A01,489717,Levkoff; Steven B.,68,0,70,2
1713316498324,ECON 3,A01,489948,Staff,70,0,70,0
1713316500377,ECON 5,A01,490103,Staff,28,0,30,2
1713316500377,ECON 5,B01,626281,Dai; Yinlin,45,0,45,0
1713316501401,ECON 100A,A01,490127,Famulari; Melissa,66,0,70,4
1713316502427,ECON 100B,A01,490129,Staff,64,0,70,6
1713316503455,ECON 109,A01,490187,Shishkin; Denis,27,0,35,8
1713316504479,ECON 110A,A01,490190,Levkoff; Steven B.,61,0,70,9
1713316505504,ECON 120A,A01,490245,Dai; Yinlin,63,0,70,7
1713316506533,ECON 120B,A01,490247,Nieto-Barthaburu; Augusto,55,0,70,15
1713316507563,ECON 120C,A01,490253,Sun; Yixiao,30,0,35,5
1713316507563,ECON 120C,B01,490255,Sun; Yixiao,34,0,35,1
1713316508589,ECON 129,A00,490256,Eckert; Fabian Paul,25,0,35,10
1713316509617,ECON 131,A00,490257,Nieto-Barthaburu; Augusto,0,2,35,35
1713316510644,ECON 138,A00,490258,Bharadwaj; Prashant,18,0,35,17
1713316510644,ECON 138,B00,490259,Bharadwaj; Prashant,17,0,35,18
1713316511674,ECON 159,A00,490260,Hendrickson; Gerald M.,0,8,0,0
1713316512700,ECON 178,A01,553995,Zhu; Ying,25,0,35,10
1713316513727,EDS 40,A01,512576,Black; Alison Michelle,20,0,20,0
1713316514756,EDS 107,A01,515848,Staff,30,0,30,0
1713316515783,EDS 110R,A01,490262,Staff,26,0,30,4
1713316516813,EDS 112,A01,490264,Chapman; Thandeka K,42,0,50,8
1713316517841,EDS 113,A00,490266,Staff,26,0,30,4
1713316518871,EDS 118,A00,490267,Warstadt; Melissa Fawn,22,0,30,8
1713316519897,EDS 124BR,A00,490268,Eguchi; Emi,6,0,25,19
1713316519897,EDS 124BR,B00,490269,Eguchi; Emi,25,0,25,0
1713316520926,EDS 126,A01,490271,Jones; Makeba,44,0,50,6
1713316521952,EDS 135,A01,490316,Staff,19,0,20,1
1713316522982,ENVR 142GS,A00,519514,Chang; Edmond Yi-Teh,28,0,28,0
1713316524011,ETHN 103,A00,490504,Staff,31,0,36,5
1713316525036,ETHN 103A,A00,490505,Man; Simeon S,5,0,9,4
1713316526067,ETHN 109,A00,490506,Staff,30,0,30,0
1713316527093,ETHN 118,A00,490507,Staff,35,0,36,1
1713316528121,ETHN 119,A00,490508,Staff,34,0,36,2
1713316529146,ETHN 121R,A00,490518,Choi; Esther Min,25,0,36,11
1713316530170,ETHN 127,A00,490528,Staff,15,0,15,0
1713316531198,ETHN 139,A00,490573,Staff,10,0,10,0
1713316532224,ETHN 150,A00,490575,Staff,15,0,15,0
1713316533252,GLBH 20,A00,491705,Elwardani; Nile Regina,38,0,40,2
1713316534275,GLBH 101,A00,491706,Staff,20,0,20,0
1713316535300,GLBH 111,A01,491708,Burgos; Jose L.,15,0,15,0
1713316536327,GLBH 146,A00,491709,Staff,11,0,20,9
1713316537355,GLBH 148,A00,491710,Olivas Hernandez; Olga Lid,14,0,20,6
1713316538382,GLBH 150,A00,491711,Sloane; Julia Kathryn,20,0,20,0
1713316539405,HIEA 131,A00,491760,Staff,29,0,32,3
1713316540432,HIEA 153,A00,491762,Staff,29,0,30,1
1713316541455,HIEU 124,A00,491811,Staff,26,0,32,6
1713316542478,HIEU 124GS,A00,491812,Markman; Kristina,27,0,28,1
1713316543504,HIEU 147,A00,491813,Staff,30,0,32,2
1713316544532,HIEU 149GS,A00,491816,Caldwell; Michael Alan,28,0,28,0
1713316545555,HILD 2C,A01,491713,Hendrickson; Gerald M.,27,0,30,3
1713316546583,HILD 7B,A01,491715,Kwak; Nancy,6,0,30,24
1713316547609,HILD 10,A01,491717,Staff,13,0,20,7
1713316548637,HILD 30GS,A00,491719,Edington; Claire Ellen,24,0,28,4
1713316549662,HINE 109,A00,491818,Shafir; Nir,28,0,32,4
1713316550692,HINE 128,A00,491821,Shafir; Nir,31,0,32,1
1713316551720,HISC 117,A00,491830,Staff,29,0,32,3
1713316552747,HIUS 103,A00,491834,Man; Simeon S,15,0,23,8
1713316553773,HIUS 108B,A00,491835,Staff,29,0,30,1
1713316554804,HIUS 141,A00,491836,Hendrickson; Gerald M.,29,0,32,3
1713316555829,HIUS 149,A00,491839,Staff,27,0,32,5
1713316556858,HUM 3,A01,512617,Crum; Matthew Stephen,45,0,50,5
1713316556858,HUM 3,A02,512618,Crum; Matthew Stephen,48,0,50,2
1713316557883,HUM 3GS,A00,512663,Markman; Kristina,0,0,0,1
1713316557883,HUM 3GS,B00,512664,Staff,0,0,0,0
1713316558909,HUM 4,A01,512620,West; Geoffrey Scott,30,0,50,20
1713316559935,HUM 4GS,A00,512666,Lyon; Antony J.,0,0,0,3
1713316560959,HUM 4R,A01,512625,Watkins; Eric,49,0,50,1
1713316561989,HUM 5,A01,512649,Zavodny; Tatiana Sophia,29,0,50,21
1713316561989,HUM 5,B01,512661,Zroka; Ryan Edward,48,0,50,2
1713316563014,INTL 190,A00,490577,Segui; Alan S,0,0,0,5
1713316564044,JAPN 20AR,A01,491267,Ross; Kayoko F,9,0,20,11
1713316565075,JAPN 180,A00,491285,Berman; Michael David,34,0,40,6
1713316566107,LATI 50,A01,502536,Kokinis; Troy Andreas,16,0,22,6
1713316566107,LATI 50,A02,502551,Kokinis; Troy Andreas,22,0,22,0
1713316566107,LATI 50,A03,502650,Kokinis; Troy Andreas,22,0,22,0
1713316566107,LATI 50,A04,502909,Kokinis; Troy Andreas,22,0,22,0
1713316567137,LATI 160,A01,502920,Kokinis; Troy Andreas,30,0,30,0
1713316568166,LIFR 1A,A00,490494,Van Moer; Vinciane G,17,0,20,3
1713316569196,LIFR 1AX,A00,490495,Van Moer; Vinciane G,17,0,20,3
1713316570221,LIFR 1B,A00,490496,Van Moer; Vinciane G,18,0,20,2
1713316571250,LIFR 1BX,A00,490497,Van Moer; Vinciane G,18,0,20,2
1713316572280,LIGN 8,A00,505198,McIntosh; Justin Daniel,136,0,150,14
1713316573309,LIGN 9GS,A00,491239,Lott; Margaret S.,18,0,20,2
1713316574334,LIGN 101,A01,505200,McIntosh; Justin Daniel,24,0,30,6
1713316575361,LIGN 120,A01,491244,Staff,24,0,30,6
1713316576384,LIGN 149GS,A00,491245,Lott; Margaret S.,18,0,20,2
1713316577410,LIGN 170,A00,491247,Staff,24,0,30,6
1713316578435,LISP 1D,A00,490498,Munoz Sanchez; Alicia,10,0,14,4
1713316578435,LISP 1D,B00,490499,Munoz Sanchez; Alicia,6,0,14,8
1713316578435,LISP 1D,C00,490500,Munoz Sanchez; Alicia,8,0,14,6
1713316578435,LISP 1D,D00,490501,Munoz Sanchez; Alicia,10,0,14,4
1713316579460,LISP 1DX,A00,490502,Munoz Sanchez; Alicia,15,0,28,13
1713316579460,LISP 1DX,B00,490503,Munoz Sanchez; Alicia,17,0,28,11
1713316581570,LTAM 110,A00,491847,Staff,23,0,25,2
1713316582598,LTCS 119,A00,491848,Staff,12,0,15,3
1713316583625,LTCS 130,A00,491849,Staff,24,0,25,1
1713316585677,LTEA 120C,A00,491852,Staff,34,0,40,6
1713316586703,LTEN 130GS,A00,491853,Lyon; Antony J.,25,0,28,3
1713316587730,LTEN 148,A00,491855,Staff,23,0,25,2
1713316588756,LTEN 159,A00,491856,Staff,21,0,25,4
1713316589788,LTEN 180,A00,491857,Staff,9,0,15,6
1713316591840,LTSP 123GS,A00,505928,Bessett; Ryan Matthew,24,0,28,4
1713316592869,LTSP 174GS,A00,506037,Bessett; Ryan Matthew,24,0,28,4
1713316594923,LTWR 102,A00,491861,Staff,11,0,15,4
1713316595958,LTWR 106,A00,491862,Staff,10,0,15,5
1713316596983,MAE 11,A00,490930,Bahadori; Mohammad Yousef,97,0,100,3
1713316598012,MAE 30A,A00,490931,Qi; Huihui,37,0,40,3
1713316599037,MAE 101A,A00,491036,Sadeghizadeh; Zahra,97,0,100,3
1713316600063,MAE 101C,A00,491037,Seshadri; Kalyanasundaram,74,0,100,26
1713316601088,MAE 113,A00,491040,Seshadri; Kalyanasundaram,66,0,80,14
1713316602116,MAE 131A,A00,491041,Ghazinejad; Maziar,39,0,40,1
1713316603140,MAE 142,A00,491053,Staff,39,0,40,1
1713316604167,MAE 143A,A00,491054,Staff,36,0,50,14
1713316605197,MAE 150,A00,491092,Truong; Phuong Thi Ngoc,23,0,35,12
1713316606229,MATH 3C,A01,494031,Pardo Guerra; Sebastian,30,0,30,0
1713316606229,MATH 3C,A02,494032,Pardo Guerra; Sebastian,29,0,30,1
1713316607261,MATH 10A,A01,494034,Staff,27,0,30,3
1713316607261,MATH 10A,A02,494035,Staff,28,0,30,2
1713316607261,MATH 10A,B01,494037,Staff,27,0,30,3
1713316607261,MATH 10A,B02,494038,Staff,29,0,30,1
1713316608291,MATH 10B,A01,494040,Habib; Yousaf,23,0,30,7
1713316608291,MATH 10B,A02,494041,Habib; Yousaf,28,0,30,2
1713316608291,MATH 10B,A03,494042,Habib; Yousaf,30,0,30,0
1713316608291,MATH 10B,A04,494043,Habib; Yousaf,30,0,30,0
1713316608291,MATH 10B,B01,494045,Habib; Yousaf,28,0,30,2
1713316608291,MATH 10B,B02,494046,Habib; Yousaf,30,0,30,0
1713316608291,MATH 10B,B03,494047,Habib; Yousaf,30,0,30,0
1713316608291,MATH 10B,B04,494048,Habib; Yousaf,30,0,30,0
1713316609336,MATH 18,A01,494050,Kemp; Todd Aahron,25,0,30,5
1713316609336,MATH 18,A02,494051,Kemp; Todd Aahron,29,0,30,1
1713316609336,MATH 18,B01,494054,Kemp; Todd Aahron,28,0,30,2
1713316609336,MATH 18,B02,494055,Kemp; Todd Aahron,29,0,30,1
1713316610362,MATH 20A,A01,494059,Suk; Andrew Hoon,30,0,30,0
1713316611388,MATH 20B,A01,494061,Briones; Jor-el Thomas Caparas,33,0,35,2
1713316611388,MATH 20B,B01,494063,Bach; Quang Tran,34,0,35,1
1713316612416,MATH 20C,A01,494065,Staff,28,0,30,2
1713316612416,MATH 20C,A02,494066,Staff,30,0,30,0
1713316612416,MATH 20C,A03,494067,Staff,30,0,30,0
1713316612416,MATH 20C,A04,494068,Staff,30,0,30,0
1713316612416,MATH 20C,B01,494070,Zhang; Ming,26,0,30,4
1713316612416,MATH 20C,B02,494071,Zhang; Ming,28,0,30,2
1713316612416,MATH 20C,B03,494072,Zhang; Ming,29,0,30,1
1713316612416,MATH 20C,B04,494073,Zhang; Ming,29,0,30,1
1713316613442,MATH 20D,A01,494075,Staff,22,0,30,8
1713316613442,MATH 20D,A02,494076,Staff,30,0,30,0
1713316614465,MATH 20E,A01,494079,Staff,24,0,30,6
1713316614465,MATH 20E,A02,494080,Staff,27,0,30,3
1713316614465,MATH 20E,B01,494082,Staff,27,0,30,3
1713316614465,MATH 20E,B02,494083,Staff,25,0,30,5
1713316615492,MATH 103A,A01,494085,Aliabadi Sr.; Mohsen,16,0,30,14
1713316615492,MATH 103A,A02,494086,Aliabadi Sr.; Mohsen,28,0,30,2
1713316615492,MATH 103A,B01,494088,Aliabadi Sr.; Mohsen,22,0,30,8
1713316615492,MATH 103A,B02,494089,Aliabadi Sr.; Mohsen,28,0,30,2
1713316616517,MATH 109,A01,494091,Staff,30,0,30,0
1713316616517,MATH 109,A02,494092,Staff,29,0,30,1
1713316616517,MATH 109,B01,494094,Staff,28,0,30,2
1713316616517,MATH 109,B02,494095,Staff,29,0,30,1
1713316617544,MATH 142A,A01,494097,Chow; Bennett,16,0,30,14
1713316617544,MATH 142A,A02,494098,Chow; Bennett,24,0,30,6
1713316617544,MATH 142A,B01,494100,Chow; Bennett,19,0,30,11
1713316617544,MATH 142A,B02,494101,Chow; Bennett,29,0,30,1
1713316619595,MATH 168A,A01,516677,Dumitriu; Ioana,15,0,35,20
1713316620628,MATH 170A,A01,516679,Dumitriu; Ioana,20,0,30,10
1713316620628,MATH 170A,A02,516680,Dumitriu; Ioana,28,0,30,2
1713316621657,MATH 193A,A01,494107,Staff,15,0,30,15
1713316621657,MATH 193A,A02,494108,Staff,21,0,30,9
1713316621657,MATH 193A,A03,494109,Staff,29,0,30,1
1713316621657,MATH 193A,A04,494110,Staff,22,0,30,8
1713316624735,MGT 16,A00,491930,McKay; Michael J,92,0,98,6
1713316625763,MGT 18,A00,491992,McKay; Michael J,97,0,98,1
1713316626793,MGT 71,A00,492003,Staff,75,0,98,23
1713316627822,MGT 103,A00,505209,Eberhard; Craig A,85,0,98,13
1713316628848,MGT 131A,A00,505210,Anderson; John Charles,90,0,98,8
1713316630899,MGT 153,A00,492077,Perols; Johan Lars,34,0,90,56
1713316633988,MGT 164,A00,492222,McKay; Mary A,93,0,98,5
1713316635014,MGT 172,A00,492245,Staff,59,0,60,1
1713316635014,MGT 172,B00,505526,Hedges; Kathleen,73,0,98,25
1713316636039,MGT 181,A00,505669,Dunn; Louis Jean,85,0,98,13
1713316637069,MMW 14,A01,494399,Staff,23,0,28,5
1713316637069,MMW 14,A02,494400,Staff,25,0,28,3
1713316637069,MMW 14,A03,494401,Staff,28,0,28,0
1713316637069,MMW 14,A04,494402,Staff,28,0,28,0
1713316637069,MMW 14,B01,494404,Carreras; Maria Victoria,13,0,28,15
1713316637069,MMW 14,B02,494405,Carreras; Maria Victoria,26,0,28,2
1713316637069,MMW 14,B03,494406,Carreras; Maria Victoria,28,0,28,0
1713316637069,MMW 14,B04,494407,Carreras; Maria Victoria,28,0,28,0
1713316638094,MMW 14GS,A00,506250,Chang; Edmond Yi-Teh,0,0,0,0
1713316639118,MMW 121R,A01,494415,Adamiak; Patrick John,13,0,28,15
1713316639118,MMW 121R,A02,494416,Adamiak; Patrick John,24,0,28,4
1713316640142,MUS 1A,A01,494113,Staff,12,0,25,13
1713316640142,MUS 1A,A02,494114,Staff,25,0,25,0
1713316641166,MUS 4,A01,494116,Staff,24,0,25,1
1713316641166,MUS 4,A02,494117,Staff,22,0,25,3
1713316642192,MUS 5R,A01,494236,Dubnov; Shlomo,10,0,25,15
1713316642192,MUS 5R,A02,494237,Dubnov; Shlomo,25,0,25,0
1713316643217,MUS 6,A01,494122,Staff,13,0,25,12
1713316643217,MUS 6,A02,494123,Staff,24,0,25,1
1713316644244,MUS 7,A01,494125,Staff,17,0,25,8
1713316644244,MUS 7,A02,494126,Staff,24,0,25,1
1713316645269,MUS 11,A01,494128,Staff,23,0,25,2
1713316645269,MUS 11,A02,494129,Staff,24,0,25,1
1713316646298,MUS 13,A01,494131,Staff,25,0,25,0
1713316646298,MUS 13,A02,494132,Staff,25,0,25,0
1713316647327,MUS 15,A01,494134,Staff,17,0,25,8
1713316647327,MUS 15,A02,494135,Staff,25,0,25,0
1713316647327,MUS 15,B01,494137,Staff,24,0,25,1
1713316648352,MUS 80,A00,494232,Staff,24,0,25,1
1713316648352,MUS 80,B00,494233,Staff,25,0,25,0
1713316648352,MUS 80,C00,494234,Staff,23,0,25,2
1713316649378,MUS 95C,A00,494141,Staff,72,0,75,3
1713316650404,MUS 114,A00,494142,Staff,41,0,50,9
1713316651429,NANO 15,A01,490636,Drews; Aaron,7,0,7,0
1713316652459,PHIL 1,A00,490578,Grush; Rick Scott,49,0,50,1
1713316653484,PHIL 10,A01,490580,Grush; Rick Scott,33,0,35,2
1713316653484,PHIL 10,A02,490586,Grush; Rick Scott,33,0,35,2
1713316654508,PHIL 27,A01,490591,Staff,23,0,25,2
1713316654508,PHIL 27,A02,490592,Staff,25,0,25,0
1713316654508,PHIL 27,A03,490593,Staff,25,0,25,0
1713316654508,PHIL 27,A04,490598,Staff,25,0,25,0
1713316655536,PHIL 32,A01,490611,Staff,20,0,20,0
1713316655536,PHIL 32,A02,490618,Staff,20,0,20,0
1713316656561,PHIL 90,A00,490624,Staff,40,0,40,0
1713316657586,PHIL 136,A00,490627,Cohen; Jonathan David,38,0,40,2
1713316658610,PHIL 155,A00,490634,Staff,63,0,70,7
1713316659635,PHYS 1A,A00,491610,Staff,246,0,250,4
1713316660662,PHYS 1AL,001,491616,Tsai; Philbert S,28,0,30,2
1713316660662,PHYS 1AL,002,491618,Tsai; Philbert S,30,0,30,0
1713316661690,PHYS 1B,A00,491623,Staff,244,0,250,6
1713316662715,PHYS 1BL,001,491626,Tsai; Philbert S,26,0,30,4
1713316662715,PHYS 1BL,002,491628,Tsai; Philbert S,27,0,30,3
1713316663740,PHYS 1C,A00,491632,Staff,220,0,245,25
1713316664765,PHYS 1CL,001,491635,Tsai; Philbert S,10,0,30,20
1713316664765,PHYS 1CL,002,491643,Tsai; Philbert S,24,0,30,6
1713316665790,PHYS 2AR,A01,491651,Meyertholen; Andrew D.,44,0,50,6
1713316666819,PHYS 2B,A01,491659,Staff,106,0,115,9
1713316667843,PHYS 2BL,A01,491685,Staff,21,0,24,3
1713316667843,PHYS 2BL,A02,491700,Staff,23,0,24,1
1713316668869,PHYS 2C,A01,505161,Staff,106,0,115,9
1713316669895,PHYS 4A,A01,491704,Grinstein; Benjamin,99,0,100,1
1713316670921,POLI 5D,A01,494144,Staff,3,0,5,2
1713316670921,POLI 5D,B01,626283,Dai; Yinlin,5,0,5,0
1713316671948,POLI 12,A00,494145,Staff,44,0,45,1
1713316672973,POLI 13R,A00,494146,Forman; Fonna,45,0,50,5
1713316673998,POLI 27,A01,494148,Staff,57,0,60,3
1713316675026,POLI 30,A00,494149,Staff,49,0,50,1
1713316676051,POLI 100DA,A00,494150,Staff,21,0,25,4
1713316678100,POLI 100I,A00,494152,Staff,28,0,30,2
1713316679125,POLI 104B,A00,494153,Smith; Glenn Chatmas,54,0,55,1
1713316680151,POLI 104F,A00,494154,Staff,28,0,30,2
1713316681179,POLI 104I,A00,494155,Smith; Glenn Chatmas,30,0,30,0
1713316682205,POLI 110C,A00,494156,Ingham; Sean,23,0,25,2
1713316683233,POLI 117R,A00,494157,Forman; Fonna,10,0,20,10
1713316684260,POLI 118,A00,494158,Ingham; Sean,22,0,25,3
1713316685341,POLI 120H,A00,494159,Fisk; David Lee,41,0,45,4
1713316686370,POLI 131CR,A00,494160,Hoston; Germaine,36,0,45,9
1713316687395,POLI 133J,A00,494161,Staff,33,0,35,2
1713316688421,POLI 135,A00,494162,Fisk; David Lee,33,0,35,2
1713316689444,POLI 140A,A00,494164,Staff,21,0,30,9
1713316690473,POLI 142I,A00,494165,Staff,30,0,30,0
1713316691502,POLI 144D,A00,494166,Staff,23,0,25,2
1713316692530,POLI 151,A00,494167,Staff,30,0,30,0
1713316693555,POLI 153,A00,494168,Staff,33,0,35,2
1713316694579,POLI 160AA,A00,494169,Staff,35,0,40,5
1713316695606,POLI 162,A00,494170,Mignozzetti; Umberto,20,0,25,5
1713316696630,POLI 171,A00,494171,Mignozzetti; Umberto,21,0,25,4
1713316697656,PSYC 1,A00,494172,Staff,97,0,100,3
1713316698683,PSYC 2,A00,494173,Moranton; Nirelia Melbina-,43,0,50,7
1713316699708,PSYC 3,A00,494174,Staff,29,0,30,1
1713316700733,PSYC 6,A00,494175,Staff,17,0,20,3
1713316701757,PSYC 60,A01,494177,Staff,39,0,45,6
1713316702785,PSYC 70,A01,505724,Geller; Emma Harlan,42,0,45,3
1713316703814,PSYC 101,A00,494180,Heyman; Gail D.,87,0,100,13
1713316704837,PSYC 105,A00,494181,Geller; Emma Harlan,60,0,90,30
1713316705867,PSYC 106,A00,494182,Dobkins; Karen R.,30,0,45,15
1713316706894,PSYC 108,A00,494183,Adrian; Julia Anna,91,0,100,9
1713316707925,PSYC 114,A01,494185,Winkielman; Piotr,0,0,30,30
1713316708950,PSYC 122,A00,494186,Moranton; Nirelia Melbina-,36,0,50,14
1713316709977,PSYC 124,A00,494187,Chapman; Eddie Nathaniel,72,0,80,8
1713316711003,PSYC 131,A00,494188,Anagnostaras; Stephan,52,0,80,28
1713316712028,PSYC 144,A00,494189,Staff,13,0,50,37
1713316713053,PSYC 154,A00,494190,Lacefield; Katharine I,127,0,180,53
1713316714079,PSYC 162,A00,494191,Wixted; John T,79,0,100,21
1713316715108,PSYC 172,A00,494192,Gorman; Michael R.,37,0,45,8
1713316716137,PSYC 178,A00,494193,Glaser; Dale,40,0,45,5
1713316717163,PSYC 193,A00,505725,Chapman; Eddie Nathaniel,20,0,20,0
1713316718191,RELI 145GS,A00,519817,Rahimi; Babak,18,0,20,2
1713316719217,SE 101A,A01,490862,Chadha; Mayank,23,0,25,2
1713316720246,SE 101C,A01,490924,Krysl; Petr,18,0,20,2
1713316721272,SE 110A,A01,490928,Staff,19,0,20,1
1713316722296,SE 130A,A00,490929,Morrison; Machel Leigh,60,0,70,10
1713316723323,SIO 1,A01,519325,Staff,39,0,40,1
1713316724347,SIO 30,A01,519327,Staff,39,0,40,1
1713316725375,SIO 40,A00,519328,Staff,40,0,40,0
1713316726404,SIO 46GS,A00,519819,Cook; Geoffrey W,18,0,25,7
1713316727430,SIO 109R,A00,494197,Forman; Fonna,4,0,20,16
1713316728457,SIO 121GS,A00,519827,Cook; Geoffrey W,18,0,25,7
1713316729486,SIO 132,A01,519330,Staff,38,0,40,2
1713316730516,SIO 133,A01,519397,Staff,37,0,40,3
1713316731546,SIO 139,A00,519396,Kacev; David,31,0,40,9
1713316732573,SOCI 1,A01,494199,Thorpe; Charles Robert,23,0,30,7
1713316732573,SOCI 1,A02,494200,Thorpe; Charles Robert,30,0,30,0
1713316732573,SOCI 1,A03,494201,Thorpe; Charles Robert,29,0,30,1
1713316732573,SOCI 1,A04,494202,Thorpe; Charles Robert,29,0,30,1
1713316732573,SOCI 1,A05,494203,Thorpe; Charles Robert,29,0,30,1
1713316732573,SOCI 1,A06,494204,Thorpe; Charles Robert,30,0,30,0
1713316732573,SOCI 1,A07,494205,Thorpe; Charles Robert,29,0,30,1
1713316733597,SOCI 60,A01,494207,Staff,35,0,40,5
1713316733597,SOCI 60,A02,494208,Staff,39,0,40,1
1713316734626,SOCI 100,A01,494210,Payne; Christine Anna,27,0,30,3
1713316734626,SOCI 100,A02,494211,Payne; Christine Anna,27,0,30,3
1713316735653,SOCI 109M,A00,494212,Staff,20,0,20,0
1713316736680,SOCI 110,A00,494213,Staff,35,0,40,5
1713316738733,SOCI 118E,A00,494215,Ng; Kwai,38,0,40,2
1713316739815,SOCI 125,A00,494216,Calderon-Zaks; Michael Aar,42,0,45,3
1713316740840,SOCI 126,A01,494218,Jones; Makeba,3,0,5,2
1713316741874,SOCI 131,A00,494219,Thorpe; Charles Robert,28,0,30,2
1713316743934,SOCI 135,A00,494221,Payne; Christine Anna,34,0,50,16
1713316744958,SOCI 136E,A00,626690,Ruiz; Jonathan Joseph,25,0,25,0
1713316745983,SOCI 138GS,A00,494222,Navon; Daniel,24,0,28,4
1713316748037,SOCI 145,A00,494224,Staff,42,0,45,3
1713316749095,SOCI 153,A00,494225,Staff,28,0,30,2
1713316750123,SOCI 160E,A00,494226,Ng; Kwai,32,0,40,8
1713316751151,SOCI 180,A00,494227,Staff,29,0,30,1
1713316752178,SOCI 189GS,A00,494228,Ribas Norris; Janet Vanesa,11,0,11,0
1713316753206,SOCI 190GS,A00,553232,Ribas Norris; Janet Vanesa,11,0,11,0
1713316754235,SOMI 220,A00,627178,Schneid; Stephen David,30,0,30,0
1713316755259,SYN 2,001,490768,Staff,14,0,15,1
1713316755259,SYN 2,002,490769,Staff,15,0,15,0
1713316755259,SYN 2,004,490775,Staff,0,0,0,0
1713316755259,SYN 2,003,490774,Staff,0,0,0,0
1713316755259,SYN 2,005,490776,Staff,0,0,0,0
1713316756289,SYN 2R,001,490779,Staff,12,0,15,3
1713316756289,SYN 2R,002,514635,Staff,14,0,15,1
1713316757314,SYN 100,A01,490783,Staff,15,0,20,5
1713316757314,SYN 100,B01,490787,Staff,10,0,20,10
1713316757314,SYN 100,C01,490789,Staff,12,0,20,8
1713316758339,SYN 150,A00,490817,Staff,14,0,15,1
1713316758339,SYN 150,B00,514610,Staff,15,0,15,0
1713316759366,TDAC 1,A00,492753,Walsh; Kim C.,19,0,20,1
1713316759366,TDAC 1,B00,492754,Harting; Carla Kelso,19,0,20,1
1713316759366,TDAC 1,C00,513995,Salovey; Todd,16,0,20,4
1713316760391,TDAC 101,A00,492766,Harting; Carla Kelso,17,0,20,3
1713316761421,TDAC 102,A00,492768,Basso; Beatrice,19,0,20,1
1713316762447,TDDE 111,A00,492769,Staff,25,0,25,0
1713316763475,TDDE 131,A00,492770,Staff,15,0,15,0
1713316763475,TDDE 131,B00,492771,Staff,15,0,15,0
1713316764505,TDDE 131GS,A00,523716,Guirguis; Mark C,24,0,28,4
1713316765530,TDGE 1,A01,492756,Salovey; Todd,57,0,60,3
1713316766556,TDGE 5,A01,492758,Staff,24,0,25,1
1713316767583,TDGE 10,A00,492759,Fulton; Julia,208,0,220,12
1713316768609,TDGE 11,A00,492760,Castro; Robert Jess,199,0,200,1
1713316770659,TDGE 124,A00,492772,Fulton; Julia,192,0,220,28
1713316771689,TDGE 125,A00,492773,Meyer; Ursula,40,0,50,10
1713316771689,TDGE 125,B00,492774,Staff,49,0,50,1
1713316771689,TDGE 125,C00,523565,Staff,48,0,50,2
1713316772713,TDGE 125GS,A00,523580,Guirguis; Mark C,24,0,28,4
1713316773739,TDGE 127,A00,492775,Havis; Allan,40,0,50,10
1713316774766,TDHT 101,A00,492776,Staff,35,0,35,0
1713316775794,TDMV 1,A00,492762,Caligagan; Maria T.,30,0,30,0
1713316775794,TDMV 1,B00,492763,Arcidiacono; Kristin,25,0,30,5
1713316776821,TDMV 2,A00,492764,Weinberg; Sadie,29,0,30,1
1713316777847,TDMV 3,A00,492765,Mack; Kara Shanai',39,0,40,1
1713316778877,TDMV 138,A00,492777,Mack; Kara Shanai',35,0,40,5
1713316779923,TDMV 140,A00,492778,Lima; Paulo Henrique,40,0,40,0
1713316780950,TDMV 142,A00,492779,Caligagan; Maria T.,36,0,40,4
1713316780950,TDMV 142,B00,492780,Caligagan; Tony,37,0,40,3
1713316781975,TDMV 143,A00,492781,Fyall; Daunte Edward,39,0,40,1
1713316782999,USP 1,A01,492401,Kwak; Nancy,26,0,35,9
1713316784031,USP 2,A01,492453,Hinds; Juli Beth,35,0,35,0
1713316785057,USP 3,A01,492516,Staff,29,0,35,6
1713316786086,USP 4,A00,492522,McTague; Sarah,19,0,25,6
1713316787115,USP 100,A00,492523,Staff,33,0,35,2
1713316788143,USP 101,A00,492524,Staff,13,0,15,2
1713316789221,USP 105,A00,492525,Staff,21,0,25,4
1713316790246,USP 151,A00,492526,Shenkman; Michael Thomas,33,0,35,2
1713316791271,USP 170,A00,492545,Hinds; Juli Beth,33,0,35,2
1713316792298,USP 171GS,A00,492608,Bussell; Mirle Rabinowitz,24,0,28,4
1713316793327,USP 183GS,A00,492613,Peerson; Susan,24,0,28,4
1713316794353,VIS 30,A01,490693,Yoldas; Pinar,21,0,22,1
1713316794353,VIS 30,A02,490694,Yoldas; Pinar,18,0,22,4
1713316795379,VIS 83,A00,490695,Kester; Grant,66,0,75,9
1713316796405,VIS 105D,A00,490696,Staff,22,0,25,3
1713316797430,VIS 124CN,A00,490699,Rose; Jordan M,68,0,75,7
1713316798457,VIS 125GS,A00,511221,Williams; Alena J,21,0,22,1
1713316799484,VIS 128D,A00,490700,Staff,74,0,75,1
1713316800531,VIS 151,A01,490717,Staff,33,0,34,1
1713316800531,VIS 151,A02,490766,Staff,33,0,34,1
1713316801557,VIS 154GS,A00,511972,Williams; Alena J,21,0,22,1
1713316802582,VIS 160A,A00,490767,Stone; Patricia,7,0,10,3
1713316803610,WCWP 10A,A00,490638,Staff,14,0,15,1
1713316803610,WCWP 10A,B00,490640,Staff,15,0,15,0
1713316804639,WCWP 10B,A00,490641,Staff,0,0,0,0
1713316804639,WCWP 10B,B00,490642,Staff,14,0,15,1
1713316804639,WCWP 10B,C00,490644,Staff,13,0,15,2
1713316804639,WCWP 10B,D00,490647,Staff,0,0,0,0
1713316805663,WCWP 100,A00,490655,Staff,0,0,0,0
1713316805663,WCWP 100,B00,490687,Staff,11,0,15,4
1713316807755,ANAR 153,A00,487222,Braswell; Geoffrey E.,54,0,60,6
1713316808786,ANBI 134,A00,487223,Staff,10,0,20,10
1713316809812,ANBI 143GS,A00,487224,Noel; Geoffroy Pierre Jean,20,0,24,4
1713316810836,ANBI 144GS,A00,519548,Noel; Geoffroy Pierre Jean,20,0,24,4
1713316811862,ANSC 101,A00,487225,Staff,19,0,20,1
1713316812894,ANSC 125,A00,487227,Brenner; Suzanne A,39,0,40,1
1713316814947,ANSC 146,A00,487229,Staff,36,0,40,4
1713316815978,ANSC 148,A00,487230,Olivas Hernandez; Olga Lid,39,0,40,1
1713316817007,ANSC 150,A00,504165,Sloane; Julia Kathryn,19,0,20,1
1713316818034,ANSC 180,A00,487232,Staff,13,0,15,2
1713316819059,ANSC 188,A00,627155,Staff,39,0,40,1
1713316820092,ANTH 5,A00,519529,Semendeferi; Ekaterini,15,0,15,0
1713316821123,ANTH 10,A00,487219,Staff,58,0,60,2
1713316822148,ANTH 23,A01,487221,Staff,17,0,20,3
1713316823177,ANTH 102,A00,487233,Wilder; Linnea Lorene,51,0,60,9
1713316824219,ANTH 103,A00,487234,Varma; Saiba,56,0,60,4
1713316825245,ANTH 105,A00,487235,Stewart; Alexander B,55,0,60,5
1713316826277,BENG 100,A01,516685,Taylor Amos; Alyssa C,28,0,30,2
1713316827306,BIBC 102,A01,491316,Flagg; Matthew Paul,31,0,88,57
1713316827306,BIBC 102,A02,491366,Flagg; Matthew Paul,83,0,88,5
1713316828335,BIBC 103,A01,491486,Boumechache; Miyyada,16,0,24,8
1713316828335,BIBC 103,A02,491487,Boumechache; Miyyada,24,0,24,0
1713316829360,BICD 100,A01,516882,Staff,75,0,75,0
1713316829360,BICD 100,A02,516890,Staff,70,0,75,5
1713316830383,BICD 102GS,A00,491488,Lo; Stanley M.,26,0,28,2
1713316831411,BIEB 136GS,A00,516940,Holway; David A. & Shurin; Jonathan,19,0,24,5
1713316832440,BIEB 137GS,A01,517034,Holway; David A. & Shurin; Jonathan,19,0,24,5
1713316833466,BIEB 138GS,A01,491492,Pirino; Giorgia,21,0,28,7
1713316834493,BILD 1,A01,491296,Staff,62,0,63,1
1713316834493,BILD 1,A02,491297,Staff,63,0,63,0
1713316835553,BILD 4,A01,517099,Gonzalez Gamboa; Ivonne,22,0,24,2
1713316835553,BILD 4,A02,517100,Gonzalez Gamboa; Ivonne,24,0,24,0
1713316836581,BILD 60GS,A00,491309,Lo; Stanley M.,26,0,28,2
1713316837607,BIMM 100,A01,517136,Staff,88,0,100,12
1713316838633,BIMM 110,A01,517182,Staff,66,0,100,34
1713316839660,BIMM 120,A01,517228,Pickett; Brooke Elizabeth,37,0,63,26
1713316839660,BIMM 120,A02,517240,Pickett; Brooke Elizabeth,48,0,63,15
1713316840689,BIMM 132GS,A01,491498,Pirino; Giorgia,21,0,28,7
1713316841719,BIMM 143,A01,491589,Bozinovic; Goran,17,0,40,23
1713316842745,BIPN 100,A01,491594,Armour; Jon Christopher,90,0,100,10
1713316843769,BIPN 140,A01,491602,Marino; Marc J,28,0,50,22
1713316845824,CAT 125,A00,515973,Staff,19,0,20,1
1713316846848,CAT 125GS,A00,515974,Rahimi; Babak,18,0,20,2
1713316847881,CAT 125R,A00,515980,Staff,14,0,20,6
1713316847881,CAT 125R,B00,515981,Tosun; Adriana,19,0,20,1
1713316847881,CAT 125R,C00,515987,Hyland; Tina Mae,1,0,20,19
1713316847881,CAT 125R,D00,515988,Bronstein; Phoebe Malan,18,0,20,2
1713316848907,CENG 15,A01,488699,Drews; Aaron,25,0,25,0
1713316849932,CENG 100,A00,505196,Opatkiewicz; Justin Paul,25,0,25,0
1713316850959,CGS 2A,A01,489598,Staff,33,0,35,2
1713316851984,CGS 112,A00,489599,Staff,15,0,15,0
1713316853010,CGS 119,A00,489603,Staff,10,0,10,0
1713316854035,CGS 120,A00,489604,Staff,14,0,15,1
1713316855063,CGS 150,A00,489607,Staff,15,0,15,0
1713316856087,CHEM 6A,A01,488715,Staff,98,0,100,2
1713316857112,CHEM 6B,A01,488719,Piercy; Marc Anthony,100,0,100,0
1713316858138,CHEM 6C,A01,488723,Albizati; Kim F.,94,0,100,6
1713316859168,CHEM 7L,A01,488728,Schurmeier; Kimberly,18,0,24,6
1713316859168,CHEM 7L,A02,488730,Schurmeier; Kimberly,23,0,24,1
1713316859168,CHEM 7L,A03,488734,Schurmeier; Kimberly,23,0,24,1
1713316859168,CHEM 7L,A04,488763,Schurmeier; Kimberly,23,0,24,1
1713316859168,CHEM 7L,B01,488798,Schurmeier; Kimberly,17,0,24,7
1713316859168,CHEM 7L,B02,488801,Schurmeier; Kimberly,23,0,24,1
1713316859168,CHEM 7L,B03,488808,Schurmeier; Kimberly,24,0,24,0
1713316859168,CHEM 7L,B04,488811,Schurmeier; Kimberly,24,0,24,0
1713316860192,CHEM 11,A01,488897,Stallings; Dontarie M,97,0,100,3
1713316861218,CHEM 40A,A01,488913,Albizati; Kim F.,89,0,100,11
1713316862244,CHEM 40B,A01,488920,Weizman; Haim,46,0,50,4
1713316862244,CHEM 40B,A02,488938,Weizman; Haim,46,0,50,4
1713316863283,CHEM 41A,A01,489029,Klosterman; Jeremy K,58,0,60,2
1713316864311,CHEM 41C,A01,500436,Tor; Yitzhak,55,0,60,5
1713316865340,CHEM 43A,A01,500426,Weizman; Haim,2,0,24,22
1713316865340,CHEM 43A,A02,500430,Weizman; Haim,13,0,24,11
1713316865340,CHEM 43A,B01,514041,Klosterman; Jeremy K,15,0,24,9
1713316865340,CHEM 43A,B02,514047,Klosterman; Jeremy K,23,0,24,1
1713316866366,CHEM 108,A01,489140,Jennings; Patricia A.,11,0,24,13
1713316866366,CHEM 108,A02,489142,Jennings; Patricia A.,14,0,24,10
1713316867395,CHEM 114A,A01,489147,Stallings; Dontarie M,77,0,100,23
1713316868425,CHIN 169A,A00,489171,Wang; Xiao,19,0,20,1
1713316870477,COGS 3,A01,518827,Boyle; Mary E. T.,29,0,40,11
1713316871503,COGS 11,A01,489175,Staff,28,0,30,2
1713316872530,COGS 14A,A01,518829,Staff,51,0,60,9
1713316873557,COGS 14B,A01,489177,Hoffman; Drew Ellen,67,0,75,8
1713316874583,COGS 100,A01,489181,Allen; Michael Gordon,65,0,75,10
1713316875609,COGS 101A,A01,489183,Staff,48,0,60,12
1713316876635,COGS 101B,A01,489185,Allen; Michael Gordon,10,0,30,20
1713316877660,COGS 101C,A01,526786,Staff,24,0,30,6
1713316879711,COGS 107A,A01,489189,Boyle; Mary E. T.,19,0,35,16
1713316880738,COGS 107B,A01,627144,Mooshagian; Eric Frederick,60,0,60,0
1713316881763,COGS 118A,A01,489191,Staff,0,40,40,40
1713316883815,COGS 171GS,A01,489194,Pineda; Jaime A,21,0,28,7
1713316884847,COGS 172,A01,489196,Staff,3,0,30,27
1713316885871,COGS 174GS,A01,489264,Pineda; Jaime A,21,0,28,7
1713316886898,COGS 180,A01,627150,Staff,28,0,30,2
1713316887928,COGS 186,A01,489274,Staff,0,0,30,30
1713316888953,COMM 10,A01,489276,Staff,23,0,25,2
1713316888953,COMM 10,A02,489303,Staff,23,0,25,2
1713316889980,COMM 100A,A01,489312,Staff,16,0,25,9
1713316889980,COMM 100A,A02,489313,Staff,24,0,25,1
1713316891015,COMM 106T,A00,512540,Staff,34,0,35,1
1713316892040,COMM 107,A00,489347,Staff,31,0,35,4
1713316893119,COMM 109P,A00,489358,Staff,31,0,35,4
1713316894145,COMM 132,A00,489361,McKenna; Denise,28,0,30,2
1713316895175,COMM 146,A00,489362,Halm; Gavin Patrick,27,0,30,3
1713316896203,COMM 190,A00,489363,Abuelhiga; Soraya Jill,20,0,23,3
1713316897227,CSE 8A,A50,489366,Staff,22,0,25,3
1713316897227,CSE 8A,A51,489367,Staff,24,0,25,1
1713316898256,CSE 11,A01,489398,Cao; Yingjun,79,0,100,21
1713316899283,CSE 12,A01,489487,Staff,43,0,50,7
1713316900312,CSE 20,A01,489497,Staff,48,0,50,2
1713316901337,CSE 21,A01,489517,Braun; Oliver,43,0,50,7
1713316902360,CSE 101,A01,489524,Braun; Oliver,0,20,50,50
1713316903387,CSE 105,A01,512594,Jones; Miles E,79,0,100,21
1713316903387,CSE 105,B01,512598,Jones; Miles E,58,0,100,42
1713316904417,CSE 140,A01,489538,Staff,44,0,50,6
1713316905449,CSE 141,A01,489550,Eldon; John,74,0,100,26
1713316906476,CSE 141L,A01,489571,Eldon; John,72,0,100,28
1713316907503,CSE 151A,A01,489583,Solares; Edwin A,147,0,200,53
1713316908532,CSE 175,A01,510886,Kumar; Rakesh,30,0,30,0
1713316909558,CSE 190,A00,516828,Dubnov; Shlomo,39,0,49,10
1713316910589,DOC 100D,A00,489667,Pass; Natalye Joann,20,0,25,5
1713316911616,DSC 10,A01,624268,Staff,72,0,75,3
1713316912647,DSC 20,A01,624476,Staff,50,0,50,0
1713316913670,DSC 40A,A01,624608,Staff,39,0,40,1
1713316914700,DSGN 1,A01,489179,Rill; Bryan,36,0,50,14
1713316915732,ECE 17,A01,490489,Sahay; Rajeev,18,0,30,12
1713316916764,ECE 65,A50,490492,Staff,15,0,20,5
1713316916764,ECE 65,A51,490493,Staff,20,0,20,0
1713316917788,ECON 1,A01,489715,Famulari; Melissa,68,0,70,2
1713316918812,ECON 2,A01,489717,Levkoff; Steven B.,68,0,70,2
1713316919843,ECON 3,A01,489948,Staff,70,0,70,0
1713316921904,ECON 5,A01,490103,Staff,28,0,30,2
1713316921904,ECON 5,B01,626281,Dai; Yinlin,45,0,45,0
1713316922931,ECON 100A,A01,490127,Famulari; Melissa,66,0,70,4
1713316923958,ECON 100B,A01,490129,Staff,64,0,70,6
1713316925036,ECON 109,A01,490187,Shishkin; Denis,27,0,35,8
1713316926064,ECON 110A,A01,490190,Levkoff; Steven B.,61,0,70,9
1713316927093,ECON 120A,A01,490245,Dai; Yinlin,63,0,70,7
1713316928123,ECON 120B,A01,490247,Nieto-Barthaburu; Augusto,54,0,70,16
1713316929151,ECON 120C,A01,490253,Sun; Yixiao,30,0,35,5
1713316929151,ECON 120C,B01,490255,Sun; Yixiao,34,0,35,1
1713316930176,ECON 129,A00,490256,Eckert; Fabian Paul,25,0,35,10
1713316931204,ECON 131,A00,490257,Nieto-Barthaburu; Augusto,0,2,35,35
1713316932229,ECON 138,A00,490258,Bharadwaj; Prashant,18,0,35,17
1713316932229,ECON 138,B00,490259,Bharadwaj; Prashant,17,0,35,18
1713316933259,ECON 159,A00,490260,Hendrickson; Gerald M.,0,8,0,0
1713316934289,ECON 178,A01,553995,Zhu; Ying,25,0,35,10
1713316935315,EDS 40,A01,512576,Black; Alison Michelle,20,0,20,0
1713316936339,EDS 107,A01,515848,Staff,30,0,30,0
1713316937364,EDS 110R,A01,490262,Staff,26,0,30,4
1713316938395,EDS 112,A01,490264,Chapman; Thandeka K,42,0,50,8
1713316939421,EDS 113,A00,490266,Staff,26,0,30,4
1713316940448,EDS 118,A00,490267,Warstadt; Melissa Fawn,22,0,30,8
1713316941494,EDS 124BR,A00,490268,Eguchi; Emi,6,0,25,19
1713316941494,EDS 124BR,B00,490269,Eguchi; Emi,25,0,25,0
1713316942525,EDS 126,A01,490271,Jones; Makeba,44,0,50,6
1713316943548,EDS 135,A01,490316,Staff,19,0,20,1
1713316944575,ENVR 142GS,A00,519514,Chang; Edmond Yi-Teh,28,0,28,0
1713316945604,ETHN 103,A00,490504,Staff,31,0,36,5
1713316946628,ETHN 103A,A00,490505,Man; Simeon S,5,0,9,4
1713316947653,ETHN 109,A00,490506,Staff,30,0,30,0
1713316948679,ETHN 118,A00,490507,Staff,35,0,36,1
1713316949708,ETHN 119,A00,490508,Staff,34,0,36,2
1713316950734,ETHN 121R,A00,490518,Choi; Esther Min,25,0,36,11
1713316951759,ETHN 127,A00,490528,Staff,15,0,15,0
1713316952787,ETHN 139,A00,490573,Staff,10,0,10,0
1713316953811,ETHN 150,A00,490575,Staff,15,0,15,0
1713316954840,GLBH 20,A00,491705,Elwardani; Nile Regina,38,0,40,2
1713316955868,GLBH 101,A00,491706,Staff,20,0,20,0
1713316956896,GLBH 111,A01,491708,Burgos; Jose L.,15,0,15,0
1713316957925,GLBH 146,A00,491709,Staff,11,0,20,9
1713316958950,GLBH 148,A00,491710,Olivas Hernandez; Olga Lid,14,0,20,6
1713316959981,GLBH 150,A00,491711,Sloane; Julia Kathryn,20,0,20,0
1713316961007,HIEA 131,A00,491760,Staff,29,0,32,3
1713316962032,HIEA 153,A00,491762,Staff,29,0,30,1
1713316963057,HIEU 124,A00,491811,Staff,26,0,32,6
1713316964086,HIEU 124GS,A00,491812,Markman; Kristina,27,0,28,1
1713316965110,HIEU 147,A00,491813,Staff,30,0,32,2
1713316966135,HIEU 149GS,A00,491816,Caldwell; Michael Alan,28,0,28,0
1713316967162,HILD 2C,A01,491713,Hendrickson; Gerald M.,27,0,30,3
1713316968188,HILD 7B,A01,491715,Kwak; Nancy,5,0,30,25
1713316969221,HILD 10,A01,491717,Staff,13,0,20,7
1713316970246,HILD 30GS,A00,491719,Edington; Claire Ellen,24,0,28,4
1713316971270,HINE 109,A00,491818,Shafir; Nir,28,0,32,4
1713316972300,HINE 128,A00,491821,Shafir; Nir,31,0,32,1
1713316973324,HISC 117,A00,491830,Staff,29,0,32,3
1713316974353,HIUS 103,A00,491834,Man; Simeon S,15,0,23,8
1713316975380,HIUS 108B,A00,491835,Staff,29,0,30,1
1713316976410,HIUS 141,A00,491836,Hendrickson; Gerald M.,29,0,32,3
1713316977436,HIUS 149,A00,491839,Staff,27,0,32,5
1713316978469,HUM 3,A01,512617,Crum; Matthew Stephen,45,0,50,5
1713316978469,HUM 3,A02,512618,Crum; Matthew Stephen,48,0,50,2
1713316979500,HUM 3GS,A00,512663,Markman; Kristina,0,0,0,1
1713316979500,HUM 3GS,B00,512664,Staff,0,0,0,0
1713316980524,HUM 4,A01,512620,West; Geoffrey Scott,30,0,50,20
1713316981549,HUM 4GS,A00,512666,Lyon; Antony J.,0,0,0,3
1713316982576,HUM 4R,A01,512625,Watkins; Eric,49,0,50,1
1713316983603,HUM 5,A01,512649,Zavodny; Tatiana Sophia,29,0,50,21
1713316983603,HUM 5,B01,512661,Zroka; Ryan Edward,48,0,50,2
1713316984631,INTL 190,A00,490577,Segui; Alan S,0,0,0,5
1713316985656,JAPN 20AR,A01,491267,Ross; Kayoko F,9,0,20,11
1713316986681,JAPN 180,A00,491285,Berman; Michael David,34,0,40,6
1713316987713,LATI 50,A01,502536,Kokinis; Troy Andreas,16,0,22,6
1713316987713,LATI 50,A02,502551,Kokinis; Troy Andreas,22,0,22,0
1713316987713,LATI 50,A03,502650,Kokinis; Troy Andreas,22,0,22,0
1713316987713,LATI 50,A04,502909,Kokinis; Troy Andreas,22,0,22,0
1713316988739,LATI 160,A01,502920,Kokinis; Troy Andreas,30,0,30,0
1713316989769,LIFR 1A,A00,490494,Van Moer; Vinciane G,17,0,20,3
1713316990795,LIFR 1AX,A00,490495,Van Moer; Vinciane G,17,0,20,3
1713316991820,LIFR 1B,A00,490496,Van Moer; Vinciane G,18,0,20,2
1713316992846,LIFR 1BX,A00,490497,Van Moer; Vinciane G,18,0,20,2
1713316993875,LIGN 8,A00,505198,McIntosh; Justin Daniel,136,0,150,14
1713316994903,LIGN 9GS,A00,491239,Lott; Margaret S.,18,0,20,2
1713316995932,LIGN 101,A01,505200,McIntosh; Justin Daniel,24,0,30,6
1713316997012,LIGN 120,A01,491244,Staff,24,0,30,6
1713316998040,LIGN 149GS,A00,491245,Lott; Margaret S.,18,0,20,2
1713316999065,LIGN 170,A00,491247,Staff,24,0,30,6
1713317000091,LISP 1D,A00,490498,Munoz Sanchez; Alicia,10,0,14,4
1713317000091,LISP 1D,B00,490499,Munoz Sanchez; Alicia,6,0,14,8
1713317000091,LISP 1D,C00,490500,Munoz Sanchez; Alicia,8,0,14,6
1713317000091,LISP 1D,D00,490501,Munoz Sanchez; Alicia,10,0,14,4
1713317001121,LISP 1DX,A00,490502,Munoz Sanchez; Alicia,15,0,28,13
1713317001121,LISP 1DX,B00,490503,Munoz Sanchez; Alicia,17,0,28,11
1713317003178,LTAM 110,A00,491847,Staff,23,0,25,2
1713317004201,LTCS 119,A00,491848,Staff,11,0,15,4
1713317005227,LTCS 130,A00,491849,Staff,24,0,25,1
1713317007281,LTEA 120C,A00,491852,Staff,34,0,40,6
1713317008309,LTEN 130GS,A00,491853,Lyon; Antony J.,25,0,28,3
1713317009337,LTEN 148,A00,491855,Staff,23,0,25,2
1713317010361,LTEN 159,A00,491856,Staff,21,0,25,4
1713317011389,LTEN 180,A00,491857,Staff,8,0,15,7
1713317013444,LTSP 123GS,A00,505928,Bessett; Ryan Matthew,24,0,28,4
1713317014473,LTSP 174GS,A00,506037,Bessett; Ryan Matthew,24,0,28,4
1713317016526,LTWR 102,A00,491861,Staff,11,0,15,4
1713317017555,LTWR 106,A00,491862,Staff,10,0,15,5
1713317018580,MAE 11,A00,490930,Bahadori; Mohammad Yousef,97,0,100,3
1713317019606,MAE 30A,A00,490931,Qi; Huihui,37,0,40,3
1713317020638,MAE 101A,A00,491036,Sadeghizadeh; Zahra,97,0,100,3
1713317021663,MAE 101C,A00,491037,Seshadri; Kalyanasundaram,73,0,100,27
1713317022691,MAE 113,A00,491040,Seshadri; Kalyanasundaram,66,0,80,14
1713317023719,MAE 131A,A00,491041,Ghazinejad; Maziar,39,0,40,1
1713317024749,MAE 142,A00,491053,Staff,39,0,40,1
1713317025777,MAE 143A,A00,491054,Staff,36,0,50,14
1713317026806,MAE 150,A00,491092,Truong; Phuong Thi Ngoc,23,0,35,12
1713317027837,MATH 3C,A01,494031,Pardo Guerra; Sebastian,30,0,30,0
1713317027837,MATH 3C,A02,494032,Pardo Guerra; Sebastian,29,0,30,1
1713317028863,MATH 10A,A01,494034,Staff,27,0,30,3
1713317028863,MATH 10A,A02,494035,Staff,28,0,30,2
1713317028863,MATH 10A,B01,494037,Staff,27,0,30,3
1713317028863,MATH 10A,B02,494038,Staff,29,0,30,1
1713317029891,MATH 10B,A01,494040,Habib; Yousaf,23,0,30,7
1713317029891,MATH 10B,A02,494041,Habib; Yousaf,28,0,30,2
1713317029891,MATH 10B,A03,494042,Habib; Yousaf,30,0,30,0
1713317029891,MATH 10B,A04,494043,Habib; Yousaf,30,0,30,0
1713317029891,MATH 10B,B01,494045,Habib; Yousaf,28,0,30,2
1713317029891,MATH 10B,B02,494046,Habib; Yousaf,30,0,30,0
1713317029891,MATH 10B,B03,494047,Habib; Yousaf,30,0,30,0
1713317029891,MATH 10B,B04,494048,Habib; Yousaf,30,0,30,0
1713317030917,MATH 18,A01,494050,Kemp; Todd Aahron,25,0,30,5
1713317030917,MATH 18,A02,494051,Kemp; Todd Aahron,29,0,30,1
1713317030917,MATH 18,B01,494054,Kemp; Todd Aahron,28,0,30,2
1713317030917,MATH 18,B02,494055,Kemp; Todd Aahron,29,0,30,1
1713317031944,MATH 20A,A01,494059,Suk; Andrew Hoon,30,0,30,0
1713317032971,MATH 20B,A01,494061,Briones; Jor-el Thomas Caparas,33,0,35,2
1713317032971,MATH 20B,B01,494063,Bach; Quang Tran,34,0,35,1
1713317034000,MATH 20C,A01,494065,Staff,28,0,30,2
1713317034000,MATH 20C,A02,494066,Staff,30,0,30,0
1713317034000,MATH 20C,A03,494067,Staff,30,0,30,0
1713317034000,MATH 20C,A04,494068,Staff,30,0,30,0
1713317034000,MATH 20C,B01,494070,Zhang; Ming,26,0,30,4
1713317034000,MATH 20C,B02,494071,Zhang; Ming,28,0,30,2
1713317034000,MATH 20C,B03,494072,Zhang; Ming,29,0,30,1
1713317034000,MATH 20C,B04,494073,Zhang; Ming,29,0,30,1
1713317035027,MATH 20D,A01,494075,Staff,22,0,30,8
1713317035027,MATH 20D,A02,494076,Staff,30,0,30,0
1713317036055,MATH 20E,A01,494079,Staff,24,0,30,6
1713317036055,MATH 20E,A02,494080,Staff,27,0,30,3
1713317036055,MATH 20E,B01,494082,Staff,27,0,30,3
1713317036055,MATH 20E,B02,494083,Staff,25,0,30,5
1713317037081,MATH 103A,A01,494085,Aliabadi Sr.; Mohsen,15,0,30,15
1713317037081,MATH 103A,A02,494086,Aliabadi Sr.; Mohsen,28,0,30,2
1713317037081,MATH 103A,B01,494088,Aliabadi Sr.; Mohsen,22,0,30,8
1713317037081,MATH 103A,B02,494089,Aliabadi Sr.; Mohsen,28,0,30,2
1713317038113,MATH 109,A01,494091,Staff,30,0,30,0
1713317038113,MATH 109,A02,494092,Staff,29,0,30,1
1713317038113,MATH 109,B01,494094,Staff,28,0,30,2
1713317038113,MATH 109,B02,494095,Staff,29,0,30,1
1713317039139,MATH 142A,A01,494097,Chow; Bennett,16,0,30,14
1713317039139,MATH 142A,A02,494098,Chow; Bennett,24,0,30,6
1713317039139,MATH 142A,B01,494100,Chow; Bennett,19,0,30,11
1713317039139,MATH 142A,B02,494101,Chow; Bennett,29,0,30,1
1713317041189,MATH 168A,A01,516677,Dumitriu; Ioana,15,0,35,20
1713317042214,MATH 170A,A01,516679,Dumitriu; Ioana,20,0,30,10
1713317042214,MATH 170A,A02,516680,Dumitriu; Ioana,28,0,30,2
1713317043240,MATH 193A,A01,494107,Staff,15,0,30,15
1713317043240,MATH 193A,A02,494108,Staff,21,0,30,9
1713317043240,MATH 193A,A03,494109,Staff,29,0,30,1
1713317043240,MATH 193A,A04,494110,Staff,22,0,30,8
1713317046317,MGT 16,A00,491930,McKay; Michael J,92,0,98,6
1713317047347,MGT 18,A00,491992,McKay; Michael J,97,0,98,1
1713317048373,MGT 71,A00,492003,Staff,74,0,98,24
1713317049396,MGT 103,A00,505209,Eberhard; Craig A,85,0,98,13
1713317050425,MGT 131A,A00,505210,Anderson; John Charles,90,0,98,8
1713317052474,MGT 153,A00,492077,Perols; Johan Lars,34,0,90,56
1713317055549,MGT 164,A00,492222,McKay; Mary A,93,0,98,5
1713317056575,MGT 172,A00,492245,Staff,59,0,60,1
1713317056575,MGT 172,B00,505526,Hedges; Kathleen,73,0,98,25
1713317057604,MGT 181,A00,505669,Dunn; Louis Jean,85,0,98,13
1713317058630,MMW 14,A01,494399,Staff,23,0,28,5
1713317058630,MMW 14,A02,494400,Staff,25,0,28,3
1713317058630,MMW 14,A03,494401,Staff,28,0,28,0
1713317058630,MMW 14,A04,494402,Staff,28,0,28,0
1713317058630,MMW 14,B01,494404,Carreras; Maria Victoria,13,0,28,15
1713317058630,MMW 14,B02,494405,Carreras; Maria Victoria,26,0,28,2
1713317058630,MMW 14,B03,494406,Carreras; Maria Victoria,28,0,28,0
1713317058630,MMW 14,B04,494407,Carreras; Maria Victoria,28,0,28,0
1713317059659,MMW 14GS,A00,506250,Chang; Edmond Yi-Teh,0,0,0,0
1713317060725,MMW 121R,A01,494415,Adamiak; Patrick John,13,0,28,15
1713317060725,MMW 121R,A02,494416,Adamiak; Patrick John,24,0,28,4
1713317061750,MUS 1A,A01,494113,Staff,12,0,25,13
1713317061750,MUS 1A,A02,494114,Staff,25,0,25,0
1713317062775,MUS 4,A01,494116,Staff,24,0,25,1
1713317062775,MUS 4,A02,494117,Staff,22,0,25,3
1713317063805,MUS 5R,A01,494236,Dubnov; Shlomo,10,0,25,15
1713317063805,MUS 5R,A02,494237,Dubnov; Shlomo,25,0,25,0
1713317064833,MUS 6,A01,494122,Staff,12,0,25,13
1713317064833,MUS 6,A02,494123,Staff,24,0,25,1
1713317065857,MUS 7,A01,494125,Staff,16,0,25,9
1713317065857,MUS 7,A02,494126,Staff,24,0,25,1
1713317066882,MUS 11,A01,494128,Staff,23,0,25,2
1713317066882,MUS 11,A02,494129,Staff,24,0,25,1
1713317067908,MUS 13,A01,494131,Staff,25,0,25,0
1713317067908,MUS 13,A02,494132,Staff,25,0,25,0
1713317068937,MUS 15,A01,494134,Staff,17,0,25,8
1713317068937,MUS 15,A02,494135,Staff,25,0,25,0
1713317068937,MUS 15,B01,494137,Staff,24,0,25,1
1713317069962,MUS 80,A00,494232,Staff,24,0,25,1
1713317069962,MUS 80,B00,494233,Staff,25,0,25,0
1713317069962,MUS 80,C00,494234,Staff,23,0,25,2
1713317070987,MUS 95C,A00,494141,Staff,72,0,75,3
1713317072013,MUS 114,A00,494142,Staff,41,0,50,9
1713317073044,NANO 15,A01,490636,Drews; Aaron,7,0,7,0
1713317074069,PHIL 1,A00,490578,Grush; Rick Scott,49,0,50,1
1713317075095,PHIL 10,A01,490580,Grush; Rick Scott,33,0,35,2
1713317075095,PHIL 10,A02,490586,Grush; Rick Scott,33,0,35,2
1713317076121,PHIL 27,A01,490591,Staff,23,0,25,2
1713317076121,PHIL 27,A02,490592,Staff,25,0,25,0
1713317076121,PHIL 27,A03,490593,Staff,25,0,25,0
1713317076121,PHIL 27,A04,490598,Staff,25,0,25,0
1713317077149,PHIL 32,A01,490611,Staff,20,0,20,0
1713317077149,PHIL 32,A02,490618,Staff,20,0,20,0
1713317078174,PHIL 90,A00,490624,Staff,40,0,40,0
1713317079202,PHIL 136,A00,490627,Cohen; Jonathan David,38,0,40,2
1713317080226,PHIL 155,A00,490634,Staff,63,0,70,7
1713317081253,PHYS 1A,A00,491610,Staff,246,0,250,4
1713317082279,PHYS 1AL,001,491616,Tsai; Philbert S,28,0,30,2
1713317082279,PHYS 1AL,002,491618,Tsai; Philbert S,30,0,30,0
1713317083309,PHYS 1B,A00,491623,Staff,243,0,250,7
1713317084335,PHYS 1BL,001,491626,Tsai; Philbert S,25,0,30,5
1713317084335,PHYS 1BL,002,491628,Tsai; Philbert S,27,0,30,3
1713317085360,PHYS 1C,A00,491632,Staff,220,0,245,25
1713317086389,PHYS 1CL,001,491635,Tsai; Philbert S,10,0,30,20
1713317086389,PHYS 1CL,002,491643,Tsai; Philbert S,24,0,30,6
1713317087420,PHYS 2AR,A01,491651,Meyertholen; Andrew D.,44,0,50,6
1713317088445,PHYS 2B,A01,491659,Staff,106,0,115,9
1713317089471,PHYS 2BL,A01,491685,Staff,21,0,24,3
1713317089471,PHYS 2BL,A02,491700,Staff,23,0,24,1
1713317090498,PHYS 2C,A01,505161,Staff,106,0,115,9
1713317091523,PHYS 4A,A01,491704,Grinstein; Benjamin,99,0,100,1
1713317092556,POLI 5D,A01,494144,Staff,3,0,5,2
1713317092556,POLI 5D,B01,626283,Dai; Yinlin,5,0,5,0
1713317093580,POLI 12,A00,494145,Staff,44,0,45,1
1713317094606,POLI 13R,A00,494146,Forman; Fonna,45,0,50,5
1713317095632,POLI 27,A01,494148,Staff,57,0,60,3
1713317096660,POLI 30,A00,494149,Staff,49,0,50,1
1713317097687,POLI 100DA,A00,494150,Staff,21,0,25,4
1713317099739,POLI 100I,A00,494152,Staff,28,0,30,2
1713317100819,POLI 104B,A00,494153,Smith; Glenn Chatmas,54,0,55,1
1713317101856,POLI 104F,A00,494154,Staff,28,0,30,2
1713317102886,POLI 104I,A00,494155,Smith; Glenn Chatmas,30,0,30,0
1713317103916,POLI 110C,A00,494156,Ingham; Sean,23,0,25,2
1713317104947,POLI 117R,A00,494157,Forman; Fonna,9,0,20,11
1713317105977,POLI 118,A00,494158,Ingham; Sean,22,0,25,3
1713317107005,POLI 120H,A00,494159,Fisk; David Lee,41,0,45,4
1713317108031,POLI 131CR,A00,494160,Hoston; Germaine,36,0,45,9
1713317109060,POLI 133J,A00,494161,Staff,33,0,35,2
1713317110086,POLI 135,A00,494162,Fisk; David Lee,33,0,35,2
1713317111114,POLI 140A,A00,494164,Staff,21,0,30,9
1713317112139,POLI 142I,A00,494165,Staff,30,0,30,0
1713317113166,POLI 144D,A00,494166,Staff,23,0,25,2
1713317114189,POLI 151,A00,494167,Staff,30,0,30,0
1713317115214,POLI 153,A00,494168,Staff,33,0,35,2
1713317116243,POLI 160AA,A00,494169,Staff,35,0,40,5
1713317117270,POLI 162,A00,494170,Mignozzetti; Umberto,20,0,25,5
1713317118304,POLI 171,A00,494171,Mignozzetti; Umberto,21,0,25,4
1713317119356,PSYC 1,A00,494172,Staff,97,0,100,3
1713317120382,PSYC 2,A00,494173,Moranton; Nirelia Melbina-,43,0,50,7
1713317121410,PSYC 3,A00,494174,Staff,29,0,30,1
1713317122435,PSYC 6,A00,494175,Staff,17,0,20,3
1713317123461,PSYC 60,A01,494177,Staff,39,0,45,6
1713317124485,PSYC 70,A01,505724,Geller; Emma Harlan,42,0,45,3
1713317125511,PSYC 101,A00,494180,Heyman; Gail D.,87,0,100,13
1713317126537,PSYC 105,A00,494181,Geller; Emma Harlan,60,0,90,30
1713317127563,PSYC 106,A00,494182,Dobkins; Karen R.,29,0,45,16
1713317128588,PSYC 108,A00,494183,Adrian; Julia Anna,91,0,100,9
1713317129615,PSYC 114,A01,494185,Winkielman; Piotr,0,0,30,30
1713317130640,PSYC 122,A00,494186,Moranton; Nirelia Melbina-,34,0,50,16
1713317131667,PSYC 124,A00,494187,Chapman; Eddie Nathaniel,72,0,80,8
1713317132691,PSYC 131,A00,494188,Anagnostaras; Stephan,52,0,80,28
1713317133720,PSYC 144,A00,494189,Staff,13,0,50,37
1713317134744,PSYC 154,A00,494190,Lacefield; Katharine I,127,0,180,53
1713317135771,PSYC 162,A00,494191,Wixted; John T,79,0,100,21
1713317136801,PSYC 172,A00,494192,Gorman; Michael R.,37,0,45,8
1713317137831,PSYC 178,A00,494193,Glaser; Dale,40,0,45,5
1713317138856,PSYC 193,A00,505725,Chapman; Eddie Nathaniel,20,0,20,0
1713317139886,RELI 145GS,A00,519817,Rahimi; Babak,18,0,20,2
1713317140912,SE 101A,A01,490862,Chadha; Mayank,23,0,25,2
1713317141942,SE 101C,A01,490924,Krysl; Petr,18,0,20,2
1713317142967,SE 110A,A01,490928,Staff,19,0,20,1
1713317143997,SE 130A,A00,490929,Morrison; Machel Leigh,60,0,70,10
1713317145024,SIO 1,A01,519325,Staff,39,0,40,1
1713317146052,SIO 30,A01,519327,Staff,39,0,40,1
1713317147080,SIO 40,A00,519328,Staff,40,0,40,0
1713317148105,SIO 46GS,A00,519819,Cook; Geoffrey W,18,0,25,7
1713317149130,SIO 109R,A00,494197,Forman; Fonna,4,0,20,16
1713317150154,SIO 121GS,A00,519827,Cook; Geoffrey W,18,0,25,7
1713317151179,SIO 132,A01,519330,Staff,38,0,40,2
1713317152209,SIO 133,A01,519397,Staff,37,0,40,3
1713317153235,SIO 139,A00,519396,Kacev; David,31,0,40,9
1713317154267,SOCI 1,A01,494199,Thorpe; Charles Robert,23,0,30,7
1713317154267,SOCI 1,A02,494200,Thorpe; Charles Robert,30,0,30,0
1713317154267,SOCI 1,A03,494201,Thorpe; Charles Robert,29,0,30,1
1713317154267,SOCI 1,A04,494202,Thorpe; Charles Robert,29,0,30,1
1713317154267,SOCI 1,A05,494203,Thorpe; Charles Robert,29,0,30,1
1713317154267,SOCI 1,A06,494204,Thorpe; Charles Robert,30,0,30,0
1713317154267,SOCI 1,A07,494205,Thorpe; Charles Robert,29,0,30,1
1713317155293,SOCI 60,A01,494207,Staff,35,0,40,5
1713317155293,SOCI 60,A02,494208,Staff,39,0,40,1
1713317156324,SOCI 100,A01,494210,Payne; Christine Anna,27,0,30,3
1713317156324,SOCI 100,A02,494211,Payne; Christine Anna,27,0,30,3
1713317157349,SOCI 109M,A00,494212,Staff,20,0,20,0
1713317158374,SOCI 110,A00,494213,Staff,35,0,40,5
1713317160425,SOCI 118E,A00,494215,Ng; Kwai,38,0,40,2
1713317161448,SOCI 125,A00,494216,Calderon-Zaks; Michael Aar,42,0,45,3
1713317162475,SOCI 126,A01,494218,Jones; Makeba,3,0,5,2
1713317163499,SOCI 131,A00,494219,Thorpe; Charles Robert,28,0,30,2
1713317165553,SOCI 135,A00,494221,Payne; Christine Anna,34,0,50,16
1713317166579,SOCI 136E,A00,626690,Ruiz; Jonathan Joseph,25,0,25,0
1713317167605,SOCI 138GS,A00,494222,Navon; Daniel,24,0,28,4
1713317169655,SOCI 145,A00,494224,Staff,42,0,45,3
1713317170681,SOCI 153,A00,494225,Staff,28,0,30,2
1713317171706,SOCI 160E,A00,494226,Ng; Kwai,32,0,40,8
1713317172729,SOCI 180,A00,494227,Staff,29,0,30,1
1713317173758,SOCI 189GS,A00,494228,Ribas Norris; Janet Vanesa,11,0,11,0
1713317174785,SOCI 190GS,A00,553232,Ribas Norris; Janet Vanesa,11,0,11,0
1713317175815,SOMI 220,A00,627178,Schneid; Stephen David,30,0,30,0
1713317176846,SYN 2,001,490768,Staff,14,0,15,1
1713317176846,SYN 2,002,490769,Staff,15,0,15,0
1713317176846,SYN 2,004,490775,Staff,0,0,0,0
1713317176846,SYN 2,003,490774,Staff,0,0,0,0
1713317176846,SYN 2,005,490776,Staff,0,0,0,0
1713317177871,SYN 2R,001,490779,Staff,12,0,15,3
1713317177871,SYN 2R,002,514635,Staff,14,0,15,1
1713317178896,SYN 100,A01,490783,Staff,15,0,20,5
1713317178896,SYN 100,B01,490787,Staff,10,0,20,10
1713317178896,SYN 100,C01,490789,Staff,12,0,20,8
1713317179923,SYN 150,A00,490817,Staff,14,0,15,1
1713317179923,SYN 150,B00,514610,Staff,15,0,15,0
1713317180953,TDAC 1,A00,492753,Walsh; Kim C.,19,0,20,1
1713317180953,TDAC 1,B00,492754,Harting; Carla Kelso,19,0,20,1
1713317180953,TDAC 1,C00,513995,Salovey; Todd,16,0,20,4
1713317181978,TDAC 101,A00,492766,Harting; Carla Kelso,17,0,20,3
1713317183005,TDAC 102,A00,492768,Basso; Beatrice,19,0,20,1
1713317184030,TDDE 111,A00,492769,Staff,25,0,25,0
1713317185060,TDDE 131,A00,492770,Staff,15,0,15,0
1713317185060,TDDE 131,B00,492771,Staff,15,0,15,0
1713317186085,TDDE 131GS,A00,523716,Guirguis; Mark C,24,0,28,4
1713317187115,TDGE 1,A01,492756,Salovey; Todd,57,0,60,3
1713317188140,TDGE 5,A01,492758,Staff,24,0,25,1
1713317189166,TDGE 10,A00,492759,Fulton; Julia,208,0,220,12
1713317190191,TDGE 11,A00,492760,Castro; Robert Jess,199,0,200,1
1713317192244,TDGE 124,A00,492772,Fulton; Julia,192,0,220,28
1713317193272,TDGE 125,A00,492773,Meyer; Ursula,40,0,50,10
1713317193272,TDGE 125,B00,492774,Staff,49,0,50,1
1713317193272,TDGE 125,C00,523565,Staff,48,0,50,2
1713317194297,TDGE 125GS,A00,523580,Guirguis; Mark C,24,0,28,4
1713317195326,TDGE 127,A00,492775,Havis; Allan,40,0,50,10
1713317196355,TDHT 101,A00,492776,Staff,35,0,35,0
1713317197381,TDMV 1,A00,492762,Caligagan; Maria T.,30,0,30,0
1713317197381,TDMV 1,B00,492763,Arcidiacono; Kristin,25,0,30,5
1713317198407,TDMV 2,A00,492764,Weinberg; Sadie,29,0,30,1
1713317199430,TDMV 3,A00,492765,Mack; Kara Shanai',39,0,40,1
1713317200455,TDMV 138,A00,492777,Mack; Kara Shanai',35,0,40,5
1713317201480,TDMV 140,A00,492778,Lima; Paulo Henrique,40,0,40,0
1713317202505,TDMV 142,A00,492779,Caligagan; Maria T.,36,0,40,4
1713317202505,TDMV 142,B00,492780,Caligagan; Tony,37,0,40,3
1713317203535,TDMV 143,A00,492781,Fyall; Daunte Edward,39,0,40,1
1713317204615,USP 1,A01,492401,Kwak; Nancy,26,0,35,9
1713317205646,USP 2,A01,492453,Hinds; Juli Beth,35,0,35,0
1713317206674,USP 3,A01,492516,Staff,29,0,35,6
1713317207700,USP 4,A00,492522,McTague; Sarah,19,0,25,6
1713317208728,USP 100,A00,492523,Staff,33,0,35,2
1713317209756,USP 101,A00,492524,Staff,13,0,15,2
1713317210782,USP 105,A00,492525,Staff,21,0,25,4
1713317211811,USP 151,A00,492526,Shenkman; Michael Thomas,33,0,35,2
1713317212836,USP 170,A00,492545,Hinds; Juli Beth,33,0,35,2
1713317213862,USP 171GS,A00,492608,Bussell; Mirle Rabinowitz,24,0,28,4
1713317214890,USP 183GS,A00,492613,Peerson; Susan,24,0,28,4
1713317215917,VIS 30,A01,490693,Yoldas; Pinar,20,0,22,2
1713317215917,VIS 30,A02,490694,Yoldas; Pinar,18,0,22,4
1713317216945,VIS 83,A00,490695,Kester; Grant,66,0,75,9
1713317217971,VIS 105D,A00,490696,Staff,22,0,25,3
1713317218997,VIS 124CN,A00,490699,Rose; Jordan M,68,0,75,7
1713317220024,VIS 125GS,A00,511221,Williams; Alena J,21,0,22,1
1713317221051,VIS 128D,A00,490700,Staff,74,0,75,1
1713317222078,VIS 151,A01,490717,Staff,33,0,34,1
1713317222078,VIS 151,A02,490766,Staff,33,0,34,1
1713317223106,VIS 154GS,A00,511972,Williams; Alena J,21,0,22,1
1713317224136,VIS 160A,A00,490767,Stone; Patricia,7,0,10,3
1713317225163,WCWP 10A,A00,490638,Staff,14,0,15,1
1713317225163,WCWP 10A,B00,490640,Staff,15,0,15,0
1713317226193,WCWP 10B,A00,490641,Staff,0,0,0,0
1713317226193,WCWP 10B,B00,490642,Staff,14,0,15,1
1713317226193,WCWP 10B,C00,490644,Staff,13,0,15,2
1713317226193,WCWP 10B,D00,490647,Staff,0,0,0,0
1713317227218,WCWP 100,A00,490655,Staff,0,0,0,0
1713317227218,WCWP 100,B00,490687,Staff,11,0,15,4
1713317229362,ANAR 153,A00,487222,Braswell; Geoffrey E.,54,0,60,6
1713317230388,ANBI 134,A00,487223,Staff,9,0,20,11
1713317231417,ANBI 143GS,A00,487224,Noel; Geoffroy Pierre Jean,20,0,24,4
1713317232442,ANBI 144GS,A00,519548,Noel; Geoffroy Pierre Jean,20,0,24,4
1713317233470,ANSC 101,A00,487225,Staff,19,0,20,1
1713317234500,ANSC 125,A00,487227,Brenner; Suzanne A,39,0,40,1
1713317236552,ANSC 146,A00,487229,Staff,36,0,40,4
1713317237582,ANSC 148,A00,487230,Olivas Hernandez; Olga Lid,39,0,40,1
1713317238610,ANSC 150,A00,504165,Sloane; Julia Kathryn,19,0,20,1
1713317239634,ANSC 180,A00,487232,Staff,13,0,15,2
1713317240658,ANSC 188,A00,627155,Staff,39,0,40,1
1713317241685,ANTH 5,A00,519529,Semendeferi; Ekaterini,15,0,15,0
1713317242710,ANTH 10,A00,487219,Staff,58,0,60,2
1713317243733,ANTH 23,A01,487221,Staff,17,0,20,3
1713317244759,ANTH 102,A00,487233,Wilder; Linnea Lorene,51,0,60,9
1713317245788,ANTH 103,A00,487234,Varma; Saiba,56,0,60,4
1713317246813,ANTH 105,A00,487235,Stewart; Alexander B,55,0,60,5
1713317247838,BENG 100,A01,516685,Taylor Amos; Alyssa C,28,0,30,2
1713317248864,BIBC 102,A01,491316,Flagg; Matthew Paul,30,0,88,58
1713317248864,BIBC 102,A02,491366,Flagg; Matthew Paul,83,0,88,5
1713317249898,BIBC 103,A01,491486,Boumechache; Miyyada,16,0,24,8
1713317249898,BIBC 103,A02,491487,Boumechache; Miyyada,24,0,24,0
1713317251115,BICD 100,A01,516882,Staff,75,0,75,0
1713317251115,BICD 100,A02,516890,Staff,70,0,75,5
1713317252147,BICD 102GS,A00,491488,Lo; Stanley M.,26,0,28,2
1713317253171,BIEB 136GS,A00,516940,Holway; David A. & Shurin; Jonathan,19,0,24,5
1713317254201,BIEB 137GS,A01,517034,Holway; David A. & Shurin; Jonathan,19,0,24,5
1713317255232,BIEB 138GS,A01,491492,Pirino; Giorgia,21,0,28,7
1713317256258,BILD 1,A01,491296,Staff,62,0,63,1
1713317256258,BILD 1,A02,491297,Staff,63,0,63,0
1713317257286,BILD 4,A01,517099,Gonzalez Gamboa; Ivonne,22,0,24,2
1713317257286,BILD 4,A02,517100,Gonzalez Gamboa; Ivonne,24,0,24,0
1713317258312,BILD 60GS,A00,491309,Lo; Stanley M.,26,0,28,2
1713317259335,BIMM 100,A01,517136,Staff,87,0,100,13
1713317260367,BIMM 110,A01,517182,Staff,66,0,100,34
1713317261398,BIMM 120,A01,517228,Pickett; Brooke Elizabeth,36,0,63,27
1713317261398,BIMM 120,A02,517240,Pickett; Brooke Elizabeth,48,0,63,15
1713317262427,BIMM 132GS,A01,491498,Pirino; Giorgia,21,0,28,7
1713317263457,BIMM 143,A01,491589,Bozinovic; Goran,17,0,40,23
1713317264485,BIPN 100,A01,491594,Armour; Jon Christopher,90,0,100,10
1713317265511,BIPN 140,A01,491602,Marino; Marc J,28,0,50,22
1713317267563,CAT 125,A00,515973,Staff,19,0,20,1
1713317268589,CAT 125GS,A00,515974,Rahimi; Babak,18,0,20,2
1713317269617,CAT 125R,A00,515980,Staff,14,0,20,6
1713317269617,CAT 125R,B00,515981,Tosun; Adriana,19,0,20,1
1713317269617,CAT 125R,C00,515987,Hyland; Tina Mae,0,0,20,20
1713317269617,CAT 125R,D00,515988,Bronstein; Phoebe Malan,18,0,20,2
1713317270643,CENG 15,A01,488699,Drews; Aaron,25,0,25,0
1713317271670,CENG 100,A00,505196,Opatkiewicz; Justin Paul,25,0,25,0
1713317272696,CGS 2A,A01,489598,Staff,33,0,35,2
1713317273722,CGS 112,A00,489599,Staff,15,0,15,0
1713317274751,CGS 119,A00,489603,Staff,10,0,10,0
1713317275780,CGS 120,A00,489604,Staff,14,0,15,1
1713317276808,CGS 150,A00,489607,Staff,15,0,15,0
1713317277839,CHEM 6A,A01,488715,Staff,98,0,100,2
1713317278871,CHEM 6B,A01,488719,Piercy; Marc Anthony,100,0,100,0
1713317279897,CHEM 6C,A01,488723,Albizati; Kim F.,94,0,100,6
1713317280936,CHEM 7L,A01,488728,Schurmeier; Kimberly,18,0,24,6
1713317280936,CHEM 7L,A02,488730,Schurmeier; Kimberly,23,0,24,1
1713317280936,CHEM 7L,A03,488734,Schurmeier; Kimberly,23,0,24,1
1713317280936,CHEM 7L,A04,488763,Schurmeier; Kimberly,23,0,24,1
1713317280936,CHEM 7L,B01,488798,Schurmeier; Kimberly,17,0,24,7
1713317280936,CHEM 7L,B02,488801,Schurmeier; Kimberly,23,0,24,1
1713317280936,CHEM 7L,B03,488808,Schurmeier; Kimberly,24,0,24,0
1713317280936,CHEM 7L,B04,488811,Schurmeier; Kimberly,24,0,24,0
1713317281961,CHEM 11,A01,488897,Stallings; Dontarie M,97,0,100,3
1713317282990,CHEM 40A,A01,488913,Albizati; Kim F.,88,0,100,12
1713317284021,CHEM 40B,A01,488920,Weizman; Haim,45,0,50,5
1713317284021,CHEM 40B,A02,488938,Weizman; Haim,46,0,50,4
1713317285049,CHEM 41A,A01,489029,Klosterman; Jeremy K,58,0,60,2
1713317286075,CHEM 41C,A01,500436,Tor; Yitzhak,55,0,60,5
1713317287098,CHEM 43A,A01,500426,Weizman; Haim,2,0,24,22
1713317287098,CHEM 43A,A02,500430,Weizman; Haim,13,0,24,11
1713317287098,CHEM 43A,B01,514041,Klosterman; Jeremy K,15,0,24,9
1713317287098,CHEM 43A,B02,514047,Klosterman; Jeremy K,23,0,24,1
1713317288126,CHEM 108,A01,489140,Jennings; Patricia A.,11,0,24,13
1713317288126,CHEM 108,A02,489142,Jennings; Patricia A.,14,0,24,10
1713317289151,CHEM 114A,A01,489147,Stallings; Dontarie M,77,0,100,23
1713317290181,CHIN 169A,A00,489171,Wang; Xiao,19,0,20,1
1713317292238,COGS 3,A01,518827,Boyle; Mary E. T.,29,0,40,11
1713317293263,COGS 11,A01,489175,Staff,28,0,30,2
1713317294295,COGS 14A,A01,518829,Staff,51,0,60,9
1713317295320,COGS 14B,A01,489177,Hoffman; Drew Ellen,67,0,75,8
1713317296345,COGS 100,A01,489181,Allen; Michael Gordon,65,0,75,10
1713317297369,COGS 101A,A01,489183,Staff,48,0,60,12
1713317298394,COGS 101B,A01,489185,Allen; Michael Gordon,10,0,30,20
1713317299424,COGS 101C,A01,526786,Staff,24,0,30,6
1713317301479,COGS 107A,A01,489189,Boyle; Mary E. T.,19,0,35,16
1713317302505,COGS 107B,A01,627144,Mooshagian; Eric Frederick,60,0,60,0
1713317303531,COGS 118A,A01,489191,Staff,0,40,40,40
1713317305583,COGS 171GS,A01,489194,Pineda; Jaime A,21,0,28,7
1713317306608,COGS 172,A01,489196,Staff,3,0,30,27
1713317307633,COGS 174GS,A01,489264,Pineda; Jaime A,21,0,28,7
1713317308715,COGS 180,A01,627150,Staff,28,0,30,2
1713317309744,COGS 186,A01,489274,Staff,0,0,30,30
1713317310770,COMM 10,A01,489276,Staff,23,0,25,2
1713317310770,COMM 10,A02,489303,Staff,23,0,25,2
1713317311801,COMM 100A,A01,489312,Staff,16,0,25,9
1713317311801,COMM 100A,A02,489313,Staff,24,0,25,1
1713317312831,COMM 106T,A00,512540,Staff,34,0,35,1
1713317313856,COMM 107,A00,489347,Staff,31,0,35,4
1713317314880,COMM 109P,A00,489358,Staff,31,0,35,4
1713317315906,COMM 132,A00,489361,McKenna; Denise,28,0,30,2
1713317316937,COMM 146,A00,489362,Halm; Gavin Patrick,27,0,30,3
1713317317963,COMM 190,A00,489363,Abuelhiga; Soraya Jill,20,0,23,3
1713317318991,CSE 8A,A50,489366,Staff,22,0,25,3
1713317318991,CSE 8A,A51,489367,Staff,24,0,25,1
1713317320017,CSE 11,A01,489398,Cao; Yingjun,79,0,100,21
1713317321050,CSE 12,A01,489487,Staff,43,0,50,7
1713317322079,CSE 20,A01,489497,Staff,48,0,50,2
1713317323111,CSE 21,A01,489517,Braun; Oliver,43,0,50,7
1713317324138,CSE 101,A01,489524,Braun; Oliver,0,20,50,50
1713317325164,CSE 105,A01,512594,Jones; Miles E,79,0,100,21
1713317325164,CSE 105,B01,512598,Jones; Miles E,58,0,100,42
1713317326191,CSE 140,A01,489538,Staff,44,0,50,6
1713317327218,CSE 141,A01,489550,Eldon; John,74,0,100,26
1713317328242,CSE 141L,A01,489571,Eldon; John,72,0,100,28
1713317329269,CSE 151A,A01,489583,Solares; Edwin A,147,0,200,53
1713317330295,CSE 175,A01,510886,Kumar; Rakesh,30,0,30,0
1713317331321,CSE 190,A00,516828,Dubnov; Shlomo,39,0,49,10
1713317332345,DOC 100D,A00,489667,Pass; Natalye Joann,20,0,25,5
1713317333371,DSC 10,A01,624268,Staff,72,0,75,3
1713317334397,DSC 20,A01,624476,Staff,50,0,50,0
1713317335423,DSC 40A,A01,624608,Staff,39,0,40,1
1713317336449,DSGN 1,A01,489179,Rill; Bryan,36,0,50,14
1713317337480,ECE 17,A01,490489,Sahay; Rajeev,18,0,30,12
1713317338505,ECE 65,A50,490492,Staff,15,0,20,5
1713317338505,ECE 65,A51,490493,Staff,20,0,20,0
1713317339532,ECON 1,A01,489715,Famulari; Melissa,68,0,70,2
1713317340563,ECON 2,A01,489717,Levkoff; Steven B.,68,0,70,2
1713317341592,ECON 3,A01,489948,Staff,70,0,70,0
1713317343643,ECON 5,A01,490103,Staff,28,0,30,2
1713317343643,ECON 5,B01,626281,Dai; Yinlin,45,0,45,0
1713317344675,ECON 100A,A01,490127,Famulari; Melissa,66,0,70,4
1713317345698,ECON 100B,A01,490129,Staff,64,0,70,6
1713317346728,ECON 109,A01,490187,Shishkin; Denis,27,0,35,8
1713317347754,ECON 110A,A01,490190,Levkoff; Steven B.,61,0,70,9
1713317348778,ECON 120A,A01,490245,Dai; Yinlin,63,0,70,7
1713317349804,ECON 120B,A01,490247,Nieto-Barthaburu; Augusto,53,0,70,17
1713317350831,ECON 120C,A01,490253,Sun; Yixiao,30,0,35,5
1713317350831,ECON 120C,B01,490255,Sun; Yixiao,34,0,35,1
1713317351860,ECON 129,A00,490256,Eckert; Fabian Paul,25,0,35,10
1713317352885,ECON 131,A00,490257,Nieto-Barthaburu; Augusto,0,3,35,35
1713317353910,ECON 138,A00,490258,Bharadwaj; Prashant,18,0,35,17
1713317353910,ECON 138,B00,490259,Bharadwaj; Prashant,17,0,35,18
1713317354937,ECON 159,A00,490260,Hendrickson; Gerald M.,0,8,0,0
1713317355965,ECON 178,A01,553995,Zhu; Ying,24,0,35,11
1713317356991,EDS 40,A01,512576,Black; Alison Michelle,20,0,20,0
1713317358019,EDS 107,A01,515848,Staff,30,0,30,0
1713317359049,EDS 110R,A01,490262,Staff,26,0,30,4
1713317360077,EDS 112,A01,490264,Chapman; Thandeka K,42,0,50,8
1713317361106,EDS 113,A00,490266,Staff,26,0,30,4
1713317362134,EDS 118,A00,490267,Warstadt; Melissa Fawn,22,0,30,8
1713317363158,EDS 124BR,A00,490268,Eguchi; Emi,6,0,25,19
1713317363158,EDS 124BR,B00,490269,Eguchi; Emi,25,0,25,0
1713317364184,EDS 126,A01,490271,Jones; Makeba,44,0,50,6
1713317365214,EDS 135,A01,490316,Staff,19,0,20,1
1713317366240,ENVR 142GS,A00,519514,Chang; Edmond Yi-Teh,28,0,28,0
1713317367265,ETHN 103,A00,490504,Staff,31,0,36,5
1713317368292,ETHN 103A,A00,490505,Man; Simeon S,5,0,9,4
1713317369317,ETHN 109,A00,490506,Staff,30,0,30,0
1713317370343,ETHN 118,A00,490507,Staff,35,0,36,1
1713317371367,ETHN 119,A00,490508,Staff,34,0,36,2
1713317372393,ETHN 121R,A00,490518,Choi; Esther Min,25,0,36,11
1713317373417,ETHN 127,A00,490528,Staff,15,0,15,0
1713317374447,ETHN 139,A00,490573,Staff,10,0,10,0
1713317375472,ETHN 150,A00,490575,Staff,15,0,15,0
1713317376498,GLBH 20,A00,491705,Elwardani; Nile Regina,38,0,40,2
1713317377531,GLBH 101,A00,491706,Staff,20,0,20,0
1713317378556,GLBH 111,A01,491708,Burgos; Jose L.,15,0,15,0
1713317379586,GLBH 146,A00,491709,Staff,11,0,20,9
1713317380617,GLBH 148,A00,491710,Olivas Hernandez; Olga Lid,14,0,20,6
1713317381647,GLBH 150,A00,491711,Sloane; Julia Kathryn,20,0,20,0
1713317382675,HIEA 131,A00,491760,Staff,29,0,32,3
1713317383700,HIEA 153,A00,491762,Staff,29,0,30,1
1713317384725,HIEU 124,A00,491811,Staff,26,0,32,6
1713317385751,HIEU 124GS,A00,491812,Markman; Kristina,27,0,28,1
1713317386779,HIEU 147,A00,491813,Staff,30,0,32,2
1713317387808,HIEU 149GS,A00,491816,Caldwell; Michael Alan,28,0,28,0
1713317388834,HILD 2C,A01,491713,Hendrickson; Gerald M.,27,0,30,3
1713317389859,HILD 7B,A01,491715,Kwak; Nancy,5,0,30,25
1713317390888,HILD 10,A01,491717,Staff,13,0,20,7
1713317391916,HILD 30GS,A00,491719,Edington; Claire Ellen,24,0,28,4
1713317392941,HINE 109,A00,491818,Shafir; Nir,27,0,32,5
1713317393966,HINE 128,A00,491821,Shafir; Nir,31,0,32,1
1713317394991,HISC 117,A00,491830,Staff,29,0,32,3
1713317396019,HIUS 103,A00,491834,Man; Simeon S,15,0,23,8
1713317397049,HIUS 108B,A00,491835,Staff,29,0,30,1
1713317398078,HIUS 141,A00,491836,Hendrickson; Gerald M.,29,0,32,3
1713317399106,HIUS 149,A00,491839,Staff,27,0,32,5
1713317400134,HUM 3,A01,512617,Crum; Matthew Stephen,45,0,50,5
1713317400134,HUM 3,A02,512618,Crum; Matthew Stephen,48,0,50,2
1713317401161,HUM 3GS,A00,512663,Markman; Kristina,0,0,0,1
1713317401161,HUM 3GS,B00,512664,Staff,0,0,0,0
1713317402187,HUM 4,A01,512620,West; Geoffrey Scott,30,0,50,20
1713317403216,HUM 4GS,A00,512666,Lyon; Antony J.,0,0,0,3
1713317404242,HUM 4R,A01,512625,Watkins; Eric,49,0,50,1
1713317405270,HUM 5,A01,512649,Zavodny; Tatiana Sophia,29,0,50,21
1713317405270,HUM 5,B01,512661,Zroka; Ryan Edward,48,0,50,2
1713317406295,INTL 190,A00,490577,Segui; Alan S,0,0,0,5
1713317407327,JAPN 20AR,A01,491267,Ross; Kayoko F,9,0,20,11
1713317408355,JAPN 180,A00,491285,Berman; Michael David,34,0,40,6
1713317409389,LATI 50,A01,502536,Kokinis; Troy Andreas,16,0,22,6
1713317409389,LATI 50,A02,502551,Kokinis; Troy Andreas,22,0,22,0
1713317409389,LATI 50,A03,502650,Kokinis; Troy Andreas,22,0,22,0
1713317409389,LATI 50,A04,502909,Kokinis; Troy Andreas,22,0,22,0
1713317410415,LATI 160,A01,502920,Kokinis; Troy Andreas,30,0,30,0
1713317411445,LIFR 1A,A00,490494,Van Moer; Vinciane G,17,0,20,3
1713317412524,LIFR 1AX,A00,490495,Van Moer; Vinciane G,17,0,20,3
1713317413553,LIFR 1B,A00,490496,Van Moer; Vinciane G,18,0,20,2
1713317414579,LIFR 1BX,A00,490497,Van Moer; Vinciane G,18,0,20,2
1713317415610,LIGN 8,A00,505198,McIntosh; Justin Daniel,136,0,150,14
1713317416635,LIGN 9GS,A00,491239,Lott; Margaret S.,18,0,20,2
1713317417661,LIGN 101,A01,505200,McIntosh; Justin Daniel,24,0,30,6
1713317418686,LIGN 120,A01,491244,Staff,24,0,30,6
1713317419713,LIGN 149GS,A00,491245,Lott; Margaret S.,18,0,20,2
1713317420738,LIGN 170,A00,491247,Staff,24,0,30,6
1713317421767,LISP 1D,A00,490498,Munoz Sanchez; Alicia,10,0,14,4
1713317421767,LISP 1D,B00,490499,Munoz Sanchez; Alicia,6,0,14,8
1713317421767,LISP 1D,C00,490500,Munoz Sanchez; Alicia,8,0,14,6
1713317421767,LISP 1D,D00,490501,Munoz Sanchez; Alicia,10,0,14,4
1713317422793,LISP 1DX,A00,490502,Munoz Sanchez; Alicia,15,0,28,13
1713317422793,LISP 1DX,B00,490503,Munoz Sanchez; Alicia,17,0,28,11
1713317424845,LTAM 110,A00,491847,Staff,23,0,25,2
1713317425870,LTCS 119,A00,491848,Staff,11,0,15,4
1713317426898,LTCS 130,A00,491849,Staff,24,0,25,1
1713317428949,LTEA 120C,A00,491852,Staff,34,0,40,6
1713317429976,LTEN 130GS,A00,491853,Lyon; Antony J.,25,0,28,3
1713317431003,LTEN 148,A00,491855,Staff,23,0,25,2
1713317432029,LTEN 159,A00,491856,Staff,21,0,25,4
1713317433057,LTEN 180,A00,491857,Staff,8,0,15,7
1713317435109,LTSP 123GS,A00,505928,Bessett; Ryan Matthew,24,0,28,4
1713317436135,LTSP 174GS,A00,506037,Bessett; Ryan Matthew,24,0,28,4
1713317438191,LTWR 102,A00,491861,Staff,11,0,15,4
1713317439215,LTWR 106,A00,491862,Staff,10,0,15,5
1713317440240,MAE 11,A00,490930,Bahadori; Mohammad Yousef,97,0,100,3
1713317441266,MAE 30A,A00,490931,Qi; Huihui,37,0,40,3
1713317442293,MAE 101A,A00,491036,Sadeghizadeh; Zahra,97,0,100,3
1713317443322,MAE 101C,A00,491037,Seshadri; Kalyanasundaram,73,0,100,27
1713317444347,MAE 113,A00,491040,Seshadri; Kalyanasundaram,66,0,80,14
1713317445373,MAE 131A,A00,491041,Ghazinejad; Maziar,39,0,40,1
1713317446401,MAE 142,A00,491053,Staff,39,0,40,1
1713317447427,MAE 143A,A00,491054,Staff,36,0,50,14
1713317448458,MAE 150,A00,491092,Truong; Phuong Thi Ngoc,23,0,35,12
1713317449487,MATH 3C,A01,494031,Pardo Guerra; Sebastian,30,0,30,0
1713317449487,MATH 3C,A02,494032,Pardo Guerra; Sebastian,29,0,30,1
1713317450514,MATH 10A,A01,494034,Staff,27,0,30,3
1713317450514,MATH 10A,A02,494035,Staff,28,0,30,2
1713317450514,MATH 10A,B01,494037,Staff,27,0,30,3
1713317450514,MATH 10A,B02,494038,Staff,29,0,30,1
1713317451549,MATH 10B,A01,494040,Habib; Yousaf,23,0,30,7
1713317451549,MATH 10B,A02,494041,Habib; Yousaf,28,0,30,2
1713317451549,MATH 10B,A03,494042,Habib; Yousaf,30,0,30,0
1713317451549,MATH 10B,A04,494043,Habib; Yousaf,30,0,30,0
1713317451549,MATH 10B,B01,494045,Habib; Yousaf,27,0,30,3
1713317451549,MATH 10B,B02,494046,Habib; Yousaf,30,0,30,0
1713317451549,MATH 10B,B03,494047,Habib; Yousaf,30,0,30,0
1713317451549,MATH 10B,B04,494048,Habib; Yousaf,30,0,30,0
1713317452576,MATH 18,A01,494050,Kemp; Todd Aahron,25,0,30,5
1713317452576,MATH 18,A02,494051,Kemp; Todd Aahron,29,0,30,1
1713317452576,MATH 18,B01,494054,Kemp; Todd Aahron,28,0,30,2
1713317452576,MATH 18,B02,494055,Kemp; Todd Aahron,29,0,30,1
1713317453604,MATH 20A,A01,494059,Suk; Andrew Hoon,30,0,30,0
1713317454631,MATH 20B,A01,494061,Briones; Jor-el Thomas Caparas,33,0,35,2
1713317454631,MATH 20B,B01,494063,Bach; Quang Tran,34,0,35,1
1713317455664,MATH 20C,A01,494065,Staff,28,0,30,2
1713317455664,MATH 20C,A02,494066,Staff,30,0,30,0
1713317455664,MATH 20C,A03,494067,Staff,30,0,30,0
1713317455664,MATH 20C,A04,494068,Staff,30,0,30,0
1713317455664,MATH 20C,B01,494070,Zhang; Ming,26,0,30,4
1713317455664,MATH 20C,B02,494071,Zhang; Ming,28,0,30,2
1713317455664,MATH 20C,B03,494072,Zhang; Ming,29,0,30,1
1713317455664,MATH 20C,B04,494073,Zhang; Ming,29,0,30,1
1713317456695,MATH 20D,A01,494075,Staff,22,0,30,8
1713317456695,MATH 20D,A02,494076,Staff,30,0,30,0
1713317457726,MATH 20E,A01,494079,Staff,24,0,30,6
1713317457726,MATH 20E,A02,494080,Staff,26,0,30,4
1713317457726,MATH 20E,B01,494082,Staff,27,0,30,3
1713317457726,MATH 20E,B02,494083,Staff,25,0,30,5
1713317458752,MATH 103A,A01,494085,Aliabadi Sr.; Mohsen,15,0,30,15
1713317458752,MATH 103A,A02,494086,Aliabadi Sr.; Mohsen,28,0,30,2
1713317458752,MATH 103A,B01,494088,Aliabadi Sr.; Mohsen,22,0,30,8
1713317458752,MATH 103A,B02,494089,Aliabadi Sr.; Mohsen,28,0,30,2
1713317459779,MATH 109,A01,494091,Staff,30,0,30,0
1713317459779,MATH 109,A02,494092,Staff,29,0,30,1
1713317459779,MATH 109,B01,494094,Staff,28,0,30,2
1713317459779,MATH 109,B02,494095,Staff,29,0,30,1
1713317460804,MATH 142A,A01,494097,Chow; Bennett,16,0,30,14
1713317460804,MATH 142A,A02,494098,Chow; Bennett,24,0,30,6
1713317460804,MATH 142A,B01,494100,Chow; Bennett,19,0,30,11
1713317460804,MATH 142A,B02,494101,Chow; Bennett,29,0,30,1
1713317462855,MATH 168A,A01,516677,Dumitriu; Ioana,15,0,35,20
1713317463882,MATH 170A,A01,516679,Dumitriu; Ioana,20,0,30,10
1713317463882,MATH 170A,A02,516680,Dumitriu; Ioana,28,0,30,2
1713317464911,MATH 193A,A01,494107,Staff,15,0,30,15
1713317464911,MATH 193A,A02,494108,Staff,21,0,30,9
1713317464911,MATH 193A,A03,494109,Staff,29,0,30,1
1713317464911,MATH 193A,A04,494110,Staff,22,0,30,8
1713317467989,MGT 16,A00,491930,McKay; Michael J,92,0,98,6
1713317469022,MGT 18,A00,491992,McKay; Michael J,97,0,98,1
1713317470046,MGT 71,A00,492003,Staff,74,0,98,24
1713317471075,MGT 103,A00,505209,Eberhard; Craig A,85,0,98,13
1713317472100,MGT 131A,A00,505210,Anderson; John Charles,90,0,98,8
1713317474156,MGT 153,A00,492077,Perols; Johan Lars,31,0,90,59
1713317477240,MGT 164,A00,492222,McKay; Mary A,93,0,98,5
1713317478264,MGT 172,A00,492245,Staff,59,0,60,1
1713317478264,MGT 172,B00,505526,Hedges; Kathleen,73,0,98,25
1713317479289,MGT 181,A00,505669,Dunn; Louis Jean,84,0,98,14
1713317480317,MMW 14,A01,494399,Staff,23,0,28,5
1713317480317,MMW 14,A02,494400,Staff,25,0,28,3
1713317480317,MMW 14,A03,494401,Staff,28,0,28,0
1713317480317,MMW 14,A04,494402,Staff,28,0,28,0
1713317480317,MMW 14,B01,494404,Carreras; Maria Victoria,13,0,28,15
1713317480317,MMW 14,B02,494405,Carreras; Maria Victoria,26,0,28,2
1713317480317,MMW 14,B03,494406,Carreras; Maria Victoria,28,0,28,0
1713317480317,MMW 14,B04,494407,Carreras; Maria Victoria,28,0,28,0
1713317481343,MMW 14GS,A00,506250,Chang; Edmond Yi-Teh,0,0,0,0
1713317482368,MMW 121R,A01,494415,Adamiak; Patrick John,13,0,28,15
1713317482368,MMW 121R,A02,494416,Adamiak; Patrick John,24,0,28,4
1713317483397,MUS 1A,A01,494113,Staff,12,0,25,13
1713317483397,MUS 1A,A02,494114,Staff,25,0,25,0
1713317484422,MUS 4,A01,494116,Staff,24,0,25,1
1713317484422,MUS 4,A02,494117,Staff,22,0,25,3
1713317485454,MUS 5R,A01,494236,Dubnov; Shlomo,10,0,25,15
1713317485454,MUS 5R,A02,494237,Dubnov; Shlomo,25,0,25,0
1713317486481,MUS 6,A01,494122,Staff,12,0,25,13
1713317486481,MUS 6,A02,494123,Staff,24,0,25,1
1713317487511,MUS 7,A01,494125,Staff,16,0,25,9
1713317487511,MUS 7,A02,494126,Staff,24,0,25,1
1713317488541,MUS 11,A01,494128,Staff,23,0,25,2
1713317488541,MUS 11,A02,494129,Staff,24,0,25,1
1713317489565,MUS 13,A01,494131,Staff,25,0,25,0
1713317489565,MUS 13,A02,494132,Staff,25,0,25,0
1713317490594,MUS 15,A01,494134,Staff,17,0,25,8
1713317490594,MUS 15,A02,494135,Staff,25,0,25,0
1713317490594,MUS 15,B01,494137,Staff,24,0,25,1
1713317491621,MUS 80,A00,494232,Staff,24,0,25,1
1713317491621,MUS 80,B00,494233,Staff,25,0,25,0
1713317491621,MUS 80,C00,494234,Staff,23,0,25,2
1713317492649,MUS 95C,A00,494141,Staff,72,0,75,3
1713317493674,MUS 114,A00,494142,Staff,41,0,50,9
1713317494701,NANO 15,A01,490636,Drews; Aaron,7,0,7,0
1713317495728,PHIL 1,A00,490578,Grush; Rick Scott,49,0,50,1
1713317496754,PHIL 10,A01,490580,Grush; Rick Scott,33,0,35,2
1713317496754,PHIL 10,A02,490586,Grush; Rick Scott,33,0,35,2
1713317497781,PHIL 27,A01,490591,Staff,23,0,25,2
1713317497781,PHIL 27,A02,490592,Staff,25,0,25,0
1713317497781,PHIL 27,A03,490593,Staff,25,0,25,0
1713317497781,PHIL 27,A04,490598,Staff,25,0,25,0
1713317498808,PHIL 32,A01,490611,Staff,20,0,20,0
1713317498808,PHIL 32,A02,490618,Staff,20,0,20,0
1713317499833,PHIL 90,A00,490624,Staff,40,0,40,0
1713317500863,PHIL 136,A00,490627,Cohen; Jonathan David,38,0,40,2
1713317501891,PHIL 155,A00,490634,Staff,63,0,70,7
1713317502918,PHYS 1A,A00,491610,Staff,246,0,250,4
1713317503944,PHYS 1AL,001,491616,Tsai; Philbert S,28,0,30,2
1713317503944,PHYS 1AL,002,491618,Tsai; Philbert S,30,0,30,0
1713317504970,PHYS 1B,A00,491623,Staff,243,0,250,7
1713317505995,PHYS 1BL,001,491626,Tsai; Philbert S,25,0,30,5
1713317505995,PHYS 1BL,002,491628,Tsai; Philbert S,27,0,30,3
1713317507025,PHYS 1C,A00,491632,Staff,220,0,245,25
1713317508054,PHYS 1CL,001,491635,Tsai; Philbert S,10,0,30,20
1713317508054,PHYS 1CL,002,491643,Tsai; Philbert S,24,0,30,6
1713317509079,PHYS 2AR,A01,491651,Meyertholen; Andrew D.,44,0,50,6
1713317510106,PHYS 2B,A01,491659,Staff,106,0,115,9
1713317511132,PHYS 2BL,A01,491685,Staff,21,0,24,3
1713317511132,PHYS 2BL,A02,491700,Staff,23,0,24,1
1713317512157,PHYS 2C,A01,505161,Staff,106,0,115,9
1713317513187,PHYS 4A,A01,491704,Grinstein; Benjamin,99,0,100,1
1713317514218,POLI 5D,A01,494144,Staff,3,0,5,2
1713317514218,POLI 5D,B01,626283,Dai; Yinlin,5,0,5,0
1713317515245,POLI 12,A00,494145,Staff,44,0,45,1
1713317516330,POLI 13R,A00,494146,Forman; Fonna,45,0,50,5
1713317517354,POLI 27,A01,494148,Staff,57,0,60,3
1713317518384,POLI 30,A00,494149,Staff,49,0,50,1
1713317519413,POLI 100DA,A00,494150,Staff,21,0,25,4
1713317521466,POLI 100I,A00,494152,Staff,28,0,30,2
1713317522500,POLI 104B,A00,494153,Smith; Glenn Chatmas,54,0,55,1
1713317523524,POLI 104F,A00,494154,Staff,28,0,30,2
1713317524552,POLI 104I,A00,494155,Smith; Glenn Chatmas,30,0,30,0
1713317525579,POLI 110C,A00,494156,Ingham; Sean,23,0,25,2
1713317526605,POLI 117R,A00,494157,Forman; Fonna,9,0,20,11
1713317527631,POLI 118,A00,494158,Ingham; Sean,22,0,25,3
1713317528656,POLI 120H,A00,494159,Fisk; David Lee,41,0,45,4
1713317529682,POLI 131CR,A00,494160,Hoston; Germaine,36,0,45,9
1713317530707,POLI 133J,A00,494161,Staff,33,0,35,2
1713317531732,POLI 135,A00,494162,Fisk; David Lee,33,0,35,2
1713317532761,POLI 140A,A00,494164,Staff,21,0,30,9
1713317533787,POLI 142I,A00,494165,Staff,30,0,30,0
1713317534811,POLI 144D,A00,494166,Staff,23,0,25,2
1713317535835,POLI 151,A00,494167,Staff,30,0,30,0
1713317536861,POLI 153,A00,494168,Staff,33,0,35,2
1713317537886,POLI 160AA,A00,494169,Staff,35,0,40,5
1713317538913,POLI 162,A00,494170,Mignozzetti; Umberto,20,0,25,5
1713317539941,POLI 171,A00,494171,Mignozzetti; Umberto,21,0,25,4
1713317540967,PSYC 1,A00,494172,Staff,97,0,100,3
1713317541992,PSYC 2,A00,494173,Moranton; Nirelia Melbina-,42,0,50,8
1713317543017,PSYC 3,A00,494174,Staff,29,0,30,1
1713317544042,PSYC 6,A00,494175,Staff,17,0,20,3
1713317545067,PSYC 60,A01,494177,Staff,39,0,45,6
1713317546091,PSYC 70,A01,505724,Geller; Emma Harlan,42,0,45,3
1713317547120,PSYC 101,A00,494180,Heyman; Gail D.,87,0,100,13
1713317548151,PSYC 105,A00,494181,Geller; Emma Harlan,59,0,90,31
1713317549176,PSYC 106,A00,494182,Dobkins; Karen R.,29,0,45,16
1713317550204,PSYC 108,A00,494183,Adrian; Julia Anna,91,0,100,9
1713317551236,PSYC 114,A01,494185,Winkielman; Piotr,0,0,30,30
1713317552262,PSYC 122,A00,494186,Moranton; Nirelia Melbina-,34,0,50,16
1713317553287,PSYC 124,A00,494187,Chapman; Eddie Nathaniel,72,0,80,8
1713317554312,PSYC 131,A00,494188,Anagnostaras; Stephan,52,0,80,28
1713317555337,PSYC 144,A00,494189,Staff,13,0,50,37
1713317556365,PSYC 154,A00,494190,Lacefield; Katharine I,127,0,180,53
1713317557393,PSYC 162,A00,494191,Wixted; John T,77,0,100,23
1713317558419,PSYC 172,A00,494192,Gorman; Michael R.,37,0,45,8
1713317559448,PSYC 178,A00,494193,Glaser; Dale,39,0,45,6
1713317560474,PSYC 193,A00,505725,Chapman; Eddie Nathaniel,20,0,20,0
1713317561502,RELI 145GS,A00,519817,Rahimi; Babak,18,0,20,2
1713317562531,SE 101A,A01,490862,Chadha; Mayank,23,0,25,2
1713317563560,SE 101C,A01,490924,Krysl; Petr,17,0,20,3
1713317564586,SE 110A,A01,490928,Staff,19,0,20,1
1713317565612,SE 130A,A00,490929,Morrison; Machel Leigh,59,0,70,11
1713317566638,SIO 1,A01,519325,Staff,39,0,40,1
1713317567667,SIO 30,A01,519327,Staff,39,0,40,1
1713317568694,SIO 40,A00,519328,Staff,40,0,40,0
1713317569720,SIO 46GS,A00,519819,Cook; Geoffrey W,18,0,25,7
1713317570744,SIO 109R,A00,494197,Forman; Fonna,4,0,20,16
1713317571772,SIO 121GS,A00,519827,Cook; Geoffrey W,18,0,25,7
1713317572840,SIO 132,A01,519330,Staff,38,0,40,2
1713317573865,SIO 133,A01,519397,Staff,37,0,40,3
1713317574892,SIO 139,A00,519396,Kacev; David,31,0,40,9
1713317575919,SOCI 1,A01,494199,Thorpe; Charles Robert,23,0,30,7
1713317575919,SOCI 1,A02,494200,Thorpe; Charles Robert,30,0,30,0
1713317575919,SOCI 1,A03,494201,Thorpe; Charles Robert,29,0,30,1
1713317575919,SOCI 1,A04,494202,Thorpe; Charles Robert,29,0,30,1
1713317575919,SOCI 1,A05,494203,Thorpe; Charles Robert,29,0,30,1
1713317575919,SOCI 1,A06,494204,Thorpe; Charles Robert,30,0,30,0
1713317575919,SOCI 1,A07,494205,Thorpe; Charles Robert,29,0,30,1
1713317576945,SOCI 60,A01,494207,Staff,35,0,40,5
1713317576945,SOCI 60,A02,494208,Staff,39,0,40,1
1713317577970,SOCI 100,A01,494210,Payne; Christine Anna,27,0,30,3
1713317577970,SOCI 100,A02,494211,Payne; Christine Anna,27,0,30,3
1713317578995,SOCI 109M,A00,494212,Staff,20,0,20,0
1713317580025,SOCI 110,A00,494213,Staff,35,0,40,5
1713317582075,SOCI 118E,A00,494215,Ng; Kwai,38,0,40,2
1713317583109,SOCI 125,A00,494216,Calderon-Zaks; Michael Aar,42,0,45,3
1713317584139,SOCI 126,A01,494218,Jones; Makeba,3,0,5,2
1713317585163,SOCI 131,A00,494219,Thorpe; Charles Robert,28,0,30,2
1713317587213,SOCI 135,A00,494221,Payne; Christine Anna,34,0,50,16
1713317588245,SOCI 136E,A00,626690,Ruiz; Jonathan Joseph,25,0,25,0
1713317589274,SOCI 138GS,A00,494222,Navon; Daniel,24,0,28,4
1713317591323,SOCI 145,A00,494224,Staff,42,0,45,3
1713317592347,SOCI 153,A00,494225,Staff,28,0,30,2
1713317593373,SOCI 160E,A00,494226,Ng; Kwai,32,0,40,8
1713317594397,SOCI 180,A00,494227,Staff,29,0,30,1
1713317595423,SOCI 189GS,A00,494228,Ribas Norris; Janet Vanesa,11,0,11,0
1713317596447,SOCI 190GS,A00,553232,Ribas Norris; Janet Vanesa,11,0,11,0
1713317597476,SOMI 220,A00,627178,Schneid; Stephen David,30,0,30,0
1713317598508,SYN 2,001,490768,Staff,14,0,15,1
1713317598508,SYN 2,002,490769,Staff,15,0,15,0
1713317598508,SYN 2,004,490775,Staff,0,0,0,0
1713317598508,SYN 2,003,490774,Staff,0,0,0,0
1713317598508,SYN 2,005,490776,Staff,0,0,0,0
1713317599534,SYN 2R,001,490779,Staff,12,0,15,3
1713317599534,SYN 2R,002,514635,Staff,14,0,15,1
1713317600560,SYN 100,A01,490783,Staff,15,0,20,5
1713317600560,SYN 100,B01,490787,Staff,10,0,20,10
1713317600560,SYN 100,C01,490789,Staff,12,0,20,8
1713317601589,SYN 150,A00,490817,Staff,14,0,15,1
1713317601589,SYN 150,B00,514610,Staff,15,0,15,0
1713317602617,TDAC 1,A00,492753,Walsh; Kim C.,19,0,20,1
1713317602617,TDAC 1,B00,492754,Harting; Carla Kelso,19,0,20,1
1713317602617,TDAC 1,C00,513995,Salovey; Todd,16,0,20,4
1713317603645,TDAC 101,A00,492766,Harting; Carla Kelso,17,0,20,3
1713317604670,TDAC 102,A00,492768,Basso; Beatrice,19,0,20,1
1713317605695,TDDE 111,A00,492769,Staff,25,0,25,0
1713317606725,TDDE 131,A00,492770,Staff,15,0,15,0
1713317606725,TDDE 131,B00,492771,Staff,15,0,15,0
1713317607751,TDDE 131GS,A00,523716,Guirguis; Mark C,24,0,28,4
1713317608776,TDGE 1,A01,492756,Salovey; Todd,57,0,60,3
1713317609806,TDGE 5,A01,492758,Staff,24,0,25,1
1713317610832,TDGE 10,A00,492759,Fulton; Julia,208,0,220,12
1713317611858,TDGE 11,A00,492760,Castro; Robert Jess,199,0,200,1
1713317613913,TDGE 124,A00,492772,Fulton; Julia,192,0,220,28
1713317614944,TDGE 125,A00,492773,Meyer; Ursula,40,0,50,10
1713317614944,TDGE 125,B00,492774,Staff,49,0,50,1
1713317614944,TDGE 125,C00,523565,Staff,48,0,50,2
1713317615969,TDGE 125GS,A00,523580,Guirguis; Mark C,24,0,28,4
1713317616999,TDGE 127,A00,492775,Havis; Allan,40,0,50,10
1713317618027,TDHT 101,A00,492776,Staff,35,0,35,0
1713317619055,TDMV 1,A00,492762,Caligagan; Maria T.,30,0,30,0
1713317619055,TDMV 1,B00,492763,Arcidiacono; Kristin,25,0,30,5
1713317620140,TDMV 2,A00,492764,Weinberg; Sadie,29,0,30,1
1713317621167,TDMV 3,A00,492765,Mack; Kara Shanai',39,0,40,1
1713317622194,TDMV 138,A00,492777,Mack; Kara Shanai',35,0,40,5
1713317623220,TDMV 140,A00,492778,Lima; Paulo Henrique,40,0,40,0
1713317624247,TDMV 142,A00,492779,Caligagan; Maria T.,36,0,40,4
1713317624247,TDMV 142,B00,492780,Caligagan; Tony,37,0,40,3
1713317625275,TDMV 143,A00,492781,Fyall; Daunte Edward,39,0,40,1
1713317626303,USP 1,A01,492401,Kwak; Nancy,26,0,35,9
1713317627329,USP 2,A01,492453,Hinds; Juli Beth,35,0,35,0
1713317628364,USP 3,A01,492516,Staff,29,0,35,6
1713317629390,USP 4,A00,492522,McTague; Sarah,19,0,25,6
1713317630414,USP 100,A00,492523,Staff,33,0,35,2
1713317631438,USP 101,A00,492524,Staff,13,0,15,2
1713317632466,USP 105,A00,492525,Staff,21,0,25,4
1713317633696,USP 151,A00,492526,Shenkman; Michael Thomas,33,0,35,2
1713317634722,USP 170,A00,492545,Hinds; Juli Beth,33,0,35,2
1713317635750,USP 171GS,A00,492608,Bussell; Mirle Rabinowitz,24,0,28,4
1713317636776,USP 183GS,A00,492613,Peerson; Susan,24,0,28,4
1713317637804,VIS 30,A01,490693,Yoldas; Pinar,20,0,22,2
1713317637804,VIS 30,A02,490694,Yoldas; Pinar,18,0,22,4
1713317638830,VIS 83,A00,490695,Kester; Grant,65,0,75,10
1713317639856,VIS 105D,A00,490696,Staff,22,0,25,3
1713317640888,VIS 124CN,A00,490699,Rose; Jordan M,68,0,75,7
1713317641919,VIS 125GS,A00,511221,Williams; Alena J,21,0,22,1
1713317642944,VIS 128D,A00,490700,Staff,74,0,75,1
1713317643969,VIS 151,A01,490717,Staff,33,0,34,1
1713317643969,VIS 151,A02,490766,Staff,33,0,34,1
1713317644999,VIS 154GS,A00,511972,Williams; Alena J,21,0,22,1
1713317646025,VIS 160A,A00,490767,Stone; Patricia,7,0,10,3
1713317647054,WCWP 10A,A00,490638,Staff,14,0,15,1
1713317647054,WCWP 10A,B00,490640,Staff,15,0,15,0
1713317648082,WCWP 10B,A00,490641,Staff,0,0,0,0
1713317648082,WCWP 10B,B00,490642,Staff,14,0,15,1
1713317648082,WCWP 10B,C00,490644,Staff,13,0,15,2
1713317648082,WCWP 10B,D00,490647,Staff,0,0,0,0
1713317649110,WCWP 100,A00,490655,Staff,0,0,0,0
1713317649110,WCWP 100,B00,490687,Staff,11,0,15,4
1713317651238,ANAR 153,A00,487222,Braswell; Geoffrey E.,54,0,60,6
1713317652264,ANBI 134,A00,487223,Staff,8,0,20,12
1713317653288,ANBI 143GS,A00,487224,Noel; Geoffroy Pierre Jean,20,0,24,4
1713317654316,ANBI 144GS,A00,519548,Noel; Geoffroy Pierre Jean,20,0,24,4
1713317655342,ANSC 101,A00,487225,Staff,19,0,20,1
1713317656368,ANSC 125,A00,487227,Brenner; Suzanne A,39,0,40,1
1713317658419,ANSC 146,A00,487229,Staff,36,0,40,4
1713317659451,ANSC 148,A00,487230,Olivas Hernandez; Olga Lid,39,0,40,1
1713317660478,ANSC 150,A00,504165,Sloane; Julia Kathryn,19,0,20,1
1713317661503,ANSC 180,A00,487232,Staff,13,0,15,2
1713317662527,ANSC 188,A00,627155,Staff,39,0,40,1
1713317663552,ANTH 5,A00,519529,Semendeferi; Ekaterini,15,0,15,0
1713317664578,ANTH 10,A00,487219,Staff,58,0,60,2
1713317665604,ANTH 23,A01,487221,Staff,17,0,20,3
1713317666630,ANTH 102,A00,487233,Wilder; Linnea Lorene,51,0,60,9
1713317667660,ANTH 103,A00,487234,Varma; Saiba,56,0,60,4
1713317668686,ANTH 105,A00,487235,Stewart; Alexander B,55,0,60,5
1713317669718,BENG 100,A01,516685,Taylor Amos; Alyssa C,28,0,30,2
1713317670747,BIBC 102,A01,491316,Flagg; Matthew Paul,30,0,88,58
1713317670747,BIBC 102,A02,491366,Flagg; Matthew Paul,83,0,88,5
1713317671773,BIBC 103,A01,491486,Boumechache; Miyyada,16,0,24,8
1713317671773,BIBC 103,A02,491487,Boumechache; Miyyada,24,0,24,0
1713317672806,BICD 100,A01,516882,Staff,75,0,75,0
1713317672806,BICD 100,A02,516890,Staff,69,0,75,6
1713317673831,BICD 102GS,A00,491488,Lo; Stanley M.,26,0,28,2
1713317674861,BIEB 136GS,A00,516940,Holway; David A. & Shurin; Jonathan,19,0,24,5
1713317675887,BIEB 137GS,A01,517034,Holway; David A. & Shurin; Jonathan,19,0,24,5
1713317676912,BIEB 138GS,A01,491492,Pirino; Giorgia,21,0,28,7
1713317677942,BILD 1,A01,491296,Staff,62,0,63,1
1713317677942,BILD 1,A02,491297,Staff,63,0,63,0
1713317679016,BILD 4,A01,517099,Gonzalez Gamboa; Ivonne,22,0,24,2
1713317679016,BILD 4,A02,517100,Gonzalez Gamboa; Ivonne,24,0,24,0
1713317680040,BILD 60GS,A00,491309,Lo; Stanley M.,26,0,28,2
1713317681069,BIMM 100,A01,517136,Staff,87,0,100,13
1713317682096,BIMM 110,A01,517182,Staff,66,0,100,34
1713317683122,BIMM 120,A01,517228,Pickett; Brooke Elizabeth,35,0,63,28
1713317683122,BIMM 120,A02,517240,Pickett; Brooke Elizabeth,48,0,63,15
1713317684152,BIMM 132GS,A01,491498,Pirino; Giorgia,21,0,28,7
1713317685176,BIMM 143,A01,491589,Bozinovic; Goran,16,0,40,24
1713317686203,BIPN 100,A01,491594,Armour; Jon Christopher,90,0,100,10
1713317687232,BIPN 140,A01,491602,Marino; Marc J,28,0,50,22
1713317689285,CAT 125,A00,515973,Staff,19,0,20,1
1713317690312,CAT 125GS,A00,515974,Rahimi; Babak,18,0,20,2
1713317691338,CAT 125R,A00,515980,Staff,14,0,20,6
1713317691338,CAT 125R,B00,515981,Tosun; Adriana,19,0,20,1
1713317691338,CAT 125R,C00,515987,Hyland; Tina Mae,0,0,20,20
1713317691338,CAT 125R,D00,515988,Bronstein; Phoebe Malan,18,0,20,2
1713317692369,CENG 15,A01,488699,Drews; Aaron,25,0,25,0
1713317693404,CENG 100,A00,505196,Opatkiewicz; Justin Paul,25,0,25,0
1713317694433,CGS 2A,A01,489598,Staff,33,0,35,2
1713317695458,CGS 112,A00,489599,Staff,15,0,15,0
1713317696484,CGS 119,A00,489603,Staff,10,0,10,0
1713317697512,CGS 120,A00,489604,Staff,14,0,15,1
1713317698538,CGS 150,A00,489607,Staff,15,0,15,0
1713317699568,CHEM 6A,A01,488715,Staff,98,0,100,2
1713317700594,CHEM 6B,A01,488719,Piercy; Marc Anthony,100,0,100,0
1713317701622,CHEM 6C,A01,488723,Albizati; Kim F.,94,0,100,6
1713317702655,CHEM 7L,A01,488728,Schurmeier; Kimberly,18,0,24,6
1713317702655,CHEM 7L,A02,488730,Schurmeier; Kimberly,23,0,24,1
1713317702655,CHEM 7L,A03,488734,Schurmeier; Kimberly,23,0,24,1
1713317702655,CHEM 7L,A04,488763,Schurmeier; Kimberly,23,0,24,1
1713317702655,CHEM 7L,B01,488798,Schurmeier; Kimberly,17,0,24,7
1713317702655,CHEM 7L,B02,488801,Schurmeier; Kimberly,23,0,24,1
1713317702655,CHEM 7L,B03,488808,Schurmeier; Kimberly,24,0,24,0
1713317702655,CHEM 7L,B04,488811,Schurmeier; Kimberly,24,0,24,0
1713317703681,CHEM 11,A01,488897,Stallings; Dontarie M,97,0,100,3
1713317704707,CHEM 40A,A01,488913,Albizati; Kim F.,88,0,100,12
1713317705736,CHEM 40B,A01,488920,Weizman; Haim,45,0,50,5
1713317705736,CHEM 40B,A02,488938,Weizman; Haim,46,0,50,4
1713317706767,CHEM 41A,A01,489029,Klosterman; Jeremy K,58,0,60,2
1713317707793,CHEM 41C,A01,500436,Tor; Yitzhak,55,0,60,5
1713317708819,CHEM 43A,A01,500426,Weizman; Haim,1,0,24,23
1713317708819,CHEM 43A,A02,500430,Weizman; Haim,13,0,24,11
1713317708819,CHEM 43A,B01,514041,Klosterman; Jeremy K,15,0,24,9
1713317708819,CHEM 43A,B02,514047,Klosterman; Jeremy K,23,0,24,1
1713317709850,CHEM 108,A01,489140,Jennings; Patricia A.,11,0,24,13
1713317709850,CHEM 108,A02,489142,Jennings; Patricia A.,14,0,24,10
1713317710876,CHEM 114A,A01,489147,Stallings; Dontarie M,77,0,100,23
1713317711905,CHIN 169A,A00,489171,Wang; Xiao,19,0,20,1
1713317713963,COGS 3,A01,518827,Boyle; Mary E. T.,29,0,40,11
1713317714988,COGS 11,A01,489175,Staff,28,0,30,2
1713317716014,COGS 14A,A01,518829,Staff,51,0,60,9
1713317717043,COGS 14B,A01,489177,Hoffman; Drew Ellen,66,0,75,9
1713317718075,COGS 100,A01,489181,Allen; Michael Gordon,65,0,75,10
1713317719100,COGS 101A,A01,489183,Staff,48,0,60,12
1713317720127,COGS 101B,A01,489185,Allen; Michael Gordon,9,0,30,21
1713317721154,COGS 101C,A01,526786,Staff,24,0,30,6
1713317723204,COGS 107A,A01,489189,Boyle; Mary E. T.,19,0,35,16
1713317724283,COGS 107B,A01,627144,Mooshagian; Eric Frederick,60,0,60,0
1713317725309,COGS 118A,A01,489191,Staff,0,40,40,40
1713317727362,COGS 171GS,A01,489194,Pineda; Jaime A,21,0,28,7
1713317728391,COGS 172,A01,489196,Staff,3,0,30,27
1713317729622,COGS 174GS,A01,489264,Pineda; Jaime A,21,0,28,7
1713317730652,COGS 180,A01,627150,Staff,28,0,30,2
1713317731679,COGS 186,A01,489274,Staff,0,0,30,30
1713317732705,COMM 10,A01,489276,Staff,23,0,25,2
1713317732705,COMM 10,A02,489303,Staff,23,0,25,2
1713317733733,COMM 100A,A01,489312,Staff,16,0,25,9
1713317733733,COMM 100A,A02,489313,Staff,24,0,25,1
1713317734758,COMM 106T,A00,512540,Staff,34,0,35,1
1713317735784,COMM 107,A00,489347,Staff,31,0,35,4
1713317736809,COMM 109P,A00,489358,Staff,31,0,35,4
1713317737836,COMM 132,A00,489361,McKenna; Denise,28,0,30,2
1713317738865,COMM 146,A00,489362,Halm; Gavin Patrick,27,0,30,3
1713317739891,COMM 190,A00,489363,Abuelhiga; Soraya Jill,20,0,23,3
1713317740917,CSE 8A,A50,489366,Staff,22,0,25,3
1713317740917,CSE 8A,A51,489367,Staff,24,0,25,1
1713317741944,CSE 11,A01,489398,Cao; Yingjun,79,0,100,21
1713317742971,CSE 12,A01,489487,Staff,43,0,50,7
1713317743997,CSE 20,A01,489497,Staff,48,0,50,2
1713317745025,CSE 21,A01,489517,Braun; Oliver,43,0,50,7
1713317746050,CSE 101,A01,489524,Braun; Oliver,0,21,50,50
1713317747075,CSE 105,A01,512594,Jones; Miles E,78,0,100,22
1713317747075,CSE 105,B01,512598,Jones; Miles E,57,0,100,43
1713317748100,CSE 140,A01,489538,Staff,44,0,50,6
1713317749130,CSE 141,A01,489550,Eldon; John,74,0,100,26
1713317750158,CSE 141L,A01,489571,Eldon; John,72,0,100,28
1713317751183,CSE 151A,A01,489583,Solares; Edwin A,147,0,200,53
1713317752213,CSE 175,A01,510886,Kumar; Rakesh,30,0,30,0
1713317753237,CSE 190,A00,516828,Dubnov; Shlomo,38,0,49,11
1713317754262,DOC 100D,A00,489667,Pass; Natalye Joann,20,0,25,5
1713317755287,DSC 10,A01,624268,Staff,72,0,75,3
1713317756311,DSC 20,A01,624476,Staff,50,0,50,0
1713317757339,DSC 40A,A01,624608,Staff,39,0,40,1
1713317758365,DSGN 1,A01,489179,Rill; Bryan,36,0,50,14
1713317759393,ECE 17,A01,490489,Sahay; Rajeev,18,0,30,12
1713317760419,ECE 65,A50,490492,Staff,15,0,20,5
1713317760419,ECE 65,A51,490493,Staff,20,0,20,0
1713317761445,ECON 1,A01,489715,Famulari; Melissa,68,0,70,2
1713317762471,ECON 2,A01,489717,Levkoff; Steven B.,68,0,70,2
1713317763497,ECON 3,A01,489948,Staff,70,0,70,0
1713317765556,ECON 5,A01,490103,Staff,28,0,30,2
1713317765556,ECON 5,B01,626281,Dai; Yinlin,45,0,45,0
1713317766582,ECON 100A,A01,490127,Famulari; Melissa,66,0,70,4
1713317767613,ECON 100B,A01,490129,Staff,64,0,70,6
1713317768643,ECON 109,A01,490187,Shishkin; Denis,27,0,35,8
1713317769668,ECON 110A,A01,490190,Levkoff; Steven B.,61,0,70,9
1713317770703,ECON 120A,A01,490245,Dai; Yinlin,63,0,70,7
1713317771733,ECON 120B,A01,490247,Nieto-Barthaburu; Augusto,52,0,70,18
1713317772761,ECON 120C,A01,490253,Sun; Yixiao,30,0,35,5
1713317772761,ECON 120C,B01,490255,Sun; Yixiao,34,0,35,1
1713317773790,ECON 129,A00,490256,Eckert; Fabian Paul,24,0,35,11
1713317774820,ECON 131,A00,490257,Nieto-Barthaburu; Augusto,0,4,35,35
1713317775845,ECON 138,A00,490258,Bharadwaj; Prashant,18,0,35,17
1713317775845,ECON 138,B00,490259,Bharadwaj; Prashant,17,0,35,18
1713317776870,ECON 159,A00,490260,Hendrickson; Gerald M.,0,8,0,0
1713317777898,ECON 178,A01,553995,Zhu; Ying,24,0,35,11
1713317778924,EDS 40,A01,512576,Black; Alison Michelle,20,0,20,0
1713317779952,EDS 107,A01,515848,Staff,30,0,30,0
1713317780977,EDS 110R,A01,490262,Staff,26,0,30,4
1713317782003,EDS 112,A01,490264,Chapman; Thandeka K,42,0,50,8
1713317783029,EDS 113,A00,490266,Staff,26,0,30,4
1713317784055,EDS 118,A00,490267,Warstadt; Melissa Fawn,22,0,30,8
1713317785079,EDS 124BR,A00,490268,Eguchi; Emi,6,0,25,19
1713317785079,EDS 124BR,B00,490269,Eguchi; Emi,25,0,25,0
1713317786108,EDS 126,A01,490271,Jones; Makeba,44,0,50,6
1713317787265,EDS 135,A01,490316,Staff,19,0,20,1
1713317788290,ENVR 142GS,A00,519514,Chang; Edmond Yi-Teh,28,0,28,0
1713317789319,ETHN 103,A00,490504,Staff,31,0,36,5
1713317790349,ETHN 103A,A00,490505,Man; Simeon S,5,0,9,4
1713317791374,ETHN 109,A00,490506,Staff,30,0,30,0
1713317792401,ETHN 118,A00,490507,Staff,35,0,36,1
1713317793425,ETHN 119,A00,490508,Staff,34,0,36,2
1713317794452,ETHN 121R,A00,490518,Choi; Esther Min,25,0,36,11
1713317795478,ETHN 127,A00,490528,Staff,15,0,15,0
1713317796507,ETHN 139,A00,490573,Staff,10,0,10,0
1713317797533,ETHN 150,A00,490575,Staff,15,0,15,0
1713317798560,GLBH 20,A00,491705,Elwardani; Nile Regina,38,0,40,2
1713317799594,GLBH 101,A00,491706,Staff,20,0,20,0
1713317800621,GLBH 111,A01,491708,Burgos; Jose L.,15,0,15,0
1713317801648,GLBH 146,A00,491709,Staff,11,0,20,9
1713317802672,GLBH 148,A00,491710,Olivas Hernandez; Olga Lid,14,0,20,6
1713317803700,GLBH 150,A00,491711,Sloane; Julia Kathryn,20,0,20,0
1713317804726,HIEA 131,A00,491760,Staff,29,0,32,3
1713317805754,HIEA 153,A00,491762,Staff,29,0,30,1
1713317806783,HIEU 124,A00,491811,Staff,26,0,32,6
1713317807810,HIEU 124GS,A00,491812,Markman; Kristina,27,0,28,1
1713317808835,HIEU 147,A00,491813,Staff,30,0,32,2
1713317809864,HIEU 149GS,A00,491816,Caldwell; Michael Alan,28,0,28,0
1713317810891,HILD 2C,A01,491713,Hendrickson; Gerald M.,27,0,30,3
1713317811919,HILD 7B,A01,491715,Kwak; Nancy,5,0,30,25
1713317812942,HILD 10,A01,491717,Staff,13,0,20,7
1713317813969,HILD 30GS,A00,491719,Edington; Claire Ellen,24,0,28,4
1713317814997,HINE 109,A00,491818,Shafir; Nir,27,0,32,5
1713317816027,HINE 128,A00,491821,Shafir; Nir,31,0,32,1
1713317817055,HISC 117,A00,491830,Staff,29,0,32,3
1713317818081,HIUS 103,A00,491834,Man; Simeon S,15,0,23,8
1713317819105,HIUS 108B,A00,491835,Staff,29,0,30,1
1713317820132,HIUS 141,A00,491836,Hendrickson; Gerald M.,29,0,32,3
1713317821160,HIUS 149,A00,491839,Staff,27,0,32,5
1713317822189,HUM 3,A01,512617,Crum; Matthew Stephen,45,0,50,5
1713317822189,HUM 3,A02,512618,Crum; Matthew Stephen,48,0,50,2
1713317823218,HUM 3GS,A00,512663,Markman; Kristina,0,0,0,1
1713317823218,HUM 3GS,B00,512664,Staff,0,0,0,0
1713317824243,HUM 4,A01,512620,West; Geoffrey Scott,30,0,50,20
1713317825267,HUM 4GS,A00,512666,Lyon; Antony J.,0,0,0,3
1713317826296,HUM 4R,A01,512625,Watkins; Eric,49,0,50,1
1713317827321,HUM 5,A01,512649,Zavodny; Tatiana Sophia,29,0,50,21
1713317827321,HUM 5,B01,512661,Zroka; Ryan Edward,48,0,50,2
1713317828403,INTL 190,A00,490577,Segui; Alan S,0,0,0,5
1713317829429,JAPN 20AR,A01,491267,Ross; Kayoko F,9,0,20,11
1713317830454,JAPN 180,A00,491285,Berman; Michael David,34,0,40,6
1713317831482,LATI 50,A01,502536,Kokinis; Troy Andreas,16,0,22,6
1713317831482,LATI 50,A02,502551,Kokinis; Troy Andreas,22,0,22,0
1713317831482,LATI 50,A03,502650,Kokinis; Troy Andreas,22,0,22,0
1713317831482,LATI 50,A04,502909,Kokinis; Troy Andreas,22,0,22,0
1713317832506,LATI 160,A01,502920,Kokinis; Troy Andreas,30,0,30,0
1713317833535,LIFR 1A,A00,490494,Van Moer; Vinciane G,17,0,20,3
1713317834560,LIFR 1AX,A00,490495,Van Moer; Vinciane G,17,0,20,3
1713317835588,LIFR 1B,A00,490496,Van Moer; Vinciane G,18,0,20,2
1713317836617,LIFR 1BX,A00,490497,Van Moer; Vinciane G,18,0,20,2
1713317837646,LIGN 8,A00,505198,McIntosh; Justin Daniel,136,0,150,14
1713317838670,LIGN 9GS,A00,491239,Lott; Margaret S.,18,0,20,2
1713317839700,LIGN 101,A01,505200,McIntosh; Justin Daniel,24,0,30,6
1713317840728,LIGN 120,A01,491244,Staff,24,0,30,6
1713317841755,LIGN 149GS,A00,491245,Lott; Margaret S.,18,0,20,2
1713317842783,LIGN 170,A00,491247,Staff,24,0,30,6
1713317843808,LISP 1D,A00,490498,Munoz Sanchez; Alicia,10,0,14,4
1713317843808,LISP 1D,B00,490499,Munoz Sanchez; Alicia,6,0,14,8
1713317843808,LISP 1D,C00,490500,Munoz Sanchez; Alicia,8,0,14,6
1713317843808,LISP 1D,D00,490501,Munoz Sanchez; Alicia,10,0,14,4
1713317844833,LISP 1DX,A00,490502,Munoz Sanchez; Alicia,15,0,28,13
1713317844833,LISP 1DX,B00,490503,Munoz Sanchez; Alicia,17,0,28,11
1713317846890,LTAM 110,A00,491847,Staff,23,0,25,2
1713317847919,LTCS 119,A00,491848,Staff,11,0,15,4
1713317848947,LTCS 130,A00,491849,Staff,24,0,25,1
1713317850996,LTEA 120C,A00,491852,Staff,34,0,40,6
1713317852024,LTEN 130GS,A00,491853,Lyon; Antony J.,25,0,28,3
1713317853051,LTEN 148,A00,491855,Staff,23,0,25,2
1713317854076,LTEN 159,A00,491856,Staff,21,0,25,4
1713317855103,LTEN 180,A00,491857,Staff,8,0,15,7
1713317857152,LTSP 123GS,A00,505928,Bessett; Ryan Matthew,24,0,28,4
1713317858181,LTSP 174GS,A00,506037,Bessett; Ryan Matthew,24,0,28,4
1713317860234,LTWR 102,A00,491861,Staff,11,0,15,4
1713317861262,LTWR 106,A00,491862,Staff,10,0,15,5
1713317862292,MAE 11,A00,490930,Bahadori; Mohammad Yousef,96,0,100,4
1713317863319,MAE 30A,A00,490931,Qi; Huihui,37,0,40,3
1713317864350,MAE 101A,A00,491036,Sadeghizadeh; Zahra,96,0,100,4
1713317865374,MAE 101C,A00,491037,Seshadri; Kalyanasundaram,72,0,100,28
1713317866403,MAE 113,A00,491040,Seshadri; Kalyanasundaram,66,0,80,14
1713317867432,MAE 131A,A00,491041,Ghazinejad; Maziar,39,0,40,1
1713317868460,MAE 142,A00,491053,Staff,39,0,40,1
1713317869488,MAE 143A,A00,491054,Staff,35,0,50,15
1713317870516,MAE 150,A00,491092,Truong; Phuong Thi Ngoc,23,0,35,12
1713317871542,MATH 3C,A01,494031,Pardo Guerra; Sebastian,30,0,30,0
1713317871542,MATH 3C,A02,494032,Pardo Guerra; Sebastian,29,0,30,1
1713317872573,MATH 10A,A01,494034,Staff,27,0,30,3
1713317872573,MATH 10A,A02,494035,Staff,28,0,30,2
1713317872573,MATH 10A,B01,494037,Staff,27,0,30,3
1713317872573,MATH 10A,B02,494038,Staff,29,0,30,1
1713317873600,MATH 10B,A01,494040,Habib; Yousaf,23,0,30,7
1713317873600,MATH 10B,A02,494041,Habib; Yousaf,28,0,30,2
1713317873600,MATH 10B,A03,494042,Habib; Yousaf,30,0,30,0
1713317873600,MATH 10B,A04,494043,Habib; Yousaf,30,0,30,0
1713317873600,MATH 10B,B01,494045,Habib; Yousaf,27,0,30,3
1713317873600,MATH 10B,B02,494046,Habib; Yousaf,30,0,30,0
1713317873600,MATH 10B,B03,494047,Habib; Yousaf,30,0,30,0
1713317873600,MATH 10B,B04,494048,Habib; Yousaf,30,0,30,0
1713317874633,MATH 18,A01,494050,Kemp; Todd Aahron,25,0,30,5
1713317874633,MATH 18,A02,494051,Kemp; Todd Aahron,29,0,30,1
1713317874633,MATH 18,B01,494054,Kemp; Todd Aahron,28,0,30,2
1713317874633,MATH 18,B02,494055,Kemp; Todd Aahron,29,0,30,1
1713317875663,MATH 20A,A01,494059,Suk; Andrew Hoon,30,0,30,0
1713317876687,MATH 20B,A01,494061,Briones; Jor-el Thomas Caparas,33,0,35,2
1713317876687,MATH 20B,B01,494063,Bach; Quang Tran,34,0,35,1
1713317877719,MATH 20C,A01,494065,Staff,28,0,30,2
1713317877719,MATH 20C,A02,494066,Staff,30,0,30,0
1713317877719,MATH 20C,A03,494067,Staff,30,0,30,0
1713317877719,MATH 20C,A04,494068,Staff,30,0,30,0
1713317877719,MATH 20C,B01,494070,Zhang; Ming,26,0,30,4
1713317877719,MATH 20C,B02,494071,Zhang; Ming,28,0,30,2
1713317877719,MATH 20C,B03,494072,Zhang; Ming,29,0,30,1
1713317877719,MATH 20C,B04,494073,Zhang; Ming,29,0,30,1
1713317878745,MATH 20D,A01,494075,Staff,22,0,30,8
1713317878745,MATH 20D,A02,494076,Staff,30,0,30,0
1713317879770,MATH 20E,A01,494079,Staff,24,0,30,6
1713317879770,MATH 20E,A02,494080,Staff,26,0,30,4
1713317879770,MATH 20E,B01,494082,Staff,27,0,30,3
1713317879770,MATH 20E,B02,494083,Staff,25,0,30,5
1713317880800,MATH 103A,A01,494085,Aliabadi Sr.; Mohsen,14,0,30,16
1713317880800,MATH 103A,A02,494086,Aliabadi Sr.; Mohsen,28,0,30,2
1713317880800,MATH 103A,B01,494088,Aliabadi Sr.; Mohsen,22,0,30,8
1713317880800,MATH 103A,B02,494089,Aliabadi Sr.; Mohsen,28,0,30,2
1713317881827,MATH 109,A01,494091,Staff,30,0,30,0
1713317881827,MATH 109,A02,494092,Staff,29,0,30,1
1713317881827,MATH 109,B01,494094,Staff,28,0,30,2
1713317881827,MATH 109,B02,494095,Staff,29,0,30,1
1713317882860,MATH 142A,A01,494097,Chow; Bennett,16,0,30,14
1713317882860,MATH 142A,A02,494098,Chow; Bennett,24,0,30,6
1713317882860,MATH 142A,B01,494100,Chow; Bennett,19,0,30,11
1713317882860,MATH 142A,B02,494101,Chow; Bennett,29,0,30,1
1713317884917,MATH 168A,A01,516677,Dumitriu; Ioana,15,0,35,20
1713317885943,MATH 170A,A01,516679,Dumitriu; Ioana,20,0,30,10
1713317885943,MATH 170A,A02,516680,Dumitriu; Ioana,28,0,30,2
1713317886974,MATH 193A,A01,494107,Staff,15,0,30,15
1713317886974,MATH 193A,A02,494108,Staff,21,0,30,9
1713317886974,MATH 193A,A03,494109,Staff,29,0,30,1
1713317886974,MATH 193A,A04,494110,Staff,22,0,30,8
1713317890055,MGT 16,A00,491930,McKay; Michael J,92,0,98,6
1713317891079,MGT 18,A00,491992,McKay; Michael J,97,0,98,1
1713317892107,MGT 71,A00,492003,Staff,73,0,98,25
1713317893134,MGT 103,A00,505209,Eberhard; Craig A,84,0,98,14
1713317894162,MGT 131A,A00,505210,Anderson; John Charles,90,0,98,8
1713317896214,MGT 153,A00,492077,Perols; Johan Lars,29,0,90,61
1713317899297,MGT 164,A00,492222,McKay; Mary A,93,0,98,5
1713317900324,MGT 172,A00,492245,Staff,59,0,60,1
1713317900324,MGT 172,B00,505526,Hedges; Kathleen,72,0,98,26
1713317901347,MGT 181,A00,505669,Dunn; Louis Jean,84,0,98,14
1713317902381,MMW 14,A01,494399,Staff,22,0,28,6
1713317902381,MMW 14,A02,494400,Staff,25,0,28,3
1713317902381,MMW 14,A03,494401,Staff,28,0,28,0
1713317902381,MMW 14,A04,494402,Staff,28,0,28,0
1713317902381,MMW 14,B01,494404,Carreras; Maria Victoria,13,0,28,15
1713317902381,MMW 14,B02,494405,Carreras; Maria Victoria,26,0,28,2
1713317902381,MMW 14,B03,494406,Carreras; Maria Victoria,28,0,28,0
1713317902381,MMW 14,B04,494407,Carreras; Maria Victoria,28,0,28,0
1713317903406,MMW 14GS,A00,506250,Chang; Edmond Yi-Teh,0,0,0,0
1713317904434,MMW 121R,A01,494415,Adamiak; Patrick John,13,0,28,15
1713317904434,MMW 121R,A02,494416,Adamiak; Patrick John,24,0,28,4
1713317905463,MUS 1A,A01,494113,Staff,12,0,25,13
1713317905463,MUS 1A,A02,494114,Staff,25,0,25,0
1713317906492,MUS 4,A01,494116,Staff,24,0,25,1
1713317906492,MUS 4,A02,494117,Staff,22,0,25,3
1713317907518,MUS 5R,A01,494236,Dubnov; Shlomo,10,0,25,15
1713317907518,MUS 5R,A02,494237,Dubnov; Shlomo,25,0,25,0
1713317908548,MUS 6,A01,494122,Staff,12,0,25,13
1713317908548,MUS 6,A02,494123,Staff,24,0,25,1
1713317909576,MUS 7,A01,494125,Staff,16,0,25,9
1713317909576,MUS 7,A02,494126,Staff,24,0,25,1
1713317910599,MUS 11,A01,494128,Staff,23,0,25,2
1713317910599,MUS 11,A02,494129,Staff,24,0,25,1
1713317911625,MUS 13,A01,494131,Staff,25,0,25,0
1713317911625,MUS 13,A02,494132,Staff,25,0,25,0
1713317912655,MUS 15,A01,494134,Staff,17,0,25,8
1713317912655,MUS 15,A02,494135,Staff,25,0,25,0
1713317912655,MUS 15,B01,494137,Staff,24,0,25,1
1713317913683,MUS 80,A00,494232,Staff,24,0,25,1
1713317913683,MUS 80,B00,494233,Staff,25,0,25,0
1713317913683,MUS 80,C00,494234,Staff,23,0,25,2
1713317914710,MUS 95C,A00,494141,Staff,72,0,75,3
1713317915738,MUS 114,A00,494142,Staff,41,0,50,9
1713317916770,NANO 15,A01,490636,Drews; Aaron,7,0,7,0
1713317917799,PHIL 1,A00,490578,Grush; Rick Scott,49,0,50,1
1713317918825,PHIL 10,A01,490580,Grush; Rick Scott,33,0,35,2
1713317918825,PHIL 10,A02,490586,Grush; Rick Scott,33,0,35,2
1713317919850,PHIL 27,A01,490591,Staff,23,0,25,2
1713317919850,PHIL 27,A02,490592,Staff,25,0,25,0
1713317919850,PHIL 27,A03,490593,Staff,25,0,25,0
1713317919850,PHIL 27,A04,490598,Staff,25,0,25,0
1713317920876,PHIL 32,A01,490611,Staff,20,0,20,0
1713317920876,PHIL 32,A02,490618,Staff,20,0,20,0
1713317921905,PHIL 90,A00,490624,Staff,40,0,40,0
1713317922929,PHIL 136,A00,490627,Cohen; Jonathan David,38,0,40,2
1713317923955,PHIL 155,A00,490634,Staff,63,0,70,7
1713317924986,PHYS 1A,A00,491610,Staff,246,0,250,4
1713317926016,PHYS 1AL,001,491616,Tsai; Philbert S,28,0,30,2
1713317926016,PHYS 1AL,002,491618,Tsai; Philbert S,30,0,30,0
1713317927042,PHYS 1B,A00,491623,Staff,243,0,250,7
1713317928070,PHYS 1BL,001,491626,Tsai; Philbert S,25,0,30,5
1713317928070,PHYS 1BL,002,491628,Tsai; Philbert S,27,0,30,3
1713317929099,PHYS 1C,A00,491632,Staff,220,0,245,25
1713317930125,PHYS 1CL,001,491635,Tsai; Philbert S,10,0,30,20
1713317930125,PHYS 1CL,002,491643,Tsai; Philbert S,24,0,30,6
1713317931155,PHYS 2AR,A01,491651,Meyertholen; Andrew D.,44,0,50,6
1713317932235,PHYS 2B,A01,491659,Staff,106,0,115,9
1713317933265,PHYS 2BL,A01,491685,Staff,21,0,24,3
1713317933265,PHYS 2BL,A02,491700,Staff,23,0,24,1
1713317934296,PHYS 2C,A01,505161,Staff,106,0,115,9
1713317935321,PHYS 4A,A01,491704,Grinstein; Benjamin,99,0,100,1
1713317936354,POLI 5D,A01,494144,Staff,3,0,5,2
1713317936354,POLI 5D,B01,626283,Dai; Yinlin,5,0,5,0
1713317937378,POLI 12,A00,494145,Staff,44,0,45,1
1713317938405,POLI 13R,A00,494146,Forman; Fonna,45,0,50,5
1713317939434,POLI 27,A01,494148,Staff,57,0,60,3
1713317940464,POLI 30,A00,494149,Staff,49,0,50,1
1713317941492,POLI 100DA,A00,494150,Staff,21,0,25,4
1713317943549,POLI 100I,A00,494152,Staff,28,0,30,2
1713317944580,POLI 104B,A00,494153,Smith; Glenn Chatmas,54,0,55,1
1713317945605,POLI 104F,A00,494154,Staff,28,0,30,2
1713317946629,POLI 104I,A00,494155,Smith; Glenn Chatmas,30,0,30,0
1713317947658,POLI 110C,A00,494156,Ingham; Sean,23,0,25,2
1713317948684,POLI 117R,A00,494157,Forman; Fonna,9,0,20,11
1713317949710,POLI 118,A00,494158,Ingham; Sean,22,0,25,3
1713317950734,POLI 120H,A00,494159,Fisk; David Lee,41,0,45,4
1713317951763,POLI 131CR,A00,494160,Hoston; Germaine,36,0,45,9
1713317952789,POLI 133J,A00,494161,Staff,33,0,35,2
1713317953813,POLI 135,A00,494162,Fisk; David Lee,33,0,35,2
1713317954838,POLI 140A,A00,494164,Staff,21,0,30,9
1713317955866,POLI 142I,A00,494165,Staff,30,0,30,0
1713317956891,POLI 144D,A00,494166,Staff,23,0,25,2
1713317957917,POLI 151,A00,494167,Staff,30,0,30,0
1713317958943,POLI 153,A00,494168,Staff,33,0,35,2
1713317959968,POLI 160AA,A00,494169,Staff,35,0,40,5
1713317960994,POLI 162,A00,494170,Mignozzetti; Umberto,20,0,25,5
1713317962022,POLI 171,A00,494171,Mignozzetti; Umberto,21,0,25,4
1713317963046,PSYC 1,A00,494172,Staff,97,0,100,3
1713317964072,PSYC 2,A00,494173,Moranton; Nirelia Melbina-,42,0,50,8
1713317965098,PSYC 3,A00,494174,Staff,29,0,30,1
1713317966128,PSYC 6,A00,494175,Staff,17,0,20,3
1713317967152,PSYC 60,A01,494177,Staff,39,0,45,6
1713317968182,PSYC 70,A01,505724,Geller; Emma Harlan,42,0,45,3
1713317969208,PSYC 101,A00,494180,Heyman; Gail D.,87,0,100,13
1713317970234,PSYC 105,A00,494181,Geller; Emma Harlan,59,0,90,31
1713317971262,PSYC 106,A00,494182,Dobkins; Karen R.,29,0,45,16
1713317972293,PSYC 108,A00,494183,Adrian; Julia Anna,91,0,100,9
1713317973322,PSYC 114,A01,494185,Winkielman; Piotr,0,0,30,30
1713317974346,PSYC 122,A00,494186,Moranton; Nirelia Melbina-,34,0,50,16
1713317975375,PSYC 124,A00,494187,Chapman; Eddie Nathaniel,72,0,80,8
1713317976401,PSYC 131,A00,494188,Anagnostaras; Stephan,52,0,80,28
1713317977426,PSYC 144,A00,494189,Staff,13,0,50,37
1713317978454,PSYC 154,A00,494190,Lacefield; Katharine I,127,0,180,53
1713317979481,PSYC 162,A00,494191,Wixted; John T,77,0,100,23
1713317980510,PSYC 172,A00,494192,Gorman; Michael R.,37,0,45,8
1713317981539,PSYC 178,A00,494193,Glaser; Dale,39,0,45,6
1713317982566,PSYC 193,A00,505725,Chapman; Eddie Nathaniel,20,0,20,0
1713317983590,RELI 145GS,A00,519817,Rahimi; Babak,18,0,20,2
1713317984617,SE 101A,A01,490862,Chadha; Mayank,23,0,25,2
1713317985645,SE 101C,A01,490924,Krysl; Petr,17,0,20,3
1713317986670,SE 110A,A01,490928,Staff,19,0,20,1
1713317987698,SE 130A,A00,490929,Morrison; Machel Leigh,59,0,70,11
1713317988725,SIO 1,A01,519325,Staff,39,0,40,1
1713317989751,SIO 30,A01,519327,Staff,39,0,40,1
1713317990776,SIO 40,A00,519328,Staff,40,0,40,0
1713317991801,SIO 46GS,A00,519819,Cook; Geoffrey W,18,0,25,7
1713317992824,SIO 109R,A00,494197,Forman; Fonna,4,0,20,16
1713317993859,SIO 121GS,A00,519827,Cook; Geoffrey W,18,0,25,7
1713317994887,SIO 132,A01,519330,Staff,38,0,40,2
1713317995912,SIO 133,A01,519397,Staff,37,0,40,3
1713317996937,SIO 139,A00,519396,Kacev; David,31,0,40,9
1713317997963,SOCI 1,A01,494199,Thorpe; Charles Robert,23,0,30,7
1713317997963,SOCI 1,A02,494200,Thorpe; Charles Robert,30,0,30,0
1713317997963,SOCI 1,A03,494201,Thorpe; Charles Robert,29,0,30,1
1713317997963,SOCI 1,A04,494202,Thorpe; Charles Robert,29,0,30,1
1713317997963,SOCI 1,A05,494203,Thorpe; Charles Robert,29,0,30,1
1713317997963,SOCI 1,A06,494204,Thorpe; Charles Robert,30,0,30,0
1713317997963,SOCI 1,A07,494205,Thorpe; Charles Robert,29,0,30,1
1713317998991,SOCI 60,A01,494207,Staff,35,0,40,5
1713317998991,SOCI 60,A02,494208,Staff,39,0,40,1
1713318000019,SOCI 100,A01,494210,Payne; Christine Anna,27,0,30,3
1713318000019,SOCI 100,A02,494211,Payne; Christine Anna,26,0,30,4
1713318001046,SOCI 109M,A00,494212,Staff,20,0,20,0
1713318002073,SOCI 110,A00,494213,Staff,35,0,40,5
1713318004130,SOCI 118E,A00,494215,Ng; Kwai,38,0,40,2
1713318005160,SOCI 125,A00,494216,Calderon-Zaks; Michael Aar,42,0,45,3
1713318006188,SOCI 126,A01,494218,Jones; Makeba,3,0,5,2
1713318007212,SOCI 131,A00,494219,Thorpe; Charles Robert,28,0,30,2
1713318009263,SOCI 135,A00,494221,Payne; Christine Anna,33,0,50,17
1713318010290,SOCI 136E,A00,626690,Ruiz; Jonathan Joseph,25,0,25,0
1713318011320,SOCI 138GS,A00,494222,Navon; Daniel,24,0,28,4
1713318013370,SOCI 145,A00,494224,Staff,42,0,45,3
1713318014394,SOCI 153,A00,494225,Staff,28,0,30,2
1713318015422,SOCI 160E,A00,494226,Ng; Kwai,32,0,40,8
1713318016452,SOCI 180,A00,494227,Staff,29,0,30,1
1713318017480,SOCI 189GS,A00,494228,Ribas Norris; Janet Vanesa,11,0,11,0
1713318018506,SOCI 190GS,A00,553232,Ribas Norris; Janet Vanesa,11,0,11,0
1713318019534,SOMI 220,A00,627178,Schneid; Stephen David,30,0,30,0
1713318020562,SYN 2,001,490768,Staff,14,0,15,1
1713318020562,SYN 2,002,490769,Staff,15,0,15,0
1713318020562,SYN 2,004,490775,Staff,0,0,0,0
1713318020562,SYN 2,003,490774,Staff,0,0,0,0
1713318020562,SYN 2,005,490776,Staff,0,0,0,0
1713318021588,SYN 2R,001,490779,Staff,12,0,15,3
1713318021588,SYN 2R,002,514635,Staff,14,0,15,1
1713318022614,SYN 100,A01,490783,Staff,15,0,20,5
1713318022614,SYN 100,B01,490787,Staff,10,0,20,10
1713318022614,SYN 100,C01,490789,Staff,12,0,20,8
1713318023643,SYN 150,A00,490817,Staff,14,0,15,1
1713318023643,SYN 150,B00,514610,Staff,15,0,15,0
1713318024678,TDAC 1,A00,492753,Walsh; Kim C.,19,0,20,1
1713318024678,TDAC 1,B00,492754,Harting; Carla Kelso,19,0,20,1
1713318024678,TDAC 1,C00,513995,Salovey; Todd,16,0,20,4
1713318025709,TDAC 101,A00,492766,Harting; Carla Kelso,17,0,20,3
1713318026734,TDAC 102,A00,492768,Basso; Beatrice,19,0,20,1
1713318027757,TDDE 111,A00,492769,Staff,25,0,25,0
1713318028787,TDDE 131,A00,492770,Staff,15,0,15,0
1713318028787,TDDE 131,B00,492771,Staff,15,0,15,0
1713318029813,TDDE 131GS,A00,523716,Guirguis; Mark C,24,0,28,4
1713318030844,TDGE 1,A01,492756,Salovey; Todd,57,0,60,3
1713318031875,TDGE 5,A01,492758,Staff,24,0,25,1
1713318032906,TDGE 10,A00,492759,Fulton; Julia,207,0,220,13
1713318033933,TDGE 11,A00,492760,Castro; Robert Jess,199,0,200,1
1713318036041,TDGE 124,A00,492772,Fulton; Julia,192,0,220,28
1713318037072,TDGE 125,A00,492773,Meyer; Ursula,40,0,50,10
1713318037072,TDGE 125,B00,492774,Staff,49,0,50,1
1713318037072,TDGE 125,C00,523565,Staff,48,0,50,2
1713318038100,TDGE 125GS,A00,523580,Guirguis; Mark C,24,0,28,4
1713318039130,TDGE 127,A00,492775,Havis; Allan,40,0,50,10
1713318040159,TDHT 101,A00,492776,Staff,35,0,35,0
1713318041185,TDMV 1,A00,492762,Caligagan; Maria T.,30,0,30,0
1713318041185,TDMV 1,B00,492763,Arcidiacono; Kristin,25,0,30,5
1713318042212,TDMV 2,A00,492764,Weinberg; Sadie,29,0,30,1
1713318043237,TDMV 3,A00,492765,Mack; Kara Shanai',39,0,40,1
1713318044262,TDMV 138,A00,492777,Mack; Kara Shanai',35,0,40,5
1713318045286,TDMV 140,A00,492778,Lima; Paulo Henrique,40,0,40,0
1713318046313,TDMV 142,A00,492779,Caligagan; Maria T.,36,0,40,4
1713318046313,TDMV 142,B00,492780,Caligagan; Tony,37,0,40,3
1713318047341,TDMV 143,A00,492781,Fyall; Daunte Edward,39,0,40,1
1713318048372,USP 1,A01,492401,Kwak; Nancy,26,0,35,9
1713318049399,USP 2,A01,492453,Hinds; Juli Beth,35,0,35,0
1713318050425,USP 3,A01,492516,Staff,29,0,35,6
1713318051449,USP 4,A00,492522,McTague; Sarah,19,0,25,6
1713318052474,USP 100,A00,492523,Staff,33,0,35,2
1713318053498,USP 101,A00,492524,Staff,13,0,15,2
1713318054524,USP 105,A00,492525,Staff,21,0,25,4
1713318055550,USP 151,A00,492526,Shenkman; Michael Thomas,33,0,35,2
1713318056576,USP 170,A00,492545,Hinds; Juli Beth,33,0,35,2
1713318057601,USP 171GS,A00,492608,Bussell; Mirle Rabinowitz,24,0,28,4
1713318058626,USP 183GS,A00,492613,Peerson; Susan,24,0,28,4
1713318059652,VIS 30,A01,490693,Yoldas; Pinar,20,0,22,2
1713318059652,VIS 30,A02,490694,Yoldas; Pinar,18,0,22,4
1713318060677,VIS 83,A00,490695,Kester; Grant,65,0,75,10
1713318061701,VIS 105D,A00,490696,Staff,22,0,25,3
1713318062726,VIS 124CN,A00,490699,Rose; Jordan M,68,0,75,7
1713318063754,VIS 125GS,A00,511221,Williams; Alena J,21,0,22,1
1713318064779,VIS 128D,A00,490700,Staff,74,0,75,1
1713318065806,VIS 151,A01,490717,Staff,33,0,34,1
1713318065806,VIS 151,A02,490766,Staff,33,0,34,1
1713318066832,VIS 154GS,A00,511972,Williams; Alena J,21,0,22,1
1713318067860,VIS 160A,A00,490767,Stone; Patricia,7,0,10,3
1713318068888,WCWP 10A,A00,490638,Staff,14,0,15,1
1713318068888,WCWP 10A,B00,490640,Staff,15,0,15,0
1713318069914,WCWP 10B,A00,490641,Staff,0,0,0,0
1713318069914,WCWP 10B,B00,490642,Staff,14,0,15,1
1713318069914,WCWP 10B,C00,490644,Staff,13,0,15,2
1713318069914,WCWP 10B,D00,490647,Staff,0,0,0,0
1713318070938,WCWP 100,A00,490655,Staff,0,0,0,0
1713318070938,WCWP 100,B00,490687,Staff,11,0,15,4
1713318073071,ANAR 153,A00,487222,Braswell; Geoffrey E.,54,0,60,6
1713318074096,ANBI 134,A00,487223,Staff,8,0,20,12
1713318075120,ANBI 143GS,A00,487224,Noel; Geoffroy Pierre Jean,20,0,24,4
1713318076149,ANBI 144GS,A00,519548,Noel; Geoffroy Pierre Jean,20,0,24,4
1713318077177,ANSC 101,A00,487225,Staff,19,0,20,1
1713318078207,ANSC 125,A00,487227,Brenner; Suzanne A,39,0,40,1
1713318080255,ANSC 146,A00,487229,Staff,36,0,40,4
1713318081278,ANSC 148,A00,487230,Olivas Hernandez; Olga Lid,39,0,40,1
1713318082303,ANSC 150,A00,504165,Sloane; Julia Kathryn,19,0,20,1
1713318083329,ANSC 180,A00,487232,Staff,13,0,15,2
1713318084396,ANSC 188,A00,627155,Staff,39,0,40,1
1713318085424,ANTH 5,A00,519529,Semendeferi; Ekaterini,15,0,15,0
1713318086449,ANTH 10,A00,487219,Staff,58,0,60,2
1713318087478,ANTH 23,A01,487221,Staff,17,0,20,3
1713318088511,ANTH 102,A00,487233,Wilder; Linnea Lorene,51,0,60,9
1713318089540,ANTH 103,A00,487234,Varma; Saiba,56,0,60,4
1713318090566,ANTH 105,A00,487235,Stewart; Alexander B,55,0,60,5
1713318091592,BENG 100,A01,516685,Taylor Amos; Alyssa C,28,0,30,2
1713318092623,BIBC 102,A01,491316,Flagg; Matthew Paul,30,0,88,58
1713318092623,BIBC 102,A02,491366,Flagg; Matthew Paul,83,0,88,5
1713318093652,BIBC 103,A01,491486,Boumechache; Miyyada,16,0,24,8
1713318093652,BIBC 103,A02,491487,Boumechache; Miyyada,24,0,24,0
1713318094681,BICD 100,A01,516882,Staff,75,0,75,0
1713318094681,BICD 100,A02,516890,Staff,69,0,75,6
1713318095708,BICD 102GS,A00,491488,Lo; Stanley M.,26,0,28,2
1713318096733,BIEB 136GS,A00,516940,Holway; David A. & Shurin; Jonathan,19,0,24,5
1713318097758,BIEB 137GS,A01,517034,Holway; David A. & Shurin; Jonathan,19,0,24,5
1713318098784,BIEB 138GS,A01,491492,Pirino; Giorgia,21,0,28,7
1713318099808,BILD 1,A01,491296,Staff,62,0,63,1
1713318099808,BILD 1,A02,491297,Staff,63,0,63,0
1713318100835,BILD 4,A01,517099,Gonzalez Gamboa; Ivonne,22,0,24,2
1713318100835,BILD 4,A02,517100,Gonzalez Gamboa; Ivonne,24,0,24,0
1713318101860,BILD 60GS,A00,491309,Lo; Stanley M.,26,0,28,2
1713318102890,BIMM 100,A01,517136,Staff,87,0,100,13
1713318103917,BIMM 110,A01,517182,Staff,65,0,100,35
1713318104947,BIMM 120,A01,517228,Pickett; Brooke Elizabeth,35,0,63,28
1713318104947,BIMM 120,A02,517240,Pickett; Brooke Elizabeth,48,0,63,15
1713318105976,BIMM 132GS,A01,491498,Pirino; Giorgia,21,0,28,7
1713318107000,BIMM 143,A01,491589,Bozinovic; Goran,16,0,40,24
1713318108031,BIPN 100,A01,491594,Armour; Jon Christopher,90,0,100,10
1713318109056,BIPN 140,A01,491602,Marino; Marc J,28,0,50,22
1713318111107,CAT 125,A00,515973,Staff,19,0,20,1
1713318112133,CAT 125GS,A00,515974,Rahimi; Babak,18,0,20,2
1713318113165,CAT 125R,A00,515980,Staff,14,0,20,6
1713318113165,CAT 125R,B00,515981,Tosun; Adriana,19,0,20,1
1713318113165,CAT 125R,C00,515987,Hyland; Tina Mae,0,0,20,20
1713318113165,CAT 125R,D00,515988,Bronstein; Phoebe Malan,18,0,20,2
1713318114190,CENG 15,A01,488699,Drews; Aaron,25,0,25,0
1713318115221,CENG 100,A00,505196,Opatkiewicz; Justin Paul,25,0,25,0
1713318116249,CGS 2A,A01,489598,Staff,33,0,35,2
1713318117274,CGS 112,A00,489599,Staff,15,0,15,0
1713318118298,CGS 119,A00,489603,Staff,10,0,10,0
1713318119326,CGS 120,A00,489604,Staff,14,0,15,1
1713318120354,CGS 150,A00,489607,Staff,15,0,15,0
1713318121385,CHEM 6A,A01,488715,Staff,98,0,100,2
1713318122410,CHEM 6B,A01,488719,Piercy; Marc Anthony,100,0,100,0
1713318123439,CHEM 6C,A01,488723,Albizati; Kim F.,94,0,100,6
1713318124467,CHEM 7L,A01,488728,Schurmeier; Kimberly,18,0,24,6
1713318124467,CHEM 7L,A02,488730,Schurmeier; Kimberly,23,0,24,1
1713318124467,CHEM 7L,A03,488734,Schurmeier; Kimberly,23,0,24,1
1713318124467,CHEM 7L,A04,488763,Schurmeier; Kimberly,23,0,24,1
1713318124467,CHEM 7L,B01,488798,Schurmeier; Kimberly,17,0,24,7
1713318124467,CHEM 7L,B02,488801,Schurmeier; Kimberly,23,0,24,1
1713318124467,CHEM 7L,B03,488808,Schurmeier; Kimberly,24,0,24,0
1713318124467,CHEM 7L,B04,488811,Schurmeier; Kimberly,24,0,24,0
1713318125494,CHEM 11,A01,488897,Stallings; Dontarie M,97,0,100,3
1713318126521,CHEM 40A,A01,488913,Albizati; Kim F.,88,0,100,12
1713318127547,CHEM 40B,A01,488920,Weizman; Haim,45,0,50,5
1713318127547,CHEM 40B,A02,488938,Weizman; Haim,46,0,50,4
1713318128573,CHEM 41A,A01,489029,Klosterman; Jeremy K,58,0,60,2
1713318129600,CHEM 41C,A01,500436,Tor; Yitzhak,55,0,60,5
1713318130624,CHEM 43A,A01,500426,Weizman; Haim,1,0,24,23
1713318130624,CHEM 43A,A02,500430,Weizman; Haim,13,0,24,11
1713318130624,CHEM 43A,B01,514041,Klosterman; Jeremy K,15,0,24,9
1713318130624,CHEM 43A,B02,514047,Klosterman; Jeremy K,23,0,24,1
1713318131651,CHEM 108,A01,489140,Jennings; Patricia A.,11,0,24,13
1713318131651,CHEM 108,A02,489142,Jennings; Patricia A.,14,0,24,10
1713318132675,CHEM 114A,A01,489147,Stallings; Dontarie M,77,0,100,23
1713318133701,CHIN 169A,A00,489171,Wang; Xiao,19,0,20,1
1713318135756,COGS 3,A01,518827,Boyle; Mary E. T.,29,0,40,11
1713318136786,COGS 11,A01,489175,Staff,28,0,30,2
1713318137812,COGS 14A,A01,518829,Staff,51,0,60,9
1713318138838,COGS 14B,A01,489177,Hoffman; Drew Ellen,66,0,75,9
1713318139919,COGS 100,A01,489181,Allen; Michael Gordon,65,0,75,10
1713318140949,COGS 101A,A01,489183,Staff,48,0,60,12
1713318141975,COGS 101B,A01,489185,Allen; Michael Gordon,9,0,30,21
1713318143002,COGS 101C,A01,526786,Staff,24,0,30,6
1713318145058,COGS 107A,A01,489189,Boyle; Mary E. T.,19,0,35,16
1713318146092,COGS 107B,A01,627144,Mooshagian; Eric Frederick,60,0,60,0
1713318147120,COGS 118A,A01,489191,Staff,0,40,40,40
1713318149175,COGS 171GS,A01,489194,Pineda; Jaime A,21,0,28,7
1713318150203,COGS 172,A01,489196,Staff,3,0,30,27
1713318151234,COGS 174GS,A01,489264,Pineda; Jaime A,21,0,28,7
1713318152263,COGS 180,A01,627150,Staff,28,0,30,2
1713318153288,COGS 186,A01,489274,Staff,0,0,30,30
1713318154314,COMM 10,A01,489276,Staff,23,0,25,2
1713318154314,COMM 10,A02,489303,Staff,23,0,25,2
1713318155341,COMM 100A,A01,489312,Staff,16,0,25,9
1713318155341,COMM 100A,A02,489313,Staff,24,0,25,1
1713318156368,COMM 106T,A00,512540,Staff,34,0,35,1
1713318157396,COMM 107,A00,489347,Staff,31,0,35,4
1713318158421,COMM 109P,A00,489358,Staff,31,0,35,4
1713318159448,COMM 132,A00,489361,McKenna; Denise,28,0,30,2
1713318160473,COMM 146,A00,489362,Halm; Gavin Patrick,27,0,30,3
1713318161496,COMM 190,A00,489363,Abuelhiga; Soraya Jill,20,0,23,3
1713318162528,CSE 8A,A50,489366,Staff,22,0,25,3
1713318162528,CSE 8A,A51,489367,Staff,24,0,25,1
1713318163558,CSE 11,A01,489398,Cao; Yingjun,79,0,100,21
1713318164588,CSE 12,A01,489487,Staff,43,0,50,7
1713318165614,CSE 20,A01,489497,Staff,48,0,50,2
1713318166641,CSE 21,A01,489517,Braun; Oliver,43,0,50,7
1713318167666,CSE 101,A01,489524,Braun; Oliver,0,23,50,50
1713318168694,CSE 105,A01,512594,Jones; Miles E,78,0,100,22
1713318168694,CSE 105,B01,512598,Jones; Miles E,57,0,100,43
1713318169725,CSE 140,A01,489538,Staff,43,0,50,7
1713318170750,CSE 141,A01,489550,Eldon; John,74,0,100,26
1713318171776,CSE 141L,A01,489571,Eldon; John,72,0,100,28
1713318172801,CSE 151A,A01,489583,Solares; Edwin A,147,0,200,53
1713318173892,CSE 175,A01,510886,Kumar; Rakesh,30,0,30,0
1713318174922,CSE 190,A00,516828,Dubnov; Shlomo,38,0,49,11
1713318175956,DOC 100D,A00,489667,Pass; Natalye Joann,19,0,25,6
1713318176982,DSC 10,A01,624268,Staff,72,0,75,3
1713318178006,DSC 20,A01,624476,Staff,50,0,50,0
1713318179033,DSC 40A,A01,624608,Staff,39,0,40,1
1713318180060,DSGN 1,A01,489179,Rill; Bryan,36,0,50,14
1713318181085,ECE 17,A01,490489,Sahay; Rajeev,18,0,30,12
1713318182112,ECE 65,A50,490492,Staff,15,0,20,5
1713318182112,ECE 65,A51,490493,Staff,20,0,20,0
1713318183138,ECON 1,A01,489715,Famulari; Melissa,68,0,70,2
1713318184164,ECON 2,A01,489717,Levkoff; Steven B.,68,0,70,2
1713318185190,ECON 3,A01,489948,Staff,70,0,70,0
1713318187246,ECON 5,A01,490103,Staff,28,0,30,2
1713318187246,ECON 5,B01,626281,Dai; Yinlin,45,0,45,0
1713318188272,ECON 100A,A01,490127,Famulari; Melissa,66,0,70,4
1713318189298,ECON 100B,A01,490129,Staff,64,0,70,6
1713318190325,ECON 109,A01,490187,Shishkin; Denis,27,0,35,8
1713318191351,ECON 110A,A01,490190,Levkoff; Steven B.,60,0,70,10
1713318192380,ECON 120A,A01,490245,Dai; Yinlin,62,0,70,8
1713318193425,ECON 120B,A01,490247,Nieto-Barthaburu; Augusto,52,0,70,18
1713318194466,ECON 120C,A01,490253,Sun; Yixiao,30,0,35,5
1713318194466,ECON 120C,B01,490255,Sun; Yixiao,34,0,35,1
1713318195490,ECON 129,A00,490256,Eckert; Fabian Paul,24,0,35,11
1713318196516,ECON 131,A00,490257,Nieto-Barthaburu; Augusto,0,4,35,35
1713318197541,ECON 138,A00,490258,Bharadwaj; Prashant,18,0,35,17
1713318197541,ECON 138,B00,490259,Bharadwaj; Prashant,17,0,35,18
1713318198567,ECON 159,A00,490260,Hendrickson; Gerald M.,0,8,0,0
1713318199592,ECON 178,A01,553995,Zhu; Ying,24,0,35,11
1713318200624,EDS 40,A01,512576,Black; Alison Michelle,20,0,20,0
1713318201652,EDS 107,A01,515848,Staff,30,0,30,0
1713318202678,EDS 110R,A01,490262,Staff,26,0,30,4
1713318203706,EDS 112,A01,490264,Chapman; Thandeka K,42,0,50,8
1713318204730,EDS 113,A00,490266,Staff,26,0,30,4
1713318205756,EDS 118,A00,490267,Warstadt; Melissa Fawn,22,0,30,8
1713318206781,EDS 124BR,A00,490268,Eguchi; Emi,6,0,25,19
1713318206781,EDS 124BR,B00,490269,Eguchi; Emi,25,0,25,0
1713318207810,EDS 126,A01,490271,Jones; Makeba,44,0,50,6
1713318208842,EDS 135,A01,490316,Staff,19,0,20,1
1713318209868,ENVR 142GS,A00,519514,Chang; Edmond Yi-Teh,28,0,28,0
1713318210894,ETHN 103,A00,490504,Staff,31,0,36,5
1713318211925,ETHN 103A,A00,490505,Man; Simeon S,5,0,9,4
1713318212953,ETHN 109,A00,490506,Staff,30,0,30,0
1713318213976,ETHN 118,A00,490507,Staff,35,0,36,1
1713318215000,ETHN 119,A00,490508,Staff,34,0,36,2
1713318216026,ETHN 121R,A00,490518,Choi; Esther Min,25,0,36,11
1713318217055,ETHN 127,A00,490528,Staff,15,0,15,0
1713318218080,ETHN 139,A00,490573,Staff,10,0,10,0
1713318219104,ETHN 150,A00,490575,Staff,15,0,15,0
1713318220134,GLBH 20,A00,491705,Elwardani; Nile Regina,38,0,40,2
1713318221157,GLBH 101,A00,491706,Staff,20,0,20,0
1713318222183,GLBH 111,A01,491708,Burgos; Jose L.,15,0,15,0
1713318223212,GLBH 146,A00,491709,Staff,11,0,20,9
1713318224238,GLBH 148,A00,491710,Olivas Hernandez; Olga Lid,14,0,20,6
1713318225263,GLBH 150,A00,491711,Sloane; Julia Kathryn,20,0,20,0
1713318226288,HIEA 131,A00,491760,Staff,29,0,32,3
1713318227312,HIEA 153,A00,491762,Staff,29,0,30,1
1713318228340,HIEU 124,A00,491811,Staff,26,0,32,6
1713318229367,HIEU 124GS,A00,491812,Markman; Kristina,27,0,28,1
1713318230392,HIEU 147,A00,491813,Staff,30,0,32,2
1713318231418,HIEU 149GS,A00,491816,Caldwell; Michael Alan,28,0,28,0
1713318232444,HILD 2C,A01,491713,Hendrickson; Gerald M.,27,0,30,3
1713318233468,HILD 7B,A01,491715,Kwak; Nancy,4,0,30,26
1713318234492,HILD 10,A01,491717,Staff,13,0,20,7
1713318235521,HILD 30GS,A00,491719,Edington; Claire Ellen,24,0,28,4
1713318236546,HINE 109,A00,491818,Shafir; Nir,27,0,32,5
1713318237572,HINE 128,A00,491821,Shafir; Nir,31,0,32,1
1713318238600,HISC 117,A00,491830,Staff,28,0,32,4
1713318239629,HIUS 103,A00,491834,Man; Simeon S,15,0,23,8
1713318240657,HIUS 108B,A00,491835,Staff,29,0,30,1
1713318241682,HIUS 141,A00,491836,Hendrickson; Gerald M.,29,0,32,3
1713318242712,HIUS 149,A00,491839,Staff,27,0,32,5
1713318243808,HUM 3,A01,512617,Crum; Matthew Stephen,44,0,50,6
1713318243808,HUM 3,A02,512618,Crum; Matthew Stephen,48,0,50,2
1713318244833,HUM 3GS,A00,512663,Markman; Kristina,0,0,0,1
1713318244833,HUM 3GS,B00,512664,Staff,0,0,0,0
1713318245859,HUM 4,A01,512620,West; Geoffrey Scott,30,0,50,20
1713318246887,HUM 4GS,A00,512666,Lyon; Antony J.,0,0,0,3
1713318247913,HUM 4R,A01,512625,Watkins; Eric,49,0,50,1
1713318248940,HUM 5,A01,512649,Zavodny; Tatiana Sophia,28,0,50,22
1713318248940,HUM 5,B01,512661,Zroka; Ryan Edward,48,0,50,2
1713318249968,INTL 190,A00,490577,Segui; Alan S,0,0,0,5
1713318250994,JAPN 20AR,A01,491267,Ross; Kayoko F,8,0,20,12
1713318252023,JAPN 180,A00,491285,Berman; Michael David,34,0,40,6
1713318253049,LATI 50,A01,502536,Kokinis; Troy Andreas,16,0,22,6
1713318253049,LATI 50,A02,502551,Kokinis; Troy Andreas,22,0,22,0
1713318253049,LATI 50,A03,502650,Kokinis; Troy Andreas,22,0,22,0
1713318253049,LATI 50,A04,502909,Kokinis; Troy Andreas,22,0,22,0
1713318254074,LATI 160,A01,502920,Kokinis; Troy Andreas,30,0,30,0
1713318255098,LIFR 1A,A00,490494,Van Moer; Vinciane G,17,0,20,3
1713318256125,LIFR 1AX,A00,490495,Van Moer; Vinciane G,17,0,20,3
1713318257150,LIFR 1B,A00,490496,Van Moer; Vinciane G,18,0,20,2
1713318258177,LIFR 1BX,A00,490497,Van Moer; Vinciane G,18,0,20,2
1713318259205,LIGN 8,A00,505198,McIntosh; Justin Daniel,136,0,150,14
1713318260230,LIGN 9GS,A00,491239,Lott; Margaret S.,18,0,20,2
1713318261254,LIGN 101,A01,505200,McIntosh; Justin Daniel,24,0,30,6
1713318262279,LIGN 120,A01,491244,Staff,24,0,30,6
1713318263309,LIGN 149GS,A00,491245,Lott; Margaret S.,18,0,20,2
1713318264332,LIGN 170,A00,491247,Staff,24,0,30,6
1713318265361,LISP 1D,A00,490498,Munoz Sanchez; Alicia,10,0,14,4
1713318265361,LISP 1D,B00,490499,Munoz Sanchez; Alicia,6,0,14,8
1713318265361,LISP 1D,C00,490500,Munoz Sanchez; Alicia,8,0,14,6
1713318265361,LISP 1D,D00,490501,Munoz Sanchez; Alicia,10,0,14,4
1713318266390,LISP 1DX,A00,490502,Munoz Sanchez; Alicia,15,0,28,13
1713318266390,LISP 1DX,B00,490503,Munoz Sanchez; Alicia,17,0,28,11
1713318268445,LTAM 110,A00,491847,Staff,23,0,25,2
1713318269473,LTCS 119,A00,491848,Staff,11,0,15,4
1713318270497,LTCS 130,A00,491849,Staff,24,0,25,1
1713318272552,LTEA 120C,A00,491852,Staff,34,0,40,6
1713318273577,LTEN 130GS,A00,491853,Lyon; Antony J.,25,0,28,3
1713318274601,LTEN 148,A00,491855,Staff,23,0,25,2
1713318275628,LTEN 159,A00,491856,Staff,21,0,25,4
1713318276654,LTEN 180,A00,491857,Staff,8,0,15,7
1713318278708,LTSP 123GS,A00,505928,Bessett; Ryan Matthew,24,0,28,4
1713318279732,LTSP 174GS,A00,506037,Bessett; Ryan Matthew,24,0,28,4
1713318281787,LTWR 102,A00,491861,Staff,11,0,15,4
1713318282814,LTWR 106,A00,491862,Staff,10,0,15,5
1713318283840,MAE 11,A00,490930,Bahadori; Mohammad Yousef,96,0,100,4
1713318284914,MAE 30A,A00,490931,Qi; Huihui,37,0,40,3
1713318285944,MAE 101A,A00,491036,Sadeghizadeh; Zahra,96,0,100,4
1713318286969,MAE 101C,A00,491037,Seshadri; Kalyanasundaram,72,0,100,28
1713318287995,MAE 113,A00,491040,Seshadri; Kalyanasundaram,66,0,80,14
1713318289025,MAE 131A,A00,491041,Ghazinejad; Maziar,38,0,40,2
1713318290052,MAE 142,A00,491053,Staff,39,0,40,1
1713318291080,MAE 143A,A00,491054,Staff,35,0,50,15
1713318292107,MAE 150,A00,491092,Truong; Phuong Thi Ngoc,23,0,35,12
1713318293158,MATH 3C,A01,494031,Pardo Guerra; Sebastian,30,0,30,0
1713318293158,MATH 3C,A02,494032,Pardo Guerra; Sebastian,29,0,30,1
1713318294184,MATH 10A,A01,494034,Staff,27,0,30,3
1713318294184,MATH 10A,A02,494035,Staff,28,0,30,2
1713318294184,MATH 10A,B01,494037,Staff,27,0,30,3
1713318294184,MATH 10A,B02,494038,Staff,29,0,30,1
1713318295219,MATH 10B,A01,494040,Habib; Yousaf,23,0,30,7
1713318295219,MATH 10B,A02,494041,Habib; Yousaf,28,0,30,2
1713318295219,MATH 10B,A03,494042,Habib; Yousaf,30,0,30,0
1713318295219,MATH 10B,A04,494043,Habib; Yousaf,30,0,30,0
1713318295219,MATH 10B,B01,494045,Habib; Yousaf,27,0,30,3
1713318295219,MATH 10B,B02,494046,Habib; Yousaf,30,0,30,0
1713318295219,MATH 10B,B03,494047,Habib; Yousaf,30,0,30,0
1713318295219,MATH 10B,B04,494048,Habib; Yousaf,30,0,30,0
1713318296248,MATH 18,A01,494050,Kemp; Todd Aahron,25,0,30,5
1713318296248,MATH 18,A02,494051,Kemp; Todd Aahron,29,0,30,1
1713318296248,MATH 18,B01,494054,Kemp; Todd Aahron,28,0,30,2
1713318296248,MATH 18,B02,494055,Kemp; Todd Aahron,29,0,30,1
1713318297274,MATH 20A,A01,494059,Suk; Andrew Hoon,30,0,30,0
1713318298301,MATH 20B,A01,494061,Briones; Jor-el Thomas Caparas,33,0,35,2
1713318298301,MATH 20B,B01,494063,Bach; Quang Tran,34,0,35,1
1713318299334,MATH 20C,A01,494065,Staff,28,0,30,2
1713318299334,MATH 20C,A02,494066,Staff,30,0,30,0
1713318299334,MATH 20C,A03,494067,Staff,30,0,30,0
1713318299334,MATH 20C,A04,494068,Staff,30,0,30,0
1713318299334,MATH 20C,B01,494070,Zhang; Ming,26,0,30,4
1713318299334,MATH 20C,B02,494071,Zhang; Ming,28,0,30,2
1713318299334,MATH 20C,B03,494072,Zhang; Ming,29,0,30,1
1713318299334,MATH 20C,B04,494073,Zhang; Ming,29,0,30,1
1713318300363,MATH 20D,A01,494075,Staff,22,0,30,8
1713318300363,MATH 20D,A02,494076,Staff,30,0,30,0
1713318301387,MATH 20E,A01,494079,Staff,24,0,30,6
1713318301387,MATH 20E,A02,494080,Staff,26,0,30,4
1713318301387,MATH 20E,B01,494082,Staff,26,0,30,4
1713318301387,MATH 20E,B02,494083,Staff,25,0,30,5
1713318302412,MATH 103A,A01,494085,Aliabadi Sr.; Mohsen,14,0,30,16
1713318302412,MATH 103A,A02,494086,Aliabadi Sr.; Mohsen,28,0,30,2
1713318302412,MATH 103A,B01,494088,Aliabadi Sr.; Mohsen,22,0,30,8
1713318302412,MATH 103A,B02,494089,Aliabadi Sr.; Mohsen,28,0,30,2
1713318303437,MATH 109,A01,494091,Staff,30,0,30,0
1713318303437,MATH 109,A02,494092,Staff,29,0,30,1
1713318303437,MATH 109,B01,494094,Staff,28,0,30,2
1713318303437,MATH 109,B02,494095,Staff,29,0,30,1
1713318304471,MATH 142A,A01,494097,Chow; Bennett,16,0,30,14
1713318304471,MATH 142A,A02,494098,Chow; Bennett,24,0,30,6
1713318304471,MATH 142A,B01,494100,Chow; Bennett,19,0,30,11
1713318304471,MATH 142A,B02,494101,Chow; Bennett,29,0,30,1
1713318306522,MATH 168A,A01,516677,Dumitriu; Ioana,15,0,35,20
1713318307548,MATH 170A,A01,516679,Dumitriu; Ioana,20,0,30,10
1713318307548,MATH 170A,A02,516680,Dumitriu; Ioana,28,0,30,2
1713318308579,MATH 193A,A01,494107,Staff,15,0,30,15
1713318308579,MATH 193A,A02,494108,Staff,21,0,30,9
1713318308579,MATH 193A,A03,494109,Staff,29,0,30,1
1713318308579,MATH 193A,A04,494110,Staff,22,0,30,8
1713318311667,MGT 16,A00,491930,McKay; Michael J,92,0,98,6
1713318312696,MGT 18,A00,491992,McKay; Michael J,97,0,98,1
1713318313722,MGT 71,A00,492003,Staff,72,0,98,26
1713318314749,MGT 103,A00,505209,Eberhard; Craig A,84,0,98,14
1713318315773,MGT 131A,A00,505210,Anderson; John Charles,90,0,98,8
1713318317824,MGT 153,A00,492077,Perols; Johan Lars,28,0,90,62
1713318320907,MGT 164,A00,492222,McKay; Mary A,93,0,98,5
1713318321933,MGT 172,A00,492245,Staff,59,0,60,1
1713318321933,MGT 172,B00,505526,Hedges; Kathleen,72,0,98,26
1713318322962,MGT 181,A00,505669,Dunn; Louis Jean,84,0,98,14
1713318323988,MMW 14,A01,494399,Staff,22,0,28,6
1713318323988,MMW 14,A02,494400,Staff,25,0,28,3
1713318323988,MMW 14,A03,494401,Staff,28,0,28,0
1713318323988,MMW 14,A04,494402,Staff,28,0,28,0
1713318323988,MMW 14,B01,494404,Carreras; Maria Victoria,13,0,28,15
1713318323988,MMW 14,B02,494405,Carreras; Maria Victoria,26,0,28,2
1713318323988,MMW 14,B03,494406,Carreras; Maria Victoria,28,0,28,0
1713318323988,MMW 14,B04,494407,Carreras; Maria Victoria,28,0,28,0
1713318325014,MMW 14GS,A00,506250,Chang; Edmond Yi-Teh,0,0,0,0
1713318326045,MMW 121R,A01,494415,Adamiak; Patrick John,12,0,28,16
1713318326045,MMW 121R,A02,494416,Adamiak; Patrick John,24,0,28,4
1713318327071,MUS 1A,A01,494113,Staff,12,0,25,13
1713318327071,MUS 1A,A02,494114,Staff,25,0,25,0
1713318328100,MUS 4,A01,494116,Staff,24,0,25,1
1713318328100,MUS 4,A02,494117,Staff,22,0,25,3
1713318329133,MUS 5R,A01,494236,Dubnov; Shlomo,10,0,25,15
1713318329133,MUS 5R,A02,494237,Dubnov; Shlomo,25,0,25,0
1713318330161,MUS 6,A01,494122,Staff,12,0,25,13
1713318330161,MUS 6,A02,494123,Staff,24,0,25,1
1713318331191,MUS 7,A01,494125,Staff,16,0,25,9
1713318331191,MUS 7,A02,494126,Staff,24,0,25,1
1713318332218,MUS 11,A01,494128,Staff,23,0,25,2
1713318332218,MUS 11,A02,494129,Staff,24,0,25,1
1713318333245,MUS 13,A01,494131,Staff,25,0,25,0
1713318333245,MUS 13,A02,494132,Staff,25,0,25,0
1713318334270,MUS 15,A01,494134,Staff,17,0,25,8
1713318334270,MUS 15,A02,494135,Staff,25,0,25,0
1713318334270,MUS 15,B01,494137,Staff,24,0,25,1
1713318335297,MUS 80,A00,494232,Staff,24,0,25,1
1713318335297,MUS 80,B00,494233,Staff,25,0,25,0
1713318335297,MUS 80,C00,494234,Staff,23,0,25,2
1713318336322,MUS 95C,A00,494141,Staff,72,0,75,3
1713318337348,MUS 114,A00,494142,Staff,40,0,50,10
1713318338374,NANO 15,A01,490636,Drews; Aaron,7,0,7,0
1713318339399,PHIL 1,A00,490578,Grush; Rick Scott,49,0,50,1
1713318340426,PHIL 10,A01,490580,Grush; Rick Scott,33,0,35,2
1713318340426,PHIL 10,A02,490586,Grush; Rick Scott,33,0,35,2
1713318341451,PHIL 27,A01,490591,Staff,23,0,25,2
1713318341451,PHIL 27,A02,490592,Staff,25,0,25,0
1713318341451,PHIL 27,A03,490593,Staff,25,0,25,0
1713318341451,PHIL 27,A04,490598,Staff,25,0,25,0
1713318342478,PHIL 32,A01,490611,Staff,20,0,20,0
1713318342478,PHIL 32,A02,490618,Staff,20,0,20,0
1713318343503,PHIL 90,A00,490624,Staff,40,0,40,0
1713318344530,PHIL 136,A00,490627,Cohen; Jonathan David,38,0,40,2
1713318345557,PHIL 155,A00,490634,Staff,63,0,70,7
1713318346588,PHYS 1A,A00,491610,Staff,246,0,250,4
1713318347671,PHYS 1AL,001,491616,Tsai; Philbert S,28,0,30,2
1713318347671,PHYS 1AL,002,491618,Tsai; Philbert S,30,0,30,0
1713318348696,PHYS 1B,A00,491623,Staff,243,0,250,7
1713318349721,PHYS 1BL,001,491626,Tsai; Philbert S,25,0,30,5
1713318349721,PHYS 1BL,002,491628,Tsai; Philbert S,27,0,30,3
1713318350747,PHYS 1C,A00,491632,Staff,220,0,245,25
1713318351771,PHYS 1CL,001,491635,Tsai; Philbert S,10,0,30,20
1713318351771,PHYS 1CL,002,491643,Tsai; Philbert S,24,0,30,6
1713318352801,PHYS 2AR,A01,491651,Meyertholen; Andrew D.,44,0,50,6
1713318353830,PHYS 2B,A01,491659,Staff,106,0,115,9
1713318354854,PHYS 2BL,A01,491685,Staff,21,0,24,3
1713318354854,PHYS 2BL,A02,491700,Staff,23,0,24,1
1713318355886,PHYS 2C,A01,505161,Staff,106,0,115,9
1713318356913,PHYS 4A,A01,491704,Grinstein; Benjamin,99,0,100,1
1713318357940,POLI 5D,A01,494144,Staff,3,0,5,2
1713318357940,POLI 5D,B01,626283,Dai; Yinlin,5,0,5,0
1713318358966,POLI 12,A00,494145,Staff,44,0,45,1
1713318359992,POLI 13R,A00,494146,Forman; Fonna,45,0,50,5
1713318361015,POLI 27,A01,494148,Staff,57,0,60,3
1713318362043,POLI 30,A00,494149,Staff,49,0,50,1
1713318363068,POLI 100DA,A00,494150,Staff,21,0,25,4
1713318365117,POLI 100I,A00,494152,Staff,28,0,30,2
1713318366141,POLI 104B,A00,494153,Smith; Glenn Chatmas,53,0,55,2
1713318367166,POLI 104F,A00,494154,Staff,28,0,30,2
1713318368192,POLI 104I,A00,494155,Smith; Glenn Chatmas,30,0,30,0
1713318369216,POLI 110C,A00,494156,Ingham; Sean,23,0,25,2
1713318370245,POLI 117R,A00,494157,Forman; Fonna,9,0,20,11
1713318371274,POLI 118,A00,494158,Ingham; Sean,22,0,25,3
1713318372302,POLI 120H,A00,494159,Fisk; David Lee,41,0,45,4
1713318373328,POLI 131CR,A00,494160,Hoston; Germaine,36,0,45,9
1713318374352,POLI 133J,A00,494161,Staff,33,0,35,2
1713318375377,POLI 135,A00,494162,Fisk; David Lee,33,0,35,2
1713318376406,POLI 140A,A00,494164,Staff,21,0,30,9
1713318377436,POLI 142I,A00,494165,Staff,30,0,30,0
1713318378459,POLI 144D,A00,494166,Staff,23,0,25,2
1713318379525,POLI 151,A00,494167,Staff,30,0,30,0
1713318380557,POLI 153,A00,494168,Staff,33,0,35,2
1713318381581,POLI 160AA,A00,494169,Staff,35,0,40,5
1713318382610,POLI 162,A00,494170,Mignozzetti; Umberto,20,0,25,5
1713318383638,POLI 171,A00,494171,Mignozzetti; Umberto,21,0,25,4
1713318384663,PSYC 1,A00,494172,Staff,97,0,100,3
1713318385694,PSYC 2,A00,494173,Moranton; Nirelia Melbina-,41,0,50,9
1713318386723,PSYC 3,A00,494174,Staff,29,0,30,1
1713318387752,PSYC 6,A00,494175,Staff,17,0,20,3
1713318388783,PSYC 60,A01,494177,Staff,39,0,45,6
1713318389807,PSYC 70,A01,505724,Geller; Emma Harlan,42,0,45,3
1713318390833,PSYC 101,A00,494180,Heyman; Gail D.,86,0,100,14
1713318391859,PSYC 105,A00,494181,Geller; Emma Harlan,59,0,90,31
1713318392889,PSYC 106,A00,494182,Dobkins; Karen R.,29,0,45,16
1713318393918,PSYC 108,A00,494183,Adrian; Julia Anna,91,0,100,9
1713318394945,PSYC 114,A01,494185,Winkielman; Piotr,0,0,30,30
1713318395971,PSYC 122,A00,494186,Moranton; Nirelia Melbina-,34,0,50,16
1713318396996,PSYC 124,A00,494187,Chapman; Eddie Nathaniel,72,0,80,8
1713318398022,PSYC 131,A00,494188,Anagnostaras; Stephan,51,0,80,29
1713318399050,PSYC 144,A00,494189,Staff,13,0,50,37
1713318400081,PSYC 154,A00,494190,Lacefield; Katharine I,123,0,180,57
1713318401109,PSYC 162,A00,494191,Wixted; John T,77,0,100,23
1713318402296,PSYC 172,A00,494192,Gorman; Michael R.,37,0,45,8
1713318403324,PSYC 178,A00,494193,Glaser; Dale,39,0,45,6
1713318404349,PSYC 193,A00,505725,Chapman; Eddie Nathaniel,20,0,20,0
1713318405376,RELI 145GS,A00,519817,Rahimi; Babak,18,0,20,2
1713318406407,SE 101A,A01,490862,Chadha; Mayank,23,0,25,2
1713318407436,SE 101C,A01,490924,Krysl; Petr,17,0,20,3
1713318408463,SE 110A,A01,490928,Staff,19,0,20,1
1713318409488,SE 130A,A00,490929,Morrison; Machel Leigh,59,0,70,11
1713318410516,SIO 1,A01,519325,Staff,39,0,40,1
1713318411540,SIO 30,A01,519327,Staff,39,0,40,1
1713318412567,SIO 40,A00,519328,Staff,40,0,40,0
1713318413594,SIO 46GS,A00,519819,Cook; Geoffrey W,18,0,25,7
1713318414619,SIO 109R,A00,494197,Forman; Fonna,4,0,20,16
1713318415643,SIO 121GS,A00,519827,Cook; Geoffrey W,18,0,25,7
1713318416671,SIO 132,A01,519330,Staff,38,0,40,2
1713318417698,SIO 133,A01,519397,Staff,37,0,40,3
1713318418721,SIO 139,A00,519396,Kacev; David,31,0,40,9
1713318419753,SOCI 1,A01,494199,Thorpe; Charles Robert,23,0,30,7
1713318419753,SOCI 1,A02,494200,Thorpe; Charles Robert,30,0,30,0
1713318419753,SOCI 1,A03,494201,Thorpe; Charles Robert,29,0,30,1
1713318419753,SOCI 1,A04,494202,Thorpe; Charles Robert,29,0,30,1
1713318419753,SOCI 1,A05,494203,Thorpe; Charles Robert,29,0,30,1
1713318419753,SOCI 1,A06,494204,Thorpe; Charles Robert,30,0,30,0
1713318419753,SOCI 1,A07,494205,Thorpe; Charles Robert,29,0,30,1
1713318420782,SOCI 60,A01,494207,Staff,35,0,40,5
1713318420782,SOCI 60,A02,494208,Staff,39,0,40,1
1713318421811,SOCI 100,A01,494210,Payne; Christine Anna,27,0,30,3
1713318421811,SOCI 100,A02,494211,Payne; Christine Anna,26,0,30,4
1713318422838,SOCI 109M,A00,494212,Staff,20,0,20,0
1713318423868,SOCI 110,A00,494213,Staff,35,0,40,5
1713318425924,SOCI 118E,A00,494215,Ng; Kwai,38,0,40,2
1713318426949,SOCI 125,A00,494216,Calderon-Zaks; Michael Aar,42,0,45,3
1713318427972,SOCI 126,A01,494218,Jones; Makeba,3,0,5,2
1713318428998,SOCI 131,A00,494219,Thorpe; Charles Robert,28,0,30,2
1713318431051,SOCI 135,A00,494221,Payne; Christine Anna,33,0,50,17
1713318432077,SOCI 136E,A00,626690,Ruiz; Jonathan Joseph,25,0,25,0
1713318433102,SOCI 138GS,A00,494222,Navon; Daniel,24,0,28,4
1713318435156,SOCI 145,A00,494224,Staff,42,0,45,3
1713318436185,SOCI 153,A00,494225,Staff,28,0,30,2
1713318437215,SOCI 160E,A00,494226,Ng; Kwai,32,0,40,8
1713318438243,SOCI 180,A00,494227,Staff,29,0,30,1
1713318439274,SOCI 189GS,A00,494228,Ribas Norris; Janet Vanesa,11,0,11,0
1713318440299,SOCI 190GS,A00,553232,Ribas Norris; Janet Vanesa,11,0,11,0
1713318441325,SOMI 220,A00,627178,Schneid; Stephen David,30,0,30,0
1713318442351,SYN 2,001,490768,Staff,14,0,15,1
1713318442351,SYN 2,002,490769,Staff,15,0,15,0
1713318442351,SYN 2,004,490775,Staff,0,0,0,0
1713318442351,SYN 2,003,490774,Staff,0,0,0,0
1713318442351,SYN 2,005,490776,Staff,0,0,0,0
1713318443377,SYN 2R,001,490779,Staff,12,0,15,3
1713318443377,SYN 2R,002,514635,Staff,14,0,15,1
1713318444402,SYN 100,A01,490783,Staff,15,0,20,5
1713318444402,SYN 100,B01,490787,Staff,10,0,20,10
1713318444402,SYN 100,C01,490789,Staff,12,0,20,8
1713318445432,SYN 150,A00,490817,Staff,14,0,15,1
1713318445432,SYN 150,B00,514610,Staff,15,0,15,0
1713318446465,TDAC 1,A00,492753,Walsh; Kim C.,19,0,20,1
1713318446465,TDAC 1,B00,492754,Harting; Carla Kelso,19,0,20,1
1713318446465,TDAC 1,C00,513995,Salovey; Todd,15,0,20,5
1713318447489,TDAC 101,A00,492766,Harting; Carla Kelso,17,0,20,3
1713318448519,TDAC 102,A00,492768,Basso; Beatrice,19,0,20,1
1713318449545,TDDE 111,A00,492769,Staff,25,0,25,0
1713318450571,TDDE 131,A00,492770,Staff,15,0,15,0
1713318450571,TDDE 131,B00,492771,Staff,15,0,15,0
1713318451654,TDDE 131GS,A00,523716,Guirguis; Mark C,24,0,28,4
1713318452685,TDGE 1,A01,492756,Salovey; Todd,57,0,60,3
1713318453714,TDGE 5,A01,492758,Staff,24,0,25,1
1713318454741,TDGE 10,A00,492759,Fulton; Julia,207,0,220,13
1713318455766,TDGE 11,A00,492760,Castro; Robert Jess,199,0,200,1
1713318457825,TDGE 124,A00,492772,Fulton; Julia,192,0,220,28
1713318458858,TDGE 125,A00,492773,Meyer; Ursula,40,0,50,10
1713318458858,TDGE 125,B00,492774,Staff,49,0,50,1
1713318458858,TDGE 125,C00,523565,Staff,48,0,50,2
1713318459887,TDGE 125GS,A00,523580,Guirguis; Mark C,24,0,28,4
1713318460912,TDGE 127,A00,492775,Havis; Allan,40,0,50,10
1713318461936,TDHT 101,A00,492776,Staff,35,0,35,0
1713318462969,TDMV 1,A00,492762,Caligagan; Maria T.,30,0,30,0
1713318462969,TDMV 1,B00,492763,Arcidiacono; Kristin,25,0,30,5
1713318463999,TDMV 2,A00,492764,Weinberg; Sadie,29,0,30,1
1713318465029,TDMV 3,A00,492765,Mack; Kara Shanai',39,0,40,1
1713318466058,TDMV 138,A00,492777,Mack; Kara Shanai',35,0,40,5
1713318467087,TDMV 140,A00,492778,Lima; Paulo Henrique,40,0,40,0
1713318468116,TDMV 142,A00,492779,Caligagan; Maria T.,35,0,40,5
1713318468116,TDMV 142,B00,492780,Caligagan; Tony,37,0,40,3
1713318469141,TDMV 143,A00,492781,Fyall; Daunte Edward,39,0,40,1
1713318470166,USP 1,A01,492401,Kwak; Nancy,26,0,35,9
1713318471195,USP 2,A01,492453,Hinds; Juli Beth,35,0,35,0
1713318472220,USP 3,A01,492516,Staff,29,0,35,6
1713318473245,USP 4,A00,492522,McTague; Sarah,19,0,25,6
1713318474269,USP 100,A00,492523,Staff,33,0,35,2
1713318475293,USP 101,A00,492524,Staff,13,0,15,2
1713318476320,USP 105,A00,492525,Staff,21,0,25,4
1713318477343,USP 151,A00,492526,Shenkman; Michael Thomas,32,0,35,3
1713318478367,USP 170,A00,492545,Hinds; Juli Beth,33,0,35,2
1713318479392,USP 171GS,A00,492608,Bussell; Mirle Rabinowitz,24,0,28,4
1713318480422,USP 183GS,A00,492613,Peerson; Susan,24,0,28,4
1713318481448,VIS 30,A01,490693,Yoldas; Pinar,20,0,22,2
1713318481448,VIS 30,A02,490694,Yoldas; Pinar,18,0,22,4
1713318482474,VIS 83,A00,490695,Kester; Grant,64,0,75,11
1713318483503,VIS 105D,A00,490696,Staff,22,0,25,3
1713318484529,VIS 124CN,A00,490699,Rose; Jordan M,68,0,75,7
1713318485556,VIS 125GS,A00,511221,Williams; Alena J,21,0,22,1
1713318486584,VIS 128D,A00,490700,Staff,73,0,75,2
1713318487610,VIS 151,A01,490717,Staff,33,0,34,1
1713318487610,VIS 151,A02,490766,Staff,33,0,34,1
1713318488757,VIS 154GS,A00,511972,Williams; Alena J,21,0,22,1
1713318489783,VIS 160A,A00,490767,Stone; Patricia,7,0,10,3
1713318490809,WCWP 10A,A00,490638,Staff,14,0,15,1
1713318490809,WCWP 10A,B00,490640,Staff,15,0,15,0
1713318491838,WCWP 10B,A00,490641,Staff,0,0,0,0
1713318491838,WCWP 10B,B00,490642,Staff,14,0,15,1
1713318491838,WCWP 10B,C00,490644,Staff,13,0,15,2
1713318491838,WCWP 10B,D00,490647,Staff,0,0,0,0
1713318492866,WCWP 100,A00,490655,Staff,0,0,0,0
1713318492866,WCWP 100,B00,490687,Staff,10,0,15,5
1713318494942,ANAR 153,A00,487222,Braswell; Geoffrey E.,54,0,60,6
1713318495966,ANBI 134,A00,487223,Staff,8,0,20,12
1713318496991,ANBI 143GS,A00,487224,Noel; Geoffroy Pierre Jean,20,0,24,4
1713318498016,ANBI 144GS,A00,519548,Noel; Geoffroy Pierre Jean,20,0,24,4
1713318499038,ANSC 101,A00,487225,Staff,19,0,20,1
1713318500062,ANSC 125,A00,487227,Brenner; Suzanne A,39,0,40,1
1713318502112,ANSC 146,A00,487229,Staff,35,0,40,5
1713318503145,ANSC 148,A00,487230,Olivas Hernandez; Olga Lid,39,0,40,1
1713318504172,ANSC 150,A00,504165,Sloane; Julia Kathryn,19,0,20,1
1713318505203,ANSC 180,A00,487232,Staff,13,0,15,2
1713318506233,ANSC 188,A00,627155,Staff,39,0,40,1
1713318507256,ANTH 5,A00,519529,Semendeferi; Ekaterini,15,0,15,0
1713318508280,ANTH 10,A00,487219,Staff,58,0,60,2
1713318509305,ANTH 23,A01,487221,Staff,17,0,20,3
1713318510334,ANTH 102,A00,487233,Wilder; Linnea Lorene,51,0,60,9
1713318511361,ANTH 103,A00,487234,Varma; Saiba,56,0,60,4
1713318512387,ANTH 105,A00,487235,Stewart; Alexander B,55,0,60,5
1713318513421,BENG 100,A01,516685,Taylor Amos; Alyssa C,28,0,30,2
1713318514452,BIBC 102,A01,491316,Flagg; Matthew Paul,29,0,88,59
1713318514452,BIBC 102,A02,491366,Flagg; Matthew Paul,82,0,88,6
1713318515484,BIBC 103,A01,491486,Boumechache; Miyyada,16,0,24,8
1713318515484,BIBC 103,A02,491487,Boumechache; Miyyada,24,0,24,0
1713318516509,BICD 100,A01,516882,Staff,75,0,75,0
1713318516509,BICD 100,A02,516890,Staff,69,0,75,6
1713318517537,BICD 102GS,A00,491488,Lo; Stanley M.,26,0,28,2
1713318518565,BIEB 136GS,A00,516940,Holway; David A. & Shurin; Jonathan,19,0,24,5
1713318519593,BIEB 137GS,A01,517034,Holway; David A. & Shurin; Jonathan,19,0,24,5
1713318520621,BIEB 138GS,A01,491492,Pirino; Giorgia,21,0,28,7
1713318521649,BILD 1,A01,491296,Staff,62,0,63,1
1713318521649,BILD 1,A02,491297,Staff,63,0,63,0
1713318522679,BILD 4,A01,517099,Gonzalez Gamboa; Ivonne,22,0,24,2
1713318522679,BILD 4,A02,517100,Gonzalez Gamboa; Ivonne,24,0,24,0
1713318523706,BILD 60GS,A00,491309,Lo; Stanley M.,26,0,28,2
1713318524731,BIMM 100,A01,517136,Staff,87,0,100,13
1713318525757,BIMM 110,A01,517182,Staff,64,0,100,36
1713318526784,BIMM 120,A01,517228,Pickett; Brooke Elizabeth,35,0,63,28
1713318526784,BIMM 120,A02,517240,Pickett; Brooke Elizabeth,47,0,63,16
1713318527810,BIMM 132GS,A01,491498,Pirino; Giorgia,21,0,28,7
1713318528839,BIMM 143,A01,491589,Bozinovic; Goran,16,0,40,24
1713318529866,BIPN 100,A01,491594,Armour; Jon Christopher,90,0,100,10
1713318530897,BIPN 140,A01,491602,Marino; Marc J,28,0,50,22
1713318532952,CAT 125,A00,515973,Staff,19,0,20,1
1713318533978,CAT 125GS,A00,515974,Rahimi; Babak,18,0,20,2
1713318535010,CAT 125R,A00,515980,Staff,14,0,20,6
1713318535010,CAT 125R,B00,515981,Tosun; Adriana,19,0,20,1
1713318535010,CAT 125R,C00,515987,Hyland; Tina Mae,0,0,20,20
1713318535010,CAT 125R,D00,515988,Bronstein; Phoebe Malan,18,0,20,2
1713318536040,CENG 15,A01,488699,Drews; Aaron,25,0,25,0
1713318537066,CENG 100,A00,505196,Opatkiewicz; Justin Paul,25,0,25,0
1713318538092,CGS 2A,A01,489598,Staff,33,0,35,2
1713318539116,CGS 112,A00,489599,Staff,15,0,15,0
1713318540143,CGS 119,A00,489603,Staff,10,0,10,0
1713318541167,CGS 120,A00,489604,Staff,14,0,15,1
1713318542193,CGS 150,A00,489607,Staff,15,0,15,0
1713318543220,CHEM 6A,A01,488715,Staff,98,0,100,2
1713318544250,CHEM 6B,A01,488719,Piercy; Marc Anthony,100,0,100,0
1713318545276,CHEM 6C,A01,488723,Albizati; Kim F.,94,0,100,6
1713318546310,CHEM 7L,A01,488728,Schurmeier; Kimberly,18,0,24,6
1713318546310,CHEM 7L,A02,488730,Schurmeier; Kimberly,23,0,24,1
1713318546310,CHEM 7L,A03,488734,Schurmeier; Kimberly,23,0,24,1
1713318546310,CHEM 7L,A04,488763,Schurmeier; Kimberly,23,0,24,1
1713318546310,CHEM 7L,B01,488798,Schurmeier; Kimberly,17,0,24,7
1713318546310,CHEM 7L,B02,488801,Schurmeier; Kimberly,23,0,24,1
1713318546310,CHEM 7L,B03,488808,Schurmeier; Kimberly,24,0,24,0
1713318546310,CHEM 7L,B04,488811,Schurmeier; Kimberly,24,0,24,0
1713318547338,CHEM 11,A01,488897,Stallings; Dontarie M,97,0,100,3
1713318548366,CHEM 40A,A01,488913,Albizati; Kim F.,88,0,100,12
1713318549391,CHEM 40B,A01,488920,Weizman; Haim,45,0,50,5
1713318549391,CHEM 40B,A02,488938,Weizman; Haim,45,0,50,5
1713318550417,CHEM 41A,A01,489029,Klosterman; Jeremy K,58,0,60,2
1713318551444,CHEM 41C,A01,500436,Tor; Yitzhak,55,0,60,5
1713318552468,CHEM 43A,A01,500426,Weizman; Haim,1,0,24,23
1713318552468,CHEM 43A,A02,500430,Weizman; Haim,13,0,24,11
1713318552468,CHEM 43A,B01,514041,Klosterman; Jeremy K,15,0,24,9
1713318552468,CHEM 43A,B02,514047,Klosterman; Jeremy K,23,0,24,1
1713318553495,CHEM 108,A01,489140,Jennings; Patricia A.,11,0,24,13
1713318553495,CHEM 108,A02,489142,Jennings; Patricia A.,14,0,24,10
1713318554525,CHEM 114A,A01,489147,Stallings; Dontarie M,77,0,100,23
1713318555610,CHIN 169A,A00,489171,Wang; Xiao,19,0,20,1
1713318557668,COGS 3,A01,518827,Boyle; Mary E. T.,28,0,40,12
1713318558697,COGS 11,A01,489175,Staff,28,0,30,2
1713318559726,COGS 14A,A01,518829,Staff,51,0,60,9
1713318560759,COGS 14B,A01,489177,Hoffman; Drew Ellen,66,0,75,9
1713318561789,COGS 100,A01,489181,Allen; Michael Gordon,65,0,75,10
1713318562816,COGS 101A,A01,489183,Staff,48,0,60,12
1713318563842,COGS 101B,A01,489185,Allen; Michael Gordon,9,0,30,21
1713318564873,COGS 101C,A01,526786,Staff,24,0,30,6
1713318566934,COGS 107A,A01,489189,Boyle; Mary E. T.,19,0,35,16
1713318567964,COGS 107B,A01,627144,Mooshagian; Eric Frederick,60,0,60,0
1713318568995,COGS 118A,A01,489191,Staff,0,40,40,40
1713318571050,COGS 171GS,A01,489194,Pineda; Jaime A,21,0,28,7
1713318572076,COGS 172,A01,489196,Staff,3,0,30,27
1713318573101,COGS 174GS,A01,489264,Pineda; Jaime A,21,0,28,7
1713318574131,COGS 180,A01,627150,Staff,28,0,30,2
1713318575161,COGS 186,A01,489274,Staff,0,0,30,30
1713318576187,COMM 10,A01,489276,Staff,23,0,25,2
1713318576187,COMM 10,A02,489303,Staff,23,0,25,2
1713318577216,COMM 100A,A01,489312,Staff,15,0,25,10
1713318577216,COMM 100A,A02,489313,Staff,24,0,25,1
1713318578244,COMM 106T,A00,512540,Staff,34,0,35,1
1713318579271,COMM 107,A00,489347,Staff,31,0,35,4
1713318580300,COMM 109P,A00,489358,Staff,31,0,35,4
1713318581330,COMM 132,A00,489361,McKenna; Denise,28,0,30,2
1713318582353,COMM 146,A00,489362,Halm; Gavin Patrick,27,0,30,3
1713318583378,COMM 190,A00,489363,Abuelhiga; Soraya Jill,20,0,23,3
1713318584411,CSE 8A,A50,489366,Staff,22,0,25,3
1713318584411,CSE 8A,A51,489367,Staff,24,0,25,1
1713318585434,CSE 11,A01,489398,Cao; Yingjun,79,0,100,21
1713318586466,CSE 12,A01,489487,Staff,43,0,50,7
1713318587494,CSE 20,A01,489497,Staff,48,0,50,2
1713318588520,CSE 21,A01,489517,Braun; Oliver,43,0,50,7
1713318589549,CSE 101,A01,489524,Braun; Oliver,0,23,50,50
1713318590579,CSE 105,A01,512594,Jones; Miles E,78,0,100,22
1713318590579,CSE 105,B01,512598,Jones; Miles E,57,0,100,43
1713318591605,CSE 140,A01,489538,Staff,43,0,50,7
1713318592631,CSE 141,A01,489550,Eldon; John,73,0,100,27
1713318593657,CSE 141L,A01,489571,Eldon; John,71,0,100,29
1713318594688,CSE 151A,A01,489583,Solares; Edwin A,147,0,200,53
1713318595716,CSE 175,A01,510886,Kumar; Rakesh,30,0,30,0
1713318596744,CSE 190,A00,516828,Dubnov; Shlomo,38,0,49,11
1713318597775,DOC 100D,A00,489667,Pass; Natalye Joann,19,0,25,6
1713318598802,DSC 10,A01,624268,Staff,72,0,75,3
1713318599828,DSC 20,A01,624476,Staff,50,0,50,0
1713318600852,DSC 40A,A01,624608,Staff,39,0,40,1
1713318601884,DSGN 1,A01,489179,Rill; Bryan,36,0,50,14
1713318602914,ECE 17,A01,490489,Sahay; Rajeev,18,0,30,12
1713318603941,ECE 65,A50,490492,Staff,14,0,20,6
1713318603941,ECE 65,A51,490493,Staff,20,0,20,0
1713318604971,ECON 1,A01,489715,Famulari; Melissa,68,0,70,2
1713318605996,ECON 2,A01,489717,Levkoff; Steven B.,68,0,70,2
1713318607025,ECON 3,A01,489948,Staff,70,0,70,0
1713318609080,ECON 5,A01,490103,Staff,28,0,30,2
1713318609080,ECON 5,B01,626281,Dai; Yinlin,45,0,45,0
1713318610107,ECON 100A,A01,490127,Famulari; Melissa,66,0,70,4
1713318611132,ECON 100B,A01,490129,Staff,64,0,70,6
1713318612161,ECON 109,A01,490187,Shishkin; Denis,27,0,35,8
1713318613189,ECON 110A,A01,490190,Levkoff; Steven B.,60,0,70,10
1713318614215,ECON 120A,A01,490245,Dai; Yinlin,62,0,70,8
1713318615246,ECON 120B,A01,490247,Nieto-Barthaburu; Augusto,52,0,70,18
1713318616279,ECON 120C,A01,490253,Sun; Yixiao,30,0,35,5
1713318616279,ECON 120C,B01,490255,Sun; Yixiao,34,0,35,1
1713318617312,ECON 129,A00,490256,Eckert; Fabian Paul,24,0,35,11
1713318618340,ECON 131,A00,490257,Nieto-Barthaburu; Augusto,0,5,35,35
1713318619367,ECON 138,A00,490258,Bharadwaj; Prashant,18,0,35,17
1713318619367,ECON 138,B00,490259,Bharadwaj; Prashant,17,0,35,18
1713318620394,ECON 159,A00,490260,Hendrickson; Gerald M.,0,8,0,0
1713318621425,ECON 178,A01,553995,Zhu; Ying,24,0,35,11
1713318622455,EDS 40,A01,512576,Black; Alison Michelle,20,0,20,0
1713318623484,EDS 107,A01,515848,Staff,30,0,30,0
1713318624509,EDS 110R,A01,490262,Staff,26,0,30,4
1713318625534,EDS 112,A01,490264,Chapman; Thandeka K,42,0,50,8
1713318626562,EDS 113,A00,490266,Staff,26,0,30,4
1713318627586,EDS 118,A00,490267,Warstadt; Melissa Fawn,22,0,30,8
1713318628611,EDS 124BR,A00,490268,Eguchi; Emi,6,0,25,19
1713318628611,EDS 124BR,B00,490269,Eguchi; Emi,25,0,25,0
1713318629638,EDS 126,A01,490271,Jones; Makeba,44,0,50,6
1713318630668,EDS 135,A01,490316,Staff,19,0,20,1
1713318631692,ENVR 142GS,A00,519514,Chang; Edmond Yi-Teh,28,0,28,0
1713318632718,ETHN 103,A00,490504,Staff,31,0,36,5
1713318633747,ETHN 103A,A00,490505,Man; Simeon S,5,0,9,4
1713318634772,ETHN 109,A00,490506,Staff,30,0,30,0
1713318635797,ETHN 118,A00,490507,Staff,35,0,36,1
1713318636822,ETHN 119,A00,490508,Staff,34,0,36,2
1713318637852,ETHN 121R,A00,490518,Choi; Esther Min,25,0,36,11
1713318638880,ETHN 127,A00,490528,Staff,15,0,15,0
1713318639905,ETHN 139,A00,490573,Staff,10,0,10,0
1713318640933,ETHN 150,A00,490575,Staff,15,0,15,0
1713318641964,GLBH 20,A00,491705,Elwardani; Nile Regina,38,0,40,2
1713318642989,GLBH 101,A00,491706,Staff,20,0,20,0
1713318644013,GLBH 111,A01,491708,Burgos; Jose L.,15,0,15,0
1713318645038,GLBH 146,A00,491709,Staff,11,0,20,9
1713318646064,GLBH 148,A00,491710,Olivas Hernandez; Olga Lid,13,0,20,7
1713318647090,GLBH 150,A00,491711,Sloane; Julia Kathryn,20,0,20,0
1713318648115,HIEA 131,A00,491760,Staff,29,0,32,3
1713318649145,HIEA 153,A00,491762,Staff,29,0,30,1
1713318650170,HIEU 124,A00,491811,Staff,26,0,32,6
1713318651194,HIEU 124GS,A00,491812,Markman; Kristina,27,0,28,1
1713318652220,HIEU 147,A00,491813,Staff,30,0,32,2
1713318653247,HIEU 149GS,A00,491816,Caldwell; Michael Alan,28,0,28,0
1713318654277,HILD 2C,A01,491713,Hendrickson; Gerald M.,27,0,30,3
1713318655302,HILD 7B,A01,491715,Kwak; Nancy,4,0,30,26
1713318656327,HILD 10,A01,491717,Staff,13,0,20,7
1713318657352,HILD 30GS,A00,491719,Edington; Claire Ellen,24,0,28,4
1713318658380,HINE 109,A00,491818,Shafir; Nir,27,0,32,5
1713318659461,HINE 128,A00,491821,Shafir; Nir,31,0,32,1
1713318660485,HISC 117,A00,491830,Staff,28,0,32,4
1713318661510,HIUS 103,A00,491834,Man; Simeon S,15,0,23,8
1713318662533,HIUS 108B,A00,491835,Staff,29,0,30,1
1713318663562,HIUS 141,A00,491836,Hendrickson; Gerald M.,29,0,32,3
1713318664588,HIUS 149,A00,491839,Staff,27,0,32,5
1713318665618,HUM 3,A01,512617,Crum; Matthew Stephen,44,0,50,6
1713318665618,HUM 3,A02,512618,Crum; Matthew Stephen,48,0,50,2
1713318666643,HUM 3GS,A00,512663,Markman; Kristina,0,0,0,1
1713318666643,HUM 3GS,B00,512664,Staff,0,0,0,0
1713318667668,HUM 4,A01,512620,West; Geoffrey Scott,30,0,50,20
1713318668692,HUM 4GS,A00,512666,Lyon; Antony J.,0,0,0,3
1713318669720,HUM 4R,A01,512625,Watkins; Eric,49,0,50,1
1713318670753,HUM 5,A01,512649,Zavodny; Tatiana Sophia,27,0,50,23
1713318670753,HUM 5,B01,512661,Zroka; Ryan Edward,48,0,50,2
1713318671781,INTL 190,A00,490577,Segui; Alan S,0,0,0,5
1713318672810,JAPN 20AR,A01,491267,Ross; Kayoko F,8,0,20,12
1713318673838,JAPN 180,A00,491285,Berman; Michael David,34,0,40,6
1713318674869,LATI 50,A01,502536,Kokinis; Troy Andreas,16,0,22,6
1713318674869,LATI 50,A02,502551,Kokinis; Troy Andreas,22,0,22,0
1713318674869,LATI 50,A03,502650,Kokinis; Troy Andreas,22,0,22,0
1713318674869,LATI 50,A04,502909,Kokinis; Troy Andreas,22,0,22,0
1713318675898,LATI 160,A01,502920,Kokinis; Troy Andreas,30,0,30,0
1713318676922,LIFR 1A,A00,490494,Van Moer; Vinciane G,17,0,20,3
1713318677948,LIFR 1AX,A00,490495,Van Moer; Vinciane G,17,0,20,3
1713318678977,LIFR 1B,A00,490496,Van Moer; Vinciane G,18,0,20,2
1713318680003,LIFR 1BX,A00,490497,Van Moer; Vinciane G,18,0,20,2
1713318681037,LIGN 8,A00,505198,McIntosh; Justin Daniel,136,0,150,14
1713318682062,LIGN 9GS,A00,491239,Lott; Margaret S.,18,0,20,2
1713318683092,LIGN 101,A01,505200,McIntosh; Justin Daniel,24,0,30,6
1713318684116,LIGN 120,A01,491244,Staff,24,0,30,6
1713318685141,LIGN 149GS,A00,491245,Lott; Margaret S.,18,0,20,2
1713318686167,LIGN 170,A00,491247,Staff,24,0,30,6
1713318687197,LISP 1D,A00,490498,Munoz Sanchez; Alicia,10,0,14,4
1713318687197,LISP 1D,B00,490499,Munoz Sanchez; Alicia,6,0,14,8
1713318687197,LISP 1D,C00,490500,Munoz Sanchez; Alicia,8,0,14,6
1713318687197,LISP 1D,D00,490501,Munoz Sanchez; Alicia,10,0,14,4
1713318688222,LISP 1DX,A00,490502,Munoz Sanchez; Alicia,15,0,28,13
1713318688222,LISP 1DX,B00,490503,Munoz Sanchez; Alicia,17,0,28,11
1713318690280,LTAM 110,A00,491847,Staff,23,0,25,2
1713318691306,LTCS 119,A00,491848,Staff,11,0,15,4
1713318692332,LTCS 130,A00,491849,Staff,24,0,25,1
1713318694383,LTEA 120C,A00,491852,Staff,34,0,40,6
1713318695409,LTEN 130GS,A00,491853,Lyon; Antony J.,25,0,28,3
1713318696435,LTEN 148,A00,491855,Staff,23,0,25,2
1713318697467,LTEN 159,A00,491856,Staff,21,0,25,4
1713318698493,LTEN 180,A00,491857,Staff,8,0,15,7
1713318700550,LTSP 123GS,A00,505928,Bessett; Ryan Matthew,24,0,28,4
1713318701575,LTSP 174GS,A00,506037,Bessett; Ryan Matthew,24,0,28,4
1713318703632,LTWR 102,A00,491861,Staff,11,0,15,4
1713318704657,LTWR 106,A00,491862,Staff,10,0,15,5
1713318705684,MAE 11,A00,490930,Bahadori; Mohammad Yousef,96,0,100,4
1713318706709,MAE 30A,A00,490931,Qi; Huihui,37,0,40,3
1713318707733,MAE 101A,A00,491036,Sadeghizadeh; Zahra,96,0,100,4
1713318708764,MAE 101C,A00,491037,Seshadri; Kalyanasundaram,72,0,100,28
1713318709790,MAE 113,A00,491040,Seshadri; Kalyanasundaram,66,0,80,14
1713318710816,MAE 131A,A00,491041,Ghazinejad; Maziar,38,0,40,2
1713318711841,MAE 142,A00,491053,Staff,39,0,40,1
1713318712867,MAE 143A,A00,491054,Staff,34,0,50,16
1713318713899,MAE 150,A00,491092,Truong; Phuong Thi Ngoc,23,0,35,12
1713318714924,MATH 3C,A01,494031,Pardo Guerra; Sebastian,30,0,30,0
1713318714924,MATH 3C,A02,494032,Pardo Guerra; Sebastian,29,0,30,1
1713318715952,MATH 10A,A01,494034,Staff,27,0,30,3
1713318715952,MATH 10A,A02,494035,Staff,28,0,30,2
1713318715952,MATH 10A,B01,494037,Staff,27,0,30,3
1713318715952,MATH 10A,B02,494038,Staff,29,0,30,1
1713318716985,MATH 10B,A01,494040,Habib; Yousaf,23,0,30,7
1713318716985,MATH 10B,A02,494041,Habib; Yousaf,28,0,30,2
1713318716985,MATH 10B,A03,494042,Habib; Yousaf,30,0,30,0
1713318716985,MATH 10B,A04,494043,Habib; Yousaf,30,0,30,0
1713318716985,MATH 10B,B01,494045,Habib; Yousaf,27,0,30,3
1713318716985,MATH 10B,B02,494046,Habib; Yousaf,30,0,30,0
1713318716985,MATH 10B,B03,494047,Habib; Yousaf,30,0,30,0
1713318716985,MATH 10B,B04,494048,Habib; Yousaf,30,0,30,0
1713318718028,MATH 18,A01,494050,Kemp; Todd Aahron,25,0,30,5
1713318718028,MATH 18,A02,494051,Kemp; Todd Aahron,29,0,30,1
1713318718028,MATH 18,B01,494054,Kemp; Todd Aahron,28,0,30,2
1713318718028,MATH 18,B02,494055,Kemp; Todd Aahron,29,0,30,1
1713318719054,MATH 20A,A01,494059,Suk; Andrew Hoon,30,0,30,0
1713318720080,MATH 20B,A01,494061,Briones; Jor-el Thomas Caparas,33,0,35,2
1713318720080,MATH 20B,B01,494063,Bach; Quang Tran,34,0,35,1
1713318721112,MATH 20C,A01,494065,Staff,28,0,30,2
1713318721112,MATH 20C,A02,494066,Staff,30,0,30,0
1713318721112,MATH 20C,A03,494067,Staff,30,0,30,0
1713318721112,MATH 20C,A04,494068,Staff,30,0,30,0
1713318721112,MATH 20C,B01,494070,Zhang; Ming,26,0,30,4
1713318721112,MATH 20C,B02,494071,Zhang; Ming,28,0,30,2
1713318721112,MATH 20C,B03,494072,Zhang; Ming,29,0,30,1
1713318721112,MATH 20C,B04,494073,Zhang; Ming,29,0,30,1
1713318722139,MATH 20D,A01,494075,Staff,22,0,30,8
1713318722139,MATH 20D,A02,494076,Staff,30,0,30,0
1713318723165,MATH 20E,A01,494079,Staff,24,0,30,6
1713318723165,MATH 20E,A02,494080,Staff,26,0,30,4
1713318723165,MATH 20E,B01,494082,Staff,25,0,30,5
1713318723165,MATH 20E,B02,494083,Staff,25,0,30,5
1713318724190,MATH 103A,A01,494085,Aliabadi Sr.; Mohsen,14,0,30,16
1713318724190,MATH 103A,A02,494086,Aliabadi Sr.; Mohsen,28,0,30,2
1713318724190,MATH 103A,B01,494088,Aliabadi Sr.; Mohsen,22,0,30,8
1713318724190,MATH 103A,B02,494089,Aliabadi Sr.; Mohsen,28,0,30,2
1713318725217,MATH 109,A01,494091,Staff,30,0,30,0
1713318725217,MATH 109,A02,494092,Staff,29,0,30,1
1713318725217,MATH 109,B01,494094,Staff,28,0,30,2
1713318725217,MATH 109,B02,494095,Staff,29,0,30,1
1713318726242,MATH 142A,A01,494097,Chow; Bennett,16,0,30,14
1713318726242,MATH 142A,A02,494098,Chow; Bennett,24,0,30,6
1713318726242,MATH 142A,B01,494100,Chow; Bennett,19,0,30,11
1713318726242,MATH 142A,B02,494101,Chow; Bennett,29,0,30,1
1713318728295,MATH 168A,A01,516677,Dumitriu; Ioana,15,0,35,20
1713318729322,MATH 170A,A01,516679,Dumitriu; Ioana,20,0,30,10
1713318729322,MATH 170A,A02,516680,Dumitriu; Ioana,28,0,30,2
1713318730358,MATH 193A,A01,494107,Staff,15,0,30,15
1713318730358,MATH 193A,A02,494108,Staff,21,0,30,9
1713318730358,MATH 193A,A03,494109,Staff,29,0,30,1
1713318730358,MATH 193A,A04,494110,Staff,22,0,30,8
1713318733439,MGT 16,A00,491930,McKay; Michael J,92,0,98,6
1713318734464,MGT 18,A00,491992,McKay; Michael J,97,0,98,1
1713318735490,MGT 71,A00,492003,Staff,72,0,98,26
1713318736515,MGT 103,A00,505209,Eberhard; Craig A,83,0,98,15
1713318737542,MGT 131A,A00,505210,Anderson; John Charles,90,0,98,8
1713318739597,MGT 153,A00,492077,Perols; Johan Lars,28,0,90,62
1713318742710,MGT 164,A00,492222,McKay; Mary A,93,0,98,5
1713318743735,MGT 172,A00,492245,Staff,59,0,60,1
1713318743735,MGT 172,B00,505526,Hedges; Kathleen,72,0,98,26
1713318744764,MGT 181,A00,505669,Dunn; Louis Jean,84,0,98,14
1713318745795,MMW 14,A01,494399,Staff,22,0,28,6
1713318745795,MMW 14,A02,494400,Staff,25,0,28,3
1713318745795,MMW 14,A03,494401,Staff,28,0,28,0
1713318745795,MMW 14,A04,494402,Staff,28,0,28,0
1713318745795,MMW 14,B01,494404,Carreras; Maria Victoria,13,0,28,15
1713318745795,MMW 14,B02,494405,Carreras; Maria Victoria,26,0,28,2
1713318745795,MMW 14,B03,494406,Carreras; Maria Victoria,28,0,28,0
1713318745795,MMW 14,B04,494407,Carreras; Maria Victoria,28,0,28,0
1713318746822,MMW 14GS,A00,506250,Chang; Edmond Yi-Teh,0,0,0,0
1713318747847,MMW 121R,A01,494415,Adamiak; Patrick John,12,0,28,16
1713318747847,MMW 121R,A02,494416,Adamiak; Patrick John,24,0,28,4
1713318748878,MUS 1A,A01,494113,Staff,12,0,25,13
1713318748878,MUS 1A,A02,494114,Staff,25,0,25,0
1713318749909,MUS 4,A01,494116,Staff,24,0,25,1
1713318749909,MUS 4,A02,494117,Staff,22,0,25,3
1713318750940,MUS 5R,A01,494236,Dubnov; Shlomo,10,0,25,15
1713318750940,MUS 5R,A02,494237,Dubnov; Shlomo,25,0,25,0
1713318751966,MUS 6,A01,494122,Staff,12,0,25,13
1713318751966,MUS 6,A02,494123,Staff,24,0,25,1
1713318752995,MUS 7,A01,494125,Staff,16,0,25,9
1713318752995,MUS 7,A02,494126,Staff,24,0,25,1
1713318754021,MUS 11,A01,494128,Staff,23,0,25,2
1713318754021,MUS 11,A02,494129,Staff,24,0,25,1
1713318755048,MUS 13,A01,494131,Staff,25,0,25,0
1713318755048,MUS 13,A02,494132,Staff,25,0,25,0
1713318756074,MUS 15,A01,494134,Staff,17,0,25,8
1713318756074,MUS 15,A02,494135,Staff,25,0,25,0
1713318756074,MUS 15,B01,494137,Staff,24,0,25,1
1713318757098,MUS 80,A00,494232,Staff,24,0,25,1
1713318757098,MUS 80,B00,494233,Staff,25,0,25,0
1713318757098,MUS 80,C00,494234,Staff,23,0,25,2
1713318758124,MUS 95C,A00,494141,Staff,72,0,75,3
1713318759152,MUS 114,A00,494142,Staff,40,0,50,10
1713318760181,NANO 15,A01,490636,Drews; Aaron,7,0,7,0
1713318761207,PHIL 1,A00,490578,Grush; Rick Scott,49,0,50,1
1713318762234,PHIL 10,A01,490580,Grush; Rick Scott,33,0,35,2
1713318762234,PHIL 10,A02,490586,Grush; Rick Scott,33,0,35,2
1713318763316,PHIL 27,A01,490591,Staff,23,0,25,2
1713318763316,PHIL 27,A02,490592,Staff,25,0,25,0
1713318763316,PHIL 27,A03,490593,Staff,25,0,25,0
1713318763316,PHIL 27,A04,490598,Staff,25,0,25,0
1713318764341,PHIL 32,A01,490611,Staff,20,0,20,0
1713318764341,PHIL 32,A02,490618,Staff,20,0,20,0
1713318765368,PHIL 90,A00,490624,Staff,40,0,40,0
1713318766396,PHIL 136,A00,490627,Cohen; Jonathan David,38,0,40,2
1713318767424,PHIL 155,A00,490634,Staff,63,0,70,7
1713318768448,PHYS 1A,A00,491610,Staff,246,0,250,4
1713318769477,PHYS 1AL,001,491616,Tsai; Philbert S,28,0,30,2
1713318769477,PHYS 1AL,002,491618,Tsai; Philbert S,30,0,30,0
1713318770502,PHYS 1B,A00,491623,Staff,242,0,250,8
1713318771531,PHYS 1BL,001,491626,Tsai; Philbert S,25,0,30,5
1713318771531,PHYS 1BL,002,491628,Tsai; Philbert S,27,0,30,3
1713318772558,PHYS 1C,A00,491632,Staff,220,0,245,25
1713318773582,PHYS 1CL,001,491635,Tsai; Philbert S,10,0,30,20
1713318773582,PHYS 1CL,002,491643,Tsai; Philbert S,24,0,30,6
1713318774613,PHYS 2AR,A01,491651,Meyertholen; Andrew D.,44,0,50,6
1713318775642,PHYS 2B,A01,491659,Staff,106,0,115,9
1713318776669,PHYS 2BL,A01,491685,Staff,21,0,24,3
1713318776669,PHYS 2BL,A02,491700,Staff,23,0,24,1
1713318777697,PHYS 2C,A01,505161,Staff,106,0,115,9
1713318778722,PHYS 4A,A01,491704,Grinstein; Benjamin,99,0,100,1
1713318779750,POLI 5D,A01,494144,Staff,3,0,5,2
1713318779750,POLI 5D,B01,626283,Dai; Yinlin,5,0,5,0
1713318780775,POLI 12,A00,494145,Staff,44,0,45,1
1713318781803,POLI 13R,A00,494146,Forman; Fonna,45,0,50,5
1713318782828,POLI 27,A01,494148,Staff,57,0,60,3
1713318783854,POLI 30,A00,494149,Staff,49,0,50,1
1713318784882,POLI 100DA,A00,494150,Staff,21,0,25,4
1713318786937,POLI 100I,A00,494152,Staff,28,0,30,2
1713318787968,POLI 104B,A00,494153,Smith; Glenn Chatmas,53,0,55,2
1713318788993,POLI 104F,A00,494154,Staff,28,0,30,2
1713318790020,POLI 104I,A00,494155,Smith; Glenn Chatmas,30,0,30,0
1713318791044,POLI 110C,A00,494156,Ingham; Sean,23,0,25,2
1713318792070,POLI 117R,A00,494157,Forman; Fonna,10,0,20,10
1713318793095,POLI 118,A00,494158,Ingham; Sean,22,0,25,3
1713318794121,POLI 120H,A00,494159,Fisk; David Lee,40,0,45,5
1713318795145,POLI 131CR,A00,494160,Hoston; Germaine,36,0,45,9
1713318796172,POLI 133J,A00,494161,Staff,33,0,35,2
1713318797199,POLI 135,A00,494162,Fisk; David Lee,33,0,35,2
1713318798224,POLI 140A,A00,494164,Staff,21,0,30,9
1713318799250,POLI 142I,A00,494165,Staff,30,0,30,0
1713318800275,POLI 144D,A00,494166,Staff,23,0,25,2
1713318801299,POLI 151,A00,494167,Staff,30,0,30,0
1713318802326,POLI 153,A00,494168,Staff,33,0,35,2
1713318803354,POLI 160AA,A00,494169,Staff,35,0,40,5
1713318804379,POLI 162,A00,494170,Mignozzetti; Umberto,20,0,25,5
1713318805404,POLI 171,A00,494171,Mignozzetti; Umberto,21,0,25,4
1713318806432,PSYC 1,A00,494172,Staff,97,0,100,3
1713318807460,PSYC 2,A00,494173,Moranton; Nirelia Melbina-,41,0,50,9
1713318808484,PSYC 3,A00,494174,Staff,29,0,30,1
1713318809512,PSYC 6,A00,494175,Staff,17,0,20,3
1713318810535,PSYC 60,A01,494177,Staff,39,0,45,6
1713318811563,PSYC 70,A01,505724,Geller; Emma Harlan,42,0,45,3
1713318812592,PSYC 101,A00,494180,Heyman; Gail D.,86,0,100,14
1713318813617,PSYC 105,A00,494181,Geller; Emma Harlan,59,0,90,31
1713318814642,PSYC 106,A00,494182,Dobkins; Karen R.,29,0,45,16
1713318815668,PSYC 108,A00,494183,Adrian; Julia Anna,91,0,100,9
1713318816694,PSYC 114,A01,494185,Winkielman; Piotr,0,0,30,30
1713318817722,PSYC 122,A00,494186,Moranton; Nirelia Melbina-,34,0,50,16
1713318818750,PSYC 124,A00,494187,Chapman; Eddie Nathaniel,72,0,80,8
1713318819775,PSYC 131,A00,494188,Anagnostaras; Stephan,51,0,80,29
1713318820800,PSYC 144,A00,494189,Staff,13,0,50,37
1713318821829,PSYC 154,A00,494190,Lacefield; Katharine I,123,0,180,57
1713318822853,PSYC 162,A00,494191,Wixted; John T,76,0,100,24
1713318823891,PSYC 172,A00,494192,Gorman; Michael R.,37,0,45,8
1713318824917,PSYC 178,A00,494193,Glaser; Dale,39,0,45,6
1713318825942,PSYC 193,A00,505725,Chapman; Eddie Nathaniel,20,0,20,0
1713318826966,RELI 145GS,A00,519817,Rahimi; Babak,18,0,20,2
1713318827993,SE 101A,A01,490862,Chadha; Mayank,23,0,25,2
1713318829022,SE 101C,A01,490924,Krysl; Petr,17,0,20,3
1713318830046,SE 110A,A01,490928,Staff,19,0,20,1
1713318831072,SE 130A,A00,490929,Morrison; Machel Leigh,59,0,70,11
1713318832096,SIO 1,A01,519325,Staff,39,0,40,1
1713318833122,SIO 30,A01,519327,Staff,38,0,40,2
1713318834146,SIO 40,A00,519328,Staff,40,0,40,0
1713318835172,SIO 46GS,A00,519819,Cook; Geoffrey W,17,0,25,8
1713318836195,SIO 109R,A00,494197,Forman; Fonna,4,0,20,16
1713318837218,SIO 121GS,A00,519827,Cook; Geoffrey W,17,0,25,8
1713318838243,SIO 132,A01,519330,Staff,38,0,40,2
1713318839271,SIO 133,A01,519397,Staff,37,0,40,3
1713318840298,SIO 139,A00,519396,Kacev; David,31,0,40,9
1713318841324,SOCI 1,A01,494199,Thorpe; Charles Robert,23,0,30,7
1713318841324,SOCI 1,A02,494200,Thorpe; Charles Robert,30,0,30,0
1713318841324,SOCI 1,A03,494201,Thorpe; Charles Robert,29,0,30,1
1713318841324,SOCI 1,A04,494202,Thorpe; Charles Robert,29,0,30,1
1713318841324,SOCI 1,A05,494203,Thorpe; Charles Robert,29,0,30,1
1713318841324,SOCI 1,A06,494204,Thorpe; Charles Robert,30,0,30,0
1713318841324,SOCI 1,A07,494205,Thorpe; Charles Robert,29,0,30,1
1713318842350,SOCI 60,A01,494207,Staff,35,0,40,5
1713318842350,SOCI 60,A02,494208,Staff,39,0,40,1
1713318843375,SOCI 100,A01,494210,Payne; Christine Anna,27,0,30,3
1713318843375,SOCI 100,A02,494211,Payne; Christine Anna,26,0,30,4
1713318844401,SOCI 109M,A00,494212,Staff,20,0,20,0
1713318845428,SOCI 110,A00,494213,Staff,35,0,40,5
1713318847480,SOCI 118E,A00,494215,Ng; Kwai,38,0,40,2
1713318848508,SOCI 125,A00,494216,Calderon-Zaks; Michael Aar,42,0,45,3
1713318849532,SOCI 126,A01,494218,Jones; Makeba,3,0,5,2
1713318850560,SOCI 131,A00,494219,Thorpe; Charles Robert,28,0,30,2
1713318852616,SOCI 135,A00,494221,Payne; Christine Anna,33,0,50,17
1713318853647,SOCI 136E,A00,626690,Ruiz; Jonathan Joseph,25,0,25,0
1713318854671,SOCI 138GS,A00,494222,Navon; Daniel,24,0,28,4
1713318856725,SOCI 145,A00,494224,Staff,42,0,45,3
1713318857751,SOCI 153,A00,494225,Staff,28,0,30,2
1713318858780,SOCI 160E,A00,494226,Ng; Kwai,32,0,40,8
1713318859804,SOCI 180,A00,494227,Staff,29,0,30,1
1713318860830,SOCI 189GS,A00,494228,Ribas Norris; Janet Vanesa,11,0,11,0
1713318861858,SOCI 190GS,A00,553232,Ribas Norris; Janet Vanesa,11,0,11,0
1713318862887,SOMI 220,A00,627178,Schneid; Stephen David,30,0,30,0
1713318863912,SYN 2,001,490768,Staff,14,0,15,1
1713318863912,SYN 2,002,490769,Staff,15,0,15,0
1713318863912,SYN 2,004,490775,Staff,0,0,0,0
1713318863912,SYN 2,003,490774,Staff,0,0,0,0
1713318863912,SYN 2,005,490776,Staff,0,0,0,0
1713318864942,SYN 2R,001,490779,Staff,12,0,15,3
1713318864942,SYN 2R,002,514635,Staff,14,0,15,1
1713318865973,SYN 100,A01,490783,Staff,15,0,20,5
1713318865973,SYN 100,B01,490787,Staff,10,0,20,10
1713318865973,SYN 100,C01,490789,Staff,12,0,20,8
1713318867052,SYN 150,A00,490817,Staff,14,0,15,1
1713318867052,SYN 150,B00,514610,Staff,15,0,15,0
1713318868084,TDAC 1,A00,492753,Walsh; Kim C.,19,0,20,1
1713318868084,TDAC 1,B00,492754,Harting; Carla Kelso,19,0,20,1
1713318868084,TDAC 1,C00,513995,Salovey; Todd,15,0,20,5
1713318869116,TDAC 101,A00,492766,Harting; Carla Kelso,17,0,20,3
1713318870144,TDAC 102,A00,492768,Basso; Beatrice,19,0,20,1
1713318871172,TDDE 111,A00,492769,Staff,25,0,25,0
1713318872198,TDDE 131,A00,492770,Staff,15,0,15,0
1713318872198,TDDE 131,B00,492771,Staff,15,0,15,0
1713318873223,TDDE 131GS,A00,523716,Guirguis; Mark C,24,0,28,4
1713318874248,TDGE 1,A01,492756,Salovey; Todd,57,0,60,3
1713318875273,TDGE 5,A01,492758,Staff,24,0,25,1
1713318876301,TDGE 10,A00,492759,Fulton; Julia,207,0,220,13
1713318877332,TDGE 11,A00,492760,Castro; Robert Jess,199,0,200,1
1713318879379,TDGE 124,A00,492772,Fulton; Julia,191,0,220,29
1713318880406,TDGE 125,A00,492773,Meyer; Ursula,40,0,50,10
1713318880406,TDGE 125,B00,492774,Staff,49,0,50,1
1713318880406,TDGE 125,C00,523565,Staff,48,0,50,2
1713318881433,TDGE 125GS,A00,523580,Guirguis; Mark C,24,0,28,4
1713318882464,TDGE 127,A00,492775,Havis; Allan,40,0,50,10
1713318883489,TDHT 101,A00,492776,Staff,35,0,35,0
1713318884520,TDMV 1,A00,492762,Caligagan; Maria T.,30,0,30,0
1713318884520,TDMV 1,B00,492763,Arcidiacono; Kristin,25,0,30,5
1713318885546,TDMV 2,A00,492764,Weinberg; Sadie,29,0,30,1
1713318886577,TDMV 3,A00,492765,Mack; Kara Shanai',39,0,40,1
1713318887605,TDMV 138,A00,492777,Mack; Kara Shanai',35,0,40,5
1713318888631,TDMV 140,A00,492778,Lima; Paulo Henrique,40,0,40,0
1713318889658,TDMV 142,A00,492779,Caligagan; Maria T.,35,0,40,5
1713318889658,TDMV 142,B00,492780,Caligagan; Tony,37,0,40,3
1713318890683,TDMV 143,A00,492781,Fyall; Daunte Edward,39,0,40,1
1713318891711,USP 1,A01,492401,Kwak; Nancy,26,0,35,9
1713318892741,USP 2,A01,492453,Hinds; Juli Beth,35,0,35,0
1713318893766,USP 3,A01,492516,Staff,29,0,35,6
1713318894797,USP 4,A00,492522,McTague; Sarah,19,0,25,6
1713318895825,USP 100,A00,492523,Staff,33,0,35,2
1713318896850,USP 101,A00,492524,Staff,13,0,15,2
1713318897877,USP 105,A00,492525,Staff,21,0,25,4
1713318898903,USP 151,A00,492526,Shenkman; Michael Thomas,32,0,35,3
1713318899930,USP 170,A00,492545,Hinds; Juli Beth,33,0,35,2
1713318900956,USP 171GS,A00,492608,Bussell; Mirle Rabinowitz,24,0,28,4
1713318901987,USP 183GS,A00,492613,Peerson; Susan,24,0,28,4
1713318903015,VIS 30,A01,490693,Yoldas; Pinar,20,0,22,2
1713318903015,VIS 30,A02,490694,Yoldas; Pinar,18,0,22,4
1713318904043,VIS 83,A00,490695,Kester; Grant,64,0,75,11
1713318905069,VIS 105D,A00,490696,Staff,22,0,25,3
1713318906095,VIS 124CN,A00,490699,Rose; Jordan M,68,0,75,7
1713318907124,VIS 125GS,A00,511221,Williams; Alena J,21,0,22,1
1713318908150,VIS 128D,A00,490700,Staff,73,0,75,2
1713318909179,VIS 151,A01,490717,Staff,33,0,34,1
1713318909179,VIS 151,A02,490766,Staff,33,0,34,1
1713318910207,VIS 154GS,A00,511972,Williams; Alena J,21,0,22,1
1713318911235,VIS 160A,A00,490767,Stone; Patricia,7,0,10,3
1713318912259,WCWP 10A,A00,490638,Staff,14,0,15,1
1713318912259,WCWP 10A,B00,490640,Staff,15,0,15,0
1713318913288,WCWP 10B,A00,490641,Staff,0,0,0,0
1713318913288,WCWP 10B,B00,490642,Staff,14,0,15,1
1713318913288,WCWP 10B,C00,490644,Staff,13,0,15,2
1713318913288,WCWP 10B,D00,490647,Staff,0,0,0,0
1713318914312,WCWP 100,A00,490655,Staff,0,0,0,0
1713318914312,WCWP 100,B00,490687,Staff,10,0,15,5
1713318916407,ANAR 153,A00,487222,Braswell; Geoffrey E.,54,0,60,6
1713318917435,ANBI 134,A00,487223,Staff,8,0,20,12
1713318918460,ANBI 143GS,A00,487224,Noel; Geoffroy Pierre Jean,19,0,24,5
1713318919489,ANBI 144GS,A00,519548,Noel; Geoffroy Pierre Jean,19,0,24,5
1713318920519,ANSC 101,A00,487225,Staff,19,0,20,1
1713318921547,ANSC 125,A00,487227,Brenner; Suzanne A,39,0,40,1
1713318923600,ANSC 146,A00,487229,Staff,35,0,40,5
1713318924630,ANSC 148,A00,487230,Olivas Hernandez; Olga Lid,39,0,40,1
1713318925663,ANSC 150,A00,504165,Sloane; Julia Kathryn,19,0,20,1
1713318926694,ANSC 180,A00,487232,Staff,13,0,15,2
1713318927722,ANSC 188,A00,627155,Staff,39,0,40,1
1713318928752,ANTH 5,A00,519529,Semendeferi; Ekaterini,15,0,15,0
1713318929780,ANTH 10,A00,487219,Staff,58,0,60,2
1713318930807,ANTH 23,A01,487221,Staff,17,0,20,3
1713318931856,ANTH 102,A00,487233,Wilder; Linnea Lorene,51,0,60,9
1713318932886,ANTH 103,A00,487234,Varma; Saiba,56,0,60,4
1713318933912,ANTH 105,A00,487235,Stewart; Alexander B,55,0,60,5
1713318934936,BENG 100,A01,516685,Taylor Amos; Alyssa C,28,0,30,2
1713318935968,BIBC 102,A01,491316,Flagg; Matthew Paul,29,0,88,59
1713318935968,BIBC 102,A02,491366,Flagg; Matthew Paul,82,0,88,6
1713318936994,BIBC 103,A01,491486,Boumechache; Miyyada,16,0,24,8
1713318936994,BIBC 103,A02,491487,Boumechache; Miyyada,24,0,24,0
1713318938021,BICD 100,A01,516882,Staff,75,0,75,0
1713318938021,BICD 100,A02,516890,Staff,69,0,75,6
1713318939046,BICD 102GS,A00,491488,Lo; Stanley M.,26,0,28,2
1713318940077,BIEB 136GS,A00,516940,Holway; David A. & Shurin; Jonathan,19,0,24,5
1713318941102,BIEB 137GS,A01,517034,Holway; David A. & Shurin; Jonathan,19,0,24,5
1713318942129,BIEB 138GS,A01,491492,Pirino; Giorgia,21,0,28,7
1713318943152,BILD 1,A01,491296,Staff,62,0,63,1
1713318943152,BILD 1,A02,491297,Staff,63,0,63,0
1713318944177,BILD 4,A01,517099,Gonzalez Gamboa; Ivonne,22,0,24,2
1713318944177,BILD 4,A02,517100,Gonzalez Gamboa; Ivonne,24,0,24,0
1713318945205,BILD 60GS,A00,491309,Lo; Stanley M.,26,0,28,2
1713318946234,BIMM 100,A01,517136,Staff,87,0,100,13
1713318947260,BIMM 110,A01,517182,Staff,64,0,100,36
1713318948286,BIMM 120,A01,517228,Pickett; Brooke Elizabeth,36,0,63,27
1713318948286,BIMM 120,A02,517240,Pickett; Brooke Elizabeth,46,0,63,17
1713318949311,BIMM 132GS,A01,491498,Pirino; Giorgia,21,0,28,7
1713318950341,BIMM 143,A01,491589,Bozinovic; Goran,16,0,40,24
1713318951370,BIPN 100,A01,491594,Armour; Jon Christopher,90,0,100,10
1713318952396,BIPN 140,A01,491602,Marino; Marc J,28,0,50,22
1713318954449,CAT 125,A00,515973,Staff,19,0,20,1
1713318955479,CAT 125GS,A00,515974,Rahimi; Babak,18,0,20,2
1713318956507,CAT 125R,A00,515980,Staff,14,0,20,6
1713318956507,CAT 125R,B00,515981,Tosun; Adriana,19,0,20,1
1713318956507,CAT 125R,C00,515987,Hyland; Tina Mae,0,0,20,20
1713318956507,CAT 125R,D00,515988,Bronstein; Phoebe Malan,18,0,20,2
1713318957537,CENG 15,A01,488699,Drews; Aaron,25,0,25,0
1713318958565,CENG 100,A00,505196,Opatkiewicz; Justin Paul,25,0,25,0
1713318959592,CGS 2A,A01,489598,Staff,33,0,35,2
1713318960617,CGS 112,A00,489599,Staff,15,0,15,0
1713318961682,CGS 119,A00,489603,Staff,10,0,10,0
1713318962709,CGS 120,A00,489604,Staff,14,0,15,1
1713318963738,CGS 150,A00,489607,Staff,15,0,15,0
1713318964769,CHEM 6A,A01,488715,Staff,98,0,100,2
1713318965799,CHEM 6B,A01,488719,Piercy; Marc Anthony,100,0,100,0
1713318966829,CHEM 6C,A01,488723,Albizati; Kim F.,94,0,100,6
1713318967864,CHEM 7L,A01,488728,Schurmeier; Kimberly,18,0,24,6
1713318967864,CHEM 7L,A02,488730,Schurmeier; Kimberly,23,0,24,1
1713318967864,CHEM 7L,A03,488734,Schurmeier; Kimberly,23,0,24,1
1713318967864,CHEM 7L,A04,488763,Schurmeier; Kimberly,23,0,24,1
1713318967864,CHEM 7L,B01,488798,Schurmeier; Kimberly,17,0,24,7
1713318967864,CHEM 7L,B02,488801,Schurmeier; Kimberly,23,0,24,1
1713318967864,CHEM 7L,B03,488808,Schurmeier; Kimberly,24,0,24,0
1713318967864,CHEM 7L,B04,488811,Schurmeier; Kimberly,24,0,24,0
1713318968890,CHEM 11,A01,488897,Stallings; Dontarie M,97,0,100,3
1713318969920,CHEM 40A,A01,488913,Albizati; Kim F.,88,0,100,12
1713318970998,CHEM 40B,A01,488920,Weizman; Haim,44,0,50,6
1713318970998,CHEM 40B,A02,488938,Weizman; Haim,45,0,50,5
1713318972028,CHEM 41A,A01,489029,Klosterman; Jeremy K,57,0,60,3
1713318973055,CHEM 41C,A01,500436,Tor; Yitzhak,55,0,60,5
1713318974083,CHEM 43A,A01,500426,Weizman; Haim,0,0,24,24
1713318974083,CHEM 43A,A02,500430,Weizman; Haim,13,0,24,11
1713318974083,CHEM 43A,B01,514041,Klosterman; Jeremy K,15,0,24,9
1713318974083,CHEM 43A,B02,514047,Klosterman; Jeremy K,23,0,24,1
1713318975109,CHEM 108,A01,489140,Jennings; Patricia A.,11,0,24,13
1713318975109,CHEM 108,A02,489142,Jennings; Patricia A.,14,0,24,10
1713318976136,CHEM 114A,A01,489147,Stallings; Dontarie M,76,0,100,24
1713318977164,CHIN 169A,A00,489171,Wang; Xiao,19,0,20,1
1713318979217,COGS 3,A01,518827,Boyle; Mary E. T.,28,0,40,12
1713318980241,COGS 11,A01,489175,Staff,28,0,30,2
1713318981265,COGS 14A,A01,518829,Staff,51,0,60,9
1713318982292,COGS 14B,A01,489177,Hoffman; Drew Ellen,66,0,75,9
1713318983318,COGS 100,A01,489181,Allen; Michael Gordon,65,0,75,10
1713318984343,COGS 101A,A01,489183,Staff,48,0,60,12
1713318985368,COGS 101B,A01,489185,Allen; Michael Gordon,9,0,30,21
1713318986393,COGS 101C,A01,526786,Staff,24,0,30,6
1713318988446,COGS 107A,A01,489189,Boyle; Mary E. T.,19,0,35,16
1713318989471,COGS 107B,A01,627144,Mooshagian; Eric Frederick,60,0,60,0
1713318990495,COGS 118A,A01,489191,Staff,0,40,40,40
1713318992554,COGS 171GS,A01,489194,Pineda; Jaime A,21,0,28,7
1713318993582,COGS 172,A01,489196,Staff,3,0,30,27
1713318994606,COGS 174GS,A01,489264,Pineda; Jaime A,21,0,28,7
1713318995634,COGS 180,A01,627150,Staff,28,0,30,2
1713318996659,COGS 186,A01,489274,Staff,0,1,30,30
1713318997688,COMM 10,A01,489276,Staff,23,0,25,2
1713318997688,COMM 10,A02,489303,Staff,23,0,25,2
1713318998716,COMM 100A,A01,489312,Staff,15,0,25,10
1713318998716,COMM 100A,A02,489313,Staff,24,0,25,1
1713318999742,COMM 106T,A00,512540,Staff,34,0,35,1
1713319000769,COMM 107,A00,489347,Staff,31,0,35,4
1713319001793,COMM 109P,A00,489358,Staff,31,0,35,4
1713319002820,COMM 132,A00,489361,McKenna; Denise,28,0,30,2
1713319003859,COMM 146,A00,489362,Halm; Gavin Patrick,27,0,30,3
1713319004884,COMM 190,A00,489363,Abuelhiga; Soraya Jill,19,0,23,4
1713319005912,CSE 8A,A50,489366,Staff,22,0,25,3
1713319005912,CSE 8A,A51,489367,Staff,24,0,25,1
1713319006935,CSE 11,A01,489398,Cao; Yingjun,79,0,100,21
1713319007966,CSE 12,A01,489487,Staff,43,0,50,7
1713319008991,CSE 20,A01,489497,Staff,48,0,50,2
1713319010020,CSE 21,A01,489517,Braun; Oliver,43,0,50,7
1713319011048,CSE 101,A01,489524,Braun; Oliver,0,25,50,50
1713319012081,CSE 105,A01,512594,Jones; Miles E,77,0,100,23
1713319012081,CSE 105,B01,512598,Jones; Miles E,57,0,100,43
1713319013109,CSE 140,A01,489538,Staff,43,0,50,7
1713319014136,CSE 141,A01,489550,Eldon; John,72,0,100,28
1713319015162,CSE 141L,A01,489571,Eldon; John,70,0,100,30
1713319016192,CSE 151A,A01,489583,Solares; Edwin A,146,0,200,54
1713319017216,CSE 175,A01,510886,Kumar; Rakesh,30,0,30,0
1713319018242,CSE 190,A00,516828,Dubnov; Shlomo,38,0,49,11
1713319019273,DOC 100D,A00,489667,Pass; Natalye Joann,19,0,25,6
1713319020303,DSC 10,A01,624268,Staff,72,0,75,3
1713319021329,DSC 20,A01,624476,Staff,50,0,50,0
1713319022353,DSC 40A,A01,624608,Staff,39,0,40,1
1713319023379,DSGN 1,A01,489179,Rill; Bryan,36,0,50,14
1713319024405,ECE 17,A01,490489,Sahay; Rajeev,18,0,30,12
1713319025433,ECE 65,A50,490492,Staff,14,0,20,6
1713319025433,ECE 65,A51,490493,Staff,20,0,20,0
1713319026459,ECON 1,A01,489715,Famulari; Melissa,68,0,70,2
1713319027485,ECON 2,A01,489717,Levkoff; Steven B.,68,0,70,2
1713319028512,ECON 3,A01,489948,Staff,70,0,70,0
1713319030572,ECON 5,A01,490103,Staff,28,0,30,2
1713319030572,ECON 5,B01,626281,Dai; Yinlin,45,0,45,0
1713319031602,ECON 100A,A01,490127,Famulari; Melissa,66,0,70,4
1713319032632,ECON 100B,A01,490129,Staff,64,0,70,6
1713319033660,ECON 109,A01,490187,Shishkin; Denis,27,0,35,8
1713319034689,ECON 110A,A01,490190,Levkoff; Steven B.,60,0,70,10
1713319035713,ECON 120A,A01,490245,Dai; Yinlin,62,0,70,8
1713319036738,ECON 120B,A01,490247,Nieto-Barthaburu; Augusto,52,0,70,18
1713319037766,ECON 120C,A01,490253,Sun; Yixiao,30,0,35,5
1713319037766,ECON 120C,B01,490255,Sun; Yixiao,34,0,35,1
1713319038793,ECON 129,A00,490256,Eckert; Fabian Paul,24,0,35,11
1713319039818,ECON 131,A00,490257,Nieto-Barthaburu; Augusto,0,5,35,35
1713319040848,ECON 138,A00,490258,Bharadwaj; Prashant,18,0,35,17
1713319040848,ECON 138,B00,490259,Bharadwaj; Prashant,17,0,35,18
1713319041876,ECON 159,A00,490260,Hendrickson; Gerald M.,0,8,0,0
1713319042908,ECON 178,A01,553995,Zhu; Ying,24,0,35,11
1713319043939,EDS 40,A01,512576,Black; Alison Michelle,20,0,20,0
1713319044964,EDS 107,A01,515848,Staff,30,0,30,0
1713319045990,EDS 110R,A01,490262,Staff,26,0,30,4
1713319047018,EDS 112,A01,490264,Chapman; Thandeka K,42,0,50,8
1713319048044,EDS 113,A00,490266,Staff,26,0,30,4
1713319049072,EDS 118,A00,490267,Warstadt; Melissa Fawn,22,0,30,8
1713319050097,EDS 124BR,A00,490268,Eguchi; Emi,6,0,25,19
1713319050097,EDS 124BR,B00,490269,Eguchi; Emi,25,0,25,0
1713319051123,EDS 126,A01,490271,Jones; Makeba,44,0,50,6
1713319052148,EDS 135,A01,490316,Staff,19,0,20,1
1713319053172,ENVR 142GS,A00,519514,Chang; Edmond Yi-Teh,27,0,28,1
1713319054198,ETHN 103,A00,490504,Staff,31,0,36,5
1713319055226,ETHN 103A,A00,490505,Man; Simeon S,5,0,9,4
1713319056254,ETHN 109,A00,490506,Staff,30,0,30,0
1713319057284,ETHN 118,A00,490507,Staff,35,0,36,1
1713319058310,ETHN 119,A00,490508,Staff,34,0,36,2
1713319059335,ETHN 121R,A00,490518,Choi; Esther Min,25,0,36,11
1713319060361,ETHN 127,A00,490528,Staff,15,0,15,0
1713319061389,ETHN 139,A00,490573,Staff,10,0,10,0
1713319062417,ETHN 150,A00,490575,Staff,15,0,15,0
1713319063441,GLBH 20,A00,491705,Elwardani; Nile Regina,38,0,40,2
1713319064467,GLBH 101,A00,491706,Staff,20,0,20,0
1713319065492,GLBH 111,A01,491708,Burgos; Jose L.,15,0,15,0
1713319066517,GLBH 146,A00,491709,Staff,11,0,20,9
1713319067540,GLBH 148,A00,491710,Olivas Hernandez; Olga Lid,13,0,20,7
1713319068565,GLBH 150,A00,491711,Sloane; Julia Kathryn,20,0,20,0
1713319069593,HIEA 131,A00,491760,Staff,29,0,32,3
1713319070620,HIEA 153,A00,491762,Staff,29,0,30,1
1713319071644,HIEU 124,A00,491811,Staff,26,0,32,6
1713319072674,HIEU 124GS,A00,491812,Markman; Kristina,27,0,28,1
1713319073702,HIEU 147,A00,491813,Staff,30,0,32,2
1713319074781,HIEU 149GS,A00,491816,Caldwell; Michael Alan,28,0,28,0
1713319075808,HILD 2C,A01,491713,Hendrickson; Gerald M.,27,0,30,3
1713319076835,HILD 7B,A01,491715,Kwak; Nancy,4,0,30,26
1713319077861,HILD 10,A01,491717,Staff,14,0,20,6
1713319078887,HILD 30GS,A00,491719,Edington; Claire Ellen,24,0,28,4
1713319079913,HINE 109,A00,491818,Shafir; Nir,27,0,32,5
1713319080941,HINE 128,A00,491821,Shafir; Nir,31,0,32,1
1713319081966,HISC 117,A00,491830,Staff,28,0,32,4
1713319082994,HIUS 103,A00,491834,Man; Simeon S,15,0,23,8
1713319084024,HIUS 108B,A00,491835,Staff,29,0,30,1
1713319085050,HIUS 141,A00,491836,Hendrickson; Gerald M.,29,0,32,3
1713319086077,HIUS 149,A00,491839,Staff,27,0,32,5
1713319087107,HUM 3,A01,512617,Crum; Matthew Stephen,44,0,50,6
1713319087107,HUM 3,A02,512618,Crum; Matthew Stephen,48,0,50,2
1713319088132,HUM 3GS,A00,512663,Markman; Kristina,0,0,0,1
1713319088132,HUM 3GS,B00,512664,Staff,0,0,0,0
1713319089158,HUM 4,A01,512620,West; Geoffrey Scott,30,0,50,20
1713319090186,HUM 4GS,A00,512666,Lyon; Antony J.,0,0,0,4
1713319091217,HUM 4R,A01,512625,Watkins; Eric,49,0,50,1
1713319092243,HUM 5,A01,512649,Zavodny; Tatiana Sophia,27,0,50,23
1713319092243,HUM 5,B01,512661,Zroka; Ryan Edward,48,0,50,2
1713319093268,INTL 190,A00,490577,Segui; Alan S,0,0,0,5
1713319094296,JAPN 20AR,A01,491267,Ross; Kayoko F,8,0,20,12
1713319095320,JAPN 180,A00,491285,Berman; Michael David,33,0,40,7
1713319096347,LATI 50,A01,502536,Kokinis; Troy Andreas,16,0,22,6
1713319096347,LATI 50,A02,502551,Kokinis; Troy Andreas,22,0,22,0
1713319096347,LATI 50,A03,502650,Kokinis; Troy Andreas,22,0,22,0
1713319096347,LATI 50,A04,502909,Kokinis; Troy Andreas,22,0,22,0
1713319097375,LATI 160,A01,502920,Kokinis; Troy Andreas,30,0,30,0
1713319098404,LIFR 1A,A00,490494,Van Moer; Vinciane G,17,0,20,3
1713319099429,LIFR 1AX,A00,490495,Van Moer; Vinciane G,17,0,20,3
1713319100458,LIFR 1B,A00,490496,Van Moer; Vinciane G,18,0,20,2
1713319101486,LIFR 1BX,A00,490497,Van Moer; Vinciane G,18,0,20,2
1713319102515,LIGN 8,A00,505198,McIntosh; Justin Daniel,136,0,150,14
1713319103540,LIGN 9GS,A00,491239,Lott; Margaret S.,18,0,20,2
1713319104567,LIGN 101,A01,505200,McIntosh; Justin Daniel,24,0,30,6
1713319105591,LIGN 120,A01,491244,Staff,24,0,30,6
1713319106620,LIGN 149GS,A00,491245,Lott; Margaret S.,18,0,20,2
1713319107644,LIGN 170,A00,491247,Staff,23,0,30,7
1713319108668,LISP 1D,A00,490498,Munoz Sanchez; Alicia,10,0,14,4
1713319108668,LISP 1D,B00,490499,Munoz Sanchez; Alicia,6,0,14,8
1713319108668,LISP 1D,C00,490500,Munoz Sanchez; Alicia,8,0,14,6
1713319108668,LISP 1D,D00,490501,Munoz Sanchez; Alicia,10,0,14,4
1713319109698,LISP 1DX,A00,490502,Munoz Sanchez; Alicia,15,0,28,13
1713319109698,LISP 1DX,B00,490503,Munoz Sanchez; Alicia,17,0,28,11
1713319111751,LTAM 110,A00,491847,Staff,23,0,25,2
1713319112777,LTCS 119,A00,491848,Staff,11,0,15,4
1713319113801,LTCS 130,A00,491849,Staff,24,0,25,1
1713319115853,LTEA 120C,A00,491852,Staff,34,0,40,6
1713319116883,LTEN 130GS,A00,491853,Lyon; Antony J.,24,0,28,4
1713319117907,LTEN 148,A00,491855,Staff,23,0,25,2
1713319118932,LTEN 159,A00,491856,Staff,21,0,25,4
1713319119960,LTEN 180,A00,491857,Staff,8,0,15,7
1713319122011,LTSP 123GS,A00,505928,Bessett; Ryan Matthew,24,0,28,4
1713319123039,LTSP 174GS,A00,506037,Bessett; Ryan Matthew,24,0,28,4
1713319125095,LTWR 102,A00,491861,Staff,11,0,15,4
1713319126124,LTWR 106,A00,491862,Staff,10,0,15,5
1713319127155,MAE 11,A00,490930,Bahadori; Mohammad Yousef,96,0,100,4
1713319128186,MAE 30A,A00,490931,Qi; Huihui,37,0,40,3
1713319129216,MAE 101A,A00,491036,Sadeghizadeh; Zahra,96,0,100,4
1713319130246,MAE 101C,A00,491037,Seshadri; Kalyanasundaram,72,0,100,28
1713319131272,MAE 113,A00,491040,Seshadri; Kalyanasundaram,66,0,80,14
1713319132300,MAE 131A,A00,491041,Ghazinejad; Maziar,38,0,40,2
1713319133327,MAE 142,A00,491053,Staff,39,0,40,1
1713319134353,MAE 143A,A00,491054,Staff,34,0,50,16
1713319135377,MAE 150,A00,491092,Truong; Phuong Thi Ngoc,23,0,35,12
1713319136402,MATH 3C,A01,494031,Pardo Guerra; Sebastian,30,0,30,0
1713319136402,MATH 3C,A02,494032,Pardo Guerra; Sebastian,29,0,30,1
1713319137432,MATH 10A,A01,494034,Staff,27,0,30,3
1713319137432,MATH 10A,A02,494035,Staff,28,0,30,2
1713319137432,MATH 10A,B01,494037,Staff,27,0,30,3
1713319137432,MATH 10A,B02,494038,Staff,29,0,30,1
1713319138459,MATH 10B,A01,494040,Habib; Yousaf,23,0,30,7
1713319138459,MATH 10B,A02,494041,Habib; Yousaf,28,0,30,2
1713319138459,MATH 10B,A03,494042,Habib; Yousaf,30,0,30,0
1713319138459,MATH 10B,A04,494043,Habib; Yousaf,30,0,30,0
1713319138459,MATH 10B,B01,494045,Habib; Yousaf,27,0,30,3
1713319138459,MATH 10B,B02,494046,Habib; Yousaf,30,0,30,0
1713319138459,MATH 10B,B03,494047,Habib; Yousaf,30,0,30,0
1713319138459,MATH 10B,B04,494048,Habib; Yousaf,30,0,30,0
1713319139492,MATH 18,A01,494050,Kemp; Todd Aahron,25,0,30,5
1713319139492,MATH 18,A02,494051,Kemp; Todd Aahron,29,0,30,1
1713319139492,MATH 18,B01,494054,Kemp; Todd Aahron,28,0,30,2
1713319139492,MATH 18,B02,494055,Kemp; Todd Aahron,29,0,30,1
1713319140521,MATH 20A,A01,494059,Suk; Andrew Hoon,30,0,30,0
1713319141551,MATH 20B,A01,494061,Briones; Jor-el Thomas Caparas,33,0,35,2
1713319141551,MATH 20B,B01,494063,Bach; Quang Tran,34,0,35,1
1713319142586,MATH 20C,A01,494065,Staff,28,0,30,2
1713319142586,MATH 20C,A02,494066,Staff,30,0,30,0
1713319142586,MATH 20C,A03,494067,Staff,30,0,30,0
1713319142586,MATH 20C,A04,494068,Staff,30,0,30,0
1713319142586,MATH 20C,B01,494070,Zhang; Ming,26,0,30,4
1713319142586,MATH 20C,B02,494071,Zhang; Ming,28,0,30,2
1713319142586,MATH 20C,B03,494072,Zhang; Ming,29,0,30,1
1713319142586,MATH 20C,B04,494073,Zhang; Ming,29,0,30,1
1713319143611,MATH 20D,A01,494075,Staff,22,0,30,8
1713319143611,MATH 20D,A02,494076,Staff,30,0,30,0
1713319144636,MATH 20E,A01,494079,Staff,24,0,30,6
1713319144636,MATH 20E,A02,494080,Staff,26,0,30,4
1713319144636,MATH 20E,B01,494082,Staff,25,0,30,5
1713319144636,MATH 20E,B02,494083,Staff,25,0,30,5
1713319145667,MATH 103A,A01,494085,Aliabadi Sr.; Mohsen,14,0,30,16
1713319145667,MATH 103A,A02,494086,Aliabadi Sr.; Mohsen,28,0,30,2
1713319145667,MATH 103A,B01,494088,Aliabadi Sr.; Mohsen,22,0,30,8
1713319145667,MATH 103A,B02,494089,Aliabadi Sr.; Mohsen,28,0,30,2
1713319146698,MATH 109,A01,494091,Staff,30,0,30,0
1713319146698,MATH 109,A02,494092,Staff,29,0,30,1
1713319146698,MATH 109,B01,494094,Staff,28,0,30,2
1713319146698,MATH 109,B02,494095,Staff,29,0,30,1
1713319147726,MATH 142A,A01,494097,Chow; Bennett,16,0,30,14
1713319147726,MATH 142A,A02,494098,Chow; Bennett,24,0,30,6
1713319147726,MATH 142A,B01,494100,Chow; Bennett,19,0,30,11
1713319147726,MATH 142A,B02,494101,Chow; Bennett,29,0,30,1
1713319149781,MATH 168A,A01,516677,Dumitriu; Ioana,15,0,35,20
1713319150806,MATH 170A,A01,516679,Dumitriu; Ioana,20,0,30,10
1713319150806,MATH 170A,A02,516680,Dumitriu; Ioana,28,0,30,2
1713319151832,MATH 193A,A01,494107,Staff,15,0,30,15
1713319151832,MATH 193A,A02,494108,Staff,21,0,30,9
1713319151832,MATH 193A,A03,494109,Staff,29,0,30,1
1713319151832,MATH 193A,A04,494110,Staff,22,0,30,8
1713319154918,MGT 16,A00,491930,McKay; Michael J,92,0,98,6
1713319155945,MGT 18,A00,491992,McKay; Michael J,97,0,98,1
1713319156971,MGT 71,A00,492003,Staff,72,0,98,26
1713319157997,MGT 103,A00,505209,Eberhard; Craig A,83,0,98,15
1713319159023,MGT 131A,A00,505210,Anderson; John Charles,90,0,98,8
1713319161078,MGT 153,A00,492077,Perols; Johan Lars,28,0,90,62
1713319164157,MGT 164,A00,492222,McKay; Mary A,93,0,98,5
1713319165188,MGT 172,A00,492245,Staff,59,0,60,1
1713319165188,MGT 172,B00,505526,Hedges; Kathleen,72,0,98,26
1713319166214,MGT 181,A00,505669,Dunn; Louis Jean,84,0,98,14
1713319167244,MMW 14,A01,494399,Staff,22,0,28,6
1713319167244,MMW 14,A02,494400,Staff,25,0,28,3
1713319167244,MMW 14,A03,494401,Staff,28,0,28,0
1713319167244,MMW 14,A04,494402,Staff,28,0,28,0
1713319167244,MMW 14,B01,494404,Carreras; Maria Victoria,13,0,28,15
1713319167244,MMW 14,B02,494405,Carreras; Maria Victoria,26,0,28,2
1713319167244,MMW 14,B03,494406,Carreras; Maria Victoria,28,0,28,0
1713319167244,MMW 14,B04,494407,Carreras; Maria Victoria,28,0,28,0
1713319168269,MMW 14GS,A00,506250,Chang; Edmond Yi-Teh,0,0,0,0
1713319169294,MMW 121R,A01,494415,Adamiak; Patrick John,12,0,28,16
1713319169294,MMW 121R,A02,494416,Adamiak; Patrick John,24,0,28,4
1713319170323,MUS 1A,A01,494113,Staff,12,0,25,13
1713319170323,MUS 1A,A02,494114,Staff,25,0,25,0
1713319171348,MUS 4,A01,494116,Staff,24,0,25,1
1713319171348,MUS 4,A02,494117,Staff,22,0,25,3
1713319172378,MUS 5R,A01,494236,Dubnov; Shlomo,10,0,25,15
1713319172378,MUS 5R,A02,494237,Dubnov; Shlomo,25,0,25,0
1713319173402,MUS 6,A01,494122,Staff,12,0,25,13
1713319173402,MUS 6,A02,494123,Staff,24,0,25,1
1713319174428,MUS 7,A01,494125,Staff,16,0,25,9
1713319174428,MUS 7,A02,494126,Staff,24,0,25,1
1713319175456,MUS 11,A01,494128,Staff,23,0,25,2
1713319175456,MUS 11,A02,494129,Staff,24,0,25,1
1713319176484,MUS 13,A01,494131,Staff,25,0,25,0
1713319176484,MUS 13,A02,494132,Staff,25,0,25,0
1713319177510,MUS 15,A01,494134,Staff,17,0,25,8
1713319177510,MUS 15,A02,494135,Staff,25,0,25,0
1713319177510,MUS 15,B01,494137,Staff,24,0,25,1
1713319178594,MUS 80,A00,494232,Staff,24,0,25,1
1713319178594,MUS 80,B00,494233,Staff,25,0,25,0
1713319178594,MUS 80,C00,494234,Staff,23,0,25,2
1713319179619,MUS 95C,A00,494141,Staff,72,0,75,3
1713319180644,MUS 114,A00,494142,Staff,40,0,50,10
1713319181674,NANO 15,A01,490636,Drews; Aaron,7,0,7,0
1713319182703,PHIL 1,A00,490578,Grush; Rick Scott,49,0,50,1
1713319183732,PHIL 10,A01,490580,Grush; Rick Scott,33,0,35,2
1713319183732,PHIL 10,A02,490586,Grush; Rick Scott,33,0,35,2
1713319184762,PHIL 27,A01,490591,Staff,23,0,25,2
1713319184762,PHIL 27,A02,490592,Staff,25,0,25,0
1713319184762,PHIL 27,A03,490593,Staff,25,0,25,0
1713319184762,PHIL 27,A04,490598,Staff,25,0,25,0
1713319185787,PHIL 32,A01,490611,Staff,20,0,20,0
1713319185787,PHIL 32,A02,490618,Staff,20,0,20,0
1713319186812,PHIL 90,A00,490624,Staff,40,0,40,0
1713319187838,PHIL 136,A00,490627,Cohen; Jonathan David,38,0,40,2
1713319188862,PHIL 155,A00,490634,Staff,63,0,70,7
1713319189891,PHYS 1A,A00,491610,Staff,246,0,250,4
1713319190919,PHYS 1AL,001,491616,Tsai; Philbert S,28,0,30,2
1713319190919,PHYS 1AL,002,491618,Tsai; Philbert S,30,0,30,0
1713319191945,PHYS 1B,A00,491623,Staff,242,0,250,8
1713319192974,PHYS 1BL,001,491626,Tsai; Philbert S,25,0,30,5
1713319192974,PHYS 1BL,002,491628,Tsai; Philbert S,27,0,30,3
1713319194002,PHYS 1C,A00,491632,Staff,220,0,245,25
1713319195032,PHYS 1CL,001,491635,Tsai; Philbert S,9,0,30,21
1713319195032,PHYS 1CL,002,491643,Tsai; Philbert S,24,0,30,6
1713319196057,PHYS 2AR,A01,491651,Meyertholen; Andrew D.,44,0,50,6
1713319197082,PHYS 2B,A01,491659,Staff,106,0,115,9
1713319198107,PHYS 2BL,A01,491685,Staff,21,0,24,3
1713319198107,PHYS 2BL,A02,491700,Staff,23,0,24,1
1713319199133,PHYS 2C,A01,505161,Staff,106,0,115,9
1713319200161,PHYS 4A,A01,491704,Grinstein; Benjamin,99,0,100,1
1713319201187,POLI 5D,A01,494144,Staff,3,0,5,2
1713319201187,POLI 5D,B01,626283,Dai; Yinlin,5,0,5,0
1713319202220,POLI 12,A00,494145,Staff,44,0,45,1
1713319203244,POLI 13R,A00,494146,Forman; Fonna,45,0,50,5
1713319204269,POLI 27,A01,494148,Staff,57,0,60,3
1713319205299,POLI 30,A00,494149,Staff,49,0,50,1
1713319206322,POLI 100DA,A00,494150,Staff,21,0,25,4
1713319208376,POLI 100I,A00,494152,Staff,28,0,30,2
1713319209404,POLI 104B,A00,494153,Smith; Glenn Chatmas,53,0,55,2
1713319210428,POLI 104F,A00,494154,Staff,28,0,30,2
1713319211455,POLI 104I,A00,494155,Smith; Glenn Chatmas,30,0,30,0
1713319212487,POLI 110C,A00,494156,Ingham; Sean,23,0,25,2
1713319213514,POLI 117R,A00,494157,Forman; Fonna,10,0,20,10
1713319214543,POLI 118,A00,494158,Ingham; Sean,22,0,25,3
1713319215568,POLI 120H,A00,494159,Fisk; David Lee,40,0,45,5
1713319216595,POLI 131CR,A00,494160,Hoston; Germaine,36,0,45,9
1713319217618,POLI 133J,A00,494161,Staff,33,0,35,2
1713319218647,POLI 135,A00,494162,Fisk; David Lee,33,0,35,2
1713319219675,POLI 140A,A00,494164,Staff,21,0,30,9
1713319220701,POLI 142I,A00,494165,Staff,30,0,30,0
1713319221727,POLI 144D,A00,494166,Staff,23,0,25,2
1713319222752,POLI 151,A00,494167,Staff,30,0,30,0
1713319223777,POLI 153,A00,494168,Staff,33,0,35,2
1713319224802,POLI 160AA,A00,494169,Staff,35,0,40,5
1713319225827,POLI 162,A00,494170,Mignozzetti; Umberto,20,0,25,5
1713319226855,POLI 171,A00,494171,Mignozzetti; Umberto,21,0,25,4
1713319227883,PSYC 1,A00,494172,Staff,97,0,100,3
1713319228909,PSYC 2,A00,494173,Moranton; Nirelia Melbina-,40,0,50,10
1713319229934,PSYC 3,A00,494174,Staff,29,0,30,1
1713319230962,PSYC 6,A00,494175,Staff,17,0,20,3
1713319231987,PSYC 60,A01,494177,Staff,39,0,45,6
1713319233023,PSYC 70,A01,505724,Geller; Emma Harlan,42,0,45,3
1713319234053,PSYC 101,A00,494180,Heyman; Gail D.,86,0,100,14
1713319235079,PSYC 105,A00,494181,Geller; Emma Harlan,59,0,90,31
1713319236108,PSYC 106,A00,494182,Dobkins; Karen R.,29,0,45,16
1713319237654,PSYC 108,A00,494183,Adrian; Julia Anna,91,0,100,9
1713319238683,PSYC 114,A01,494185,Winkielman; Piotr,0,0,30,30
1713319239708,PSYC 122,A00,494186,Moranton; Nirelia Melbina-,34,0,50,16
1713319240736,PSYC 124,A00,494187,Chapman; Eddie Nathaniel,72,0,80,8
1713319241760,PSYC 131,A00,494188,Anagnostaras; Stephan,50,0,80,30
1713319242787,PSYC 144,A00,494189,Staff,12,0,50,38
1713319243812,PSYC 154,A00,494190,Lacefield; Katharine I,123,0,180,57
1713319244842,PSYC 162,A00,494191,Wixted; John T,76,0,100,24
1713319245872,PSYC 172,A00,494192,Gorman; Michael R.,36,0,45,9
1713319246900,PSYC 178,A00,494193,Glaser; Dale,38,0,45,7
1713319247928,PSYC 193,A00,505725,Chapman; Eddie Nathaniel,20,0,20,0
1713319248952,RELI 145GS,A00,519817,Rahimi; Babak,18,0,20,2
1713319249982,SE 101A,A01,490862,Chadha; Mayank,23,0,25,2
1713319251006,SE 101C,A01,490924,Krysl; Petr,17,0,20,3
1713319252032,SE 110A,A01,490928,Staff,19,0,20,1
1713319253060,SE 130A,A00,490929,Morrison; Machel Leigh,59,0,70,11
1713319254086,SIO 1,A01,519325,Staff,39,0,40,1
1713319255114,SIO 30,A01,519327,Staff,38,0,40,2
1713319256138,SIO 40,A00,519328,Staff,39,0,40,1
1713319257167,SIO 46GS,A00,519819,Cook; Geoffrey W,17,0,25,8
1713319258192,SIO 109R,A00,494197,Forman; Fonna,4,0,20,16
1713319259220,SIO 121GS,A00,519827,Cook; Geoffrey W,17,0,25,8
1713319260264,SIO 132,A01,519330,Staff,38,0,40,2
1713319261297,SIO 133,A01,519397,Staff,37,0,40,3
1713319262328,SIO 139,A00,519396,Kacev; David,31,0,40,9
1713319263354,SOCI 1,A01,494199,Thorpe; Charles Robert,23,0,30,7
1713319263354,SOCI 1,A02,494200,Thorpe; Charles Robert,30,0,30,0
1713319263354,SOCI 1,A03,494201,Thorpe; Charles Robert,29,0,30,1
1713319263354,SOCI 1,A04,494202,Thorpe; Charles Robert,29,0,30,1
1713319263354,SOCI 1,A05,494203,Thorpe; Charles Robert,29,0,30,1
1713319263354,SOCI 1,A06,494204,Thorpe; Charles Robert,30,0,30,0
1713319263354,SOCI 1,A07,494205,Thorpe; Charles Robert,29,0,30,1
1713319264382,SOCI 60,A01,494207,Staff,35,0,40,5
1713319264382,SOCI 60,A02,494208,Staff,39,0,40,1
1713319265415,SOCI 100,A01,494210,Payne; Christine Anna,27,0,30,3
1713319265415,SOCI 100,A02,494211,Payne; Christine Anna,26,0,30,4
1713319266439,SOCI 109M,A00,494212,Staff,20,0,20,0
1713319267465,SOCI 110,A00,494213,Staff,35,0,40,5
1713319269518,SOCI 118E,A00,494215,Ng; Kwai,38,0,40,2
1713319270543,SOCI 125,A00,494216,Calderon-Zaks; Michael Aar,42,0,45,3
1713319271570,SOCI 126,A01,494218,Jones; Makeba,3,0,5,2
1713319272595,SOCI 131,A00,494219,Thorpe; Charles Robert,28,0,30,2
1713319274648,SOCI 135,A00,494221,Payne; Christine Anna,32,0,50,18
1713319275677,SOCI 136E,A00,626690,Ruiz; Jonathan Joseph,25,0,25,0
1713319276709,SOCI 138GS,A00,494222,Navon; Daniel,24,0,28,4
1713319278759,SOCI 145,A00,494224,Staff,42,0,45,3
1713319279786,SOCI 153,A00,494225,Staff,28,0,30,2
1713319280811,SOCI 160E,A00,494226,Ng; Kwai,32,0,40,8
1713319281838,SOCI 180,A00,494227,Staff,29,0,30,1
1713319282922,SOCI 189GS,A00,494228,Ribas Norris; Janet Vanesa,11,0,11,0
1713319283948,SOCI 190GS,A00,553232,Ribas Norris; Janet Vanesa,11,0,11,0
1713319284974,SOMI 220,A00,627178,Schneid; Stephen David,30,0,30,0
1713319286051,SYN 2,001,490768,Staff,14,0,15,1
1713319286051,SYN 2,002,490769,Staff,15,0,15,0
1713319286051,SYN 2,004,490775,Staff,0,0,0,0
1713319286051,SYN 2,003,490774,Staff,0,0,0,0
1713319286051,SYN 2,005,490776,Staff,0,0,0,0
1713319287079,SYN 2R,001,490779,Staff,12,0,15,3
1713319287079,SYN 2R,002,514635,Staff,14,0,15,1
1713319288105,SYN 100,A01,490783,Staff,15,0,20,5
1713319288105,SYN 100,B01,490787,Staff,10,0,20,10
1713319288105,SYN 100,C01,490789,Staff,12,0,20,8
1713319289134,SYN 150,A00,490817,Staff,14,0,15,1
1713319289134,SYN 150,B00,514610,Staff,15,0,15,0
1713319290167,TDAC 1,A00,492753,Walsh; Kim C.,19,0,20,1
1713319290167,TDAC 1,B00,492754,Harting; Carla Kelso,19,0,20,1
1713319290167,TDAC 1,C00,513995,Salovey; Todd,15,0,20,5
1713319291193,TDAC 101,A00,492766,Harting; Carla Kelso,17,0,20,3
1713319292222,TDAC 102,A00,492768,Basso; Beatrice,19,0,20,1
1713319293271,TDDE 111,A00,492769,Staff,25,0,25,0
1713319294301,TDDE 131,A00,492770,Staff,15,0,15,0
1713319294301,TDDE 131,B00,492771,Staff,15,0,15,0
1713319295330,TDDE 131GS,A00,523716,Guirguis; Mark C,24,0,28,4
1713319296362,TDGE 1,A01,492756,Salovey; Todd,57,0,60,3
1713319297392,TDGE 5,A01,492758,Staff,24,0,25,1
1713319298420,TDGE 10,A00,492759,Fulton; Julia,207,0,220,13
1713319299444,TDGE 11,A00,492760,Castro; Robert Jess,198,0,200,2
1713319301497,TDGE 124,A00,492772,Fulton; Julia,191,0,220,29
1713319302522,TDGE 125,A00,492773,Meyer; Ursula,40,0,50,10
1713319302522,TDGE 125,B00,492774,Staff,49,0,50,1
1713319302522,TDGE 125,C00,523565,Staff,48,0,50,2
1713319303547,TDGE 125GS,A00,523580,Guirguis; Mark C,24,0,28,4
1713319304576,TDGE 127,A00,492775,Havis; Allan,39,0,50,11
1713319305600,TDHT 101,A00,492776,Staff,35,0,35,0
1713319306632,TDMV 1,A00,492762,Caligagan; Maria T.,30,0,30,0
1713319306632,TDMV 1,B00,492763,Arcidiacono; Kristin,25,0,30,5
1713319307662,TDMV 2,A00,492764,Weinberg; Sadie,29,0,30,1
1713319308693,TDMV 3,A00,492765,Mack; Kara Shanai',39,0,40,1
1713319309718,TDMV 138,A00,492777,Mack; Kara Shanai',35,0,40,5
1713319310746,TDMV 140,A00,492778,Lima; Paulo Henrique,40,0,40,0
1713319311773,TDMV 142,A00,492779,Caligagan; Maria T.,34,0,40,6
1713319311773,TDMV 142,B00,492780,Caligagan; Tony,37,0,40,3
1713319312801,TDMV 143,A00,492781,Fyall; Daunte Edward,39,0,40,1
1713319313831,USP 1,A01,492401,Kwak; Nancy,26,0,35,9
1713319314860,USP 2,A01,492453,Hinds; Juli Beth,35,0,35,0
1713319315886,USP 3,A01,492516,Staff,29,0,35,6
1713319316912,USP 4,A00,492522,McTague; Sarah,19,0,25,6
1713319317937,USP 100,A00,492523,Staff,33,0,35,2
1713319318962,USP 101,A00,492524,Staff,13,0,15,2
1713319319987,USP 105,A00,492525,Staff,21,0,25,4
1713319321016,USP 151,A00,492526,Shenkman; Michael Thomas,32,0,35,3
1713319322041,USP 170,A00,492545,Hinds; Juli Beth,33,0,35,2
1713319323067,USP 171GS,A00,492608,Bussell; Mirle Rabinowitz,24,0,28,4
1713319324091,USP 183GS,A00,492613,Peerson; Susan,24,0,28,4
1713319325121,VIS 30,A01,490693,Yoldas; Pinar,20,0,22,2
1713319325121,VIS 30,A02,490694,Yoldas; Pinar,18,0,22,4
1713319326145,VIS 83,A00,490695,Kester; Grant,64,0,75,11
1713319327172,VIS 105D,A00,490696,Staff,22,0,25,3
1713319328199,VIS 124CN,A00,490699,Rose; Jordan M,68,0,75,7
1713319329224,VIS 125GS,A00,511221,Williams; Alena J,21,0,22,1
1713319330254,VIS 128D,A00,490700,Staff,73,0,75,2
1713319331281,VIS 151,A01,490717,Staff,33,0,34,1
1713319331281,VIS 151,A02,490766,Staff,33,0,34,1
1713319332305,VIS 154GS,A00,511972,Williams; Alena J,21,0,22,1
1713319333332,VIS 160A,A00,490767,Stone; Patricia,7,0,10,3
1713319334357,WCWP 10A,A00,490638,Staff,14,0,15,1
1713319334357,WCWP 10A,B00,490640,Staff,15,0,15,0
1713319335381,WCWP 10B,A00,490641,Staff,0,0,0,0
1713319335381,WCWP 10B,B00,490642,Staff,14,0,15,1
1713319335381,WCWP 10B,C00,490644,Staff,13,0,15,2
1713319335381,WCWP 10B,D00,490647,Staff,0,0,0,0
1713319336408,WCWP 100,A00,490655,Staff,0,0,0,0
1713319336408,WCWP 100,B00,490687,Staff,10,0,15,5
1713319338537,ANAR 153,A00,487222,Braswell; Geoffrey E.,54,0,60,6
1713319339562,ANBI 134,A00,487223,Staff,8,0,20,12
1713319340587,ANBI 143GS,A00,487224,Noel; Geoffroy Pierre Jean,19,0,24,5
1713319341616,ANBI 144GS,A00,519548,Noel; Geoffroy Pierre Jean,19,0,24,5
1713319342647,ANSC 101,A00,487225,Staff,19,0,20,1
1713319343674,ANSC 125,A00,487227,Brenner; Suzanne A,39,0,40,1
1713319345725,ANSC 146,A00,487229,Staff,35,0,40,5
1713319346750,ANSC 148,A00,487230,Olivas Hernandez; Olga Lid,39,0,40,1
1713319347778,ANSC 150,A00,504165,Sloane; Julia Kathryn,19,0,20,1
1713319348803,ANSC 180,A00,487232,Staff,13,0,15,2
1713319349827,ANSC 188,A00,627155,Staff,39,0,40,1
1713319350853,ANTH 5,A00,519529,Semendeferi; Ekaterini,15,0,15,0
1713319351878,ANTH 10,A00,487219,Staff,58,0,60,2
1713319352904,ANTH 23,A01,487221,Staff,17,0,20,3
1713319353931,ANTH 102,A00,487233,Wilder; Linnea Lorene,51,0,60,9
1713319354957,ANTH 103,A00,487234,Varma; Saiba,55,0,60,5
1713319355985,ANTH 105,A00,487235,Stewart; Alexander B,55,0,60,5
1713319357012,BENG 100,A01,516685,Taylor Amos; Alyssa C,28,0,30,2
1713319358035,BIBC 102,A01,491316,Flagg; Matthew Paul,25,0,88,63
1713319358035,BIBC 102,A02,491366,Flagg; Matthew Paul,82,0,88,6
1713319359234,BIBC 103,A01,491486,Boumechache; Miyyada,16,0,24,8
1713319359234,BIBC 103,A02,491487,Boumechache; Miyyada,24,0,24,0
1713319360260,BICD 100,A01,516882,Staff,75,0,75,0
1713319360260,BICD 100,A02,516890,Staff,69,0,75,6
1713319361285,BICD 102GS,A00,491488,Lo; Stanley M.,26,0,28,2
1713319362313,BIEB 136GS,A00,516940,Holway; David A. & Shurin; Jonathan,19,0,24,5
1713319363341,BIEB 137GS,A01,517034,Holway; David A. & Shurin; Jonathan,19,0,24,5
1713319364370,BIEB 138GS,A01,491492,Pirino; Giorgia,21,0,28,7
1713319365397,BILD 1,A01,491296,Staff,62,0,63,1
1713319365397,BILD 1,A02,491297,Staff,63,0,63,0
1713319366425,BILD 4,A01,517099,Gonzalez Gamboa; Ivonne,22,0,24,2
1713319366425,BILD 4,A02,517100,Gonzalez Gamboa; Ivonne,24,0,24,0
1713319367455,BILD 60GS,A00,491309,Lo; Stanley M.,26,0,28,2
1713319368485,BIMM 100,A01,517136,Staff,87,0,100,13
1713319369509,BIMM 110,A01,517182,Staff,63,0,100,37
1713319370540,BIMM 120,A01,517228,Pickett; Brooke Elizabeth,35,0,63,28
1713319370540,BIMM 120,A02,517240,Pickett; Brooke Elizabeth,46,0,63,17
1713319371564,BIMM 132GS,A01,491498,Pirino; Giorgia,21,0,28,7
1713319372589,BIMM 143,A01,491589,Bozinovic; Goran,16,0,40,24
1713319373619,BIPN 100,A01,491594,Armour; Jon Christopher,90,0,100,10
1713319374649,BIPN 140,A01,491602,Marino; Marc J,28,0,50,22
1713319376708,CAT 125,A00,515973,Staff,19,0,20,1
1713319377733,CAT 125GS,A00,515974,Rahimi; Babak,18,0,20,2
1713319378766,CAT 125R,A00,515980,Staff,14,0,20,6
1713319378766,CAT 125R,B00,515981,Tosun; Adriana,19,0,20,1
1713319378766,CAT 125R,C00,515987,Hyland; Tina Mae,0,1,20,20
1713319378766,CAT 125R,D00,515988,Bronstein; Phoebe Malan,18,0,20,2
1713319379791,CENG 15,A01,488699,Drews; Aaron,25,0,25,0
1713319380817,CENG 100,A00,505196,Opatkiewicz; Justin Paul,25,0,25,0
1713319381843,CGS 2A,A01,489598,Staff,33,0,35,2
1713319382993,CGS 112,A00,489599,Staff,15,0,15,0
1713319384019,CGS 119,A00,489603,Staff,10,0,10,0
1713319385048,CGS 120,A00,489604,Staff,14,0,15,1
1713319386074,CGS 150,A00,489607,Staff,15,0,15,0
1713319387173,CHEM 6A,A01,488715,Staff,98,0,100,2
1713319388200,CHEM 6B,A01,488719,Piercy; Marc Anthony,100,0,100,0
1713319389225,CHEM 6C,A01,488723,Albizati; Kim F.,94,0,100,6
1713319390257,CHEM 7L,A01,488728,Schurmeier; Kimberly,18,0,24,6
1713319390257,CHEM 7L,A02,488730,Schurmeier; Kimberly,23,0,24,1
1713319390257,CHEM 7L,A03,488734,Schurmeier; Kimberly,23,0,24,1
1713319390257,CHEM 7L,A04,488763,Schurmeier; Kimberly,23,0,24,1
1713319390257,CHEM 7L,B01,488798,Schurmeier; Kimberly,17,0,24,7
1713319390257,CHEM 7L,B02,488801,Schurmeier; Kimberly,23,0,24,1
1713319390257,CHEM 7L,B03,488808,Schurmeier; Kimberly,24,0,24,0
1713319390257,CHEM 7L,B04,488811,Schurmeier; Kimberly,24,0,24,0
1713319391283,CHEM 11,A01,488897,Stallings; Dontarie M,97,0,100,3
1713319392308,CHEM 40A,A01,488913,Albizati; Kim F.,88,0,100,12
1713319393334,CHEM 40B,A01,488920,Weizman; Haim,44,0,50,6
1713319393334,CHEM 40B,A02,488938,Weizman; Haim,45,0,50,5
1713319394360,CHEM 41A,A01,489029,Klosterman; Jeremy K,57,0,60,3
1713319395385,CHEM 41C,A01,500436,Tor; Yitzhak,55,0,60,5
1713319396412,CHEM 43A,A01,500426,Weizman; Haim,0,0,24,24
1713319396412,CHEM 43A,A02,500430,Weizman; Haim,13,0,24,11
1713319396412,CHEM 43A,B01,514041,Klosterman; Jeremy K,15,0,24,9
1713319396412,CHEM 43A,B02,514047,Klosterman; Jeremy K,23,0,24,1
1713319397438,CHEM 108,A01,489140,Jennings; Patricia A.,11,0,24,13
1713319397438,CHEM 108,A02,489142,Jennings; Patricia A.,14,0,24,10
1713319398462,CHEM 114A,A01,489147,Stallings; Dontarie M,76,0,100,24
1713319399488,CHIN 169A,A00,489171,Wang; Xiao,19,0,20,1
1713319401543,COGS 3,A01,518827,Boyle; Mary E. T.,28,0,40,12
1713319402569,COGS 11,A01,489175,Staff,28,0,30,2
1713319403594,COGS 14A,A01,518829,Staff,51,0,60,9
1713319404620,COGS 14B,A01,489177,Hoffman; Drew Ellen,66,0,75,9
1713319405650,COGS 100,A01,489181,Allen; Michael Gordon,65,0,75,10
1713319406678,COGS 101A,A01,489183,Staff,48,0,60,12
1713319407705,COGS 101B,A01,489185,Allen; Michael Gordon,9,0,30,21
1713319408731,COGS 101C,A01,526786,Staff,24,0,30,6
1713319410787,COGS 107A,A01,489189,Boyle; Mary E. T.,19,0,35,16
1713319411820,COGS 107B,A01,627144,Mooshagian; Eric Frederick,60,0,60,0
1713319412845,COGS 118A,A01,489191,Staff,0,40,40,40
1713319414900,COGS 171GS,A01,489194,Pineda; Jaime A,21,0,28,7
1713319415929,COGS 172,A01,489196,Staff,4,0,30,26
1713319416958,COGS 174GS,A01,489264,Pineda; Jaime A,21,0,28,7
1713319417981,COGS 180,A01,627150,Staff,28,0,30,2
1713319419009,COGS 186,A01,489274,Staff,0,1,30,30
1713319420039,COMM 10,A01,489276,Staff,23,0,25,2
1713319420039,COMM 10,A02,489303,Staff,23,0,25,2
1713319421063,COMM 100A,A01,489312,Staff,14,0,25,11
1713319421063,COMM 100A,A02,489313,Staff,24,0,25,1
1713319422088,COMM 106T,A00,512540,Staff,34,0,35,1
1713319423116,COMM 107,A00,489347,Staff,31,0,35,4
1713319424146,COMM 109P,A00,489358,Staff,31,0,35,4
1713319425173,COMM 132,A00,489361,McKenna; Denise,28,0,30,2
1713319426198,COMM 146,A00,489362,Halm; Gavin Patrick,27,0,30,3
1713319427223,COMM 190,A00,489363,Abuelhiga; Soraya Jill,18,0,23,5
1713319428252,CSE 8A,A50,489366,Staff,22,0,25,3
1713319428252,CSE 8A,A51,489367,Staff,24,0,25,1
1713319429283,CSE 11,A01,489398,Cao; Yingjun,79,0,100,21
1713319430309,CSE 12,A01,489487,Staff,43,0,50,7
1713319431335,CSE 20,A01,489497,Staff,48,0,50,2
1713319432361,CSE 21,A01,489517,Braun; Oliver,43,0,50,7
1713319433386,CSE 101,A01,489524,Braun; Oliver,0,25,50,50
1713319434412,CSE 105,A01,512594,Jones; Miles E,77,0,100,23
1713319434412,CSE 105,B01,512598,Jones; Miles E,57,0,100,43
1713319435438,CSE 140,A01,489538,Staff,43,0,50,7
1713319436466,CSE 141,A01,489550,Eldon; John,72,0,100,28
1713319437490,CSE 141L,A01,489571,Eldon; John,70,0,100,30
1713319438515,CSE 151A,A01,489583,Solares; Edwin A,146,0,200,54
1713319439540,CSE 175,A01,510886,Kumar; Rakesh,30,0,30,0
1713319440564,CSE 190,A00,516828,Dubnov; Shlomo,38,0,49,11
1713319441594,DOC 100D,A00,489667,Pass; Natalye Joann,19,0,25,6
1713319442620,DSC 10,A01,624268,Staff,72,0,75,3
1713319443644,DSC 20,A01,624476,Staff,50,0,50,0
1713319444669,DSC 40A,A01,624608,Staff,39,0,40,1
1713319445695,DSGN 1,A01,489179,Rill; Bryan,36,0,50,14
1713319446730,ECE 17,A01,490489,Sahay; Rajeev,18,0,30,12
1713319447755,ECE 65,A50,490492,Staff,14,0,20,6
1713319447755,ECE 65,A51,490493,Staff,20,0,20,0
1713319449363,ECON 1,A01,489715,Famulari; Melissa,68,0,70,2
1713319450388,ECON 2,A01,489717,Levkoff; Steven B.,68,0,70,2
1713319451414,ECON 3,A01,489948,Staff,70,0,70,0
1713319453471,ECON 5,A01,490103,Staff,28,0,30,2
1713319453471,ECON 5,B01,626281,Dai; Yinlin,45,0,45,0
1713319454496,ECON 100A,A01,490127,Famulari; Melissa,66,0,70,4
1713319455523,ECON 100B,A01,490129,Staff,64,0,70,6
1713319456547,ECON 109,A01,490187,Shishkin; Denis,27,0,35,8
1713319457572,ECON 110A,A01,490190,Levkoff; Steven B.,60,0,70,10
1713319458597,ECON 120A,A01,490245,Dai; Yinlin,62,0,70,8
1713319459625,ECON 120B,A01,490247,Nieto-Barthaburu; Augusto,50,0,70,20
1713319460652,ECON 120C,A01,490253,Sun; Yixiao,30,0,35,5
1713319460652,ECON 120C,B01,490255,Sun; Yixiao,34,0,35,1
1713319461681,ECON 129,A00,490256,Eckert; Fabian Paul,24,0,35,11
1713319462705,ECON 131,A00,490257,Nieto-Barthaburu; Augusto,0,5,35,35
1713319463736,ECON 138,A00,490258,Bharadwaj; Prashant,18,0,35,17
1713319463736,ECON 138,B00,490259,Bharadwaj; Prashant,17,0,35,18
1713319464767,ECON 159,A00,490260,Hendrickson; Gerald M.,0,8,0,0
1713319465795,ECON 178,A01,553995,Zhu; Ying,24,0,35,11
1713319466826,EDS 40,A01,512576,Black; Alison Michelle,20,0,20,0
1713319467852,EDS 107,A01,515848,Staff,30,0,30,0
1713319468877,EDS 110R,A01,490262,Staff,26,0,30,4
1713319469903,EDS 112,A01,490264,Chapman; Thandeka K,42,0,50,8
1713319470927,EDS 113,A00,490266,Staff,26,0,30,4
1713319471953,EDS 118,A00,490267,Warstadt; Melissa Fawn,21,0,30,9
1713319472980,EDS 124BR,A00,490268,Eguchi; Emi,6,0,25,19
1713319472980,EDS 124BR,B00,490269,Eguchi; Emi,25,0,25,0
1713319474006,EDS 126,A01,490271,Jones; Makeba,44,0,50,6
1713319475036,EDS 135,A01,490316,Staff,19,0,20,1
1713319476066,ENVR 142GS,A00,519514,Chang; Edmond Yi-Teh,27,0,28,1
1713319477091,ETHN 103,A00,490504,Staff,31,0,36,5
1713319478119,ETHN 103A,A00,490505,Man; Simeon S,5,0,9,4
1713319479147,ETHN 109,A00,490506,Staff,30,0,30,0
1713319480175,ETHN 118,A00,490507,Staff,35,0,36,1
1713319481200,ETHN 119,A00,490508,Staff,34,0,36,2
1713319482225,ETHN 121R,A00,490518,Choi; Esther Min,25,0,36,11
1713319483249,ETHN 127,A00,490528,Staff,15,0,15,0
1713319484275,ETHN 139,A00,490573,Staff,10,0,10,0
1713319485304,ETHN 150,A00,490575,Staff,15,0,15,0
1713319486333,GLBH 20,A00,491705,Elwardani; Nile Regina,38,0,40,2
1713319487358,GLBH 101,A00,491706,Staff,20,0,20,0
1713319488382,GLBH 111,A01,491708,Burgos; Jose L.,15,0,15,0
1713319489405,GLBH 146,A00,491709,Staff,11,0,20,9
1713319490431,GLBH 148,A00,491710,Olivas Hernandez; Olga Lid,13,0,20,7
1713319491515,GLBH 150,A00,491711,Sloane; Julia Kathryn,20,0,20,0
1713319492545,HIEA 131,A00,491760,Staff,29,0,32,3
1713319493571,HIEA 153,A00,491762,Staff,29,0,30,1
1713319494597,HIEU 124,A00,491811,Staff,26,0,32,6
1713319495624,HIEU 124GS,A00,491812,Markman; Kristina,27,0,28,1
1713319496649,HIEU 147,A00,491813,Staff,30,0,32,2
1713319497811,HIEU 149GS,A00,491816,Caldwell; Michael Alan,28,0,28,0
1713319498841,HILD 2C,A01,491713,Hendrickson; Gerald M.,27,0,30,3
1713319499865,HILD 7B,A01,491715,Kwak; Nancy,4,0,30,26
1713319500894,HILD 10,A01,491717,Staff,14,0,20,6
1713319501923,HILD 30GS,A00,491719,Edington; Claire Ellen,24,0,28,4
1713319502952,HINE 109,A00,491818,Shafir; Nir,27,0,32,5
1713319503977,HINE 128,A00,491821,Shafir; Nir,31,0,32,1
1713319505003,HISC 117,A00,491830,Staff,28,0,32,4
1713319506028,HIUS 103,A00,491834,Man; Simeon S,15,0,23,8
1713319507057,HIUS 108B,A00,491835,Staff,29,0,30,1
1713319508085,HIUS 141,A00,491836,Hendrickson; Gerald M.,29,0,32,3
1713319509114,HIUS 149,A00,491839,Staff,27,0,32,5
1713319510140,HUM 3,A01,512617,Crum; Matthew Stephen,44,0,50,6
1713319510140,HUM 3,A02,512618,Crum; Matthew Stephen,48,0,50,2
1713319511169,HUM 3GS,A00,512663,Markman; Kristina,0,0,0,1
1713319511169,HUM 3GS,B00,512664,Staff,0,0,0,0
1713319512196,HUM 4,A01,512620,West; Geoffrey Scott,30,0,50,20
1713319513223,HUM 4GS,A00,512666,Lyon; Antony J.,0,0,0,4
1713319514248,HUM 4R,A01,512625,Watkins; Eric,49,0,50,1
1713319515280,HUM 5,A01,512649,Zavodny; Tatiana Sophia,27,0,50,23
1713319515280,HUM 5,B01,512661,Zroka; Ryan Edward,48,0,50,2
1713319516305,INTL 190,A00,490577,Segui; Alan S,0,0,0,5
1713319517337,JAPN 20AR,A01,491267,Ross; Kayoko F,8,0,20,12
1713319518362,JAPN 180,A00,491285,Berman; Michael David,33,0,40,7
1713319519388,LATI 50,A01,502536,Kokinis; Troy Andreas,16,0,22,6
1713319519388,LATI 50,A02,502551,Kokinis; Troy Andreas,22,0,22,0
1713319519388,LATI 50,A03,502650,Kokinis; Troy Andreas,22,0,22,0
1713319519388,LATI 50,A04,502909,Kokinis; Troy Andreas,22,0,22,0
1713319520414,LATI 160,A01,502920,Kokinis; Troy Andreas,30,0,30,0
1713319521441,LIFR 1A,A00,490494,Van Moer; Vinciane G,17,0,20,3
1713319522464,LIFR 1AX,A00,490495,Van Moer; Vinciane G,17,0,20,3
1713319523489,LIFR 1B,A00,490496,Van Moer; Vinciane G,18,0,20,2
1713319524516,LIFR 1BX,A00,490497,Van Moer; Vinciane G,18,0,20,2
1713319525546,LIGN 8,A00,505198,McIntosh; Justin Daniel,136,0,150,14
1713319526571,LIGN 9GS,A00,491239,Lott; Margaret S.,18,0,20,2
1713319527596,LIGN 101,A01,505200,McIntosh; Justin Daniel,24,0,30,6
1713319528628,LIGN 120,A01,491244,Staff,24,0,30,6
1713319529655,LIGN 149GS,A00,491245,Lott; Margaret S.,18,0,20,2
1713319530681,LIGN 170,A00,491247,Staff,23,0,30,7
1713319531712,LISP 1D,A00,490498,Munoz Sanchez; Alicia,10,0,14,4
1713319531712,LISP 1D,B00,490499,Munoz Sanchez; Alicia,6,0,14,8
1713319531712,LISP 1D,C00,490500,Munoz Sanchez; Alicia,8,0,14,6
1713319531712,LISP 1D,D00,490501,Munoz Sanchez; Alicia,10,0,14,4
1713319532741,LISP 1DX,A00,490502,Munoz Sanchez; Alicia,15,0,28,13
1713319532741,LISP 1DX,B00,490503,Munoz Sanchez; Alicia,17,0,28,11
1713319534793,LTAM 110,A00,491847,Staff,23,0,25,2
1713319535821,LTCS 119,A00,491848,Staff,11,0,15,4
1713319536850,LTCS 130,A00,491849,Staff,24,0,25,1
1713319538900,LTEA 120C,A00,491852,Staff,32,0,40,8
1713319539928,LTEN 130GS,A00,491853,Lyon; Antony J.,24,0,28,4
1713319540957,LTEN 148,A00,491855,Staff,23,0,25,2
1713319541982,LTEN 159,A00,491856,Staff,21,0,25,4
1713319543006,LTEN 180,A00,491857,Staff,8,0,15,7
1713319545060,LTSP 123GS,A00,505928,Bessett; Ryan Matthew,24,0,28,4
1713319546085,LTSP 174GS,A00,506037,Bessett; Ryan Matthew,24,0,28,4
1713319548142,LTWR 102,A00,491861,Staff,10,0,15,5
1713319549168,LTWR 106,A00,491862,Staff,10,0,15,5
1713319550193,MAE 11,A00,490930,Bahadori; Mohammad Yousef,96,0,100,4
1713319551220,MAE 30A,A00,490931,Qi; Huihui,37,0,40,3
1713319552250,MAE 101A,A00,491036,Sadeghizadeh; Zahra,96,0,100,4
1713319553275,MAE 101C,A00,491037,Seshadri; Kalyanasundaram,72,0,100,28
1713319554301,MAE 113,A00,491040,Seshadri; Kalyanasundaram,66,0,80,14
1713319555331,MAE 131A,A00,491041,Ghazinejad; Maziar,38,0,40,2
1713319556358,MAE 142,A00,491053,Staff,39,0,40,1
1713319557386,MAE 143A,A00,491054,Staff,34,0,50,16
1713319558416,MAE 150,A00,491092,Truong; Phuong Thi Ngoc,23,0,35,12
1713319559442,MATH 3C,A01,494031,Pardo Guerra; Sebastian,30,0,30,0
1713319559442,MATH 3C,A02,494032,Pardo Guerra; Sebastian,29,0,30,1
1713319560467,MATH 10A,A01,494034,Staff,27,0,30,3
1713319560467,MATH 10A,A02,494035,Staff,28,0,30,2
1713319560467,MATH 10A,B01,494037,Staff,27,0,30,3
1713319560467,MATH 10A,B02,494038,Staff,29,0,30,1
1713319561495,MATH 10B,A01,494040,Habib; Yousaf,23,0,30,7
1713319561495,MATH 10B,A02,494041,Habib; Yousaf,28,0,30,2
1713319561495,MATH 10B,A03,494042,Habib; Yousaf,29,0,30,1
1713319561495,MATH 10B,A04,494043,Habib; Yousaf,30,0,30,0
1713319561495,MATH 10B,B01,494045,Habib; Yousaf,27,0,30,3
1713319561495,MATH 10B,B02,494046,Habib; Yousaf,30,0,30,0
1713319561495,MATH 10B,B03,494047,Habib; Yousaf,30,0,30,0
1713319561495,MATH 10B,B04,494048,Habib; Yousaf,30,0,30,0
1713319562528,MATH 18,A01,494050,Kemp; Todd Aahron,25,0,30,5
1713319562528,MATH 18,A02,494051,Kemp; Todd Aahron,29,0,30,1
1713319562528,MATH 18,B01,494054,Kemp; Todd Aahron,28,0,30,2
1713319562528,MATH 18,B02,494055,Kemp; Todd Aahron,29,0,30,1
1713319563556,MATH 20A,A01,494059,Suk; Andrew Hoon,30,0,30,0
1713319564584,MATH 20B,A01,494061,Briones; Jor-el Thomas Caparas,33,0,35,2
1713319564584,MATH 20B,B01,494063,Bach; Quang Tran,34,0,35,1
1713319565610,MATH 20C,A01,494065,Staff,28,0,30,2
1713319565610,MATH 20C,A02,494066,Staff,30,0,30,0
1713319565610,MATH 20C,A03,494067,Staff,30,0,30,0
1713319565610,MATH 20C,A04,494068,Staff,30,0,30,0
1713319565610,MATH 20C,B01,494070,Zhang; Ming,26,0,30,4
1713319565610,MATH 20C,B02,494071,Zhang; Ming,28,0,30,2
1713319565610,MATH 20C,B03,494072,Zhang; Ming,29,0,30,1
1713319565610,MATH 20C,B04,494073,Zhang; Ming,29,0,30,1
1713319566635,MATH 20D,A01,494075,Staff,22,0,30,8
1713319566635,MATH 20D,A02,494076,Staff,30,0,30,0
1713319567667,MATH 20E,A01,494079,Staff,24,0,30,6
1713319567667,MATH 20E,A02,494080,Staff,26,0,30,4
1713319567667,MATH 20E,B01,494082,Staff,25,0,30,5
1713319567667,MATH 20E,B02,494083,Staff,25,0,30,5
1713319568700,MATH 103A,A01,494085,Aliabadi Sr.; Mohsen,14,0,30,16
1713319568700,MATH 103A,A02,494086,Aliabadi Sr.; Mohsen,28,0,30,2
1713319568700,MATH 103A,B01,494088,Aliabadi Sr.; Mohsen,22,0,30,8
1713319568700,MATH 103A,B02,494089,Aliabadi Sr.; Mohsen,28,0,30,2
1713319569736,MATH 109,A01,494091,Staff,30,0,30,0
1713319569736,MATH 109,A02,494092,Staff,29,0,30,1
1713319569736,MATH 109,B01,494094,Staff,27,0,30,3
1713319569736,MATH 109,B02,494095,Staff,29,0,30,1
1713319570763,MATH 142A,A01,494097,Chow; Bennett,16,0,30,14
1713319570763,MATH 142A,A02,494098,Chow; Bennett,24,0,30,6
1713319570763,MATH 142A,B01,494100,Chow; Bennett,19,0,30,11
1713319570763,MATH 142A,B02,494101,Chow; Bennett,29,0,30,1
1713319572821,MATH 168A,A01,516677,Dumitriu; Ioana,15,0,35,20
1713319573846,MATH 170A,A01,516679,Dumitriu; Ioana,20,0,30,10
1713319573846,MATH 170A,A02,516680,Dumitriu; Ioana,28,0,30,2
1713319574875,MATH 193A,A01,494107,Staff,15,0,30,15
1713319574875,MATH 193A,A02,494108,Staff,21,0,30,9
1713319574875,MATH 193A,A03,494109,Staff,29,0,30,1
1713319574875,MATH 193A,A04,494110,Staff,22,0,30,8
1713319577950,MGT 16,A00,491930,McKay; Michael J,91,0,98,7
1713319578975,MGT 18,A00,491992,McKay; Michael J,97,0,98,1
1713319580002,MGT 71,A00,492003,Staff,72,0,98,26
1713319581028,MGT 103,A00,505209,Eberhard; Craig A,82,0,98,16
1713319582060,MGT 131A,A00,505210,Anderson; John Charles,90,0,98,8
1713319584117,MGT 153,A00,492077,Perols; Johan Lars,25,0,90,65
1713319587198,MGT 164,A00,492222,McKay; Mary A,93,0,98,5
1713319588228,MGT 172,A00,492245,Staff,59,0,60,1
1713319588228,MGT 172,B00,505526,Hedges; Kathleen,72,0,98,26
1713319589254,MGT 181,A00,505669,Dunn; Louis Jean,84,0,98,14
1713319590278,MMW 14,A01,494399,Staff,22,0,28,6
1713319590278,MMW 14,A02,494400,Staff,25,0,28,3
1713319590278,MMW 14,A03,494401,Staff,28,0,28,0
1713319590278,MMW 14,A04,494402,Staff,28,0,28,0
1713319590278,MMW 14,B01,494404,Carreras; Maria Victoria,12,0,28,16
1713319590278,MMW 14,B02,494405,Carreras; Maria Victoria,26,0,28,2
1713319590278,MMW 14,B03,494406,Carreras; Maria Victoria,28,0,28,0
1713319590278,MMW 14,B04,494407,Carreras; Maria Victoria,28,0,28,0
1713319591305,MMW 14GS,A00,506250,Chang; Edmond Yi-Teh,0,0,0,0
1713319592330,MMW 121R,A01,494415,Adamiak; Patrick John,12,0,28,16
1713319592330,MMW 121R,A02,494416,Adamiak; Patrick John,24,0,28,4
1713319593360,MUS 1A,A01,494113,Staff,12,0,25,13
1713319593360,MUS 1A,A02,494114,Staff,25,0,25,0
1713319594384,MUS 4,A01,494116,Staff,24,0,25,1
1713319594384,MUS 4,A02,494117,Staff,22,0,25,3
1713319595470,MUS 5R,A01,494236,Dubnov; Shlomo,10,0,25,15
1713319595470,MUS 5R,A02,494237,Dubnov; Shlomo,25,0,25,0
1713319596495,MUS 6,A01,494122,Staff,12,0,25,13
1713319596495,MUS 6,A02,494123,Staff,24,0,25,1
1713319597521,MUS 7,A01,494125,Staff,16,0,25,9
1713319597521,MUS 7,A02,494126,Staff,24,0,25,1
1713319598551,MUS 11,A01,494128,Staff,23,0,25,2
1713319598551,MUS 11,A02,494129,Staff,24,0,25,1
1713319599577,MUS 13,A01,494131,Staff,25,0,25,0
1713319599577,MUS 13,A02,494132,Staff,25,0,25,0
1713319600606,MUS 15,A01,494134,Staff,17,0,25,8
1713319600606,MUS 15,A02,494135,Staff,25,0,25,0
1713319600606,MUS 15,B01,494137,Staff,24,0,25,1
1713319601634,MUS 80,A00,494232,Staff,24,0,25,1
1713319601634,MUS 80,B00,494233,Staff,25,0,25,0
1713319601634,MUS 80,C00,494234,Staff,23,0,25,2
1713319602659,MUS 95C,A00,494141,Staff,72,0,75,3
1713319603684,MUS 114,A00,494142,Staff,40,0,50,10
1713319604712,NANO 15,A01,490636,Drews; Aaron,7,0,7,0
1713319605744,PHIL 1,A00,490578,Grush; Rick Scott,49,0,50,1
1713319607022,PHIL 10,A01,490580,Grush; Rick Scott,33,0,35,2
1713319607022,PHIL 10,A02,490586,Grush; Rick Scott,33,0,35,2
1713319608052,PHIL 27,A01,490591,Staff,23,0,25,2
1713319608052,PHIL 27,A02,490592,Staff,25,0,25,0
1713319608052,PHIL 27,A03,490593,Staff,25,0,25,0
1713319608052,PHIL 27,A04,490598,Staff,25,0,25,0
1713319609076,PHIL 32,A01,490611,Staff,20,0,20,0
1713319609076,PHIL 32,A02,490618,Staff,20,0,20,0
1713319610101,PHIL 90,A00,490624,Staff,40,0,40,0
1713319611127,PHIL 136,A00,490627,Cohen; Jonathan David,37,0,40,3
1713319612156,PHIL 155,A00,490634,Staff,63,0,70,7
1713319613185,PHYS 1A,A00,491610,Staff,246,0,250,4
1713319614211,PHYS 1AL,001,491616,Tsai; Philbert S,28,0,30,2
1713319614211,PHYS 1AL,002,491618,Tsai; Philbert S,30,0,30,0
1713319615238,PHYS 1B,A00,491623,Staff,242,0,250,8
1713319616266,PHYS 1BL,001,491626,Tsai; Philbert S,25,0,30,5
1713319616266,PHYS 1BL,002,491628,Tsai; Philbert S,27,0,30,3
1713319617293,PHYS 1C,A00,491632,Staff,220,0,245,25
1713319618319,PHYS 1CL,001,491635,Tsai; Philbert S,9,0,30,21
1713319618319,PHYS 1CL,002,491643,Tsai; Philbert S,23,0,30,7
1713319619345,PHYS 2AR,A01,491651,Meyertholen; Andrew D.,44,0,50,6
1713319620372,PHYS 2B,A01,491659,Staff,106,0,115,9
1713319621397,PHYS 2BL,A01,491685,Staff,21,0,24,3
1713319621397,PHYS 2BL,A02,491700,Staff,23,0,24,1
1713319622421,PHYS 2C,A01,505161,Staff,106,0,115,9
1713319623451,PHYS 4A,A01,491704,Grinstein; Benjamin,99,0,100,1
1713319624483,POLI 5D,A01,494144,Staff,3,0,5,2
1713319624483,POLI 5D,B01,626283,Dai; Yinlin,5,0,5,0
1713319625509,POLI 12,A00,494145,Staff,44,0,45,1
1713319626533,POLI 13R,A00,494146,Forman; Fonna,45,0,50,5
1713319627561,POLI 27,A01,494148,Staff,57,0,60,3
1713319628586,POLI 30,A00,494149,Staff,49,0,50,1
1713319629610,POLI 100DA,A00,494150,Staff,21,0,25,4
1713319631663,POLI 100I,A00,494152,Staff,28,0,30,2
1713319632693,POLI 104B,A00,494153,Smith; Glenn Chatmas,53,0,55,2
1713319633721,POLI 104F,A00,494154,Staff,28,0,30,2
1713319634813,POLI 104I,A00,494155,Smith; Glenn Chatmas,30,0,30,0
1713319635838,POLI 110C,A00,494156,Ingham; Sean,23,0,25,2
1713319636868,POLI 117R,A00,494157,Forman; Fonna,10,0,20,10
1713319637893,POLI 118,A00,494158,Ingham; Sean,22,0,25,3
1713319638918,POLI 120H,A00,494159,Fisk; David Lee,40,0,45,5
1713319639942,POLI 131CR,A00,494160,Hoston; Germaine,36,0,45,9
1713319640968,POLI 133J,A00,494161,Staff,33,0,35,2
1713319642000,POLI 135,A00,494162,Fisk; David Lee,33,0,35,2
1713319643029,POLI 140A,A00,494164,Staff,21,0,30,9
1713319644059,POLI 142I,A00,494165,Staff,30,0,30,0
1713319645083,POLI 144D,A00,494166,Staff,23,0,25,2
1713319646109,POLI 151,A00,494167,Staff,30,0,30,0
1713319647133,POLI 153,A00,494168,Staff,33,0,35,2
1713319648158,POLI 160AA,A00,494169,Staff,35,0,40,5
1713319649185,POLI 162,A00,494170,Mignozzetti; Umberto,20,0,25,5
1713319650228,POLI 171,A00,494171,Mignozzetti; Umberto,21,0,25,4
1713319651254,PSYC 1,A00,494172,Staff,97,0,100,3
1713319652281,PSYC 2,A00,494173,Moranton; Nirelia Melbina-,40,0,50,10
1713319653305,PSYC 3,A00,494174,Staff,29,0,30,1
1713319654330,PSYC 6,A00,494175,Staff,17,0,20,3
1713319655356,PSYC 60,A01,494177,Staff,39,0,45,6
1713319656383,PSYC 70,A01,505724,Geller; Emma Harlan,42,0,45,3
1713319657412,PSYC 101,A00,494180,Heyman; Gail D.,85,0,100,15
1713319658438,PSYC 105,A00,494181,Geller; Emma Harlan,59,0,90,31
1713319659462,PSYC 106,A00,494182,Dobkins; Karen R.,29,0,45,16
1713319660491,PSYC 108,A00,494183,Adrian; Julia Anna,91,0,100,9
1713319661516,PSYC 114,A01,494185,Winkielman; Piotr,0,0,30,30
1713319662548,PSYC 122,A00,494186,Moranton; Nirelia Melbina-,34,0,50,16
1713319663573,PSYC 124,A00,494187,Chapman; Eddie Nathaniel,71,0,80,9
1713319664603,PSYC 131,A00,494188,Anagnostaras; Stephan,50,0,80,30
1713319665631,PSYC 144,A00,494189,Staff,12,0,50,38
1713319666661,PSYC 154,A00,494190,Lacefield; Katharine I,123,0,180,57
1713319667686,PSYC 162,A00,494191,Wixted; John T,75,0,100,25
1713319668715,PSYC 172,A00,494192,Gorman; Michael R.,37,0,45,8
1713319669741,PSYC 178,A00,494193,Glaser; Dale,38,0,45,7
1713319670765,PSYC 193,A00,505725,Chapman; Eddie Nathaniel,20,0,20,0
1713319671796,RELI 145GS,A00,519817,Rahimi; Babak,18,0,20,2
1713319672824,SE 101A,A01,490862,Chadha; Mayank,23,0,25,2
1713319673860,SE 101C,A01,490924,Krysl; Petr,17,0,20,3
1713319674885,SE 110A,A01,490928,Staff,19,0,20,1
1713319675910,SE 130A,A00,490929,Morrison; Machel Leigh,59,0,70,11
1713319676935,SIO 1,A01,519325,Staff,39,0,40,1
1713319677962,SIO 30,A01,519327,Staff,38,0,40,2
1713319678991,SIO 40,A00,519328,Staff,39,0,40,1
1713319680020,SIO 46GS,A00,519819,Cook; Geoffrey W,17,0,25,8
1713319681048,SIO 109R,A00,494197,Forman; Fonna,2,0,20,18
1713319682074,SIO 121GS,A00,519827,Cook; Geoffrey W,17,0,25,8
1713319683114,SIO 132,A01,519330,Staff,38,0,40,2
1713319684140,SIO 133,A01,519397,Staff,37,0,40,3
1713319685170,SIO 139,A00,519396,Kacev; David,31,0,40,9
1713319686200,SOCI 1,A01,494199,Thorpe; Charles Robert,22,0,30,8
1713319686200,SOCI 1,A02,494200,Thorpe; Charles Robert,30,0,30,0
1713319686200,SOCI 1,A03,494201,Thorpe; Charles Robert,29,0,30,1
1713319686200,SOCI 1,A04,494202,Thorpe; Charles Robert,29,0,30,1
1713319686200,SOCI 1,A05,494203,Thorpe; Charles Robert,29,0,30,1
1713319686200,SOCI 1,A06,494204,Thorpe; Charles Robert,30,0,30,0
1713319686200,SOCI 1,A07,494205,Thorpe; Charles Robert,29,0,30,1
1713319687228,SOCI 60,A01,494207,Staff,35,0,40,5
1713319687228,SOCI 60,A02,494208,Staff,39,0,40,1
1713319688258,SOCI 100,A01,494210,Payne; Christine Anna,27,0,30,3
1713319688258,SOCI 100,A02,494211,Payne; Christine Anna,26,0,30,4
1713319689284,SOCI 109M,A00,494212,Staff,20,0,20,0
1713319690307,SOCI 110,A00,494213,Staff,35,0,40,5
1713319692361,SOCI 118E,A00,494215,Ng; Kwai,37,0,40,3
1713319693386,SOCI 125,A00,494216,Calderon-Zaks; Michael Aar,42,0,45,3
1713319694412,SOCI 126,A01,494218,Jones; Makeba,3,0,5,2
1713319695441,SOCI 131,A00,494219,Thorpe; Charles Robert,28,0,30,2
1713319697498,SOCI 135,A00,494221,Payne; Christine Anna,32,0,50,18
1713319698523,SOCI 136E,A00,626690,Ruiz; Jonathan Joseph,25,0,25,0
1713319699605,SOCI 138GS,A00,494222,Navon; Daniel,24,0,28,4
1713319701656,SOCI 145,A00,494224,Staff,42,0,45,3
1713319702685,SOCI 153,A00,494225,Staff,28,0,30,2
1713319703710,SOCI 160E,A00,494226,Ng; Kwai,32,0,40,8
1713319704732,SOCI 180,A00,494227,Staff,29,0,30,1
1713319705759,SOCI 189GS,A00,494228,Ribas Norris; Janet Vanesa,11,0,11,0
1713319706787,SOCI 190GS,A00,553232,Ribas Norris; Janet Vanesa,11,0,11,0
1713319707814,SOMI 220,A00,627178,Schneid; Stephen David,30,0,30,0
1713319708841,SYN 2,001,490768,Staff,14,0,15,1
1713319708841,SYN 2,002,490769,Staff,15,0,15,0
1713319708841,SYN 2,004,490775,Staff,0,0,0,0
1713319708841,SYN 2,003,490774,Staff,0,0,0,0
1713319708841,SYN 2,005,490776,Staff,0,0,0,0
1713319709869,SYN 2R,001,490779,Staff,12,0,15,3
1713319709869,SYN 2R,002,514635,Staff,14,0,15,1
1713319710939,SYN 100,A01,490783,Staff,14,0,20,6
1713319710939,SYN 100,B01,490787,Staff,10,0,20,10
1713319710939,SYN 100,C01,490789,Staff,12,0,20,8
1713319711969,SYN 150,A00,490817,Staff,14,0,15,1
1713319711969,SYN 150,B00,514610,Staff,15,0,15,0
1713319713002,TDAC 1,A00,492753,Walsh; Kim C.,19,0,20,1
1713319713002,TDAC 1,B00,492754,Harting; Carla Kelso,19,0,20,1
1713319713002,TDAC 1,C00,513995,Salovey; Todd,15,0,20,5
1713319714030,TDAC 101,A00,492766,Harting; Carla Kelso,17,0,20,3
1713319715058,TDAC 102,A00,492768,Basso; Beatrice,19,0,20,1
1713319716084,TDDE 111,A00,492769,Staff,25,0,25,0
1713319717113,TDDE 131,A00,492770,Staff,15,0,15,0
1713319717113,TDDE 131,B00,492771,Staff,15,0,15,0
1713319718141,TDDE 131GS,A00,523716,Guirguis; Mark C,24,0,28,4
1713319719169,TDGE 1,A01,492756,Salovey; Todd,57,0,60,3
1713319720195,TDGE 5,A01,492758,Staff,24,0,25,1
1713319721224,TDGE 10,A00,492759,Fulton; Julia,207,0,220,13
1713319722253,TDGE 11,A00,492760,Castro; Robert Jess,198,0,200,2
1713319724301,TDGE 124,A00,492772,Fulton; Julia,191,0,220,29
1713319725331,TDGE 125,A00,492773,Meyer; Ursula,40,0,50,10
1713319725331,TDGE 125,B00,492774,Staff,49,0,50,1
1713319725331,TDGE 125,C00,523565,Staff,48,0,50,2
1713319726355,TDGE 125GS,A00,523580,Guirguis; Mark C,24,0,28,4
1713319727384,TDGE 127,A00,492775,Havis; Allan,39,0,50,11
1713319728412,TDHT 101,A00,492776,Staff,35,0,35,0
1713319729438,TDMV 1,A00,492762,Caligagan; Maria T.,30,0,30,0
1713319729438,TDMV 1,B00,492763,Arcidiacono; Kristin,25,0,30,5
1713319730464,TDMV 2,A00,492764,Weinberg; Sadie,29,0,30,1
1713319731489,TDMV 3,A00,492765,Mack; Kara Shanai',39,0,40,1
1713319732517,TDMV 138,A00,492777,Mack; Kara Shanai',35,0,40,5
1713319733543,TDMV 140,A00,492778,Lima; Paulo Henrique,40,0,40,0
1713319734575,TDMV 142,A00,492779,Caligagan; Maria T.,34,0,40,6
1713319734575,TDMV 142,B00,492780,Caligagan; Tony,37,0,40,3
1713319735604,TDMV 143,A00,492781,Fyall; Daunte Edward,39,0,40,1
1713319736634,USP 1,A01,492401,Kwak; Nancy,26,0,35,9
1713319737666,USP 2,A01,492453,Hinds; Juli Beth,35,0,35,0
1713319738695,USP 3,A01,492516,Staff,29,0,35,6
1713319739721,USP 4,A00,492522,McTague; Sarah,18,0,25,7
1713319740747,USP 100,A00,492523,Staff,33,0,35,2
1713319741774,USP 101,A00,492524,Staff,13,0,15,2
1713319742801,USP 105,A00,492525,Staff,21,0,25,4
1713319743831,USP 151,A00,492526,Shenkman; Michael Thomas,32,0,35,3
1713319744855,USP 170,A00,492545,Hinds; Juli Beth,33,0,35,2
1713319745881,USP 171GS,A00,492608,Bussell; Mirle Rabinowitz,24,0,28,4
1713319746907,USP 183GS,A00,492613,Peerson; Susan,24,0,28,4
1713319747935,VIS 30,A01,490693,Yoldas; Pinar,20,0,22,2
1713319747935,VIS 30,A02,490694,Yoldas; Pinar,18,0,22,4
1713319748961,VIS 83,A00,490695,Kester; Grant,64,0,75,11
1713319749986,VIS 105D,A00,490696,Staff,22,0,25,3
1713319751015,VIS 124CN,A00,490699,Rose; Jordan M,68,0,75,7
1713319752045,VIS 125GS,A00,511221,Williams; Alena J,21,0,22,1
1713319753074,VIS 128D,A00,490700,Staff,73,0,75,2
1713319754104,VIS 151,A01,490717,Staff,33,0,34,1
1713319754104,VIS 151,A02,490766,Staff,33,0,34,1
1713319755130,VIS 154GS,A00,511972,Williams; Alena J,21,0,22,1
1713319756157,VIS 160A,A00,490767,Stone; Patricia,7,0,10,3
1713319757183,WCWP 10A,A00,490638,Staff,14,0,15,1
1713319757183,WCWP 10A,B00,490640,Staff,15,0,15,0
1713319758206,WCWP 10B,A00,490641,Staff,0,0,0,0
1713319758206,WCWP 10B,B00,490642,Staff,14,0,15,1
1713319758206,WCWP 10B,C00,490644,Staff,13,0,15,2
1713319758206,WCWP 10B,D00,490647,Staff,0,0,0,0
1713319759235,WCWP 100,A00,490655,Staff,0,0,0,0
1713319759235,WCWP 100,B00,490687,Staff,10,0,15,5
1713319761338,ANAR 153,A00,487222,Braswell; Geoffrey E.,54,0,60,6
1713319762363,ANBI 134,A00,487223,Staff,7,0,20,13
1713319763390,ANBI 143GS,A00,487224,Noel; Geoffroy Pierre Jean,19,0,24,5
1713319764415,ANBI 144GS,A00,519548,Noel; Geoffroy Pierre Jean,19,0,24,5
1713319765441,ANSC 101,A00,487225,Staff,19,0,20,1
1713319766470,ANSC 125,A00,487227,Brenner; Suzanne A,39,0,40,1
1713319768523,ANSC 146,A00,487229,Staff,35,0,40,5
1713319769549,ANSC 148,A00,487230,Olivas Hernandez; Olga Lid,39,0,40,1
1713319770574,ANSC 150,A00,504165,Sloane; Julia Kathryn,19,0,20,1
1713319771600,ANSC 180,A00,487232,Staff,13,0,15,2
1713319772629,ANSC 188,A00,627155,Staff,39,0,40,1
1713319773656,ANTH 5,A00,519529,Semendeferi; Ekaterini,15,0,15,0
1713319774682,ANTH 10,A00,487219,Staff,58,0,60,2
1713319775710,ANTH 23,A01,487221,Staff,17,0,20,3
1713319776736,ANTH 102,A00,487233,Wilder; Linnea Lorene,51,0,60,9
1713319777761,ANTH 103,A00,487234,Varma; Saiba,55,0,60,5
1713319778786,ANTH 105,A00,487235,Stewart; Alexander B,55,0,60,5
1713319779818,BENG 100,A01,516685,Taylor Amos; Alyssa C,28,0,30,2
1713319780843,BIBC 102,A01,491316,Flagg; Matthew Paul,25,0,88,63
1713319780843,BIBC 102,A02,491366,Flagg; Matthew Paul,82,0,88,6
1713319781868,BIBC 103,A01,491486,Boumechache; Miyyada,16,0,24,8
1713319781868,BIBC 103,A02,491487,Boumechache; Miyyada,24,0,24,0
1713319782895,BICD 100,A01,516882,Staff,75,0,75,0
1713319782895,BICD 100,A02,516890,Staff,69,0,75,6
1713319783921,BICD 102GS,A00,491488,Lo; Stanley M.,26,0,28,2
1713319784946,BIEB 136GS,A00,516940,Holway; David A. & Shurin; Jonathan,19,0,24,5
1713319785971,BIEB 137GS,A01,517034,Holway; David A. & Shurin; Jonathan,19,0,24,5
1713319786996,BIEB 138GS,A01,491492,Pirino; Giorgia,21,0,28,7
1713319788025,BILD 1,A01,491296,Staff,62,0,63,1
1713319788025,BILD 1,A02,491297,Staff,63,0,63,0
1713319789055,BILD 4,A01,517099,Gonzalez Gamboa; Ivonne,22,0,24,2
1713319789055,BILD 4,A02,517100,Gonzalez Gamboa; Ivonne,24,0,24,0
1713319790080,BILD 60GS,A00,491309,Lo; Stanley M.,26,0,28,2
1713319791107,BIMM 100,A01,517136,Staff,87,0,100,13
1713319792133,BIMM 110,A01,517182,Staff,63,0,100,37
1713319793165,BIMM 120,A01,517228,Pickett; Brooke Elizabeth,35,0,63,28
1713319793165,BIMM 120,A02,517240,Pickett; Brooke Elizabeth,46,0,63,17
1713319794188,BIMM 132GS,A01,491498,Pirino; Giorgia,21,0,28,7
1713319795213,BIMM 143,A01,491589,Bozinovic; Goran,15,0,40,25
1713319796240,BIPN 100,A01,491594,Armour; Jon Christopher,90,0,100,10
1713319797265,BIPN 140,A01,491602,Marino; Marc J,28,0,50,22
1713319799319,CAT 125,A00,515973,Staff,19,0,20,1
1713319800349,CAT 125GS,A00,515974,Rahimi; Babak,18,0,20,2
1713319801382,CAT 125R,A00,515980,Staff,14,0,20,6
1713319801382,CAT 125R,B00,515981,Tosun; Adriana,19,0,20,1
1713319801382,CAT 125R,C00,515987,Hyland; Tina Mae,0,1,20,20
1713319801382,CAT 125R,D00,515988,Bronstein; Phoebe Malan,18,0,20,2
1713319802509,CENG 15,A01,488699,Drews; Aaron,25,0,25,0
1713319803591,CENG 100,A00,505196,Opatkiewicz; Justin Paul,25,0,25,0
1713319804615,CGS 2A,A01,489598,Staff,33,0,35,2
1713319805641,CGS 112,A00,489599,Staff,15,0,15,0
1713319806668,CGS 119,A00,489603,Staff,10,0,10,0
1713319807696,CGS 120,A00,489604,Staff,14,0,15,1
1713319808726,CGS 150,A00,489607,Staff,15,0,15,0
1713319809756,CHEM 6A,A01,488715,Staff,98,0,100,2
1713319810782,CHEM 6B,A01,488719,Piercy; Marc Anthony,100,0,100,0
1713319811806,CHEM 6C,A01,488723,Albizati; Kim F.,94,0,100,6
1713319812831,CHEM 7L,A01,488728,Schurmeier; Kimberly,18,0,24,6
1713319812831,CHEM 7L,A02,488730,Schurmeier; Kimberly,23,0,24,1
1713319812831,CHEM 7L,A03,488734,Schurmeier; Kimberly,22,0,24,2
1713319812831,CHEM 7L,A04,488763,Schurmeier; Kimberly,23,0,24,1
1713319812831,CHEM 7L,B01,488798,Schurmeier; Kimberly,17,0,24,7
1713319812831,CHEM 7L,B02,488801,Schurmeier; Kimberly,23,0,24,1
1713319812831,CHEM 7L,B03,488808,Schurmeier; Kimberly,24,0,24,0
1713319812831,CHEM 7L,B04,488811,Schurmeier; Kimberly,24,0,24,0
1713319813855,CHEM 11,A01,488897,Stallings; Dontarie M,97,0,100,3
1713319814885,CHEM 40A,A01,488913,Albizati; Kim F.,88,0,100,12
1713319815913,CHEM 40B,A01,488920,Weizman; Haim,44,0,50,6
1713319815913,CHEM 40B,A02,488938,Weizman; Haim,45,0,50,5
1713319816936,CHEM 41A,A01,489029,Klosterman; Jeremy K,57,0,60,3
1713319817960,CHEM 41C,A01,500436,Tor; Yitzhak,55,0,60,5
1713319818990,CHEM 43A,A01,500426,Weizman; Haim,0,0,24,24
1713319818990,CHEM 43A,A02,500430,Weizman; Haim,13,0,24,11
1713319818990,CHEM 43A,B01,514041,Klosterman; Jeremy K,15,0,24,9
1713319818990,CHEM 43A,B02,514047,Klosterman; Jeremy K,23,0,24,1
1713319820019,CHEM 108,A01,489140,Jennings; Patricia A.,11,0,24,13
1713319820019,CHEM 108,A02,489142,Jennings; Patricia A.,14,0,24,10
1713319821052,CHEM 114A,A01,489147,Stallings; Dontarie M,76,0,100,24
1713319822086,CHIN 169A,A00,489171,Wang; Xiao,19,0,20,1
1713319824138,COGS 3,A01,518827,Boyle; Mary E. T.,27,0,40,13
1713319825167,COGS 11,A01,489175,Staff,28,0,30,2
1713319826192,COGS 14A,A01,518829,Staff,51,0,60,9
1713319827217,COGS 14B,A01,489177,Hoffman; Drew Ellen,66,0,75,9
1713319828239,COGS 100,A01,489181,Allen; Michael Gordon,65,0,75,10
1713319829264,COGS 101A,A01,489183,Staff,48,0,60,12
1713319830292,COGS 101B,A01,489185,Allen; Michael Gordon,9,0,30,21
1713319831317,COGS 101C,A01,526786,Staff,24,0,30,6
1713319833370,COGS 107A,A01,489189,Boyle; Mary E. T.,19,0,35,16
1713319834399,COGS 107B,A01,627144,Mooshagian; Eric Frederick,60,0,60,0
1713319835424,COGS 118A,A01,489191,Staff,0,40,40,40
1713319837472,COGS 171GS,A01,489194,Pineda; Jaime A,21,0,28,7
1713319838497,COGS 172,A01,489196,Staff,4,0,30,26
1713319839522,COGS 174GS,A01,489264,Pineda; Jaime A,21,0,28,7
1713319840547,COGS 180,A01,627150,Staff,28,0,30,2
1713319841572,COGS 186,A01,489274,Staff,0,1,30,30
1713319842597,COMM 10,A01,489276,Staff,23,0,25,2
1713319842597,COMM 10,A02,489303,Staff,23,0,25,2
1713319843621,COMM 100A,A01,489312,Staff,14,0,25,11
1713319843621,COMM 100A,A02,489313,Staff,24,0,25,1
1713319844649,COMM 106T,A00,512540,Staff,34,0,35,1
1713319845674,COMM 107,A00,489347,Staff,30,0,35,5
1713319846698,COMM 109P,A00,489358,Staff,31,0,35,4
1713319847724,COMM 132,A00,489361,McKenna; Denise,28,0,30,2
1713319848748,COMM 146,A00,489362,Halm; Gavin Patrick,27,0,30,3
1713319849777,COMM 190,A00,489363,Abuelhiga; Soraya Jill,18,0,23,5
1713319850805,CSE 8A,A50,489366,Staff,22,0,25,3
1713319850805,CSE 8A,A51,489367,Staff,24,0,25,1
1713319851833,CSE 11,A01,489398,Cao; Yingjun,79,0,100,21
1713319852859,CSE 12,A01,489487,Staff,43,0,50,7
1713319853892,CSE 20,A01,489497,Staff,48,0,50,2
1713319854915,CSE 21,A01,489517,Braun; Oliver,43,0,50,7
1713319855940,CSE 101,A01,489524,Braun; Oliver,0,25,50,50
1713319856969,CSE 105,A01,512594,Jones; Miles E,76,0,100,24
1713319856969,CSE 105,B01,512598,Jones; Miles E,55,0,100,45
1713319858089,CSE 140,A01,489538,Staff,43,0,50,7
1713319859118,CSE 141,A01,489550,Eldon; John,71,0,100,29
1713319860145,CSE 141L,A01,489571,Eldon; John,69,0,100,31
1713319861172,CSE 151A,A01,489583,Solares; Edwin A,146,0,200,54
1713319862198,CSE 175,A01,510886,Kumar; Rakesh,30,0,30,0
1713319863223,CSE 190,A00,516828,Dubnov; Shlomo,38,0,49,11
1713319864252,DOC 100D,A00,489667,Pass; Natalye Joann,19,0,25,6
1713319865283,DSC 10,A01,624268,Staff,72,0,75,3
1713319866307,DSC 20,A01,624476,Staff,50,0,50,0
1713319867333,DSC 40A,A01,624608,Staff,39,0,40,1
1713319868362,DSGN 1,A01,489179,Rill; Bryan,36,0,50,14
1713319869386,ECE 17,A01,490489,Sahay; Rajeev,18,0,30,12
1713319870414,ECE 65,A50,490492,Staff,14,0,20,6
1713319870414,ECE 65,A51,490493,Staff,20,0,20,0
1713319871439,ECON 1,A01,489715,Famulari; Melissa,68,0,70,2
1713319872468,ECON 2,A01,489717,Levkoff; Steven B.,68,0,70,2
1713319873498,ECON 3,A01,489948,Staff,70,0,70,0
1713319875559,ECON 5,A01,490103,Staff,27,0,30,3
1713319875559,ECON 5,B01,626281,Dai; Yinlin,45,0,45,0
1713319876584,ECON 100A,A01,490127,Famulari; Melissa,66,0,70,4
1713319877609,ECON 100B,A01,490129,Staff,64,0,70,6
1713319878635,ECON 109,A01,490187,Shishkin; Denis,27,0,35,8
1713319879661,ECON 110A,A01,490190,Levkoff; Steven B.,60,0,70,10
1713319880689,ECON 120A,A01,490245,Dai; Yinlin,62,0,70,8
1713319881718,ECON 120B,A01,490247,Nieto-Barthaburu; Augusto,50,0,70,20
1713319882748,ECON 120C,A01,490253,Sun; Yixiao,30,0,35,5
1713319882748,ECON 120C,B01,490255,Sun; Yixiao,34,0,35,1
1713319883773,ECON 129,A00,490256,Eckert; Fabian Paul,24,0,35,11
1713319884800,ECON 131,A00,490257,Nieto-Barthaburu; Augusto,0,6,35,35
1713319885826,ECON 138,A00,490258,Bharadwaj; Prashant,18,0,35,17
1713319885826,ECON 138,B00,490259,Bharadwaj; Prashant,16,0,35,19
1713319886852,ECON 159,A00,490260,Hendrickson; Gerald M.,0,8,0,0
1713319887884,ECON 178,A01,553995,Zhu; Ying,24,0,35,11
1713319888909,EDS 40,A01,512576,Black; Alison Michelle,20,0,20,0
1713319889935,EDS 107,A01,515848,Staff,30,0,30,0
1713319890959,EDS 110R,A01,490262,Staff,26,0,30,4
1713319891988,EDS 112,A01,490264,Chapman; Thandeka K,42,0,50,8
1713319893014,EDS 113,A00,490266,Staff,26,0,30,4
1713319894039,EDS 118,A00,490267,Warstadt; Melissa Fawn,21,0,30,9
1713319895068,EDS 124BR,A00,490268,Eguchi; Emi,4,0,25,21
1713319895068,EDS 124BR,B00,490269,Eguchi; Emi,25,0,25,0
1713319896094,EDS 126,A01,490271,Jones; Makeba,44,0,50,6
1713319897118,EDS 135,A01,490316,Staff,19,0,20,1
1713319898145,ENVR 142GS,A00,519514,Chang; Edmond Yi-Teh,27,0,28,1
1713319899170,ETHN 103,A00,490504,Staff,30,0,36,6
1713319900194,ETHN 103A,A00,490505,Man; Simeon S,5,0,9,4
1713319901218,ETHN 109,A00,490506,Staff,30,0,30,0
1713319902241,ETHN 118,A00,490507,Staff,35,0,36,1
1713319903270,ETHN 119,A00,490508,Staff,34,0,36,2
1713319904301,ETHN 121R,A00,490518,Choi; Esther Min,25,0,36,11
1713319905328,ETHN 127,A00,490528,Staff,15,0,15,0
1713319906352,ETHN 139,A00,490573,Staff,10,0,10,0
1713319907430,ETHN 150,A00,490575,Staff,15,0,15,0
1713319908454,GLBH 20,A00,491705,Elwardani; Nile Regina,38,0,40,2
1713319909478,GLBH 101,A00,491706,Staff,20,0,20,0
1713319910506,GLBH 111,A01,491708,Burgos; Jose L.,15,0,15,0
1713319911530,GLBH 146,A00,491709,Staff,11,0,20,9
1713319912554,GLBH 148,A00,491710,Olivas Hernandez; Olga Lid,13,0,20,7
1713319913581,GLBH 150,A00,491711,Sloane; Julia Kathryn,20,0,20,0
1713319914606,HIEA 131,A00,491760,Staff,29,0,32,3
1713319915631,HIEA 153,A00,491762,Staff,29,0,30,1
1713319916659,HIEU 124,A00,491811,Staff,26,0,32,6
1713319917685,HIEU 124GS,A00,491812,Markman; Kristina,27,0,28,1
1713319918710,HIEU 147,A00,491813,Staff,30,0,32,2
1713319919737,HIEU 149GS,A00,491816,Caldwell; Michael Alan,28,0,28,0
1713319920762,HILD 2C,A01,491713,Hendrickson; Gerald M.,27,0,30,3
1713319921788,HILD 7B,A01,491715,Kwak; Nancy,4,0,30,26
1713319922811,HILD 10,A01,491717,Staff,13,0,20,7
1713319923837,HILD 30GS,A00,491719,Edington; Claire Ellen,24,0,28,4
1713319924864,HINE 109,A00,491818,Shafir; Nir,27,0,32,5
1713319925891,HINE 128,A00,491821,Shafir; Nir,31,0,32,1
1713319926918,HISC 117,A00,491830,Staff,28,0,32,4
1713319927942,HIUS 103,A00,491834,Man; Simeon S,15,0,23,8
1713319928965,HIUS 108B,A00,491835,Staff,29,0,30,1
1713319929990,HIUS 141,A00,491836,Hendrickson; Gerald M.,29,0,32,3
1713319931031,HIUS 149,A00,491839,Staff,27,0,32,5
1713319932056,HUM 3,A01,512617,Crum; Matthew Stephen,44,0,50,6
1713319932056,HUM 3,A02,512618,Crum; Matthew Stephen,48,0,50,2
1713319933081,HUM 3GS,A00,512663,Markman; Kristina,0,0,0,1
1713319933081,HUM 3GS,B00,512664,Staff,0,0,0,0
1713319934106,HUM 4,A01,512620,West; Geoffrey Scott,30,0,50,20
1713319935134,HUM 4GS,A00,512666,Lyon; Antony J.,0,0,0,4
1713319936159,HUM 4R,A01,512625,Watkins; Eric,49,0,50,1
1713319937186,HUM 5,A01,512649,Zavodny; Tatiana Sophia,27,0,50,23
1713319937186,HUM 5,B01,512661,Zroka; Ryan Edward,48,0,50,2
1713319938211,INTL 190,A00,490577,Segui; Alan S,0,0,0,5
1713319939240,JAPN 20AR,A01,491267,Ross; Kayoko F,8,0,20,12
1713319940269,JAPN 180,A00,491285,Berman; Michael David,33,0,40,7
1713319941300,LATI 50,A01,502536,Kokinis; Troy Andreas,16,0,22,6
1713319941300,LATI 50,A02,502551,Kokinis; Troy Andreas,22,0,22,0
1713319941300,LATI 50,A03,502650,Kokinis; Troy Andreas,22,0,22,0
1713319941300,LATI 50,A04,502909,Kokinis; Troy Andreas,22,0,22,0
1713319942325,LATI 160,A01,502920,Kokinis; Troy Andreas,30,0,30,0
1713319943349,LIFR 1A,A00,490494,Van Moer; Vinciane G,17,0,20,3
1713319944374,LIFR 1AX,A00,490495,Van Moer; Vinciane G,17,0,20,3
1713319945402,LIFR 1B,A00,490496,Van Moer; Vinciane G,18,0,20,2
1713319946426,LIFR 1BX,A00,490497,Van Moer; Vinciane G,18,0,20,2
1713319947454,LIGN 8,A00,505198,McIntosh; Justin Daniel,135,0,150,15
1713319948483,LIGN 9GS,A00,491239,Lott; Margaret S.,18,0,20,2
1713319949507,LIGN 101,A01,505200,McIntosh; Justin Daniel,24,0,30,6
1713319950533,LIGN 120,A01,491244,Staff,24,0,30,6
1713319951557,LIGN 149GS,A00,491245,Lott; Margaret S.,18,0,20,2
1713319952581,LIGN 170,A00,491247,Staff,23,0,30,7
1713319953606,LISP 1D,A00,490498,Munoz Sanchez; Alicia,10,0,14,4
1713319953606,LISP 1D,B00,490499,Munoz Sanchez; Alicia,6,0,14,8
1713319953606,LISP 1D,C00,490500,Munoz Sanchez; Alicia,8,0,14,6
1713319953606,LISP 1D,D00,490501,Munoz Sanchez; Alicia,10,0,14,4
1713319954633,LISP 1DX,A00,490502,Munoz Sanchez; Alicia,15,0,28,13
1713319954633,LISP 1DX,B00,490503,Munoz Sanchez; Alicia,17,0,28,11
1713319956685,LTAM 110,A00,491847,Staff,23,0,25,2
1713319957711,LTCS 119,A00,491848,Staff,11,0,15,4
1713319958738,LTCS 130,A00,491849,Staff,24,0,25,1
1713319960793,LTEA 120C,A00,491852,Staff,32,0,40,8
1713319961818,LTEN 130GS,A00,491853,Lyon; Antony J.,24,0,28,4
1713319962845,LTEN 148,A00,491855,Staff,23,0,25,2
1713319963869,LTEN 159,A00,491856,Staff,21,0,25,4
1713319964896,LTEN 180,A00,491857,Staff,8,0,15,7
1713319966949,LTSP 123GS,A00,505928,Bessett; Ryan Matthew,24,0,28,4
1713319967973,LTSP 174GS,A00,506037,Bessett; Ryan Matthew,24,0,28,4
1713319970029,LTWR 102,A00,491861,Staff,9,0,15,6
1713319971063,LTWR 106,A00,491862,Staff,10,0,15,5
1713319972087,MAE 11,A00,490930,Bahadori; Mohammad Yousef,96,0,100,4
1713319973111,MAE 30A,A00,490931,Qi; Huihui,37,0,40,3
1713319974138,MAE 101A,A00,491036,Sadeghizadeh; Zahra,96,0,100,4
1713319975162,MAE 101C,A00,491037,Seshadri; Kalyanasundaram,72,0,100,28
1713319976190,MAE 113,A00,491040,Seshadri; Kalyanasundaram,66,0,80,14
1713319977215,MAE 131A,A00,491041,Ghazinejad; Maziar,38,0,40,2
1713319978241,MAE 142,A00,491053,Staff,39,0,40,1
1713319979267,MAE 143A,A00,491054,Staff,34,0,50,16
1713319980297,MAE 150,A00,491092,Truong; Phuong Thi Ngoc,23,0,35,12
1713319981321,MATH 3C,A01,494031,Pardo Guerra; Sebastian,30,0,30,0
1713319981321,MATH 3C,A02,494032,Pardo Guerra; Sebastian,29,0,30,1
1713319982346,MATH 10A,A01,494034,Staff,27,0,30,3
1713319982346,MATH 10A,A02,494035,Staff,28,0,30,2
1713319982346,MATH 10A,B01,494037,Staff,27,0,30,3
1713319982346,MATH 10A,B02,494038,Staff,29,0,30,1
1713319983373,MATH 10B,A01,494040,Habib; Yousaf,23,0,30,7
1713319983373,MATH 10B,A02,494041,Habib; Yousaf,28,0,30,2
1713319983373,MATH 10B,A03,494042,Habib; Yousaf,29,0,30,1
1713319983373,MATH 10B,A04,494043,Habib; Yousaf,30,0,30,0
1713319983373,MATH 10B,B01,494045,Habib; Yousaf,27,0,30,3
1713319983373,MATH 10B,B02,494046,Habib; Yousaf,30,0,30,0
1713319983373,MATH 10B,B03,494047,Habib; Yousaf,30,0,30,0
1713319983373,MATH 10B,B04,494048,Habib; Yousaf,30,0,30,0
1713319984402,MATH 18,A01,494050,Kemp; Todd Aahron,25,0,30,5
1713319984402,MATH 18,A02,494051,Kemp; Todd Aahron,29,0,30,1
1713319984402,MATH 18,B01,494054,Kemp; Todd Aahron,27,0,30,3
1713319984402,MATH 18,B02,494055,Kemp; Todd Aahron,29,0,30,1
1713319985431,MATH 20A,A01,494059,Suk; Andrew Hoon,30,0,30,0
1713319986455,MATH 20B,A01,494061,Briones; Jor-el Thomas Caparas,33,0,35,2
1713319986455,MATH 20B,B01,494063,Bach; Quang Tran,34,0,35,1
1713319987488,MATH 20C,A01,494065,Staff,28,0,30,2
1713319987488,MATH 20C,A02,494066,Staff,30,0,30,0
1713319987488,MATH 20C,A03,494067,Staff,30,0,30,0
1713319987488,MATH 20C,A04,494068,Staff,30,0,30,0
1713319987488,MATH 20C,B01,494070,Zhang; Ming,26,0,30,4
1713319987488,MATH 20C,B02,494071,Zhang; Ming,28,0,30,2
1713319987488,MATH 20C,B03,494072,Zhang; Ming,29,0,30,1
1713319987488,MATH 20C,B04,494073,Zhang; Ming,29,0,30,1
1713319988514,MATH 20D,A01,494075,Staff,22,0,30,8
1713319988514,MATH 20D,A02,494076,Staff,30,0,30,0
1713319989538,MATH 20E,A01,494079,Staff,24,0,30,6
1713319989538,MATH 20E,A02,494080,Staff,26,0,30,4
1713319989538,MATH 20E,B01,494082,Staff,25,0,30,5
1713319989538,MATH 20E,B02,494083,Staff,25,0,30,5
1713319990564,MATH 103A,A01,494085,Aliabadi Sr.; Mohsen,14,0,30,16
1713319990564,MATH 103A,A02,494086,Aliabadi Sr.; Mohsen,28,0,30,2
1713319990564,MATH 103A,B01,494088,Aliabadi Sr.; Mohsen,22,0,30,8
1713319990564,MATH 103A,B02,494089,Aliabadi Sr.; Mohsen,28,0,30,2
1713319991589,MATH 109,A01,494091,Staff,30,0,30,0
1713319991589,MATH 109,A02,494092,Staff,29,0,30,1
1713319991589,MATH 109,B01,494094,Staff,27,0,30,3
1713319991589,MATH 109,B02,494095,Staff,29,0,30,1
1713319992620,MATH 142A,A01,494097,Chow; Bennett,16,0,30,14
1713319992620,MATH 142A,A02,494098,Chow; Bennett,24,0,30,6
1713319992620,MATH 142A,B01,494100,Chow; Bennett,19,0,30,11
1713319992620,MATH 142A,B02,494101,Chow; Bennett,29,0,30,1
1713319994674,MATH 168A,A01,516677,Dumitriu; Ioana,15,0,35,20
1713319995704,MATH 170A,A01,516679,Dumitriu; Ioana,20,0,30,10
1713319995704,MATH 170A,A02,516680,Dumitriu; Ioana,28,0,30,2
1713319996728,MATH 193A,A01,494107,Staff,15,0,30,15
1713319996728,MATH 193A,A02,494108,Staff,21,0,30,9
1713319996728,MATH 193A,A03,494109,Staff,29,0,30,1
1713319996728,MATH 193A,A04,494110,Staff,22,0,30,8
1713319999804,MGT 16,A00,491930,McKay; Michael J,91,0,98,7
1713320000833,MGT 18,A00,491992,McKay; Michael J,97,0,98,1
1713320001858,MGT 71,A00,492003,Staff,70,0,98,28
1713320002886,MGT 103,A00,505209,Eberhard; Craig A,82,0,98,16
1713320003914,MGT 131A,A00,505210,Anderson; John Charles,90,0,98,8
1713320005962,MGT 153,A00,492077,Perols; Johan Lars,24,0,90,66
1713320009042,MGT 164,A00,492222,McKay; Mary A,93,0,98,5
1713320010070,MGT 172,A00,492245,Staff,59,0,60,1
1713320010070,MGT 172,B00,505526,Hedges; Kathleen,71,0,98,27
1713320011152,MGT 181,A00,505669,Dunn; Louis Jean,84,0,98,14
1713320012176,MMW 14,A01,494399,Staff,20,0,28,8
1713320012176,MMW 14,A02,494400,Staff,25,0,28,3
1713320012176,MMW 14,A03,494401,Staff,28,0,28,0
1713320012176,MMW 14,A04,494402,Staff,28,0,28,0
1713320012176,MMW 14,B01,494404,Carreras; Maria Victoria,12,0,28,16
1713320012176,MMW 14,B02,494405,Carreras; Maria Victoria,26,0,28,2
1713320012176,MMW 14,B03,494406,Carreras; Maria Victoria,27,0,28,1
1713320012176,MMW 14,B04,494407,Carreras; Maria Victoria,28,0,28,0
1713320013202,MMW 14GS,A00,506250,Chang; Edmond Yi-Teh,0,0,0,0
1713320014311,MMW 121R,A01,494415,Adamiak; Patrick John,12,0,28,16
1713320014311,MMW 121R,A02,494416,Adamiak; Patrick John,24,0,28,4
1713320015339,MUS 1A,A01,494113,Staff,12,0,25,13
1713320015339,MUS 1A,A02,494114,Staff,25,0,25,0
1713320016362,MUS 4,A01,494116,Staff,24,0,25,1
1713320016362,MUS 4,A02,494117,Staff,22,0,25,3
1713320017390,MUS 5R,A01,494236,Dubnov; Shlomo,10,0,25,15
1713320017390,MUS 5R,A02,494237,Dubnov; Shlomo,25,0,25,0
1713320018416,MUS 6,A01,494122,Staff,12,0,25,13
1713320018416,MUS 6,A02,494123,Staff,24,0,25,1
1713320019443,MUS 7,A01,494125,Staff,16,0,25,9
1713320019443,MUS 7,A02,494126,Staff,24,0,25,1
1713320020466,MUS 11,A01,494128,Staff,23,0,25,2
1713320020466,MUS 11,A02,494129,Staff,24,0,25,1
1713320021493,MUS 13,A01,494131,Staff,25,0,25,0
1713320021493,MUS 13,A02,494132,Staff,25,0,25,0
1713320022521,MUS 15,A01,494134,Staff,17,0,25,8
1713320022521,MUS 15,A02,494135,Staff,25,0,25,0
1713320022521,MUS 15,B01,494137,Staff,24,0,25,1
1713320023549,MUS 80,A00,494232,Staff,24,0,25,1
1713320023549,MUS 80,B00,494233,Staff,25,0,25,0
1713320023549,MUS 80,C00,494234,Staff,23,0,25,2
1713320024574,MUS 95C,A00,494141,Staff,71,0,75,4
1713320025599,MUS 114,A00,494142,Staff,40,0,50,10
1713320026623,NANO 15,A01,490636,Drews; Aaron,7,0,7,0
1713320027649,PHIL 1,A00,490578,Grush; Rick Scott,49,0,50,1
1713320028673,PHIL 10,A01,490580,Grush; Rick Scott,33,0,35,2
1713320028673,PHIL 10,A02,490586,Grush; Rick Scott,33,0,35,2
1713320029699,PHIL 27,A01,490591,Staff,23,0,25,2
1713320029699,PHIL 27,A02,490592,Staff,25,0,25,0
1713320029699,PHIL 27,A03,490593,Staff,25,0,25,0
1713320029699,PHIL 27,A04,490598,Staff,25,0,25,0
1713320030728,PHIL 32,A01,490611,Staff,20,0,20,0
1713320030728,PHIL 32,A02,490618,Staff,20,0,20,0
1713320031755,PHIL 90,A00,490624,Staff,40,0,40,0
1713320032780,PHIL 136,A00,490627,Cohen; Jonathan David,37,0,40,3
1713320033806,PHIL 155,A00,490634,Staff,63,0,70,7
1713320034832,PHYS 1A,A00,491610,Staff,246,0,250,4
1713320035860,PHYS 1AL,001,491616,Tsai; Philbert S,28,0,30,2
1713320035860,PHYS 1AL,002,491618,Tsai; Philbert S,30,0,30,0
1713320036887,PHYS 1B,A00,491623,Staff,242,0,250,8
1713320037912,PHYS 1BL,001,491626,Tsai; Philbert S,25,0,30,5
1713320037912,PHYS 1BL,002,491628,Tsai; Philbert S,27,0,30,3
1713320038936,PHYS 1C,A00,491632,Staff,220,0,245,25
1713320039958,PHYS 1CL,001,491635,Tsai; Philbert S,9,0,30,21
1713320039958,PHYS 1CL,002,491643,Tsai; Philbert S,23,0,30,7
1713320040983,PHYS 2AR,A01,491651,Meyertholen; Andrew D.,44,0,50,6
1713320042008,PHYS 2B,A01,491659,Staff,106,0,115,9
1713320043037,PHYS 2BL,A01,491685,Staff,21,0,24,3
1713320043037,PHYS 2BL,A02,491700,Staff,23,0,24,1
1713320044064,PHYS 2C,A01,505161,Staff,106,0,115,9
1713320045090,PHYS 4A,A01,491704,Grinstein; Benjamin,99,0,100,1
1713320046117,POLI 5D,A01,494144,Staff,3,0,5,2
1713320046117,POLI 5D,B01,626283,Dai; Yinlin,5,0,5,0
1713320047143,POLI 12,A00,494145,Staff,44,0,45,1
1713320048171,POLI 13R,A00,494146,Forman; Fonna,45,0,50,5
1713320049195,POLI 27,A01,494148,Staff,57,0,60,3
1713320050220,POLI 30,A00,494149,Staff,49,0,50,1
1713320051246,POLI 100DA,A00,494150,Staff,21,0,25,4
1713320053300,POLI 100I,A00,494152,Staff,28,0,30,2
1713320054326,POLI 104B,A00,494153,Smith; Glenn Chatmas,53,0,55,2
1713320055350,POLI 104F,A00,494154,Staff,28,0,30,2
1713320056376,POLI 104I,A00,494155,Smith; Glenn Chatmas,30,0,30,0
1713320057400,POLI 110C,A00,494156,Ingham; Sean,23,0,25,2
1713320058424,POLI 117R,A00,494157,Forman; Fonna,10,0,20,10
1713320059452,POLI 118,A00,494158,Ingham; Sean,22,0,25,3
1713320060476,POLI 120H,A00,494159,Fisk; David Lee,40,0,45,5
1713320061500,POLI 131CR,A00,494160,Hoston; Germaine,36,0,45,9
1713320062524,POLI 133J,A00,494161,Staff,33,0,35,2
1713320063551,POLI 135,A00,494162,Fisk; David Lee,33,0,35,2
1713320064579,POLI 140A,A00,494164,Staff,21,0,30,9
1713320065604,POLI 142I,A00,494165,Staff,30,0,30,0
1713320066631,POLI 144D,A00,494166,Staff,23,0,25,2
1713320067791,POLI 151,A00,494167,Staff,30,0,30,0
1713320068818,POLI 153,A00,494168,Staff,33,0,35,2
1713320069843,POLI 160AA,A00,494169,Staff,35,0,40,5
1713320070868,POLI 162,A00,494170,Mignozzetti; Umberto,19,0,25,6
1713320071896,POLI 171,A00,494171,Mignozzetti; Umberto,21,0,25,4
1713320072923,PSYC 1,A00,494172,Staff,97,0,100,3
1713320073947,PSYC 2,A00,494173,Moranton; Nirelia Melbina-,40,0,50,10
1713320074975,PSYC 3,A00,494174,Staff,29,0,30,1
1713320076000,PSYC 6,A00,494175,Staff,17,0,20,3
1713320077026,PSYC 60,A01,494177,Staff,38,0,45,7
1713320078054,PSYC 70,A01,505724,Geller; Emma Harlan,42,0,45,3
1713320079080,PSYC 101,A00,494180,Heyman; Gail D.,85,0,100,15
1713320080104,PSYC 105,A00,494181,Geller; Emma Harlan,57,0,90,33
1713320081129,PSYC 106,A00,494182,Dobkins; Karen R.,29,0,45,16
1713320082157,PSYC 108,A00,494183,Adrian; Julia Anna,91,0,100,9
1713320083185,PSYC 114,A01,494185,Winkielman; Piotr,0,1,30,30
1713320084212,PSYC 122,A00,494186,Moranton; Nirelia Melbina-,34,0,50,16
1713320085242,PSYC 124,A00,494187,Chapman; Eddie Nathaniel,71,0,80,9
1713320086271,PSYC 131,A00,494188,Anagnostaras; Stephan,50,0,80,30
1713320087297,PSYC 144,A00,494189,Staff,11,0,50,39
1713320088325,PSYC 154,A00,494190,Lacefield; Katharine I,123,0,180,57
1713320089351,PSYC 162,A00,494191,Wixted; John T,75,0,100,25
1713320090377,PSYC 172,A00,494192,Gorman; Michael R.,36,0,45,9
1713320091405,PSYC 178,A00,494193,Glaser; Dale,37,0,45,8
1713320092429,PSYC 193,A00,505725,Chapman; Eddie Nathaniel,20,0,20,0
1713320093457,RELI 145GS,A00,519817,Rahimi; Babak,18,0,20,2
1713320094486,SE 101A,A01,490862,Chadha; Mayank,23,0,25,2
1713320095515,SE 101C,A01,490924,Krysl; Petr,16,0,20,4
1713320096539,SE 110A,A01,490928,Staff,19,0,20,1
1713320097564,SE 130A,A00,490929,Morrison; Machel Leigh,58,0,70,12
1713320098587,SIO 1,A01,519325,Staff,39,0,40,1
1713320099612,SIO 30,A01,519327,Staff,38,0,40,2
1713320100641,SIO 40,A00,519328,Staff,39,0,40,1
1713320101669,SIO 46GS,A00,519819,Cook; Geoffrey W,17,0,25,8
1713320102693,SIO 109R,A00,494197,Forman; Fonna,0,0,20,20
1713320103719,SIO 121GS,A00,519827,Cook; Geoffrey W,17,0,25,8
1713320104744,SIO 132,A01,519330,Staff,38,0,40,2
1713320105769,SIO 133,A01,519397,Staff,37,0,40,3
1713320106799,SIO 139,A00,519396,Kacev; David,31,0,40,9
1713320107825,SOCI 1,A01,494199,Thorpe; Charles Robert,22,0,30,8
1713320107825,SOCI 1,A02,494200,Thorpe; Charles Robert,30,0,30,0
1713320107825,SOCI 1,A03,494201,Thorpe; Charles Robert,29,0,30,1
1713320107825,SOCI 1,A04,494202,Thorpe; Charles Robert,29,0,30,1
1713320107825,SOCI 1,A05,494203,Thorpe; Charles Robert,29,0,30,1
1713320107825,SOCI 1,A06,494204,Thorpe; Charles Robert,30,0,30,0
1713320107825,SOCI 1,A07,494205,Thorpe; Charles Robert,29,0,30,1
1713320108849,SOCI 60,A01,494207,Staff,35,0,40,5
1713320108849,SOCI 60,A02,494208,Staff,39,0,40,1
1713320109875,SOCI 100,A01,494210,Payne; Christine Anna,27,0,30,3
1713320109875,SOCI 100,A02,494211,Payne; Christine Anna,26,0,30,4
1713320110901,SOCI 109M,A00,494212,Staff,20,0,20,0
1713320111926,SOCI 110,A00,494213,Staff,35,0,40,5
1713320113981,SOCI 118E,A00,494215,Ng; Kwai,37,0,40,3
1713320115061,SOCI 125,A00,494216,Calderon-Zaks; Michael Aar,42,0,45,3
1713320116090,SOCI 126,A01,494218,Jones; Makeba,3,0,5,2
1713320117118,SOCI 131,A00,494219,Thorpe; Charles Robert,28,0,30,2
1713320119168,SOCI 135,A00,494221,Payne; Christine Anna,31,0,50,19
1713320120192,SOCI 136E,A00,626690,Ruiz; Jonathan Joseph,25,0,25,0
1713320121217,SOCI 138GS,A00,494222,Navon; Daniel,24,0,28,4
1713320123269,SOCI 145,A00,494224,Staff,42,0,45,3
1713320124294,SOCI 153,A00,494225,Staff,28,0,30,2
1713320125322,SOCI 160E,A00,494226,Ng; Kwai,31,0,40,9
1713320126350,SOCI 180,A00,494227,Staff,29,0,30,1
1713320127375,SOCI 189GS,A00,494228,Ribas Norris; Janet Vanesa,11,0,11,0
1713320128401,SOCI 190GS,A00,553232,Ribas Norris; Janet Vanesa,11,0,11,0
1713320129427,SOMI 220,A00,627178,Schneid; Stephen David,30,0,30,0
1713320130451,SYN 2,001,490768,Staff,14,0,15,1
1713320130451,SYN 2,002,490769,Staff,15,0,15,0
1713320130451,SYN 2,004,490775,Staff,0,0,0,0
1713320130451,SYN 2,003,490774,Staff,0,0,0,0
1713320130451,SYN 2,005,490776,Staff,0,0,0,0
1713320131479,SYN 2R,001,490779,Staff,12,0,15,3
1713320131479,SYN 2R,002,514635,Staff,14,0,15,1
1713320132508,SYN 100,A01,490783,Staff,14,0,20,6
1713320132508,SYN 100,B01,490787,Staff,10,0,20,10
1713320132508,SYN 100,C01,490789,Staff,12,0,20,8
1713320133532,SYN 150,A00,490817,Staff,14,0,15,1
1713320133532,SYN 150,B00,514610,Staff,15,0,15,0
1713320134561,TDAC 1,A00,492753,Walsh; Kim C.,19,0,20,1
1713320134561,TDAC 1,B00,492754,Harting; Carla Kelso,19,0,20,1
1713320134561,TDAC 1,C00,513995,Salovey; Todd,15,0,20,5
1713320135585,TDAC 101,A00,492766,Harting; Carla Kelso,17,0,20,3
1713320136615,TDAC 102,A00,492768,Basso; Beatrice,19,0,20,1
1713320137639,TDDE 111,A00,492769,Staff,25,0,25,0
1713320138668,TDDE 131,A00,492770,Staff,15,0,15,0
1713320138668,TDDE 131,B00,492771,Staff,15,0,15,0
1713320139693,TDDE 131GS,A00,523716,Guirguis; Mark C,24,0,28,4
1713320140720,TDGE 1,A01,492756,Salovey; Todd,57,0,60,3
1713320141746,TDGE 5,A01,492758,Staff,24,0,25,1
1713320142772,TDGE 10,A00,492759,Fulton; Julia,207,0,220,13
1713320143800,TDGE 11,A00,492760,Castro; Robert Jess,199,0,200,1
1713320145850,TDGE 124,A00,492772,Fulton; Julia,191,0,220,29
1713320146880,TDGE 125,A00,492773,Meyer; Ursula,40,0,50,10
1713320146880,TDGE 125,B00,492774,Staff,49,0,50,1
1713320146880,TDGE 125,C00,523565,Staff,48,0,50,2
1713320147905,TDGE 125GS,A00,523580,Guirguis; Mark C,24,0,28,4
1713320148930,TDGE 127,A00,492775,Havis; Allan,39,0,50,11
1713320149958,TDHT 101,A00,492776,Staff,35,0,35,0
1713320150989,TDMV 1,A00,492762,Caligagan; Maria T.,30,0,30,0
1713320150989,TDMV 1,B00,492763,Arcidiacono; Kristin,25,0,30,5
1713320152017,TDMV 2,A00,492764,Weinberg; Sadie,29,0,30,1
1713320153044,TDMV 3,A00,492765,Mack; Kara Shanai',39,0,40,1
1713320154069,TDMV 138,A00,492777,Mack; Kara Shanai',35,0,40,5
1713320155094,TDMV 140,A00,492778,Lima; Paulo Henrique,40,0,40,0
1713320156120,TDMV 142,A00,492779,Caligagan; Maria T.,34,0,40,6
1713320156120,TDMV 142,B00,492780,Caligagan; Tony,37,0,40,3
1713320157144,TDMV 143,A00,492781,Fyall; Daunte Edward,39,0,40,1
1713320158169,USP 1,A01,492401,Kwak; Nancy,26,0,35,9
1713320159199,USP 2,A01,492453,Hinds; Juli Beth,35,0,35,0
1713320160230,USP 3,A01,492516,Staff,29,0,35,6
1713320161259,USP 4,A00,492522,McTague; Sarah,18,0,25,7
1713320162287,USP 100,A00,492523,Staff,33,0,35,2
1713320163311,USP 101,A00,492524,Staff,13,0,15,2
1713320164340,USP 105,A00,492525,Staff,21,0,25,4
1713320165369,USP 151,A00,492526,Shenkman; Michael Thomas,32,0,35,3
1713320166394,USP 170,A00,492545,Hinds; Juli Beth,33,0,35,2
1713320167422,USP 171GS,A00,492608,Bussell; Mirle Rabinowitz,24,0,28,4
1713320168450,USP 183GS,A00,492613,Peerson; Susan,24,0,28,4
1713320169476,VIS 30,A01,490693,Yoldas; Pinar,20,0,22,2
1713320169476,VIS 30,A02,490694,Yoldas; Pinar,18,0,22,4
1713320170503,VIS 83,A00,490695,Kester; Grant,64,0,75,11
1713320171528,VIS 105D,A00,490696,Staff,22,0,25,3
1713320172556,VIS 124CN,A00,490699,Rose; Jordan M,68,0,75,7
1713320173581,VIS 125GS,A00,511221,Williams; Alena J,21,0,22,1
1713320174608,VIS 128D,A00,490700,Staff,73,0,75,2
1713320175637,VIS 151,A01,490717,Staff,33,0,34,1
1713320175637,VIS 151,A02,490766,Staff,33,0,34,1
1713320176666,VIS 154GS,A00,511972,Williams; Alena J,21,0,22,1
1713320177692,VIS 160A,A00,490767,Stone; Patricia,7,0,10,3
1713320178717,WCWP 10A,A00,490638,Staff,14,0,15,1
1713320178717,WCWP 10A,B00,490640,Staff,15,0,15,0
1713320179744,WCWP 10B,A00,490641,Staff,0,0,0,0
1713320179744,WCWP 10B,B00,490642,Staff,14,0,15,1
1713320179744,WCWP 10B,C00,490644,Staff,13,0,15,2
1713320179744,WCWP 10B,D00,490647,Staff,0,0,0,0
1713320180768,WCWP 100,A00,490655,Staff,0,0,0,0
1713320180768,WCWP 100,B00,490687,Staff,10,0,15,5
1713320182853,ANAR 153,A00,487222,Braswell; Geoffrey E.,54,0,60,6
1713320183877,ANBI 134,A00,487223,Staff,7,0,20,13
1713320184904,ANBI 143GS,A00,487224,Noel; Geoffroy Pierre Jean,18,0,24,6
1713320185931,ANBI 144GS,A00,519548,Noel; Geoffroy Pierre Jean,18,0,24,6
1713320186956,ANSC 101,A00,487225,Staff,19,0,20,1
1713320187980,ANSC 125,A00,487227,Brenner; Suzanne A,39,0,40,1
1713320190033,ANSC 146,A00,487229,Staff,35,0,40,5
1713320191063,ANSC 148,A00,487230,Olivas Hernandez; Olga Lid,39,0,40,1
1713320192091,ANSC 150,A00,504165,Sloane; Julia Kathryn,19,0,20,1
1713320193118,ANSC 180,A00,487232,Staff,14,0,15,1
1713320194145,ANSC 188,A00,627155,Staff,39,0,40,1
1713320195174,ANTH 5,A00,519529,Semendeferi; Ekaterini,15,0,15,0
1713320196198,ANTH 10,A00,487219,Staff,58,0,60,2
1713320197227,ANTH 23,A01,487221,Staff,17,0,20,3
1713320198256,ANTH 102,A00,487233,Wilder; Linnea Lorene,51,0,60,9
1713320199284,ANTH 103,A00,487234,Varma; Saiba,55,0,60,5
1713320200309,ANTH 105,A00,487235,Stewart; Alexander B,55,0,60,5
1713320201339,BENG 100,A01,516685,Taylor Amos; Alyssa C,28,0,30,2
1713320202370,BIBC 102,A01,491316,Flagg; Matthew Paul,24,0,88,64
1713320202370,BIBC 102,A02,491366,Flagg; Matthew Paul,82,0,88,6
1713320203394,BIBC 103,A01,491486,Boumechache; Miyyada,16,0,24,8
1713320203394,BIBC 103,A02,491487,Boumechache; Miyyada,24,0,24,0
1713320204423,BICD 100,A01,516882,Staff,75,0,75,0
1713320204423,BICD 100,A02,516890,Staff,69,0,75,6
1713320205447,BICD 102GS,A00,491488,Lo; Stanley M.,26,0,28,2
1713320206476,BIEB 136GS,A00,516940,Holway; David A. & Shurin; Jonathan,19,0,24,5
1713320207500,BIEB 137GS,A01,517034,Holway; David A. & Shurin; Jonathan,19,0,24,5
1713320208525,BIEB 138GS,A01,491492,Pirino; Giorgia,21,0,28,7
1713320209550,BILD 1,A01,491296,Staff,61,0,63,2
1713320209550,BILD 1,A02,491297,Staff,63,0,63,0
1713320210579,BILD 4,A01,517099,Gonzalez Gamboa; Ivonne,22,0,24,2
1713320210579,BILD 4,A02,517100,Gonzalez Gamboa; Ivonne,24,0,24,0
1713320211603,BILD 60GS,A00,491309,Lo; Stanley M.,26,0,28,2
1713320212628,BIMM 100,A01,517136,Staff,87,0,100,13
1713320213654,BIMM 110,A01,517182,Staff,63,0,100,37
1713320214678,BIMM 120,A01,517228,Pickett; Brooke Elizabeth,35,0,63,28
1713320214678,BIMM 120,A02,517240,Pickett; Brooke Elizabeth,46,0,63,17
1713320215707,BIMM 132GS,A01,491498,Pirino; Giorgia,21,0,28,7
1713320216734,BIMM 143,A01,491589,Bozinovic; Goran,15,0,40,25
1713320217764,BIPN 100,A01,491594,Armour; Jon Christopher,90,0,100,10
1713320218847,BIPN 140,A01,491602,Marino; Marc J,28,0,50,22
1713320220904,CAT 125,A00,515973,Staff,19,0,20,1
1713320221929,CAT 125GS,A00,515974,Rahimi; Babak,18,0,20,2
1713320222956,CAT 125R,A00,515980,Staff,14,0,20,6
1713320222956,CAT 125R,B00,515981,Tosun; Adriana,19,0,20,1
1713320222956,CAT 125R,C00,515987,Hyland; Tina Mae,0,1,20,20
1713320222956,CAT 125R,D00,515988,Bronstein; Phoebe Malan,18,0,20,2
1713320223984,CENG 15,A01,488699,Drews; Aaron,25,0,25,0
1713320225010,CENG 100,A00,505196,Opatkiewicz; Justin Paul,25,0,25,0
1713320226033,CGS 2A,A01,489598,Staff,33,0,35,2
1713320227058,CGS 112,A00,489599,Staff,15,0,15,0
1713320228085,CGS 119,A00,489603,Staff,10,0,10,0
1713320229113,CGS 120,A00,489604,Staff,14,0,15,1
1713320230140,CGS 150,A00,489607,Staff,15,0,15,0
1713320231163,CHEM 6A,A01,488715,Staff,98,0,100,2
1713320232189,CHEM 6B,A01,488719,Piercy; Marc Anthony,100,0,100,0
1713320233215,CHEM 6C,A01,488723,Albizati; Kim F.,94,0,100,6
1713320234242,CHEM 7L,A01,488728,Schurmeier; Kimberly,18,0,24,6
1713320234242,CHEM 7L,A02,488730,Schurmeier; Kimberly,23,0,24,1
1713320234242,CHEM 7L,A03,488734,Schurmeier; Kimberly,22,0,24,2
1713320234242,CHEM 7L,A04,488763,Schurmeier; Kimberly,23,0,24,1
1713320234242,CHEM 7L,B01,488798,Schurmeier; Kimberly,17,0,24,7
1713320234242,CHEM 7L,B02,488801,Schurmeier; Kimberly,23,0,24,1
1713320234242,CHEM 7L,B03,488808,Schurmeier; Kimberly,24,0,24,0
1713320234242,CHEM 7L,B04,488811,Schurmeier; Kimberly,24,0,24,0
1713320235267,CHEM 11,A01,488897,Stallings; Dontarie M,96,0,100,4
1713320236294,CHEM 40A,A01,488913,Albizati; Kim F.,88,0,100,12
1713320237324,CHEM 40B,A01,488920,Weizman; Haim,44,0,50,6
1713320237324,CHEM 40B,A02,488938,Weizman; Haim,45,0,50,5
1713320238348,CHEM 41A,A01,489029,Klosterman; Jeremy K,57,0,60,3
1713320239379,CHEM 41C,A01,500436,Tor; Yitzhak,55,0,60,5
1713320240409,CHEM 43A,A01,500426,Weizman; Haim,0,0,24,24
1713320240409,CHEM 43A,A02,500430,Weizman; Haim,13,0,24,11
1713320240409,CHEM 43A,B01,514041,Klosterman; Jeremy K,15,0,24,9
1713320240409,CHEM 43A,B02,514047,Klosterman; Jeremy K,23,0,24,1
1713320241439,CHEM 108,A01,489140,Jennings; Patricia A.,11,0,24,13
1713320241439,CHEM 108,A02,489142,Jennings; Patricia A.,14,0,24,10
1713320242467,CHEM 114A,A01,489147,Stallings; Dontarie M,75,0,100,25
1713320243496,CHIN 169A,A00,489171,Wang; Xiao,19,0,20,1
1713320245547,COGS 3,A01,518827,Boyle; Mary E. T.,27,0,40,13
1713320246572,COGS 11,A01,489175,Staff,28,0,30,2
1713320247599,COGS 14A,A01,518829,Staff,51,0,60,9
1713320248626,COGS 14B,A01,489177,Hoffman; Drew Ellen,66,0,75,9
1713320249654,COGS 100,A01,489181,Allen; Michael Gordon,64,0,75,11
1713320250683,COGS 101A,A01,489183,Staff,47,0,60,13
1713320251712,COGS 101B,A01,489185,Allen; Michael Gordon,9,0,30,21
1713320252741,COGS 101C,A01,526786,Staff,24,0,30,6
1713320254791,COGS 107A,A01,489189,Boyle; Mary E. T.,19,0,35,16
1713320255817,COGS 107B,A01,627144,Mooshagian; Eric Frederick,60,0,60,0
1713320256844,COGS 118A,A01,489191,Staff,0,40,40,40
1713320258894,COGS 171GS,A01,489194,Pineda; Jaime A,21,0,28,7
1713320259921,COGS 172,A01,489196,Staff,3,0,30,27
1713320260949,COGS 174GS,A01,489264,Pineda; Jaime A,21,0,28,7
1713320261973,COGS 180,A01,627150,Staff,28,0,30,2
1713320262998,COGS 186,A01,489274,Staff,0,1,30,30
1713320264028,COMM 10,A01,489276,Staff,23,0,25,2
1713320264028,COMM 10,A02,489303,Staff,23,0,25,2
1713320265056,COMM 100A,A01,489312,Staff,14,0,25,11
1713320265056,COMM 100A,A02,489313,Staff,24,0,25,1
1713320266081,COMM 106T,A00,512540,Staff,34,0,35,1
1713320267104,COMM 107,A00,489347,Staff,30,0,35,5
1713320268129,COMM 109P,A00,489358,Staff,31,0,35,4
1713320269155,COMM 132,A00,489361,McKenna; Denise,28,0,30,2
1713320270184,COMM 146,A00,489362,Halm; Gavin Patrick,27,0,30,3
1713320271209,COMM 190,A00,489363,Abuelhiga; Soraya Jill,18,0,23,5
1713320272240,CSE 8A,A50,489366,Staff,22,0,25,3
1713320272240,CSE 8A,A51,489367,Staff,24,0,25,1
1713320273266,CSE 11,A01,489398,Cao; Yingjun,79,0,100,21
1713320274290,CSE 12,A01,489487,Staff,43,0,50,7
1713320275319,CSE 20,A01,489497,Staff,48,0,50,2
1713320276348,CSE 21,A01,489517,Braun; Oliver,42,0,50,8
1713320277374,CSE 101,A01,489524,Braun; Oliver,0,26,50,50
1713320278397,CSE 105,A01,512594,Jones; Miles E,74,0,100,26
1713320278397,CSE 105,B01,512598,Jones; Miles E,56,0,100,44
1713320279422,CSE 140,A01,489538,Staff,43,0,50,7
1713320280447,CSE 141,A01,489550,Eldon; John,71,0,100,29
1713320281471,CSE 141L,A01,489571,Eldon; John,69,0,100,31
1713320282499,CSE 151A,A01,489583,Solares; Edwin A,146,0,200,54
1713320283524,CSE 175,A01,510886,Kumar; Rakesh,30,0,30,0
1713320284554,CSE 190,A00,516828,Dubnov; Shlomo,38,0,49,11
1713320285581,DOC 100D,A00,489667,Pass; Natalye Joann,19,0,25,6
1713320286607,DSC 10,A01,624268,Staff,72,0,75,3
1713320287635,DSC 20,A01,624476,Staff,50,0,50,0
1713320288662,DSC 40A,A01,624608,Staff,39,0,40,1
1713320289690,DSGN 1,A01,489179,Rill; Bryan,36,0,50,14
1713320290715,ECE 17,A01,490489,Sahay; Rajeev,18,0,30,12
1713320291739,ECE 65,A50,490492,Staff,14,0,20,6
1713320291739,ECE 65,A51,490493,Staff,20,0,20,0
1713320292764,ECON 1,A01,489715,Famulari; Melissa,68,0,70,2
1713320293788,ECON 2,A01,489717,Levkoff; Steven B.,68,0,70,2
1713320294814,ECON 3,A01,489948,Staff,70,0,70,0
1713320296867,ECON 5,A01,490103,Staff,27,0,30,3
1713320296867,ECON 5,B01,626281,Dai; Yinlin,45,0,45,0
1713320297896,ECON 100A,A01,490127,Famulari; Melissa,66,0,70,4
1713320298921,ECON 100B,A01,490129,Staff,64,0,70,6
1713320299945,ECON 109,A01,490187,Shishkin; Denis,27,0,35,8
1713320300974,ECON 110A,A01,490190,Levkoff; Steven B.,60,0,70,10
1713320302000,ECON 120A,A01,490245,Dai; Yinlin,62,0,70,8
1713320303024,ECON 120B,A01,490247,Nieto-Barthaburu; Augusto,50,0,70,20
1713320304048,ECON 120C,A01,490253,Sun; Yixiao,30,0,35,5
1713320304048,ECON 120C,B01,490255,Sun; Yixiao,34,0,35,1
1713320305077,ECON 129,A00,490256,Eckert; Fabian Paul,24,0,35,11
1713320306102,ECON 131,A00,490257,Nieto-Barthaburu; Augusto,0,6,35,35
1713320307128,ECON 138,A00,490258,Bharadwaj; Prashant,17,0,35,18
1713320307128,ECON 138,B00,490259,Bharadwaj; Prashant,16,0,35,19
1713320308153,ECON 159,A00,490260,Hendrickson; Gerald M.,0,8,0,0
1713320309180,ECON 178,A01,553995,Zhu; Ying,24,0,35,11
1713320310204,EDS 40,A01,512576,Black; Alison Michelle,20,0,20,0
1713320311229,EDS 107,A01,515848,Staff,30,0,30,0
1713320312256,EDS 110R,A01,490262,Staff,26,0,30,4
1713320313281,EDS 112,A01,490264,Chapman; Thandeka K,41,0,50,9
1713320314310,EDS 113,A00,490266,Staff,26,0,30,4
1713320315338,EDS 118,A00,490267,Warstadt; Melissa Fawn,21,0,30,9
1713320316365,EDS 124BR,A00,490268,Eguchi; Emi,4,0,25,21
1713320316365,EDS 124BR,B00,490269,Eguchi; Emi,25,0,25,0
1713320317394,EDS 126,A01,490271,Jones; Makeba,44,0,50,6
1713320318420,EDS 135,A01,490316,Staff,19,0,20,1
1713320319447,ENVR 142GS,A00,519514,Chang; Edmond Yi-Teh,27,0,28,1
1713320320474,ETHN 103,A00,490504,Staff,29,0,36,7
1713320321503,ETHN 103A,A00,490505,Man; Simeon S,5,0,9,4
1713320322583,ETHN 109,A00,490506,Staff,30,0,30,0
1713320323611,ETHN 118,A00,490507,Staff,35,0,36,1
1713320324634,ETHN 119,A00,490508,Staff,34,0,36,2
1713320325659,ETHN 121R,A00,490518,Choi; Esther Min,25,0,36,11
1713320326688,ETHN 127,A00,490528,Staff,15,0,15,0
1713320327715,ETHN 139,A00,490573,Staff,10,0,10,0
1713320328741,ETHN 150,A00,490575,Staff,15,0,15,0
1713320329767,GLBH 20,A00,491705,Elwardani; Nile Regina,38,0,40,2
1713320330793,GLBH 101,A00,491706,Staff,20,0,20,0
1713320331819,GLBH 111,A01,491708,Burgos; Jose L.,15,0,15,0
1713320332844,GLBH 146,A00,491709,Staff,11,0,20,9
1713320333871,GLBH 148,A00,491710,Olivas Hernandez; Olga Lid,13,0,20,7
1713320334899,GLBH 150,A00,491711,Sloane; Julia Kathryn,20,0,20,0
1713320335923,HIEA 131,A00,491760,Staff,29,0,32,3
1713320336952,HIEA 153,A00,491762,Staff,29,0,30,1
1713320337981,HIEU 124,A00,491811,Staff,26,0,32,6
1713320339008,HIEU 124GS,A00,491812,Markman; Kristina,27,0,28,1
1713320340049,HIEU 147,A00,491813,Staff,30,0,32,2
1713320341078,HIEU 149GS,A00,491816,Caldwell; Michael Alan,28,0,28,0
1713320342104,HILD 2C,A01,491713,Hendrickson; Gerald M.,27,0,30,3
1713320343130,HILD 7B,A01,491715,Kwak; Nancy,3,0,30,27
1713320344158,HILD 10,A01,491717,Staff,13,0,20,7
1713320345183,HILD 30GS,A00,491719,Edington; Claire Ellen,24,0,28,4
1713320346209,HINE 109,A00,491818,Shafir; Nir,27,0,32,5
1713320347237,HINE 128,A00,491821,Shafir; Nir,31,0,32,1
1713320348266,HISC 117,A00,491830,Staff,28,0,32,4
1713320349294,HIUS 103,A00,491834,Man; Simeon S,15,0,23,8
1713320350323,HIUS 108B,A00,491835,Staff,29,0,30,1
1713320351349,HIUS 141,A00,491836,Hendrickson; Gerald M.,29,0,32,3
1713320352373,HIUS 149,A00,491839,Staff,27,0,32,5
1713320353402,HUM 3,A01,512617,Crum; Matthew Stephen,44,0,50,6
1713320353402,HUM 3,A02,512618,Crum; Matthew Stephen,48,0,50,2
1713320354427,HUM 3GS,A00,512663,Markman; Kristina,0,0,0,1
1713320354427,HUM 3GS,B00,512664,Staff,0,0,0,0
1713320355453,HUM 4,A01,512620,West; Geoffrey Scott,30,0,50,20
1713320356480,HUM 4GS,A00,512666,Lyon; Antony J.,0,0,0,4
1713320357506,HUM 4R,A01,512625,Watkins; Eric,49,0,50,1
1713320358533,HUM 5,A01,512649,Zavodny; Tatiana Sophia,27,0,50,23
1713320358533,HUM 5,B01,512661,Zroka; Ryan Edward,48,0,50,2
1713320359558,INTL 190,A00,490577,Segui; Alan S,0,0,0,5
1713320360582,JAPN 20AR,A01,491267,Ross; Kayoko F,8,0,20,12
1713320361610,JAPN 180,A00,491285,Berman; Michael David,33,0,40,7
1713320362636,LATI 50,A01,502536,Kokinis; Troy Andreas,16,0,22,6
1713320362636,LATI 50,A02,502551,Kokinis; Troy Andreas,22,0,22,0
1713320362636,LATI 50,A03,502650,Kokinis; Troy Andreas,22,0,22,0
1713320362636,LATI 50,A04,502909,Kokinis; Troy Andreas,22,0,22,0
1713320363662,LATI 160,A01,502920,Kokinis; Troy Andreas,30,0,30,0
1713320364685,LIFR 1A,A00,490494,Van Moer; Vinciane G,17,0,20,3
1713320365710,LIFR 1AX,A00,490495,Van Moer; Vinciane G,17,0,20,3
1713320366735,LIFR 1B,A00,490496,Van Moer; Vinciane G,18,0,20,2
1713320367760,LIFR 1BX,A00,490497,Van Moer; Vinciane G,18,0,20,2
1713320368788,LIGN 8,A00,505198,McIntosh; Justin Daniel,135,0,150,15
1713320369813,LIGN 9GS,A00,491239,Lott; Margaret S.,18,0,20,2
1713320370838,LIGN 101,A01,505200,McIntosh; Justin Daniel,24,0,30,6
1713320371866,LIGN 120,A01,491244,Staff,24,0,30,6
1713320372890,LIGN 149GS,A00,491245,Lott; Margaret S.,18,0,20,2
1713320373915,LIGN 170,A00,491247,Staff,23,0,30,7
1713320374944,LISP 1D,A00,490498,Munoz Sanchez; Alicia,10,0,14,4
1713320374944,LISP 1D,B00,490499,Munoz Sanchez; Alicia,6,0,14,8
1713320374944,LISP 1D,C00,490500,Munoz Sanchez; Alicia,8,0,14,6
1713320374944,LISP 1D,D00,490501,Munoz Sanchez; Alicia,10,0,14,4
1713320375973,LISP 1DX,A00,490502,Munoz Sanchez; Alicia,15,0,28,13
1713320375973,LISP 1DX,B00,490503,Munoz Sanchez; Alicia,17,0,28,11
1713320378029,LTAM 110,A00,491847,Staff,23,0,25,2
1713320379057,LTCS 119,A00,491848,Staff,11,0,15,4
1713320380084,LTCS 130,A00,491849,Staff,24,0,25,1
1713320382137,LTEA 120C,A00,491852,Staff,32,0,40,8
1713320383162,LTEN 130GS,A00,491853,Lyon; Antony J.,24,0,28,4
1713320384188,LTEN 148,A00,491855,Staff,23,0,25,2
1713320385213,LTEN 159,A00,491856,Staff,21,0,25,4
1713320386240,LTEN 180,A00,491857,Staff,8,0,15,7
1713320388310,LTSP 123GS,A00,505928,Bessett; Ryan Matthew,24,0,28,4
1713320389334,LTSP 174GS,A00,506037,Bessett; Ryan Matthew,24,0,28,4
1713320391385,LTWR 102,A00,491861,Staff,9,0,15,6
1713320392408,LTWR 106,A00,491862,Staff,10,0,15,5
1713320393436,MAE 11,A00,490930,Bahadori; Mohammad Yousef,96,0,100,4
1713320394461,MAE 30A,A00,490931,Qi; Huihui,37,0,40,3
1713320395486,MAE 101A,A00,491036,Sadeghizadeh; Zahra,96,0,100,4
1713320396585,MAE 101C,A00,491037,Seshadri; Kalyanasundaram,72,0,100,28
1713320397612,MAE 113,A00,491040,Seshadri; Kalyanasundaram,66,0,80,14
1713320398639,MAE 131A,A00,491041,Ghazinejad; Maziar,38,0,40,2
1713320399664,MAE 142,A00,491053,Staff,39,0,40,1
1713320400692,MAE 143A,A00,491054,Staff,34,0,50,16
1713320401716,MAE 150,A00,491092,Truong; Phuong Thi Ngoc,23,0,35,12
1713320402747,MATH 3C,A01,494031,Pardo Guerra; Sebastian,30,0,30,0
1713320402747,MATH 3C,A02,494032,Pardo Guerra; Sebastian,29,0,30,1
1713320403772,MATH 10A,A01,494034,Staff,27,0,30,3
1713320403772,MATH 10A,A02,494035,Staff,28,0,30,2
1713320403772,MATH 10A,B01,494037,Staff,27,0,30,3
1713320403772,MATH 10A,B02,494038,Staff,29,0,30,1
1713320404798,MATH 10B,A01,494040,Habib; Yousaf,22,0,30,8
1713320404798,MATH 10B,A02,494041,Habib; Yousaf,28,0,30,2
1713320404798,MATH 10B,A03,494042,Habib; Yousaf,29,0,30,1
1713320404798,MATH 10B,A04,494043,Habib; Yousaf,30,0,30,0
1713320404798,MATH 10B,B01,494045,Habib; Yousaf,27,0,30,3
1713320404798,MATH 10B,B02,494046,Habib; Yousaf,30,0,30,0
1713320404798,MATH 10B,B03,494047,Habib; Yousaf,30,0,30,0
1713320404798,MATH 10B,B04,494048,Habib; Yousaf,30,0,30,0
1713320405829,MATH 18,A01,494050,Kemp; Todd Aahron,25,0,30,5
1713320405829,MATH 18,A02,494051,Kemp; Todd Aahron,29,0,30,1
1713320405829,MATH 18,B01,494054,Kemp; Todd Aahron,27,0,30,3
1713320405829,MATH 18,B02,494055,Kemp; Todd Aahron,29,0,30,1
1713320406858,MATH 20A,A01,494059,Suk; Andrew Hoon,30,0,30,0
1713320407888,MATH 20B,A01,494061,Briones; Jor-el Thomas Caparas,33,0,35,2
1713320407888,MATH 20B,B01,494063,Bach; Quang Tran,34,0,35,1
1713320408912,MATH 20C,A01,494065,Staff,28,0,30,2
1713320408912,MATH 20C,A02,494066,Staff,30,0,30,0
1713320408912,MATH 20C,A03,494067,Staff,30,0,30,0
1713320408912,MATH 20C,A04,494068,Staff,30,0,30,0
1713320408912,MATH 20C,B01,494070,Zhang; Ming,26,0,30,4
1713320408912,MATH 20C,B02,494071,Zhang; Ming,28,0,30,2
1713320408912,MATH 20C,B03,494072,Zhang; Ming,29,0,30,1
1713320408912,MATH 20C,B04,494073,Zhang; Ming,29,0,30,1
1713320409936,MATH 20D,A01,494075,Staff,22,0,30,8
1713320409936,MATH 20D,A02,494076,Staff,30,0,30,0
1713320410964,MATH 20E,A01,494079,Staff,24,0,30,6
1713320410964,MATH 20E,A02,494080,Staff,26,0,30,4
1713320410964,MATH 20E,B01,494082,Staff,25,0,30,5
1713320410964,MATH 20E,B02,494083,Staff,25,0,30,5
1713320411990,MATH 103A,A01,494085,Aliabadi Sr.; Mohsen,14,0,30,16
1713320411990,MATH 103A,A02,494086,Aliabadi Sr.; Mohsen,28,0,30,2
1713320411990,MATH 103A,B01,494088,Aliabadi Sr.; Mohsen,22,0,30,8
1713320411990,MATH 103A,B02,494089,Aliabadi Sr.; Mohsen,28,0,30,2
1713320413015,MATH 109,A01,494091,Staff,30,0,30,0
1713320413015,MATH 109,A02,494092,Staff,29,0,30,1
1713320413015,MATH 109,B01,494094,Staff,27,0,30,3
1713320413015,MATH 109,B02,494095,Staff,29,0,30,1
1713320414040,MATH 142A,A01,494097,Chow; Bennett,16,0,30,14
1713320414040,MATH 142A,A02,494098,Chow; Bennett,24,0,30,6
1713320414040,MATH 142A,B01,494100,Chow; Bennett,19,0,30,11
1713320414040,MATH 142A,B02,494101,Chow; Bennett,29,0,30,1
1713320416088,MATH 168A,A01,516677,Dumitriu; Ioana,15,0,35,20
1713320417117,MATH 170A,A01,516679,Dumitriu; Ioana,19,0,30,11
1713320417117,MATH 170A,A02,516680,Dumitriu; Ioana,28,0,30,2
1713320418147,MATH 193A,A01,494107,Staff,15,0,30,15
1713320418147,MATH 193A,A02,494108,Staff,21,0,30,9
1713320418147,MATH 193A,A03,494109,Staff,29,0,30,1
1713320418147,MATH 193A,A04,494110,Staff,22,0,30,8
1713320421221,MGT 16,A00,491930,McKay; Michael J,90,0,98,8
1713320422246,MGT 18,A00,491992,McKay; Michael J,97,0,98,1
1713320423273,MGT 71,A00,492003,Staff,69,0,98,29
1713320424303,MGT 103,A00,505209,Eberhard; Craig A,81,0,98,17
1713320425328,MGT 131A,A00,505210,Anderson; John Charles,90,0,98,8
1713320427432,MGT 153,A00,492077,Perols; Johan Lars,24,0,90,66
1713320430511,MGT 164,A00,492222,McKay; Mary A,93,0,98,5
1713320431540,MGT 172,A00,492245,Staff,59,0,60,1
1713320431540,MGT 172,B00,505526,Hedges; Kathleen,71,0,98,27
1713320432567,MGT 181,A00,505669,Dunn; Louis Jean,84,0,98,14
1713320433595,MMW 14,A01,494399,Staff,20,0,28,8
1713320433595,MMW 14,A02,494400,Staff,25,0,28,3
1713320433595,MMW 14,A03,494401,Staff,28,0,28,0
1713320433595,MMW 14,A04,494402,Staff,28,0,28,0
1713320433595,MMW 14,B01,494404,Carreras; Maria Victoria,12,0,28,16
1713320433595,MMW 14,B02,494405,Carreras; Maria Victoria,26,0,28,2
1713320433595,MMW 14,B03,494406,Carreras; Maria Victoria,27,0,28,1
1713320433595,MMW 14,B04,494407,Carreras; Maria Victoria,28,0,28,0
1713320434623,MMW 14GS,A00,506250,Chang; Edmond Yi-Teh,0,0,0,0
1713320435649,MMW 121R,A01,494415,Adamiak; Patrick John,12,0,28,16
1713320435649,MMW 121R,A02,494416,Adamiak; Patrick John,24,0,28,4
1713320436675,MUS 1A,A01,494113,Staff,12,0,25,13
1713320436675,MUS 1A,A02,494114,Staff,25,0,25,0
1713320437700,MUS 4,A01,494116,Staff,24,0,25,1
1713320437700,MUS 4,A02,494117,Staff,22,0,25,3
1713320438724,MUS 5R,A01,494236,Dubnov; Shlomo,10,0,25,15
1713320438724,MUS 5R,A02,494237,Dubnov; Shlomo,25,0,25,0
1713320439751,MUS 6,A01,494122,Staff,12,0,25,13
1713320439751,MUS 6,A02,494123,Staff,24,0,25,1
1713320440775,MUS 7,A01,494125,Staff,16,0,25,9
1713320440775,MUS 7,A02,494126,Staff,24,0,25,1
1713320441798,MUS 11,A01,494128,Staff,23,0,25,2
1713320441798,MUS 11,A02,494129,Staff,24,0,25,1
1713320442824,MUS 13,A01,494131,Staff,25,0,25,0
1713320442824,MUS 13,A02,494132,Staff,25,0,25,0
1713320443852,MUS 15,A01,494134,Staff,17,0,25,8
1713320443852,MUS 15,A02,494135,Staff,25,0,25,0
1713320443852,MUS 15,B01,494137,Staff,24,0,25,1
1713320444876,MUS 80,A00,494232,Staff,24,0,25,1
1713320444876,MUS 80,B00,494233,Staff,25,0,25,0
1713320444876,MUS 80,C00,494234,Staff,23,0,25,2
1713320445905,MUS 95C,A00,494141,Staff,71,0,75,4
1713320446930,MUS 114,A00,494142,Staff,40,0,50,10
1713320447954,NANO 15,A01,490636,Drews; Aaron,7,0,7,0
1713320448980,PHIL 1,A00,490578,Grush; Rick Scott,49,0,50,1
1713320450010,PHIL 10,A01,490580,Grush; Rick Scott,33,0,35,2
1713320450010,PHIL 10,A02,490586,Grush; Rick Scott,33,0,35,2
1713320451037,PHIL 27,A01,490591,Staff,23,0,25,2
1713320451037,PHIL 27,A02,490592,Staff,25,0,25,0
1713320451037,PHIL 27,A03,490593,Staff,25,0,25,0
1713320451037,PHIL 27,A04,490598,Staff,25,0,25,0
1713320452062,PHIL 32,A01,490611,Staff,20,0,20,0
1713320452062,PHIL 32,A02,490618,Staff,20,0,20,0
1713320453086,PHIL 90,A00,490624,Staff,40,0,40,0
1713320454112,PHIL 136,A00,490627,Cohen; Jonathan David,37,0,40,3
1713320455138,PHIL 155,A00,490634,Staff,63,0,70,7
1713320456166,PHYS 1A,A00,491610,Staff,246,0,250,4
1713320457195,PHYS 1AL,001,491616,Tsai; Philbert S,28,0,30,2
1713320457195,PHYS 1AL,002,491618,Tsai; Philbert S,30,0,30,0
1713320458220,PHYS 1B,A00,491623,Staff,242,0,250,8
1713320459244,PHYS 1BL,001,491626,Tsai; Philbert S,25,0,30,5
1713320459244,PHYS 1BL,002,491628,Tsai; Philbert S,27,0,30,3
1713320460272,PHYS 1C,A00,491632,Staff,220,0,245,25
1713320461296,PHYS 1CL,001,491635,Tsai; Philbert S,9,0,30,21
1713320461296,PHYS 1CL,002,491643,Tsai; Philbert S,23,0,30,7
1713320462320,PHYS 2AR,A01,491651,Meyertholen; Andrew D.,44,0,50,6
1713320463345,PHYS 2B,A01,491659,Staff,106,0,115,9
1713320464372,PHYS 2BL,A01,491685,Staff,21,0,24,3
1713320464372,PHYS 2BL,A02,491700,Staff,23,0,24,1
1713320465403,PHYS 2C,A01,505161,Staff,106,0,115,9
1713320466431,PHYS 4A,A01,491704,Grinstein; Benjamin,99,0,100,1
1713320467460,POLI 5D,A01,494144,Staff,3,0,5,2
1713320467460,POLI 5D,B01,626283,Dai; Yinlin,5,0,5,0
1713320468484,POLI 12,A00,494145,Staff,44,0,45,1
1713320469515,POLI 13R,A00,494146,Forman; Fonna,45,0,50,5
1713320470541,POLI 27,A01,494148,Staff,57,0,60,3
1713320471570,POLI 30,A00,494149,Staff,49,0,50,1
1713320472600,POLI 100DA,A00,494150,Staff,21,0,25,4
1713320474652,POLI 100I,A00,494152,Staff,28,0,30,2
1713320475681,POLI 104B,A00,494153,Smith; Glenn Chatmas,53,0,55,2
1713320476705,POLI 104F,A00,494154,Staff,28,0,30,2
1713320477730,POLI 104I,A00,494155,Smith; Glenn Chatmas,30,0,30,0
1713320478755,POLI 110C,A00,494156,Ingham; Sean,23,0,25,2
1713320479781,POLI 117R,A00,494157,Forman; Fonna,9,0,20,11
1713320480806,POLI 118,A00,494158,Ingham; Sean,22,0,25,3
1713320481831,POLI 120H,A00,494159,Fisk; David Lee,40,0,45,5
1713320482859,POLI 131CR,A00,494160,Hoston; Germaine,36,0,45,9
1713320483893,POLI 133J,A00,494161,Staff,33,0,35,2
1713320484920,POLI 135,A00,494162,Fisk; David Lee,33,0,35,2
1713320485949,POLI 140A,A00,494164,Staff,21,0,30,9
1713320486977,POLI 142I,A00,494165,Staff,30,0,30,0
1713320488001,POLI 144D,A00,494166,Staff,23,0,25,2
1713320489025,POLI 151,A00,494167,Staff,30,0,30,0
1713320490052,POLI 153,A00,494168,Staff,33,0,35,2
1713320491076,POLI 160AA,A00,494169,Staff,35,0,40,5
1713320492102,POLI 162,A00,494170,Mignozzetti; Umberto,19,0,25,6
1713320493127,POLI 171,A00,494171,Mignozzetti; Umberto,21,0,25,4
1713320494151,PSYC 1,A00,494172,Staff,97,0,100,3
1713320495175,PSYC 2,A00,494173,Moranton; Nirelia Melbina-,40,0,50,10
1713320496202,PSYC 3,A00,494174,Staff,29,0,30,1
1713320497228,PSYC 6,A00,494175,Staff,17,0,20,3
1713320498254,PSYC 60,A01,494177,Staff,38,0,45,7
1713320499277,PSYC 70,A01,505724,Geller; Emma Harlan,42,0,45,3
1713320500303,PSYC 101,A00,494180,Heyman; Gail D.,84,0,100,16
1713320501328,PSYC 105,A00,494181,Geller; Emma Harlan,59,0,90,31
1713320502353,PSYC 106,A00,494182,Dobkins; Karen R.,29,0,45,16
1713320503377,PSYC 108,A00,494183,Adrian; Julia Anna,91,0,100,9
1713320504403,PSYC 114,A01,494185,Winkielman; Piotr,0,0,30,30
1713320505432,PSYC 122,A00,494186,Moranton; Nirelia Melbina-,33,0,50,17
1713320506460,PSYC 124,A00,494187,Chapman; Eddie Nathaniel,71,0,80,9
1713320507485,PSYC 131,A00,494188,Anagnostaras; Stephan,50,0,80,30
1713320508512,PSYC 144,A00,494189,Staff,10,0,50,40
1713320509540,PSYC 154,A00,494190,Lacefield; Katharine I,121,0,180,59
1713320510566,PSYC 162,A00,494191,Wixted; John T,76,0,100,24
1713320511589,PSYC 172,A00,494192,Gorman; Michael R.,36,0,45,9
1713320512612,PSYC 178,A00,494193,Glaser; Dale,37,0,45,8
1713320513636,PSYC 193,A00,505725,Chapman; Eddie Nathaniel,20,0,20,0
1713320514664,RELI 145GS,A00,519817,Rahimi; Babak,18,0,20,2
1713320515687,SE 101A,A01,490862,Chadha; Mayank,23,0,25,2
1713320516712,SE 101C,A01,490924,Krysl; Petr,16,0,20,4
1713320517740,SE 110A,A01,490928,Staff,19,0,20,1
1713320518769,SE 130A,A00,490929,Morrison; Machel Leigh,58,0,70,12
1713320519796,SIO 1,A01,519325,Staff,39,0,40,1
1713320520823,SIO 30,A01,519327,Staff,38,0,40,2
1713320521846,SIO 40,A00,519328,Staff,39,0,40,1
1713320522871,SIO 46GS,A00,519819,Cook; Geoffrey W,17,0,25,8
1713320523900,SIO 109R,A00,494197,Forman; Fonna,0,0,20,20
1713320524925,SIO 121GS,A00,519827,Cook; Geoffrey W,17,0,25,8
1713320525951,SIO 132,A01,519330,Staff,38,0,40,2
1713320526980,SIO 133,A01,519397,Staff,37,0,40,3
1713320528008,SIO 139,A00,519396,Kacev; David,31,0,40,9
1713320529035,SOCI 1,A01,494199,Thorpe; Charles Robert,22,0,30,8
1713320529035,SOCI 1,A02,494200,Thorpe; Charles Robert,30,0,30,0
1713320529035,SOCI 1,A03,494201,Thorpe; Charles Robert,29,0,30,1
1713320529035,SOCI 1,A04,494202,Thorpe; Charles Robert,29,0,30,1
1713320529035,SOCI 1,A05,494203,Thorpe; Charles Robert,29,0,30,1
1713320529035,SOCI 1,A06,494204,Thorpe; Charles Robert,30,0,30,0
1713320529035,SOCI 1,A07,494205,Thorpe; Charles Robert,29,0,30,1
1713320530120,SOCI 60,A01,494207,Staff,34,0,40,6
1713320530120,SOCI 60,A02,494208,Staff,39,0,40,1
1713320531146,SOCI 100,A01,494210,Payne; Christine Anna,27,0,30,3
1713320531146,SOCI 100,A02,494211,Payne; Christine Anna,26,0,30,4
1713320532172,SOCI 109M,A00,494212,Staff,20,0,20,0
1713320533195,SOCI 110,A00,494213,Staff,35,0,40,5
1713320535246,SOCI 118E,A00,494215,Ng; Kwai,37,0,40,3
1713320536272,SOCI 125,A00,494216,Calderon-Zaks; Michael Aar,42,0,45,3
1713320537298,SOCI 126,A01,494218,Jones; Makeba,3,0,5,2
1713320538322,SOCI 131,A00,494219,Thorpe; Charles Robert,28,0,30,2
1713320540376,SOCI 135,A00,494221,Payne; Christine Anna,31,0,50,19
1713320541399,SOCI 136E,A00,626690,Ruiz; Jonathan Joseph,25,0,25,0
1713320542424,SOCI 138GS,A00,494222,Navon; Daniel,24,0,28,4
1713320544472,SOCI 145,A00,494224,Staff,41,0,45,4
1713320545498,SOCI 153,A00,494225,Staff,28,0,30,2
1713320546528,SOCI 160E,A00,494226,Ng; Kwai,30,0,40,10
1713320547553,SOCI 180,A00,494227,Staff,29,0,30,1
1713320548580,SOCI 189GS,A00,494228,Ribas Norris; Janet Vanesa,11,0,11,0
1713320549604,SOCI 190GS,A00,553232,Ribas Norris; Janet Vanesa,11,0,11,0
1713320550629,SOMI 220,A00,627178,Schneid; Stephen David,30,0,30,0
1713320551654,SYN 2,001,490768,Staff,14,0,15,1
1713320551654,SYN 2,002,490769,Staff,15,0,15,0
1713320551654,SYN 2,004,490775,Staff,0,0,0,0
1713320551654,SYN 2,003,490774,Staff,0,0,0,0
1713320551654,SYN 2,005,490776,Staff,0,0,0,0
1713320552682,SYN 2R,001,490779,Staff,12,0,15,3
1713320552682,SYN 2R,002,514635,Staff,14,0,15,1
1713320553707,SYN 100,A01,490783,Staff,14,0,20,6
1713320553707,SYN 100,B01,490787,Staff,10,0,20,10
1713320553707,SYN 100,C01,490789,Staff,11,0,20,9
1713320554732,SYN 150,A00,490817,Staff,14,0,15,1
1713320554732,SYN 150,B00,514610,Staff,15,0,15,0
1713320555758,TDAC 1,A00,492753,Walsh; Kim C.,19,0,20,1
1713320555758,TDAC 1,B00,492754,Harting; Carla Kelso,19,0,20,1
1713320555758,TDAC 1,C00,513995,Salovey; Todd,15,0,20,5
1713320556781,TDAC 101,A00,492766,Harting; Carla Kelso,17,0,20,3
1713320557813,TDAC 102,A00,492768,Basso; Beatrice,19,0,20,1
1713320558838,TDDE 111,A00,492769,Staff,25,0,25,0
1713320559861,TDDE 131,A00,492770,Staff,15,0,15,0
1713320559861,TDDE 131,B00,492771,Staff,15,0,15,0
1713320560886,TDDE 131GS,A00,523716,Guirguis; Mark C,24,0,28,4
1713320561911,TDGE 1,A01,492756,Salovey; Todd,57,0,60,3
1713320562937,TDGE 5,A01,492758,Staff,24,0,25,1
1713320563964,TDGE 10,A00,492759,Fulton; Julia,207,0,220,13
1713320564992,TDGE 11,A00,492760,Castro; Robert Jess,198,0,200,2
1713320567044,TDGE 124,A00,492772,Fulton; Julia,191,0,220,29
1713320568070,TDGE 125,A00,492773,Meyer; Ursula,39,0,50,11
1713320568070,TDGE 125,B00,492774,Staff,49,0,50,1
1713320568070,TDGE 125,C00,523565,Staff,48,0,50,2
1713320569097,TDGE 125GS,A00,523580,Guirguis; Mark C,24,0,28,4
1713320570124,TDGE 127,A00,492775,Havis; Allan,39,0,50,11
1713320571150,TDHT 101,A00,492776,Staff,35,0,35,0
1713320572178,TDMV 1,A00,492762,Caligagan; Maria T.,30,0,30,0
1713320572178,TDMV 1,B00,492763,Arcidiacono; Kristin,25,0,30,5
1713320573204,TDMV 2,A00,492764,Weinberg; Sadie,29,0,30,1
1713320574231,TDMV 3,A00,492765,Mack; Kara Shanai',38,0,40,2
1713320575259,TDMV 138,A00,492777,Mack; Kara Shanai',35,0,40,5
1713320576285,TDMV 140,A00,492778,Lima; Paulo Henrique,40,0,40,0
1713320577312,TDMV 142,A00,492779,Caligagan; Maria T.,34,0,40,6
1713320577312,TDMV 142,B00,492780,Caligagan; Tony,37,0,40,3
1713320578337,TDMV 143,A00,492781,Fyall; Daunte Edward,39,0,40,1
1713320579367,USP 1,A01,492401,Kwak; Nancy,26,0,35,9
1713320580392,USP 2,A01,492453,Hinds; Juli Beth,35,0,35,0
1713320581417,USP 3,A01,492516,Staff,28,0,35,7
1713320582442,USP 4,A00,492522,McTague; Sarah,17,0,25,8
1713320583470,USP 100,A00,492523,Staff,33,0,35,2
1713320584494,USP 101,A00,492524,Staff,13,0,15,2
1713320585519,USP 105,A00,492525,Staff,21,0,25,4
1713320586543,USP 151,A00,492526,Shenkman; Michael Thomas,32,0,35,3
1713320587572,USP 170,A00,492545,Hinds; Juli Beth,33,0,35,2
1713320588597,USP 171GS,A00,492608,Bussell; Mirle Rabinowitz,24,0,28,4
1713320589624,USP 183GS,A00,492613,Peerson; Susan,24,0,28,4
1713320590650,VIS 30,A01,490693,Yoldas; Pinar,19,0,22,3
1713320590650,VIS 30,A02,490694,Yoldas; Pinar,18,0,22,4
1713320591675,VIS 83,A00,490695,Kester; Grant,63,0,75,12
1713320592699,VIS 105D,A00,490696,Staff,22,0,25,3
1713320593724,VIS 124CN,A00,490699,Rose; Jordan M,67,0,75,8
1713320594749,VIS 125GS,A00,511221,Williams; Alena J,21,0,22,1
1713320595777,VIS 128D,A00,490700,Staff,73,0,75,2
1713320596806,VIS 151,A01,490717,Staff,33,0,34,1
1713320596806,VIS 151,A02,490766,Staff,33,0,34,1
1713320597834,VIS 154GS,A00,511972,Williams; Alena J,21,0,22,1
1713320598861,VIS 160A,A00,490767,Stone; Patricia,7,0,10,3
1713320599888,WCWP 10A,A00,490638,Staff,14,0,15,1
1713320599888,WCWP 10A,B00,490640,Staff,15,0,15,0
1713320600914,WCWP 10B,A00,490641,Staff,0,0,0,0
1713320600914,WCWP 10B,B00,490642,Staff,14,0,15,1
1713320600914,WCWP 10B,C00,490644,Staff,13,0,15,2
1713320600914,WCWP 10B,D00,490647,Staff,0,0,0,0
1713320601941,WCWP 100,A00,490655,Staff,0,0,0,0
1713320601941,WCWP 100,B00,490687,Staff,10,0,15,5
1713320604006,ANAR 153,A00,487222,Braswell; Geoffrey E.,54,0,60,6
1713320605033,ANBI 134,A00,487223,Staff,7,0,20,13
1713320606058,ANBI 143GS,A00,487224,Noel; Geoffroy Pierre Jean,18,0,24,6
1713320607082,ANBI 144GS,A00,519548,Noel; Geoffroy Pierre Jean,18,0,24,6
1713320608105,ANSC 101,A00,487225,Staff,19,0,20,1
1713320609130,ANSC 125,A00,487227,Brenner; Suzanne A,39,0,40,1
1713320611183,ANSC 146,A00,487229,Staff,35,0,40,5
1713320612208,ANSC 148,A00,487230,Olivas Hernandez; Olga Lid,39,0,40,1
1713320613235,ANSC 150,A00,504165,Sloane; Julia Kathryn,19,0,20,1
1713320614260,ANSC 180,A00,487232,Staff,14,0,15,1
1713320615285,ANSC 188,A00,627155,Staff,39,0,40,1
1713320616308,ANTH 5,A00,519529,Semendeferi; Ekaterini,15,0,15,0
1713320617333,ANTH 10,A00,487219,Staff,58,0,60,2
1713320618360,ANTH 23,A01,487221,Staff,17,0,20,3
1713320619384,ANTH 102,A00,487233,Wilder; Linnea Lorene,51,0,60,9
1713320620412,ANTH 103,A00,487234,Varma; Saiba,55,0,60,5
1713320621454,ANTH 105,A00,487235,Stewart; Alexander B,55,0,60,5
1713320622477,BENG 100,A01,516685,Taylor Amos; Alyssa C,28,0,30,2
1713320623503,BIBC 102,A01,491316,Flagg; Matthew Paul,24,0,88,64
1713320623503,BIBC 102,A02,491366,Flagg; Matthew Paul,82,0,88,6
1713320624527,BIBC 103,A01,491486,Boumechache; Miyyada,16,0,24,8
1713320624527,BIBC 103,A02,491487,Boumechache; Miyyada,24,0,24,0
1713320625553,BICD 100,A01,516882,Staff,75,0,75,0
1713320625553,BICD 100,A02,516890,Staff,69,0,75,6
1713320626575,BICD 102GS,A00,491488,Lo; Stanley M.,26,0,28,2
1713320627600,BIEB 136GS,A00,516940,Holway; David A. & Shurin; Jonathan,19,0,24,5
1713320628624,BIEB 137GS,A01,517034,Holway; David A. & Shurin; Jonathan,19,0,24,5
1713320629652,BIEB 138GS,A01,491492,Pirino; Giorgia,21,0,28,7
1713320630676,BILD 1,A01,491296,Staff,61,0,63,2
1713320630676,BILD 1,A02,491297,Staff,63,0,63,0
1713320631706,BILD 4,A01,517099,Gonzalez Gamboa; Ivonne,22,0,24,2
1713320631706,BILD 4,A02,517100,Gonzalez Gamboa; Ivonne,24,0,24,0
1713320632733,BILD 60GS,A00,491309,Lo; Stanley M.,26,0,28,2
1713320633816,BIMM 100,A01,517136,Staff,87,0,100,13
1713320634841,BIMM 110,A01,517182,Staff,63,0,100,37
1713320635866,BIMM 120,A01,517228,Pickett; Brooke Elizabeth,35,0,63,28
1713320635866,BIMM 120,A02,517240,Pickett; Brooke Elizabeth,46,0,63,17
1713320636892,BIMM 132GS,A01,491498,Pirino; Giorgia,21,0,28,7
1713320637918,BIMM 143,A01,491589,Bozinovic; Goran,15,0,40,25
1713320638946,BIPN 100,A01,491594,Armour; Jon Christopher,90,0,100,10
1713320639975,BIPN 140,A01,491602,Marino; Marc J,28,0,50,22
1713320642027,CAT 125,A00,515973,Staff,18,0,20,2
1713320643055,CAT 125GS,A00,515974,Rahimi; Babak,18,0,20,2
1713320644083,CAT 125R,A00,515980,Staff,13,0,20,7
1713320644083,CAT 125R,B00,515981,Tosun; Adriana,19,0,20,1
1713320644083,CAT 125R,C00,515987,Hyland; Tina Mae,0,2,20,20
1713320644083,CAT 125R,D00,515988,Bronstein; Phoebe Malan,18,0,20,2
1713320645108,CENG 15,A01,488699,Drews; Aaron,25,0,25,0
1713320646132,CENG 100,A00,505196,Opatkiewicz; Justin Paul,25,0,25,0
1713320647160,CGS 2A,A01,489598,Staff,33,0,35,2
1713320648189,CGS 112,A00,489599,Staff,15,0,15,0
1713320649217,CGS 119,A00,489603,Staff,10,0,10,0
1713320650242,CGS 120,A00,489604,Staff,14,0,15,1
1713320651267,CGS 150,A00,489607,Staff,15,0,15,0
1713320652293,CHEM 6A,A01,488715,Staff,98,0,100,2
1713320653319,CHEM 6B,A01,488719,Piercy; Marc Anthony,100,0,100,0
1713320654344,CHEM 6C,A01,488723,Albizati; Kim F.,94,0,100,6
1713320655370,CHEM 7L,A01,488728,Schurmeier; Kimberly,17,0,24,7
1713320655370,CHEM 7L,A02,488730,Schurmeier; Kimberly,23,0,24,1
1713320655370,CHEM 7L,A03,488734,Schurmeier; Kimberly,22,0,24,2
1713320655370,CHEM 7L,A04,488763,Schurmeier; Kimberly,23,0,24,1
1713320655370,CHEM 7L,B01,488798,Schurmeier; Kimberly,17,0,24,7
1713320655370,CHEM 7L,B02,488801,Schurmeier; Kimberly,23,0,24,1
1713320655370,CHEM 7L,B03,488808,Schurmeier; Kimberly,24,0,24,0
1713320655370,CHEM 7L,B04,488811,Schurmeier; Kimberly,24,0,24,0
1713320656395,CHEM 11,A01,488897,Stallings; Dontarie M,96,0,100,4
1713320657423,CHEM 40A,A01,488913,Albizati; Kim F.,88,0,100,12
1713320658449,CHEM 40B,A01,488920,Weizman; Haim,44,0,50,6
1713320658449,CHEM 40B,A02,488938,Weizman; Haim,45,0,50,5
1713320659477,CHEM 41A,A01,489029,Klosterman; Jeremy K,57,0,60,3
1713320660503,CHEM 41C,A01,500436,Tor; Yitzhak,55,0,60,5
1713320661527,CHEM 43A,A01,500426,Weizman; Haim,0,0,24,24
1713320661527,CHEM 43A,A02,500430,Weizman; Haim,13,0,24,11
1713320661527,CHEM 43A,B01,514041,Klosterman; Jeremy K,15,0,24,9
1713320661527,CHEM 43A,B02,514047,Klosterman; Jeremy K,23,0,24,1
1713320662553,CHEM 108,A01,489140,Jennings; Patricia A.,11,0,24,13
1713320662553,CHEM 108,A02,489142,Jennings; Patricia A.,14,0,24,10
1713320663579,CHEM 114A,A01,489147,Stallings; Dontarie M,74,0,100,26
1713320664604,CHIN 169A,A00,489171,Wang; Xiao,19,0,20,1
1713320666657,COGS 3,A01,518827,Boyle; Mary E. T.,27,0,40,13
1713320667683,COGS 11,A01,489175,Staff,28,0,30,2
1713320668707,COGS 14A,A01,518829,Staff,51,0,60,9
1713320669732,COGS 14B,A01,489177,Hoffman; Drew Ellen,66,0,75,9
1713320670757,COGS 100,A01,489181,Allen; Michael Gordon,64,0,75,11
1713320671782,COGS 101A,A01,489183,Staff,47,0,60,13
1713320672810,COGS 101B,A01,489185,Allen; Michael Gordon,9,0,30,21
1713320673835,COGS 101C,A01,526786,Staff,24,0,30,6
1713320675888,COGS 107A,A01,489189,Boyle; Mary E. T.,19,0,35,16
1713320676914,COGS 107B,A01,627144,Mooshagian; Eric Frederick,60,0,60,0
1713320677941,COGS 118A,A01,489191,Staff,0,40,40,40
1713320679988,COGS 171GS,A01,489194,Pineda; Jaime A,21,0,28,7
1713320681013,COGS 172,A01,489196,Staff,3,0,30,27
1713320682038,COGS 174GS,A01,489264,Pineda; Jaime A,21,0,28,7
1713320683068,COGS 180,A01,627150,Staff,28,0,30,2
1713320684096,COGS 186,A01,489274,Staff,0,1,30,30
1713320685123,COMM 10,A01,489276,Staff,23,0,25,2
1713320685123,COMM 10,A02,489303,Staff,23,0,25,2
1713320686148,COMM 100A,A01,489312,Staff,14,0,25,11
1713320686148,COMM 100A,A02,489313,Staff,24,0,25,1
1713320687171,COMM 106T,A00,512540,Staff,34,0,35,1
1713320688197,COMM 107,A00,489347,Staff,29,0,35,6
1713320689221,COMM 109P,A00,489358,Staff,31,0,35,4
1713320690246,COMM 132,A00,489361,McKenna; Denise,28,0,30,2
1713320691271,COMM 146,A00,489362,Halm; Gavin Patrick,27,0,30,3
1713320692297,COMM 190,A00,489363,Abuelhiga; Soraya Jill,18,0,23,5
1713320693325,CSE 8A,A50,489366,Staff,22,0,25,3
1713320693325,CSE 8A,A51,489367,Staff,24,0,25,1
1713320694352,CSE 11,A01,489398,Cao; Yingjun,79,0,100,21
1713320695377,CSE 12,A01,489487,Staff,43,0,50,7
1713320696399,CSE 20,A01,489497,Staff,48,0,50,2
1713320697424,CSE 21,A01,489517,Braun; Oliver,42,0,50,8
1713320698448,CSE 101,A01,489524,Braun; Oliver,0,27,50,50
1713320699476,CSE 105,A01,512594,Jones; Miles E,74,0,100,26
1713320699476,CSE 105,B01,512598,Jones; Miles E,56,0,100,44
1713320700502,CSE 140,A01,489538,Staff,43,0,50,7
1713320701534,CSE 141,A01,489550,Eldon; John,71,0,100,29
1713320702560,CSE 141L,A01,489571,Eldon; John,69,0,100,31
1713320703584,CSE 151A,A01,489583,Solares; Edwin A,145,0,200,55
1713320704613,CSE 175,A01,510886,Kumar; Rakesh,30,0,30,0
1713320705642,CSE 190,A00,516828,Dubnov; Shlomo,38,0,49,11
1713320706667,DOC 100D,A00,489667,Pass; Natalye Joann,19,0,25,6
1713320707694,DSC 10,A01,624268,Staff,72,0,75,3
1713320708722,DSC 20,A01,624476,Staff,50,0,50,0
1713320709748,DSC 40A,A01,624608,Staff,39,0,40,1
1713320710773,DSGN 1,A01,489179,Rill; Bryan,36,0,50,14
1713320711802,ECE 17,A01,490489,Sahay; Rajeev,18,0,30,12
1713320712828,ECE 65,A50,490492,Staff,14,0,20,6
1713320712828,ECE 65,A51,490493,Staff,20,0,20,0
1713320713855,ECON 1,A01,489715,Famulari; Melissa,68,0,70,2
1713320714884,ECON 2,A01,489717,Levkoff; Steven B.,68,0,70,2
1713320715907,ECON 3,A01,489948,Staff,70,0,70,0
1713320717957,ECON 5,A01,490103,Staff,27,0,30,3
1713320717957,ECON 5,B01,626281,Dai; Yinlin,45,0,45,0
1713320718981,ECON 100A,A01,490127,Famulari; Melissa,66,0,70,4
1713320720008,ECON 100B,A01,490129,Staff,64,0,70,6
1713320721032,ECON 109,A01,490187,Shishkin; Denis,27,0,35,8
1713320722056,ECON 110A,A01,490190,Levkoff; Steven B.,60,0,70,10
1713320723081,ECON 120A,A01,490245,Dai; Yinlin,62,0,70,8
1713320724109,ECON 120B,A01,490247,Nieto-Barthaburu; Augusto,49,0,70,21
1713320725133,ECON 120C,A01,490253,Sun; Yixiao,30,0,35,5
1713320725133,ECON 120C,B01,490255,Sun; Yixiao,34,0,35,1
1713320726157,ECON 129,A00,490256,Eckert; Fabian Paul,24,0,35,11
1713320727185,ECON 131,A00,490257,Nieto-Barthaburu; Augusto,0,6,35,35
1713320728210,ECON 138,A00,490258,Bharadwaj; Prashant,17,0,35,18
1713320728210,ECON 138,B00,490259,Bharadwaj; Prashant,16,0,35,19
1713320729234,ECON 159,A00,490260,Hendrickson; Gerald M.,0,8,0,0
1713320730259,ECON 178,A01,553995,Zhu; Ying,24,0,35,11
1713320731287,EDS 40,A01,512576,Black; Alison Michelle,20,0,20,0
1713320732313,EDS 107,A01,515848,Staff,30,0,30,0
1713320733337,EDS 110R,A01,490262,Staff,26,0,30,4
1713320734361,EDS 112,A01,490264,Chapman; Thandeka K,41,0,50,9
1713320735386,EDS 113,A00,490266,Staff,26,0,30,4
1713320736413,EDS 118,A00,490267,Warstadt; Melissa Fawn,21,0,30,9
1713320737494,EDS 124BR,A00,490268,Eguchi; Emi,4,0,25,21
1713320737494,EDS 124BR,B00,490269,Eguchi; Emi,25,0,25,0
1713320738519,EDS 126,A01,490271,Jones; Makeba,44,0,50,6
1713320739546,EDS 135,A01,490316,Staff,19,0,20,1
1713320740573,ENVR 142GS,A00,519514,Chang; Edmond Yi-Teh,27,0,28,1
1713320741598,ETHN 103,A00,490504,Staff,28,0,36,8
1713320742626,ETHN 103A,A00,490505,Man; Simeon S,5,0,9,4
1713320743652,ETHN 109,A00,490506,Staff,30,0,30,0
1713320744676,ETHN 118,A00,490507,Staff,35,0,36,1
1713320745701,ETHN 119,A00,490508,Staff,34,0,36,2
1713320746725,ETHN 121R,A00,490518,Choi; Esther Min,25,0,36,11
1713320747750,ETHN 127,A00,490528,Staff,15,0,15,0
1713320748774,ETHN 139,A00,490573,Staff,10,0,10,0
1713320749800,ETHN 150,A00,490575,Staff,15,0,15,0
1713320750824,GLBH 20,A00,491705,Elwardani; Nile Regina,38,0,40,2
1713320751852,GLBH 101,A00,491706,Staff,20,0,20,0
1713320752876,GLBH 111,A01,491708,Burgos; Jose L.,15,0,15,0
1713320753902,GLBH 146,A00,491709,Staff,11,0,20,9
1713320754927,GLBH 148,A00,491710,Olivas Hernandez; Olga Lid,13,0,20,7
1713320755952,GLBH 150,A00,491711,Sloane; Julia Kathryn,20,0,20,0
1713320756980,HIEA 131,A00,491760,Staff,29,0,32,3
1713320758008,HIEA 153,A00,491762,Staff,29,0,30,1
1713320759034,HIEU 124,A00,491811,Staff,26,0,32,6
1713320760061,HIEU 124GS,A00,491812,Markman; Kristina,27,0,28,1
1713320761086,HIEU 147,A00,491813,Staff,30,0,32,2
1713320762112,HIEU 149GS,A00,491816,Caldwell; Michael Alan,28,0,28,0
1713320763139,HILD 2C,A01,491713,Hendrickson; Gerald M.,27,0,30,3
1713320764163,HILD 7B,A01,491715,Kwak; Nancy,3,0,30,27
1713320765186,HILD 10,A01,491717,Staff,13,0,20,7
1713320766214,HILD 30GS,A00,491719,Edington; Claire Ellen,24,0,28,4
1713320767237,HINE 109,A00,491818,Shafir; Nir,27,0,32,5
1713320768262,HINE 128,A00,491821,Shafir; Nir,31,0,32,1
1713320769288,HISC 117,A00,491830,Staff,28,0,32,4
1713320770315,HIUS 103,A00,491834,Man; Simeon S,15,0,23,8
1713320771341,HIUS 108B,A00,491835,Staff,29,0,30,1
1713320772366,HIUS 141,A00,491836,Hendrickson; Gerald M.,29,0,32,3
1713320773391,HIUS 149,A00,491839,Staff,27,0,32,5
1713320774419,HUM 3,A01,512617,Crum; Matthew Stephen,44,0,50,6
1713320774419,HUM 3,A02,512618,Crum; Matthew Stephen,48,0,50,2
1713320775447,HUM 3GS,A00,512663,Markman; Kristina,0,0,0,1
1713320775447,HUM 3GS,B00,512664,Staff,0,0,0,0
1713320776486,HUM 4,A01,512620,West; Geoffrey Scott,30,0,50,20
1713320777514,HUM 4GS,A00,512666,Lyon; Antony J.,0,0,0,4
1713320778541,HUM 4R,A01,512625,Watkins; Eric,49,0,50,1
1713320779566,HUM 5,A01,512649,Zavodny; Tatiana Sophia,27,0,50,23
1713320779566,HUM 5,B01,512661,Zroka; Ryan Edward,48,0,50,2
1713320780594,INTL 190,A00,490577,Segui; Alan S,0,0,0,5
1713320781619,JAPN 20AR,A01,491267,Ross; Kayoko F,8,0,20,12
1713320782644,JAPN 180,A00,491285,Berman; Michael David,33,0,40,7
1713320783669,LATI 50,A01,502536,Kokinis; Troy Andreas,16,0,22,6
1713320783669,LATI 50,A02,502551,Kokinis; Troy Andreas,22,0,22,0
1713320783669,LATI 50,A03,502650,Kokinis; Troy Andreas,22,0,22,0
1713320783669,LATI 50,A04,502909,Kokinis; Troy Andreas,22,0,22,0
1713320784694,LATI 160,A01,502920,Kokinis; Troy Andreas,30,0,30,0
1713320785719,LIFR 1A,A00,490494,Van Moer; Vinciane G,17,0,20,3
1713320786745,LIFR 1AX,A00,490495,Van Moer; Vinciane G,17,0,20,3
1713320787795,LIFR 1B,A00,490496,Van Moer; Vinciane G,18,0,20,2
1713320788823,LIFR 1BX,A00,490497,Van Moer; Vinciane G,18,0,20,2
1713320789850,LIGN 8,A00,505198,McIntosh; Justin Daniel,135,0,150,15
1713320790876,LIGN 9GS,A00,491239,Lott; Margaret S.,18,0,20,2
1713320791904,LIGN 101,A01,505200,McIntosh; Justin Daniel,24,0,30,6
1713320792932,LIGN 120,A01,491244,Staff,24,0,30,6
1713320793956,LIGN 149GS,A00,491245,Lott; Margaret S.,18,0,20,2
1713320794985,LIGN 170,A00,491247,Staff,23,0,30,7
1713320796013,LISP 1D,A00,490498,Munoz Sanchez; Alicia,10,0,14,4
1713320796013,LISP 1D,B00,490499,Munoz Sanchez; Alicia,6,0,14,8
1713320796013,LISP 1D,C00,490500,Munoz Sanchez; Alicia,8,0,14,6
1713320796013,LISP 1D,D00,490501,Munoz Sanchez; Alicia,10,0,14,4
1713320797041,LISP 1DX,A00,490502,Munoz Sanchez; Alicia,15,0,28,13
1713320797041,LISP 1DX,B00,490503,Munoz Sanchez; Alicia,17,0,28,11
1713320799093,LTAM 110,A00,491847,Staff,23,0,25,2
1713320800120,LTCS 119,A00,491848,Staff,11,0,15,4
1713320801148,LTCS 130,A00,491849,Staff,24,0,25,1
1713320803202,LTEA 120C,A00,491852,Staff,32,0,40,8
1713320804227,LTEN 130GS,A00,491853,Lyon; Antony J.,24,0,28,4
1713320805255,LTEN 148,A00,491855,Staff,23,0,25,2
1713320806280,LTEN 159,A00,491856,Staff,21,0,25,4
1713320807307,LTEN 180,A00,491857,Staff,8,0,15,7
1713320809356,LTSP 123GS,A00,505928,Bessett; Ryan Matthew,24,0,28,4
1713320810387,LTSP 174GS,A00,506037,Bessett; Ryan Matthew,24,0,28,4
1713320812444,LTWR 102,A00,491861,Staff,9,0,15,6
1713320813468,LTWR 106,A00,491862,Staff,10,0,15,5
1713320814492,MAE 11,A00,490930,Bahadori; Mohammad Yousef,96,0,100,4
1713320815521,MAE 30A,A00,490931,Qi; Huihui,37,0,40,3
1713320816546,MAE 101A,A00,491036,Sadeghizadeh; Zahra,96,0,100,4
1713320817574,MAE 101C,A00,491037,Seshadri; Kalyanasundaram,72,0,100,28
1713320818602,MAE 113,A00,491040,Seshadri; Kalyanasundaram,66,0,80,14
1713320819627,MAE 131A,A00,491041,Ghazinejad; Maziar,38,0,40,2
1713320820657,MAE 142,A00,491053,Staff,39,0,40,1
1713320821685,MAE 143A,A00,491054,Staff,34,0,50,16
1713320822714,MAE 150,A00,491092,Truong; Phuong Thi Ngoc,23,0,35,12
1713320823744,MATH 3C,A01,494031,Pardo Guerra; Sebastian,30,0,30,0
1713320823744,MATH 3C,A02,494032,Pardo Guerra; Sebastian,29,0,30,1
1713320824771,MATH 10A,A01,494034,Staff,27,0,30,3
1713320824771,MATH 10A,A02,494035,Staff,28,0,30,2
1713320824771,MATH 10A,B01,494037,Staff,27,0,30,3
1713320824771,MATH 10A,B02,494038,Staff,29,0,30,1
1713320825802,MATH 10B,A01,494040,Habib; Yousaf,22,0,30,8
1713320825802,MATH 10B,A02,494041,Habib; Yousaf,28,0,30,2
1713320825802,MATH 10B,A03,494042,Habib; Yousaf,29,0,30,1
1713320825802,MATH 10B,A04,494043,Habib; Yousaf,30,0,30,0
1713320825802,MATH 10B,B01,494045,Habib; Yousaf,27,0,30,3
1713320825802,MATH 10B,B02,494046,Habib; Yousaf,30,0,30,0
1713320825802,MATH 10B,B03,494047,Habib; Yousaf,30,0,30,0
1713320825802,MATH 10B,B04,494048,Habib; Yousaf,30,0,30,0
1713320826828,MATH 18,A01,494050,Kemp; Todd Aahron,25,0,30,5
1713320826828,MATH 18,A02,494051,Kemp; Todd Aahron,29,0,30,1
1713320826828,MATH 18,B01,494054,Kemp; Todd Aahron,27,0,30,3
1713320826828,MATH 18,B02,494055,Kemp; Todd Aahron,29,0,30,1
1713320827856,MATH 20A,A01,494059,Suk; Andrew Hoon,30,0,30,0
1713320828887,MATH 20B,A01,494061,Briones; Jor-el Thomas Caparas,33,0,35,2
1713320828887,MATH 20B,B01,494063,Bach; Quang Tran,34,0,35,1
1713320829914,MATH 20C,A01,494065,Staff,28,0,30,2
1713320829914,MATH 20C,A02,494066,Staff,30,0,30,0
1713320829914,MATH 20C,A03,494067,Staff,30,0,30,0
1713320829914,MATH 20C,A04,494068,Staff,30,0,30,0
1713320829914,MATH 20C,B01,494070,Zhang; Ming,26,0,30,4
1713320829914,MATH 20C,B02,494071,Zhang; Ming,28,0,30,2
1713320829914,MATH 20C,B03,494072,Zhang; Ming,29,0,30,1
1713320829914,MATH 20C,B04,494073,Zhang; Ming,29,0,30,1
1713320830943,MATH 20D,A01,494075,Staff,22,0,30,8
1713320830943,MATH 20D,A02,494076,Staff,30,0,30,0
1713320831968,MATH 20E,A01,494079,Staff,24,0,30,6
1713320831968,MATH 20E,A02,494080,Staff,26,0,30,4
1713320831968,MATH 20E,B01,494082,Staff,25,0,30,5
1713320831968,MATH 20E,B02,494083,Staff,25,0,30,5
1713320832997,MATH 103A,A01,494085,Aliabadi Sr.; Mohsen,14,0,30,16
1713320832997,MATH 103A,A02,494086,Aliabadi Sr.; Mohsen,28,0,30,2
1713320832997,MATH 103A,B01,494088,Aliabadi Sr.; Mohsen,22,0,30,8
1713320832997,MATH 103A,B02,494089,Aliabadi Sr.; Mohsen,28,0,30,2
1713320834026,MATH 109,A01,494091,Staff,30,0,30,0
1713320834026,MATH 109,A02,494092,Staff,29,0,30,1
1713320834026,MATH 109,B01,494094,Staff,27,0,30,3
1713320834026,MATH 109,B02,494095,Staff,29,0,30,1
1713320835051,MATH 142A,A01,494097,Chow; Bennett,16,0,30,14
1713320835051,MATH 142A,A02,494098,Chow; Bennett,24,0,30,6
1713320835051,MATH 142A,B01,494100,Chow; Bennett,19,0,30,11
1713320835051,MATH 142A,B02,494101,Chow; Bennett,29,0,30,1
1713320837104,MATH 168A,A01,516677,Dumitriu; Ioana,15,0,35,20
1713320838132,MATH 170A,A01,516679,Dumitriu; Ioana,19,0,30,11
1713320838132,MATH 170A,A02,516680,Dumitriu; Ioana,28,0,30,2
1713320839159,MATH 193A,A01,494107,Staff,15,0,30,15
1713320839159,MATH 193A,A02,494108,Staff,21,0,30,9
1713320839159,MATH 193A,A03,494109,Staff,29,0,30,1
1713320839159,MATH 193A,A04,494110,Staff,22,0,30,8
1713320842287,MGT 16,A00,491930,McKay; Michael J,90,0,98,8
1713320843312,MGT 18,A00,491992,McKay; Michael J,97,0,98,1
1713320844337,MGT 71,A00,492003,Staff,69,0,98,29
1713320845362,MGT 103,A00,505209,Eberhard; Craig A,81,0,98,17
1713320846389,MGT 131A,A00,505210,Anderson; John Charles,90,0,98,8
1713320848440,MGT 153,A00,492077,Perols; Johan Lars,24,0,90,66
1713320851515,MGT 164,A00,492222,McKay; Mary A,93,0,98,5
1713320852541,MGT 172,A00,492245,Staff,59,0,60,1
1713320852541,MGT 172,B00,505526,Hedges; Kathleen,71,0,98,27
1713320853566,MGT 181,A00,505669,Dunn; Louis Jean,83,0,98,15
1713320854591,MMW 14,A01,494399,Staff,20,0,28,8
1713320854591,MMW 14,A02,494400,Staff,25,0,28,3
1713320854591,MMW 14,A03,494401,Staff,28,0,28,0
1713320854591,MMW 14,A04,494402,Staff,28,0,28,0
1713320854591,MMW 14,B01,494404,Carreras; Maria Victoria,12,0,28,16
1713320854591,MMW 14,B02,494405,Carreras; Maria Victoria,26,0,28,2
1713320854591,MMW 14,B03,494406,Carreras; Maria Victoria,27,0,28,1
1713320854591,MMW 14,B04,494407,Carreras; Maria Victoria,28,0,28,0
1713320855616,MMW 14GS,A00,506250,Chang; Edmond Yi-Teh,0,0,0,0
1713320856645,MMW 121R,A01,494415,Adamiak; Patrick John,12,0,28,16
1713320856645,MMW 121R,A02,494416,Adamiak; Patrick John,24,0,28,4
1713320857674,MUS 1A,A01,494113,Staff,12,0,25,13
1713320857674,MUS 1A,A02,494114,Staff,24,0,25,1
1713320858702,MUS 4,A01,494116,Staff,24,0,25,1
1713320858702,MUS 4,A02,494117,Staff,22,0,25,3
1713320859728,MUS 5R,A01,494236,Dubnov; Shlomo,10,0,25,15
1713320859728,MUS 5R,A02,494237,Dubnov; Shlomo,25,0,25,0
1713320860758,MUS 6,A01,494122,Staff,11,0,25,14
1713320860758,MUS 6,A02,494123,Staff,24,0,25,1
1713320861782,MUS 7,A01,494125,Staff,16,0,25,9
1713320861782,MUS 7,A02,494126,Staff,24,0,25,1
1713320862807,MUS 11,A01,494128,Staff,23,0,25,2
1713320862807,MUS 11,A02,494129,Staff,24,0,25,1
1713320863837,MUS 13,A01,494131,Staff,25,0,25,0
1713320863837,MUS 13,A02,494132,Staff,25,0,25,0
1713320864863,MUS 15,A01,494134,Staff,17,0,25,8
1713320864863,MUS 15,A02,494135,Staff,25,0,25,0
1713320864863,MUS 15,B01,494137,Staff,24,0,25,1
1713320865892,MUS 80,A00,494232,Staff,24,0,25,1
1713320865892,MUS 80,B00,494233,Staff,25,0,25,0
1713320865892,MUS 80,C00,494234,Staff,23,0,25,2
1713320866919,MUS 95C,A00,494141,Staff,71,0,75,4
1713320867948,MUS 114,A00,494142,Staff,40,0,50,10
1713320868972,NANO 15,A01,490636,Drews; Aaron,7,0,7,0
1713320870006,PHIL 1,A00,490578,Grush; Rick Scott,49,0,50,1
1713320871035,PHIL 10,A01,490580,Grush; Rick Scott,33,0,35,2
1713320871035,PHIL 10,A02,490586,Grush; Rick Scott,33,0,35,2
1713320872064,PHIL 27,A01,490591,Staff,23,0,25,2
1713320872064,PHIL 27,A02,490592,Staff,25,0,25,0
1713320872064,PHIL 27,A03,490593,Staff,25,0,25,0
1713320872064,PHIL 27,A04,490598,Staff,25,0,25,0
1713320873091,PHIL 32,A01,490611,Staff,20,0,20,0
1713320873091,PHIL 32,A02,490618,Staff,20,0,20,0
1713320874116,PHIL 90,A00,490624,Staff,40,0,40,0
1713320875143,PHIL 136,A00,490627,Cohen; Jonathan David,37,0,40,3
1713320876169,PHIL 155,A00,490634,Staff,63,0,70,7
1713320877196,PHYS 1A,A00,491610,Staff,246,0,250,4
1713320878220,PHYS 1AL,001,491616,Tsai; Philbert S,28,0,30,2
1713320878220,PHYS 1AL,002,491618,Tsai; Philbert S,30,0,30,0
1713320879249,PHYS 1B,A00,491623,Staff,242,0,250,8
1713320880274,PHYS 1BL,001,491626,Tsai; Philbert S,25,0,30,5
1713320880274,PHYS 1BL,002,491628,Tsai; Philbert S,27,0,30,3
1713320881302,PHYS 1C,A00,491632,Staff,220,0,245,25
1713320882327,PHYS 1CL,001,491635,Tsai; Philbert S,9,0,30,21
1713320882327,PHYS 1CL,002,491643,Tsai; Philbert S,23,0,30,7
1713320883352,PHYS 2AR,A01,491651,Meyertholen; Andrew D.,44,0,50,6
1713320884379,PHYS 2B,A01,491659,Staff,105,0,115,10
1713320885407,PHYS 2BL,A01,491685,Staff,21,0,24,3
1713320885407,PHYS 2BL,A02,491700,Staff,23,0,24,1
1713320886435,PHYS 2C,A01,505161,Staff,106,0,115,9
1713320887459,PHYS 4A,A01,491704,Grinstein; Benjamin,99,0,100,1
1713320888483,POLI 5D,A01,494144,Staff,3,0,5,2
1713320888483,POLI 5D,B01,626283,Dai; Yinlin,5,0,5,0
1713320889506,POLI 12,A00,494145,Staff,44,0,45,1
1713320890534,POLI 13R,A00,494146,Forman; Fonna,45,0,50,5
1713320891559,POLI 27,A01,494148,Staff,57,0,60,3
1713320892588,POLI 30,A00,494149,Staff,49,0,50,1
1713320893617,POLI 100DA,A00,494150,Staff,21,0,25,4
1713320895673,POLI 100I,A00,494152,Staff,28,0,30,2
1713320896698,POLI 104B,A00,494153,Smith; Glenn Chatmas,53,0,55,2
1713320897725,POLI 104F,A00,494154,Staff,28,0,30,2
1713320898751,POLI 104I,A00,494155,Smith; Glenn Chatmas,30,0,30,0
1713320899780,POLI 110C,A00,494156,Ingham; Sean,23,0,25,2
1713320900807,POLI 117R,A00,494157,Forman; Fonna,8,0,20,12
1713320901833,POLI 118,A00,494158,Ingham; Sean,22,0,25,3
1713320902857,POLI 120H,A00,494159,Fisk; David Lee,40,0,45,5
1713320903886,POLI 131CR,A00,494160,Hoston; Germaine,36,0,45,9
1713320904914,POLI 133J,A00,494161,Staff,33,0,35,2
1713320905943,POLI 135,A00,494162,Fisk; David Lee,33,0,35,2
1713320906970,POLI 140A,A00,494164,Staff,21,0,30,9
1713320907998,POLI 142I,A00,494165,Staff,30,0,30,0
1713320909024,POLI 144D,A00,494166,Staff,23,0,25,2
1713320910053,POLI 151,A00,494167,Staff,30,0,30,0
1713320911078,POLI 153,A00,494168,Staff,33,0,35,2
1713320912107,POLI 160AA,A00,494169,Staff,35,0,40,5
1713320913135,POLI 162,A00,494170,Mignozzetti; Umberto,19,0,25,6
1713320914161,POLI 171,A00,494171,Mignozzetti; Umberto,21,0,25,4
1713320915186,PSYC 1,A00,494172,Staff,97,0,100,3
1713320916213,PSYC 2,A00,494173,Moranton; Nirelia Melbina-,40,0,50,10
1713320917236,PSYC 3,A00,494174,Staff,29,0,30,1
1713320918266,PSYC 6,A00,494175,Staff,17,0,20,3
1713320919290,PSYC 60,A01,494177,Staff,38,0,45,7
1713320920315,PSYC 70,A01,505724,Geller; Emma Harlan,42,0,45,3
1713320921344,PSYC 101,A00,494180,Heyman; Gail D.,84,0,100,16
1713320922373,PSYC 105,A00,494181,Geller; Emma Harlan,58,0,90,32
1713320923398,PSYC 106,A00,494182,Dobkins; Karen R.,29,0,45,16
1713320924424,PSYC 108,A00,494183,Adrian; Julia Anna,91,0,100,9
1713320925448,PSYC 114,A01,494185,Winkielman; Piotr,0,0,30,30
1713320926475,PSYC 122,A00,494186,Moranton; Nirelia Melbina-,32,0,50,18
1713320927501,PSYC 124,A00,494187,Chapman; Eddie Nathaniel,71,0,80,9
1713320928525,PSYC 131,A00,494188,Anagnostaras; Stephan,50,0,80,30
1713320929551,PSYC 144,A00,494189,Staff,10,0,50,40
1713320930581,PSYC 154,A00,494190,Lacefield; Katharine I,121,0,180,59
1713320931608,PSYC 162,A00,494191,Wixted; John T,75,0,100,25
1713320932633,PSYC 172,A00,494192,Gorman; Michael R.,36,0,45,9
1713320933663,PSYC 178,A00,494193,Glaser; Dale,36,0,45,9
1713320934694,PSYC 193,A00,505725,Chapman; Eddie Nathaniel,20,0,20,0
1713320935719,RELI 145GS,A00,519817,Rahimi; Babak,18,0,20,2
1713320936749,SE 101A,A01,490862,Chadha; Mayank,23,0,25,2
1713320937773,SE 101C,A01,490924,Krysl; Petr,16,0,20,4
1713320938803,SE 110A,A01,490928,Staff,19,0,20,1
1713320939828,SE 130A,A00,490929,Morrison; Machel Leigh,58,0,70,12
1713320940854,SIO 1,A01,519325,Staff,39,0,40,1
1713320941884,SIO 30,A01,519327,Staff,38,0,40,2
1713320942907,SIO 40,A00,519328,Staff,39,0,40,1
1713320943933,SIO 46GS,A00,519819,Cook; Geoffrey W,17,0,25,8
1713320945011,SIO 109R,A00,494197,Forman; Fonna,0,0,20,20
1713320946036,SIO 121GS,A00,519827,Cook; Geoffrey W,17,0,25,8
1713320947064,SIO 132,A01,519330,Staff,38,0,40,2
1713320948088,SIO 133,A01,519397,Staff,37,0,40,3
1713320949240,SIO 139,A00,519396,Kacev; David,31,0,40,9
1713320950267,SOCI 1,A01,494199,Thorpe; Charles Robert,22,0,30,8
1713320950267,SOCI 1,A02,494200,Thorpe; Charles Robert,30,0,30,0
1713320950267,SOCI 1,A03,494201,Thorpe; Charles Robert,29,0,30,1
1713320950267,SOCI 1,A04,494202,Thorpe; Charles Robert,29,0,30,1
1713320950267,SOCI 1,A05,494203,Thorpe; Charles Robert,29,0,30,1
1713320950267,SOCI 1,A06,494204,Thorpe; Charles Robert,30,0,30,0
1713320950267,SOCI 1,A07,494205,Thorpe; Charles Robert,29,0,30,1
1713320951297,SOCI 60,A01,494207,Staff,34,0,40,6
1713320951297,SOCI 60,A02,494208,Staff,39,0,40,1
1713320952326,SOCI 100,A01,494210,Payne; Christine Anna,27,0,30,3
1713320952326,SOCI 100,A02,494211,Payne; Christine Anna,26,0,30,4
1713320953350,SOCI 109M,A00,494212,Staff,20,0,20,0
1713320954378,SOCI 110,A00,494213,Staff,35,0,40,5
1713320956430,SOCI 118E,A00,494215,Ng; Kwai,37,0,40,3
1713320957459,SOCI 125,A00,494216,Calderon-Zaks; Michael Aar,42,0,45,3
1713320958485,SOCI 126,A01,494218,Jones; Makeba,3,0,5,2
1713320959513,SOCI 131,A00,494219,Thorpe; Charles Robert,28,0,30,2
1713320961579,SOCI 135,A00,494221,Payne; Christine Anna,31,0,50,19
1713320962606,SOCI 136E,A00,626690,Ruiz; Jonathan Joseph,25,0,25,0
1713320963635,SOCI 138GS,A00,494222,Navon; Daniel,24,0,28,4
1713320965691,SOCI 145,A00,494224,Staff,41,0,45,4
1713320966717,SOCI 153,A00,494225,Staff,28,0,30,2
1713320967746,SOCI 160E,A00,494226,Ng; Kwai,30,0,40,10
1713320968772,SOCI 180,A00,494227,Staff,29,0,30,1
1713320969799,SOCI 189GS,A00,494228,Ribas Norris; Janet Vanesa,11,0,11,0
1713320970824,SOCI 190GS,A00,553232,Ribas Norris; Janet Vanesa,11,0,11,0
1713320971851,SOMI 220,A00,627178,Schneid; Stephen David,30,0,30,0
1713320972877,SYN 2,001,490768,Staff,14,0,15,1
1713320972877,SYN 2,002,490769,Staff,15,0,15,0
1713320972877,SYN 2,004,490775,Staff,0,0,0,0
1713320972877,SYN 2,003,490774,Staff,0,0,0,0
1713320972877,SYN 2,005,490776,Staff,0,0,0,0
1713320973901,SYN 2R,001,490779,Staff,12,0,15,3
1713320973901,SYN 2R,002,514635,Staff,14,0,15,1
1713320974928,SYN 100,A01,490783,Staff,14,0,20,6
1713320974928,SYN 100,B01,490787,Staff,10,0,20,10
1713320974928,SYN 100,C01,490789,Staff,11,0,20,9
1713320975956,SYN 150,A00,490817,Staff,14,0,15,1
1713320975956,SYN 150,B00,514610,Staff,15,0,15,0
1713320976981,TDAC 1,A00,492753,Walsh; Kim C.,19,0,20,1
1713320976981,TDAC 1,B00,492754,Harting; Carla Kelso,19,0,20,1
1713320976981,TDAC 1,C00,513995,Salovey; Todd,15,0,20,5
1713320978010,TDAC 101,A00,492766,Harting; Carla Kelso,17,0,20,3
1713320979040,TDAC 102,A00,492768,Basso; Beatrice,19,0,20,1
1713320980063,TDDE 111,A00,492769,Staff,25,0,25,0
1713320981091,TDDE 131,A00,492770,Staff,15,0,15,0
1713320981091,TDDE 131,B00,492771,Staff,15,0,15,0
1713320982115,TDDE 131GS,A00,523716,Guirguis; Mark C,24,0,28,4
1713320983141,TDGE 1,A01,492756,Salovey; Todd,57,0,60,3
1713320984166,TDGE 5,A01,492758,Staff,24,0,25,1
1713320985191,TDGE 10,A00,492759,Fulton; Julia,206,0,220,14
1713320986216,TDGE 11,A00,492760,Castro; Robert Jess,198,0,200,2
1713320988271,TDGE 124,A00,492772,Fulton; Julia,191,0,220,29
1713320989300,TDGE 125,A00,492773,Meyer; Ursula,39,0,50,11
1713320989300,TDGE 125,B00,492774,Staff,49,0,50,1
1713320989300,TDGE 125,C00,523565,Staff,48,0,50,2
1713320990324,TDGE 125GS,A00,523580,Guirguis; Mark C,24,0,28,4
1713320991350,TDGE 127,A00,492775,Havis; Allan,39,0,50,11
1713320992377,TDHT 101,A00,492776,Staff,34,0,35,1
1713320993409,TDMV 1,A00,492762,Caligagan; Maria T.,30,0,30,0
1713320993409,TDMV 1,B00,492763,Arcidiacono; Kristin,25,0,30,5
1713320994436,TDMV 2,A00,492764,Weinberg; Sadie,29,0,30,1
1713320995464,TDMV 3,A00,492765,Mack; Kara Shanai',38,0,40,2
1713320996492,TDMV 138,A00,492777,Mack; Kara Shanai',35,0,40,5
1713320997519,TDMV 140,A00,492778,Lima; Paulo Henrique,40,0,40,0
1713320998544,TDMV 142,A00,492779,Caligagan; Maria T.,34,0,40,6
1713320998544,TDMV 142,B00,492780,Caligagan; Tony,37,0,40,3
1713320999569,TDMV 143,A00,492781,Fyall; Daunte Edward,39,0,40,1
1713321000595,USP 1,A01,492401,Kwak; Nancy,26,0,35,9
1713321001623,USP 2,A01,492453,Hinds; Juli Beth,35,0,35,0
1713321002650,USP 3,A01,492516,Staff,28,0,35,7
1713321003676,USP 4,A00,492522,McTague; Sarah,17,0,25,8
1713321004700,USP 100,A00,492523,Staff,33,0,35,2
1713321005725,USP 101,A00,492524,Staff,13,0,15,2
1713321006749,USP 105,A00,492525,Staff,21,0,25,4
1713321007773,USP 151,A00,492526,Shenkman; Michael Thomas,32,0,35,3
1713321008799,USP 170,A00,492545,Hinds; Juli Beth,33,0,35,2
1713321009827,USP 171GS,A00,492608,Bussell; Mirle Rabinowitz,24,0,28,4
1713321010856,USP 183GS,A00,492613,Peerson; Susan,24,0,28,4
1713321011883,VIS 30,A01,490693,Yoldas; Pinar,19,0,22,3
1713321011883,VIS 30,A02,490694,Yoldas; Pinar,18,0,22,4
1713321012909,VIS 83,A00,490695,Kester; Grant,63,0,75,12
1713321013934,VIS 105D,A00,490696,Staff,22,0,25,3
1713321014960,VIS 124CN,A00,490699,Rose; Jordan M,66,0,75,9
1713321015987,VIS 125GS,A00,511221,Williams; Alena J,21,0,22,1
1713321017015,VIS 128D,A00,490700,Staff,73,0,75,2
1713321018046,VIS 151,A01,490717,Staff,33,0,34,1
1713321018046,VIS 151,A02,490766,Staff,33,0,34,1
1713321019071,VIS 154GS,A00,511972,Williams; Alena J,21,0,22,1
1713321020100,VIS 160A,A00,490767,Stone; Patricia,7,0,10,3
1713321021124,WCWP 10A,A00,490638,Staff,14,0,15,1
1713321021124,WCWP 10A,B00,490640,Staff,15,0,15,0
1713321022154,WCWP 10B,A00,490641,Staff,0,0,0,0
1713321022154,WCWP 10B,B00,490642,Staff,14,0,15,1
1713321022154,WCWP 10B,C00,490644,Staff,13,0,15,2
1713321022154,WCWP 10B,D00,490647,Staff,0,0,0,0
1713321023178,WCWP 100,A00,490655,Staff,0,0,0,0
1713321023178,WCWP 100,B00,490687,Staff,10,0,15,5
1713321025290,ANAR 153,A00,487222,Braswell; Geoffrey E.,54,0,60,6
1713321026320,ANBI 134,A00,487223,Staff,7,0,20,13
1713321027345,ANBI 143GS,A00,487224,Noel; Geoffroy Pierre Jean,18,0,24,6
1713321028371,ANBI 144GS,A00,519548,Noel; Geoffroy Pierre Jean,18,0,24,6
1713321029396,ANSC 101,A00,487225,Staff,19,0,20,1
1713321030421,ANSC 125,A00,487227,Brenner; Suzanne A,39,0,40,1
1713321032476,ANSC 146,A00,487229,Staff,35,0,40,5
1713321033503,ANSC 148,A00,487230,Olivas Hernandez; Olga Lid,39,0,40,1
1713321034532,ANSC 150,A00,504165,Sloane; Julia Kathryn,19,0,20,1
1713321035560,ANSC 180,A00,487232,Staff,14,0,15,1
1713321036589,ANSC 188,A00,627155,Staff,39,0,40,1
1713321037617,ANTH 5,A00,519529,Semendeferi; Ekaterini,15,0,15,0
1713321038645,ANTH 10,A00,487219,Staff,58,0,60,2
1713321039674,ANTH 23,A01,487221,Staff,17,0,20,3
1713321040698,ANTH 102,A00,487233,Wilder; Linnea Lorene,51,0,60,9
1713321041726,ANTH 103,A00,487234,Varma; Saiba,55,0,60,5
1713321042751,ANTH 105,A00,487235,Stewart; Alexander B,55,0,60,5
1713321043777,BENG 100,A01,516685,Taylor Amos; Alyssa C,28,0,30,2
1713321044804,BIBC 102,A01,491316,Flagg; Matthew Paul,23,0,88,65
1713321044804,BIBC 102,A02,491366,Flagg; Matthew Paul,82,0,88,6
1713321045833,BIBC 103,A01,491486,Boumechache; Miyyada,16,0,24,8
1713321045833,BIBC 103,A02,491487,Boumechache; Miyyada,24,0,24,0
1713321046861,BICD 100,A01,516882,Staff,75,0,75,0
1713321046861,BICD 100,A02,516890,Staff,69,0,75,6
1713321047886,BICD 102GS,A00,491488,Lo; Stanley M.,26,0,28,2
1713321048964,BIEB 136GS,A00,516940,Holway; David A. & Shurin; Jonathan,19,0,24,5
1713321049988,BIEB 137GS,A01,517034,Holway; David A. & Shurin; Jonathan,19,0,24,5
1713321051014,BIEB 138GS,A01,491492,Pirino; Giorgia,21,0,28,7
1713321052041,BILD 1,A01,491296,Staff,61,0,63,2
1713321052041,BILD 1,A02,491297,Staff,63,0,63,0
1713321053067,BILD 4,A01,517099,Gonzalez Gamboa; Ivonne,22,0,24,2
1713321053067,BILD 4,A02,517100,Gonzalez Gamboa; Ivonne,24,0,24,0
1713321054096,BILD 60GS,A00,491309,Lo; Stanley M.,26,0,28,2
1713321055120,BIMM 100,A01,517136,Staff,87,0,100,13
1713321056149,BIMM 110,A01,517182,Staff,63,0,100,37
1713321057174,BIMM 120,A01,517228,Pickett; Brooke Elizabeth,34,0,63,29
1713321057174,BIMM 120,A02,517240,Pickett; Brooke Elizabeth,46,0,63,17
1713321058199,BIMM 132GS,A01,491498,Pirino; Giorgia,21,0,28,7
1713321059225,BIMM 143,A01,491589,Bozinovic; Goran,15,0,40,25
1713321060250,BIPN 100,A01,491594,Armour; Jon Christopher,90,0,100,10
1713321061289,BIPN 140,A01,491602,Marino; Marc J,28,0,50,22
1713321063342,CAT 125,A00,515973,Staff,18,0,20,2
1713321064366,CAT 125GS,A00,515974,Rahimi; Babak,17,0,20,3
1713321065393,CAT 125R,A00,515980,Staff,13,0,20,7
1713321065393,CAT 125R,B00,515981,Tosun; Adriana,19,0,20,1
1713321065393,CAT 125R,C00,515987,Hyland; Tina Mae,0,2,20,20
1713321065393,CAT 125R,D00,515988,Bronstein; Phoebe Malan,18,0,20,2
1713321066422,CENG 15,A01,488699,Drews; Aaron,25,0,25,0
1713321067451,CENG 100,A00,505196,Opatkiewicz; Justin Paul,25,0,25,0
1713321068475,CGS 2A,A01,489598,Staff,33,0,35,2
1713321069499,CGS 112,A00,489599,Staff,15,0,15,0
1713321070526,CGS 119,A00,489603,Staff,10,0,10,0
1713321071551,CGS 120,A00,489604,Staff,14,0,15,1
1713321072579,CGS 150,A00,489607,Staff,15,0,15,0
1713321073607,CHEM 6A,A01,488715,Staff,98,0,100,2
1713321074633,CHEM 6B,A01,488719,Piercy; Marc Anthony,100,0,100,0
1713321075660,CHEM 6C,A01,488723,Albizati; Kim F.,94,0,100,6
1713321076686,CHEM 7L,A01,488728,Schurmeier; Kimberly,17,0,24,7
1713321076686,CHEM 7L,A02,488730,Schurmeier; Kimberly,23,0,24,1
1713321076686,CHEM 7L,A03,488734,Schurmeier; Kimberly,22,0,24,2
1713321076686,CHEM 7L,A04,488763,Schurmeier; Kimberly,23,0,24,1
1713321076686,CHEM 7L,B01,488798,Schurmeier; Kimberly,17,0,24,7
1713321076686,CHEM 7L,B02,488801,Schurmeier; Kimberly,23,0,24,1
1713321076686,CHEM 7L,B03,488808,Schurmeier; Kimberly,24,0,24,0
1713321076686,CHEM 7L,B04,488811,Schurmeier; Kimberly,24,0,24,0
1713321077712,CHEM 11,A01,488897,Stallings; Dontarie M,96,0,100,4
1713321078741,CHEM 40A,A01,488913,Albizati; Kim F.,88,0,100,12
1713321079767,CHEM 40B,A01,488920,Weizman; Haim,44,0,50,6
1713321079767,CHEM 40B,A02,488938,Weizman; Haim,45,0,50,5
1713321080796,CHEM 41A,A01,489029,Klosterman; Jeremy K,57,0,60,3
1713321081820,CHEM 41C,A01,500436,Tor; Yitzhak,55,0,60,5
1713321082845,CHEM 43A,A01,500426,Weizman; Haim,0,0,24,24
1713321082845,CHEM 43A,A02,500430,Weizman; Haim,13,0,24,11
1713321082845,CHEM 43A,B01,514041,Klosterman; Jeremy K,15,0,24,9
1713321082845,CHEM 43A,B02,514047,Klosterman; Jeremy K,23,0,24,1
1713321083870,CHEM 108,A01,489140,Jennings; Patricia A.,11,0,24,13
1713321083870,CHEM 108,A02,489142,Jennings; Patricia A.,14,0,24,10
1713321084895,CHEM 114A,A01,489147,Stallings; Dontarie M,74,0,100,26
1713321085921,CHIN 169A,A00,489171,Wang; Xiao,19,0,20,1
1713321087979,COGS 3,A01,518827,Boyle; Mary E. T.,27,0,40,13
1713321089004,COGS 11,A01,489175,Staff,28,0,30,2
1713321090033,COGS 14A,A01,518829,Staff,51,0,60,9
1713321091060,COGS 14B,A01,489177,Hoffman; Drew Ellen,66,0,75,9
1713321092090,COGS 100,A01,489181,Allen; Michael Gordon,64,0,75,11
1713321093117,COGS 101A,A01,489183,Staff,47,0,60,13
1713321094142,COGS 101B,A01,489185,Allen; Michael Gordon,9,0,30,21
1713321095169,COGS 101C,A01,526786,Staff,24,0,30,6
1713321097221,COGS 107A,A01,489189,Boyle; Mary E. T.,19,0,35,16
1713321098244,COGS 107B,A01,627144,Mooshagian; Eric Frederick,60,0,60,0
1713321099268,COGS 118A,A01,489191,Staff,0,40,40,40
1713321101324,COGS 171GS,A01,489194,Pineda; Jaime A,21,0,28,7
1713321102348,COGS 172,A01,489196,Staff,3,0,30,27
1713321103372,COGS 174GS,A01,489264,Pineda; Jaime A,21,0,28,7
1713321104397,COGS 180,A01,627150,Staff,28,0,30,2
1713321105421,COGS 186,A01,489274,Staff,0,1,30,30
1713321106449,COMM 10,A01,489276,Staff,23,0,25,2
1713321106449,COMM 10,A02,489303,Staff,23,0,25,2
1713321107476,COMM 100A,A01,489312,Staff,14,0,25,11
1713321107476,COMM 100A,A02,489313,Staff,24,0,25,1
1713321108499,COMM 106T,A00,512540,Staff,33,0,35,2
1713321109524,COMM 107,A00,489347,Staff,28,0,35,7
1713321110559,COMM 109P,A00,489358,Staff,31,0,35,4
1713321111582,COMM 132,A00,489361,McKenna; Denise,28,0,30,2
1713321112606,COMM 146,A00,489362,Halm; Gavin Patrick,26,0,30,4
1713321113633,COMM 190,A00,489363,Abuelhiga; Soraya Jill,17,0,23,6
1713321114658,CSE 8A,A50,489366,Staff,22,0,25,3
1713321114658,CSE 8A,A51,489367,Staff,24,0,25,1
1713321115684,CSE 11,A01,489398,Cao; Yingjun,79,0,100,21
1713321116709,CSE 12,A01,489487,Staff,43,0,50,7
1713321117737,CSE 20,A01,489497,Staff,48,0,50,2
1713321118762,CSE 21,A01,489517,Braun; Oliver,42,0,50,8
1713321119791,CSE 101,A01,489524,Braun; Oliver,0,27,50,50
1713321120816,CSE 105,A01,512594,Jones; Miles E,74,0,100,26
1713321120816,CSE 105,B01,512598,Jones; Miles E,56,0,100,44
1713321121846,CSE 140,A01,489538,Staff,43,0,50,7
1713321122870,CSE 141,A01,489550,Eldon; John,71,0,100,29
1713321123896,CSE 141L,A01,489571,Eldon; John,69,0,100,31
1713321124921,CSE 151A,A01,489583,Solares; Edwin A,145,0,200,55
1713321125946,CSE 175,A01,510886,Kumar; Rakesh,30,0,30,0
1713321126971,CSE 190,A00,516828,Dubnov; Shlomo,38,0,49,11
1713321127996,DOC 100D,A00,489667,Pass; Natalye Joann,19,0,25,6
1713321129021,DSC 10,A01,624268,Staff,72,0,75,3
1713321130045,DSC 20,A01,624476,Staff,50,0,50,0
1713321131073,DSC 40A,A01,624608,Staff,39,0,40,1
1713321132101,DSGN 1,A01,489179,Rill; Bryan,36,0,50,14
1713321133127,ECE 17,A01,490489,Sahay; Rajeev,18,0,30,12
1713321134155,ECE 65,A50,490492,Staff,14,0,20,6
1713321134155,ECE 65,A51,490493,Staff,20,0,20,0
1713321135182,ECON 1,A01,489715,Famulari; Melissa,68,0,70,2
1713321136207,ECON 2,A01,489717,Levkoff; Steven B.,68,0,70,2
1713321137234,ECON 3,A01,489948,Staff,70,0,70,0
1713321139291,ECON 5,A01,490103,Staff,27,0,30,3
1713321139291,ECON 5,B01,626281,Dai; Yinlin,45,0,45,0
1713321140321,ECON 100A,A01,490127,Famulari; Melissa,66,0,70,4
1713321141350,ECON 100B,A01,490129,Staff,64,0,70,6
1713321142377,ECON 109,A01,490187,Shishkin; Denis,27,0,35,8
1713321143402,ECON 110A,A01,490190,Levkoff; Steven B.,60,0,70,10
1713321144431,ECON 120A,A01,490245,Dai; Yinlin,62,0,70,8
1713321145459,ECON 120B,A01,490247,Nieto-Barthaburu; Augusto,48,0,70,22
1713321146487,ECON 120C,A01,490253,Sun; Yixiao,30,0,35,5
1713321146487,ECON 120C,B01,490255,Sun; Yixiao,34,0,35,1
1713321147511,ECON 129,A00,490256,Eckert; Fabian Paul,24,0,35,11
1713321148536,ECON 131,A00,490257,Nieto-Barthaburu; Augusto,0,6,35,35
1713321149561,ECON 138,A00,490258,Bharadwaj; Prashant,17,0,35,18
1713321149561,ECON 138,B00,490259,Bharadwaj; Prashant,16,0,35,19
1713321150586,ECON 159,A00,490260,Hendrickson; Gerald M.,0,8,0,0
1713321151615,ECON 178,A01,553995,Zhu; Ying,24,0,35,11
1713321152695,EDS 40,A01,512576,Black; Alison Michelle,20,0,20,0
1713321153720,EDS 107,A01,515848,Staff,30,0,30,0
1713321154745,EDS 110R,A01,490262,Staff,26,0,30,4
1713321155774,EDS 112,A01,490264,Chapman; Thandeka K,41,0,50,9
1713321156799,EDS 113,A00,490266,Staff,26,0,30,4
1713321157827,EDS 118,A00,490267,Warstadt; Melissa Fawn,21,0,30,9
1713321158854,EDS 124BR,A00,490268,Eguchi; Emi,4,0,25,21
1713321158854,EDS 124BR,B00,490269,Eguchi; Emi,25,0,25,0
1713321159881,EDS 126,A01,490271,Jones; Makeba,44,0,50,6
1713321160906,EDS 135,A01,490316,Staff,19,0,20,1
1713321161935,ENVR 142GS,A00,519514,Chang; Edmond Yi-Teh,27,0,28,1
1713321162961,ETHN 103,A00,490504,Staff,27,0,36,9
1713321163989,ETHN 103A,A00,490505,Man; Simeon S,5,0,9,4
1713321165014,ETHN 109,A00,490506,Staff,30,0,30,0
1713321166043,ETHN 118,A00,490507,Staff,35,0,36,1
1713321167070,ETHN 119,A00,490508,Staff,34,0,36,2
1713321168095,ETHN 121R,A00,490518,Choi; Esther Min,25,0,36,11
1713321169119,ETHN 127,A00,490528,Staff,15,0,15,0
1713321170145,ETHN 139,A00,490573,Staff,10,0,10,0
1713321171169,ETHN 150,A00,490575,Staff,15,0,15,0
1713321172192,GLBH 20,A00,491705,Elwardani; Nile Regina,38,0,40,2
1713321173216,GLBH 101,A00,491706,Staff,20,0,20,0
1713321174244,GLBH 111,A01,491708,Burgos; Jose L.,15,0,15,0
1713321175272,GLBH 146,A00,491709,Staff,11,0,20,9
1713321176299,GLBH 148,A00,491710,Olivas Hernandez; Olga Lid,13,0,20,7
1713321177322,GLBH 150,A00,491711,Sloane; Julia Kathryn,20,0,20,0
1713321178348,HIEA 131,A00,491760,Staff,29,0,32,3
1713321179376,HIEA 153,A00,491762,Staff,29,0,30,1
1713321180402,HIEU 124,A00,491811,Staff,26,0,32,6
1713321181430,HIEU 124GS,A00,491812,Markman; Kristina,27,0,28,1
1713321182456,HIEU 147,A00,491813,Staff,30,0,32,2
1713321183484,HIEU 149GS,A00,491816,Caldwell; Michael Alan,28,0,28,0
1713321184515,HILD 2C,A01,491713,Hendrickson; Gerald M.,27,0,30,3
1713321185540,HILD 7B,A01,491715,Kwak; Nancy,2,0,30,28
1713321186567,HILD 10,A01,491717,Staff,13,0,20,7
1713321187591,HILD 30GS,A00,491719,Edington; Claire Ellen,24,0,28,4
1713321188620,HINE 109,A00,491818,Shafir; Nir,27,0,32,5
1713321189643,HINE 128,A00,491821,Shafir; Nir,31,0,32,1
1713321190670,HISC 117,A00,491830,Staff,28,0,32,4
1713321191699,HIUS 103,A00,491834,Man; Simeon S,15,0,23,8
1713321192727,HIUS 108B,A00,491835,Staff,28,0,30,2
1713321193753,HIUS 141,A00,491836,Hendrickson; Gerald M.,29,0,32,3
1713321194779,HIUS 149,A00,491839,Staff,27,0,32,5
1713321195803,HUM 3,A01,512617,Crum; Matthew Stephen,44,0,50,6
1713321195803,HUM 3,A02,512618,Crum; Matthew Stephen,48,0,50,2
1713321196828,HUM 3GS,A00,512663,Markman; Kristina,0,0,0,1
1713321196828,HUM 3GS,B00,512664,Staff,0,0,0,0
1713321197853,HUM 4,A01,512620,West; Geoffrey Scott,30,0,50,20
1713321198878,HUM 4GS,A00,512666,Lyon; Antony J.,0,0,0,4
1713321199902,HUM 4R,A01,512625,Watkins; Eric,49,0,50,1
1713321200933,HUM 5,A01,512649,Zavodny; Tatiana Sophia,27,0,50,23
1713321200933,HUM 5,B01,512661,Zroka; Ryan Edward,48,0,50,2
1713321201960,INTL 190,A00,490577,Segui; Alan S,0,0,0,5
1713321202987,JAPN 20AR,A01,491267,Ross; Kayoko F,8,0,20,12
1713321204012,JAPN 180,A00,491285,Berman; Michael David,33,0,40,7
1713321205038,LATI 50,A01,502536,Kokinis; Troy Andreas,16,0,22,6
1713321205038,LATI 50,A02,502551,Kokinis; Troy Andreas,22,0,22,0
1713321205038,LATI 50,A03,502650,Kokinis; Troy Andreas,22,0,22,0
1713321205038,LATI 50,A04,502909,Kokinis; Troy Andreas,22,0,22,0
1713321206064,LATI 160,A01,502920,Kokinis; Troy Andreas,30,0,30,0
1713321207090,LIFR 1A,A00,490494,Van Moer; Vinciane G,17,0,20,3
1713321208119,LIFR 1AX,A00,490495,Van Moer; Vinciane G,17,0,20,3
1713321209148,LIFR 1B,A00,490496,Van Moer; Vinciane G,18,0,20,2
1713321210174,LIFR 1BX,A00,490497,Van Moer; Vinciane G,18,0,20,2
1713321211200,LIGN 8,A00,505198,McIntosh; Justin Daniel,135,0,150,15
1713321212226,LIGN 9GS,A00,491239,Lott; Margaret S.,18,0,20,2
1713321213250,LIGN 101,A01,505200,McIntosh; Justin Daniel,24,0,30,6
1713321214275,LIGN 120,A01,491244,Staff,24,0,30,6
1713321215300,LIGN 149GS,A00,491245,Lott; Margaret S.,18,0,20,2
1713321216326,LIGN 170,A00,491247,Staff,23,0,30,7
1713321217350,LISP 1D,A00,490498,Munoz Sanchez; Alicia,10,0,14,4
1713321217350,LISP 1D,B00,490499,Munoz Sanchez; Alicia,6,0,14,8
1713321217350,LISP 1D,C00,490500,Munoz Sanchez; Alicia,8,0,14,6
1713321217350,LISP 1D,D00,490501,Munoz Sanchez; Alicia,10,0,14,4
1713321218376,LISP 1DX,A00,490502,Munoz Sanchez; Alicia,15,0,28,13
1713321218376,LISP 1DX,B00,490503,Munoz Sanchez; Alicia,17,0,28,11
1713321220425,LTAM 110,A00,491847,Staff,23,0,25,2
1713321221451,LTCS 119,A00,491848,Staff,11,0,15,4
1713321222476,LTCS 130,A00,491849,Staff,24,0,25,1
1713321224527,LTEA 120C,A00,491852,Staff,32,0,40,8
1713321225554,LTEN 130GS,A00,491853,Lyon; Antony J.,24,0,28,4
1713321226580,LTEN 148,A00,491855,Staff,23,0,25,2
1713321227606,LTEN 159,A00,491856,Staff,21,0,25,4
1713321228631,LTEN 180,A00,491857,Staff,8,0,15,7
1713321230681,LTSP 123GS,A00,505928,Bessett; Ryan Matthew,24,0,28,4
1713321231707,LTSP 174GS,A00,506037,Bessett; Ryan Matthew,24,0,28,4
1713321233761,LTWR 102,A00,491861,Staff,9,0,15,6
1713321234789,LTWR 106,A00,491862,Staff,10,0,15,5
1713321235818,MAE 11,A00,490930,Bahadori; Mohammad Yousef,96,0,100,4
1713321236842,MAE 30A,A00,490931,Qi; Huihui,37,0,40,3
1713321237867,MAE 101A,A00,491036,Sadeghizadeh; Zahra,96,0,100,4
1713321238896,MAE 101C,A00,491037,Seshadri; Kalyanasundaram,72,0,100,28
1713321240034,MAE 113,A00,491040,Seshadri; Kalyanasundaram,66,0,80,14
1713321241057,MAE 131A,A00,491041,Ghazinejad; Maziar,38,0,40,2
1713321242083,MAE 142,A00,491053,Staff,39,0,40,1
1713321243109,MAE 143A,A00,491054,Staff,34,0,50,16
1713321244137,MAE 150,A00,491092,Truong; Phuong Thi Ngoc,23,0,35,12
1713321245163,MATH 3C,A01,494031,Pardo Guerra; Sebastian,30,0,30,0
1713321245163,MATH 3C,A02,494032,Pardo Guerra; Sebastian,29,0,30,1
1713321246190,MATH 10A,A01,494034,Staff,27,0,30,3
1713321246190,MATH 10A,A02,494035,Staff,28,0,30,2
1713321246190,MATH 10A,B01,494037,Staff,27,0,30,3
1713321246190,MATH 10A,B02,494038,Staff,29,0,30,1
1713321247216,MATH 10B,A01,494040,Habib; Yousaf,22,0,30,8
1713321247216,MATH 10B,A02,494041,Habib; Yousaf,28,0,30,2
1713321247216,MATH 10B,A03,494042,Habib; Yousaf,29,0,30,1
1713321247216,MATH 10B,A04,494043,Habib; Yousaf,30,0,30,0
1713321247216,MATH 10B,B01,494045,Habib; Yousaf,27,0,30,3
1713321247216,MATH 10B,B02,494046,Habib; Yousaf,30,0,30,0
1713321247216,MATH 10B,B03,494047,Habib; Yousaf,30,0,30,0
1713321247216,MATH 10B,B04,494048,Habib; Yousaf,30,0,30,0
1713321248242,MATH 18,A01,494050,Kemp; Todd Aahron,25,0,30,5
1713321248242,MATH 18,A02,494051,Kemp; Todd Aahron,29,0,30,1
1713321248242,MATH 18,B01,494054,Kemp; Todd Aahron,27,0,30,3
1713321248242,MATH 18,B02,494055,Kemp; Todd Aahron,29,0,30,1
1713321249266,MATH 20A,A01,494059,Suk; Andrew Hoon,30,0,30,0
1713321250293,MATH 20B,A01,494061,Briones; Jor-el Thomas Caparas,33,0,35,2
1713321250293,MATH 20B,B01,494063,Bach; Quang Tran,34,0,35,1
1713321251326,MATH 20C,A01,494065,Staff,28,0,30,2
1713321251326,MATH 20C,A02,494066,Staff,30,0,30,0
1713321251326,MATH 20C,A03,494067,Staff,30,0,30,0
1713321251326,MATH 20C,A04,494068,Staff,30,0,30,0
1713321251326,MATH 20C,B01,494070,Zhang; Ming,26,0,30,4
1713321251326,MATH 20C,B02,494071,Zhang; Ming,28,0,30,2
1713321251326,MATH 20C,B03,494072,Zhang; Ming,29,0,30,1
1713321251326,MATH 20C,B04,494073,Zhang; Ming,29,0,30,1
1713321252355,MATH 20D,A01,494075,Staff,22,0,30,8
1713321252355,MATH 20D,A02,494076,Staff,30,0,30,0
1713321253383,MATH 20E,A01,494079,Staff,24,0,30,6
1713321253383,MATH 20E,A02,494080,Staff,26,0,30,4
1713321253383,MATH 20E,B01,494082,Staff,25,0,30,5
1713321253383,MATH 20E,B02,494083,Staff,25,0,30,5
1713321254408,MATH 103A,A01,494085,Aliabadi Sr.; Mohsen,14,0,30,16
1713321254408,MATH 103A,A02,494086,Aliabadi Sr.; Mohsen,28,0,30,2
1713321254408,MATH 103A,B01,494088,Aliabadi Sr.; Mohsen,22,0,30,8
1713321254408,MATH 103A,B02,494089,Aliabadi Sr.; Mohsen,28,0,30,2
1713321255437,MATH 109,A01,494091,Staff,30,0,30,0
1713321255437,MATH 109,A02,494092,Staff,29,0,30,1
1713321255437,MATH 109,B01,494094,Staff,27,0,30,3
1713321255437,MATH 109,B02,494095,Staff,29,0,30,1
1713321256518,MATH 142A,A01,494097,Chow; Bennett,16,0,30,14
1713321256518,MATH 142A,A02,494098,Chow; Bennett,24,0,30,6
1713321256518,MATH 142A,B01,494100,Chow; Bennett,19,0,30,11
1713321256518,MATH 142A,B02,494101,Chow; Bennett,29,0,30,1
1713321258574,MATH 168A,A01,516677,Dumitriu; Ioana,15,0,35,20
1713321259599,MATH 170A,A01,516679,Dumitriu; Ioana,19,0,30,11
1713321259599,MATH 170A,A02,516680,Dumitriu; Ioana,28,0,30,2
1713321260624,MATH 193A,A01,494107,Staff,15,0,30,15
1713321260624,MATH 193A,A02,494108,Staff,21,0,30,9
1713321260624,MATH 193A,A03,494109,Staff,29,0,30,1
1713321260624,MATH 193A,A04,494110,Staff,22,0,30,8
1713321263700,MGT 16,A00,491930,McKay; Michael J,91,0,98,7
1713321264724,MGT 18,A00,491992,McKay; Michael J,97,0,98,1
1713321265749,MGT 71,A00,492003,Staff,68,0,98,30
1713321266773,MGT 103,A00,505209,Eberhard; Craig A,81,0,98,17
1713321267801,MGT 131A,A00,505210,Anderson; John Charles,90,0,98,8
1713321269855,MGT 153,A00,492077,Perols; Johan Lars,23,0,90,67
1713321272934,MGT 164,A00,492222,McKay; Mary A,92,0,98,6
1713321273965,MGT 172,A00,492245,Staff,59,0,60,1
1713321273965,MGT 172,B00,505526,Hedges; Kathleen,68,0,98,30
1713321274990,MGT 181,A00,505669,Dunn; Louis Jean,84,0,98,14
1713321276016,MMW 14,A01,494399,Staff,20,0,28,8
1713321276016,MMW 14,A02,494400,Staff,25,0,28,3
1713321276016,MMW 14,A03,494401,Staff,28,0,28,0
1713321276016,MMW 14,A04,494402,Staff,28,0,28,0
1713321276016,MMW 14,B01,494404,Carreras; Maria Victoria,12,0,28,16
1713321276016,MMW 14,B02,494405,Carreras; Maria Victoria,26,0,28,2
1713321276016,MMW 14,B03,494406,Carreras; Maria Victoria,27,0,28,1
1713321276016,MMW 14,B04,494407,Carreras; Maria Victoria,28,0,28,0
1713321277041,MMW 14GS,A00,506250,Chang; Edmond Yi-Teh,0,0,0,0
1713321278066,MMW 121R,A01,494415,Adamiak; Patrick John,12,0,28,16
1713321278066,MMW 121R,A02,494416,Adamiak; Patrick John,24,0,28,4
1713321279092,MUS 1A,A01,494113,Staff,12,0,25,13
1713321279092,MUS 1A,A02,494114,Staff,24,0,25,1
1713321280117,MUS 4,A01,494116,Staff,24,0,25,1
1713321280117,MUS 4,A02,494117,Staff,22,0,25,3
1713321281145,MUS 5R,A01,494236,Dubnov; Shlomo,9,0,25,16
1713321281145,MUS 5R,A02,494237,Dubnov; Shlomo,25,0,25,0
1713321282169,MUS 6,A01,494122,Staff,11,0,25,14
1713321282169,MUS 6,A02,494123,Staff,24,0,25,1
1713321283194,MUS 7,A01,494125,Staff,16,0,25,9
1713321283194,MUS 7,A02,494126,Staff,24,0,25,1
1713321284217,MUS 11,A01,494128,Staff,23,0,25,2
1713321284217,MUS 11,A02,494129,Staff,24,0,25,1
1713321285244,MUS 13,A01,494131,Staff,25,0,25,0
1713321285244,MUS 13,A02,494132,Staff,25,0,25,0
1713321286272,MUS 15,A01,494134,Staff,17,0,25,8
1713321286272,MUS 15,A02,494135,Staff,25,0,25,0
1713321286272,MUS 15,B01,494137,Staff,24,0,25,1
1713321287296,MUS 80,A00,494232,Staff,24,0,25,1
1713321287296,MUS 80,B00,494233,Staff,25,0,25,0
1713321287296,MUS 80,C00,494234,Staff,23,0,25,2
1713321288322,MUS 95C,A00,494141,Staff,71,0,75,4
1713321289350,MUS 114,A00,494142,Staff,40,0,50,10
1713321290377,NANO 15,A01,490636,Drews; Aaron,7,0,7,0
1713321291404,PHIL 1,A00,490578,Grush; Rick Scott,49,0,50,1
1713321292430,PHIL 10,A01,490580,Grush; Rick Scott,33,0,35,2
1713321292430,PHIL 10,A02,490586,Grush; Rick Scott,33,0,35,2
1713321293456,PHIL 27,A01,490591,Staff,23,0,25,2
1713321293456,PHIL 27,A02,490592,Staff,25,0,25,0
1713321293456,PHIL 27,A03,490593,Staff,25,0,25,0
1713321293456,PHIL 27,A04,490598,Staff,25,0,25,0
1713321294483,PHIL 32,A01,490611,Staff,20,0,20,0
1713321294483,PHIL 32,A02,490618,Staff,20,0,20,0
1713321295509,PHIL 90,A00,490624,Staff,40,0,40,0
1713321296537,PHIL 136,A00,490627,Cohen; Jonathan David,37,0,40,3
1713321297563,PHIL 155,A00,490634,Staff,63,0,70,7
1713321298588,PHYS 1A,A00,491610,Staff,246,0,250,4
1713321299613,PHYS 1AL,001,491616,Tsai; Philbert S,28,0,30,2
1713321299613,PHYS 1AL,002,491618,Tsai; Philbert S,30,0,30,0
1713321300642,PHYS 1B,A00,491623,Staff,242,0,250,8
1713321301670,PHYS 1BL,001,491626,Tsai; Philbert S,25,0,30,5
1713321301670,PHYS 1BL,002,491628,Tsai; Philbert S,27,0,30,3
1713321302698,PHYS 1C,A00,491632,Staff,220,0,245,25
1713321303726,PHYS 1CL,001,491635,Tsai; Philbert S,9,0,30,21
1713321303726,PHYS 1CL,002,491643,Tsai; Philbert S,23,0,30,7
1713321304755,PHYS 2AR,A01,491651,Meyertholen; Andrew D.,44,0,50,6
1713321305784,PHYS 2B,A01,491659,Staff,105,0,115,10
1713321306807,PHYS 2BL,A01,491685,Staff,21,0,24,3
1713321306807,PHYS 2BL,A02,491700,Staff,23,0,24,1
1713321307834,PHYS 2C,A01,505161,Staff,106,0,115,9
1713321308858,PHYS 4A,A01,491704,Grinstein; Benjamin,99,0,100,1
1713321309887,POLI 5D,A01,494144,Staff,3,0,5,2
1713321309887,POLI 5D,B01,626283,Dai; Yinlin,5,0,5,0
1713321310912,POLI 12,A00,494145,Staff,44,0,45,1
1713321311935,POLI 13R,A00,494146,Forman; Fonna,45,0,50,5
1713321312963,POLI 27,A01,494148,Staff,57,0,60,3
1713321313986,POLI 30,A00,494149,Staff,49,0,50,1
1713321315014,POLI 100DA,A00,494150,Staff,21,0,25,4
1713321317067,POLI 100I,A00,494152,Staff,28,0,30,2
1713321318094,POLI 104B,A00,494153,Smith; Glenn Chatmas,53,0,55,2
1713321319122,POLI 104F,A00,494154,Staff,28,0,30,2
1713321320151,POLI 104I,A00,494155,Smith; Glenn Chatmas,30,0,30,0
1713321321177,POLI 110C,A00,494156,Ingham; Sean,23,0,25,2
1713321322206,POLI 117R,A00,494157,Forman; Fonna,8,0,20,12
1713321323231,POLI 118,A00,494158,Ingham; Sean,22,0,25,3
1713321324256,POLI 120H,A00,494159,Fisk; David Lee,40,0,45,5
1713321325283,POLI 131CR,A00,494160,Hoston; Germaine,36,0,45,9
1713321326308,POLI 133J,A00,494161,Staff,33,0,35,2
1713321327332,POLI 135,A00,494162,Fisk; David Lee,33,0,35,2
1713321328361,POLI 140A,A00,494164,Staff,21,0,30,9
1713321329387,POLI 142I,A00,494165,Staff,30,0,30,0
1713321330415,POLI 144D,A00,494166,Staff,23,0,25,2
1713321331444,POLI 151,A00,494167,Staff,30,0,30,0
1713321332471,POLI 153,A00,494168,Staff,33,0,35,2
1713321333500,POLI 160AA,A00,494169,Staff,35,0,40,5
1713321334530,POLI 162,A00,494170,Mignozzetti; Umberto,19,0,25,6
1713321335554,POLI 171,A00,494171,Mignozzetti; Umberto,21,0,25,4
1713321336583,PSYC 1,A00,494172,Staff,97,0,100,3
1713321337608,PSYC 2,A00,494173,Moranton; Nirelia Melbina-,40,0,50,10
1713321338635,PSYC 3,A00,494174,Staff,29,0,30,1
1713321339664,PSYC 6,A00,494175,Staff,17,0,20,3
1713321340693,PSYC 60,A01,494177,Staff,38,0,45,7
1713321341718,PSYC 70,A01,505724,Geller; Emma Harlan,42,0,45,3
1713321342746,PSYC 101,A00,494180,Heyman; Gail D.,84,0,100,16
1713321343774,PSYC 105,A00,494181,Geller; Emma Harlan,58,0,90,32
1713321344799,PSYC 106,A00,494182,Dobkins; Karen R.,29,0,45,16
1713321345828,PSYC 108,A00,494183,Adrian; Julia Anna,91,0,100,9
1713321346854,PSYC 114,A01,494185,Winkielman; Piotr,0,0,30,30
1713321347882,PSYC 122,A00,494186,Moranton; Nirelia Melbina-,32,0,50,18
1713321348907,PSYC 124,A00,494187,Chapman; Eddie Nathaniel,71,0,80,9
1713321349930,PSYC 131,A00,494188,Anagnostaras; Stephan,49,0,80,31
1713321350958,PSYC 144,A00,494189,Staff,10,0,50,40
1713321351982,PSYC 154,A00,494190,Lacefield; Katharine I,119,0,180,61
1713321353008,PSYC 162,A00,494191,Wixted; John T,75,0,100,25
1713321354034,PSYC 172,A00,494192,Gorman; Michael R.,36,0,45,9
1713321355059,PSYC 178,A00,494193,Glaser; Dale,34,0,45,11
1713321356084,PSYC 193,A00,505725,Chapman; Eddie Nathaniel,20,0,20,0
1713321357108,RELI 145GS,A00,519817,Rahimi; Babak,18,0,20,2
1713321358135,SE 101A,A01,490862,Chadha; Mayank,23,0,25,2
1713321359164,SE 101C,A01,490924,Krysl; Petr,16,0,20,4
1713321360242,SE 110A,A01,490928,Staff,19,0,20,1
1713321361271,SE 130A,A00,490929,Morrison; Machel Leigh,58,0,70,12
1713321362296,SIO 1,A01,519325,Staff,39,0,40,1
1713321363320,SIO 30,A01,519327,Staff,38,0,40,2
1713321364344,SIO 40,A00,519328,Staff,39,0,40,1
1713321365368,SIO 46GS,A00,519819,Cook; Geoffrey W,17,0,25,8
1713321366393,SIO 109R,A00,494197,Forman; Fonna,0,0,20,20
1713321367420,SIO 121GS,A00,519827,Cook; Geoffrey W,17,0,25,8
1713321368446,SIO 132,A01,519330,Staff,38,0,40,2
1713321369470,SIO 133,A01,519397,Staff,37,0,40,3
1713321370499,SIO 139,A00,519396,Kacev; David,31,0,40,9
1713321371525,SOCI 1,A01,494199,Thorpe; Charles Robert,22,0,30,8
1713321371525,SOCI 1,A02,494200,Thorpe; Charles Robert,30,0,30,0
1713321371525,SOCI 1,A03,494201,Thorpe; Charles Robert,29,0,30,1
1713321371525,SOCI 1,A04,494202,Thorpe; Charles Robert,29,0,30,1
1713321371525,SOCI 1,A05,494203,Thorpe; Charles Robert,29,0,30,1
1713321371525,SOCI 1,A06,494204,Thorpe; Charles Robert,30,0,30,0
1713321371525,SOCI 1,A07,494205,Thorpe; Charles Robert,28,0,30,2
1713321372552,SOCI 60,A01,494207,Staff,34,0,40,6
1713321372552,SOCI 60,A02,494208,Staff,39,0,40,1
1713321373580,SOCI 100,A01,494210,Payne; Christine Anna,27,0,30,3
1713321373580,SOCI 100,A02,494211,Payne; Christine Anna,26,0,30,4
1713321374606,SOCI 109M,A00,494212,Staff,20,0,20,0
1713321375634,SOCI 110,A00,494213,Staff,35,0,40,5
1713321377686,SOCI 118E,A00,494215,Ng; Kwai,37,0,40,3
1713321378710,SOCI 125,A00,494216,Calderon-Zaks; Michael Aar,42,0,45,3
1713321379738,SOCI 126,A01,494218,Jones; Makeba,3,0,5,2
1713321380763,SOCI 131,A00,494219,Thorpe; Charles Robert,28,0,30,2
1713321382812,SOCI 135,A00,494221,Payne; Christine Anna,31,0,50,19
1713321383841,SOCI 136E,A00,626690,Ruiz; Jonathan Joseph,25,0,25,0
1713321384865,SOCI 138GS,A00,494222,Navon; Daniel,24,0,28,4
1713321386914,SOCI 145,A00,494224,Staff,41,0,45,4
1713321387939,SOCI 153,A00,494225,Staff,28,0,30,2
1713321388964,SOCI 160E,A00,494226,Ng; Kwai,30,0,40,10
1713321389987,SOCI 180,A00,494227,Staff,29,0,30,1
1713321391012,SOCI 189GS,A00,494228,Ribas Norris; Janet Vanesa,11,0,11,0
1713321392043,SOCI 190GS,A00,553232,Ribas Norris; Janet Vanesa,11,0,11,0
1713321393067,SOMI 220,A00,627178,Schneid; Stephen David,30,0,30,0
1713321394092,SYN 2,001,490768,Staff,14,0,15,1
1713321394092,SYN 2,002,490769,Staff,15,0,15,0
1713321394092,SYN 2,004,490775,Staff,0,0,0,0
1713321394092,SYN 2,003,490774,Staff,0,0,0,0
1713321394092,SYN 2,005,490776,Staff,0,0,0,0
1713321395118,SYN 2R,001,490779,Staff,12,0,15,3
1713321395118,SYN 2R,002,514635,Staff,14,0,15,1
1713321396146,SYN 100,A01,490783,Staff,14,0,20,6
1713321396146,SYN 100,B01,490787,Staff,10,0,20,10
1713321396146,SYN 100,C01,490789,Staff,11,0,20,9
1713321397171,SYN 150,A00,490817,Staff,14,0,15,1
1713321397171,SYN 150,B00,514610,Staff,15,0,15,0
1713321398196,TDAC 1,A00,492753,Walsh; Kim C.,19,0,20,1
1713321398196,TDAC 1,B00,492754,Harting; Carla Kelso,19,0,20,1
1713321398196,TDAC 1,C00,513995,Salovey; Todd,15,0,20,5
1713321399224,TDAC 101,A00,492766,Harting; Carla Kelso,17,0,20,3
1713321400253,TDAC 102,A00,492768,Basso; Beatrice,19,0,20,1
1713321401278,TDDE 111,A00,492769,Staff,25,0,25,0
1713321402309,TDDE 131,A00,492770,Staff,15,0,15,0
1713321402309,TDDE 131,B00,492771,Staff,15,0,15,0
1713321403334,TDDE 131GS,A00,523716,Guirguis; Mark C,24,0,28,4
1713321404358,TDGE 1,A01,492756,Salovey; Todd,57,0,60,3
1713321405387,TDGE 5,A01,492758,Staff,23,0,25,2
1713321406416,TDGE 10,A00,492759,Fulton; Julia,206,0,220,14
1713321407441,TDGE 11,A00,492760,Castro; Robert Jess,198,0,200,2
1713321409489,TDGE 124,A00,492772,Fulton; Julia,190,0,220,30
1713321410512,TDGE 125,A00,492773,Meyer; Ursula,39,0,50,11
1713321410512,TDGE 125,B00,492774,Staff,49,0,50,1
1713321410512,TDGE 125,C00,523565,Staff,48,0,50,2
1713321411536,TDGE 125GS,A00,523580,Guirguis; Mark C,24,0,28,4
1713321412565,TDGE 127,A00,492775,Havis; Allan,39,0,50,11
1713321413589,TDHT 101,A00,492776,Staff,34,0,35,1
1713321414618,TDMV 1,A00,492762,Caligagan; Maria T.,30,0,30,0
1713321414618,TDMV 1,B00,492763,Arcidiacono; Kristin,25,0,30,5
1713321415646,TDMV 2,A00,492764,Weinberg; Sadie,29,0,30,1
1713321416674,TDMV 3,A00,492765,Mack; Kara Shanai',38,0,40,2
1713321417699,TDMV 138,A00,492777,Mack; Kara Shanai',35,0,40,5
1713321418723,TDMV 140,A00,492778,Lima; Paulo Henrique,40,0,40,0
1713321419751,TDMV 142,A00,492779,Caligagan; Maria T.,34,0,40,6
1713321419751,TDMV 142,B00,492780,Caligagan; Tony,37,0,40,3
1713321420778,TDMV 143,A00,492781,Fyall; Daunte Edward,39,0,40,1
1713321421806,USP 1,A01,492401,Kwak; Nancy,26,0,35,9
1713321422834,USP 2,A01,492453,Hinds; Juli Beth,35,0,35,0
1713321423862,USP 3,A01,492516,Staff,28,0,35,7
1713321424887,USP 4,A00,492522,McTague; Sarah,17,0,25,8
1713321425911,USP 100,A00,492523,Staff,33,0,35,2
1713321426937,USP 101,A00,492524,Staff,13,0,15,2
1713321427967,USP 105,A00,492525,Staff,21,0,25,4
1713321428995,USP 151,A00,492526,Shenkman; Michael Thomas,32,0,35,3
1713321430021,USP 170,A00,492545,Hinds; Juli Beth,33,0,35,2
1713321431047,USP 171GS,A00,492608,Bussell; Mirle Rabinowitz,24,0,28,4
1713321432075,USP 183GS,A00,492613,Peerson; Susan,24,0,28,4
1713321433100,VIS 30,A01,490693,Yoldas; Pinar,19,0,22,3
1713321433100,VIS 30,A02,490694,Yoldas; Pinar,18,0,22,4
1713321434126,VIS 83,A00,490695,Kester; Grant,63,0,75,12
1713321435155,VIS 105D,A00,490696,Staff,22,0,25,3
1713321436178,VIS 124CN,A00,490699,Rose; Jordan M,66,0,75,9
1713321437204,VIS 125GS,A00,511221,Williams; Alena J,21,0,22,1
1713321438228,VIS 128D,A00,490700,Staff,73,0,75,2
1713321439256,VIS 151,A01,490717,Staff,33,0,34,1
1713321439256,VIS 151,A02,490766,Staff,33,0,34,1
1713321440284,VIS 154GS,A00,511972,Williams; Alena J,21,0,22,1
1713321441311,VIS 160A,A00,490767,Stone; Patricia,7,0,10,3
1713321442336,WCWP 10A,A00,490638,Staff,14,0,15,1
1713321442336,WCWP 10A,B00,490640,Staff,15,0,15,0
1713321443364,WCWP 10B,A00,490641,Staff,0,0,0,0
1713321443364,WCWP 10B,B00,490642,Staff,14,0,15,1
1713321443364,WCWP 10B,C00,490644,Staff,13,0,15,2
1713321443364,WCWP 10B,D00,490647,Staff,0,0,0,0
1713321444390,WCWP 100,A00,490655,Staff,0,0,0,0
1713321444390,WCWP 100,B00,490687,Staff,10,0,15,5
1713321446463,ANAR 153,A00,487222,Braswell; Geoffrey E.,54,0,60,6
1713321447489,ANBI 134,A00,487223,Staff,7,0,20,13
1713321448518,ANBI 143GS,A00,487224,Noel; Geoffroy Pierre Jean,18,0,24,6
1713321449543,ANBI 144GS,A00,519548,Noel; Geoffroy Pierre Jean,18,0,24,6
1713321450565,ANSC 101,A00,487225,Staff,19,0,20,1
1713321451589,ANSC 125,A00,487227,Brenner; Suzanne A,39,0,40,1
1713321453644,ANSC 146,A00,487229,Staff,35,0,40,5
1713321454672,ANSC 148,A00,487230,Olivas Hernandez; Olga Lid,39,0,40,1
1713321455700,ANSC 150,A00,504165,Sloane; Julia Kathryn,19,0,20,1
1713321456727,ANSC 180,A00,487232,Staff,14,0,15,1
1713321457755,ANSC 188,A00,627155,Staff,39,0,40,1
1713321458777,ANTH 5,A00,519529,Semendeferi; Ekaterini,15,0,15,0
1713321459801,ANTH 10,A00,487219,Staff,58,0,60,2
1713321460827,ANTH 23,A01,487221,Staff,17,0,20,3
1713321461855,ANTH 102,A00,487233,Wilder; Linnea Lorene,51,0,60,9
1713321462879,ANTH 103,A00,487234,Varma; Saiba,55,0,60,5
1713321463958,ANTH 105,A00,487235,Stewart; Alexander B,55,0,60,5
1713321464984,BENG 100,A01,516685,Taylor Amos; Alyssa C,28,0,30,2
1713321466011,BIBC 102,A01,491316,Flagg; Matthew Paul,23,0,88,65
1713321466011,BIBC 102,A02,491366,Flagg; Matthew Paul,82,0,88,6
1713321467036,BIBC 103,A01,491486,Boumechache; Miyyada,16,0,24,8
1713321467036,BIBC 103,A02,491487,Boumechache; Miyyada,24,0,24,0
1713321468065,BICD 100,A01,516882,Staff,74,0,75,1
1713321468065,BICD 100,A02,516890,Staff,69,0,75,6
1713321469091,BICD 102GS,A00,491488,Lo; Stanley M.,26,0,28,2
1713321470117,BIEB 136GS,A00,516940,Holway; David A. & Shurin; Jonathan,19,0,24,5
1713321471143,BIEB 137GS,A01,517034,Holway; David A. & Shurin; Jonathan,19,0,24,5
1713321472167,BIEB 138GS,A01,491492,Pirino; Giorgia,21,0,28,7
1713321473195,BILD 1,A01,491296,Staff,61,0,63,2
1713321473195,BILD 1,A02,491297,Staff,63,0,63,0
1713321474221,BILD 4,A01,517099,Gonzalez Gamboa; Ivonne,22,0,24,2
1713321474221,BILD 4,A02,517100,Gonzalez Gamboa; Ivonne,24,0,24,0
1713321475247,BILD 60GS,A00,491309,Lo; Stanley M.,26,0,28,2
1713321476270,BIMM 100,A01,517136,Staff,87,0,100,13
1713321477293,BIMM 110,A01,517182,Staff,63,0,100,37
1713321478317,BIMM 120,A01,517228,Pickett; Brooke Elizabeth,34,0,63,29
1713321478317,BIMM 120,A02,517240,Pickett; Brooke Elizabeth,46,0,63,17
1713321479341,BIMM 132GS,A01,491498,Pirino; Giorgia,21,0,28,7
1713321480365,BIMM 143,A01,491589,Bozinovic; Goran,15,0,40,25
1713321481393,BIPN 100,A01,491594,Armour; Jon Christopher,90,0,100,10
1713321482420,BIPN 140,A01,491602,Marino; Marc J,28,0,50,22
1713321484471,CAT 125,A00,515973,Staff,18,0,20,2
1713321485495,CAT 125GS,A00,515974,Rahimi; Babak,17,0,20,3
1713321486523,CAT 125R,A00,515980,Staff,13,0,20,7
1713321486523,CAT 125R,B00,515981,Tosun; Adriana,19,0,20,1
1713321486523,CAT 125R,C00,515987,Hyland; Tina Mae,0,2,20,20
1713321486523,CAT 125R,D00,515988,Bronstein; Phoebe Malan,18,0,20,2
1713321487549,CENG 15,A01,488699,Drews; Aaron,25,0,25,0
1713321488576,CENG 100,A00,505196,Opatkiewicz; Justin Paul,25,0,25,0
1713321489601,CGS 2A,A01,489598,Staff,33,0,35,2
1713321490625,CGS 112,A00,489599,Staff,15,0,15,0
1713321491650,CGS 119,A00,489603,Staff,10,0,10,0
1713321492675,CGS 120,A00,489604,Staff,14,0,15,1
1713321493700,CGS 150,A00,489607,Staff,15,0,15,0
1713321494724,CHEM 6A,A01,488715,Staff,98,0,100,2
1713321495749,CHEM 6B,A01,488719,Piercy; Marc Anthony,100,0,100,0
1713321496773,CHEM 6C,A01,488723,Albizati; Kim F.,94,0,100,6
1713321497798,CHEM 7L,A01,488728,Schurmeier; Kimberly,18,0,24,6
1713321497798,CHEM 7L,A02,488730,Schurmeier; Kimberly,23,0,24,1
1713321497798,CHEM 7L,A03,488734,Schurmeier; Kimberly,22,0,24,2
1713321497798,CHEM 7L,A04,488763,Schurmeier; Kimberly,23,0,24,1
1713321497798,CHEM 7L,B01,488798,Schurmeier; Kimberly,17,0,24,7
1713321497798,CHEM 7L,B02,488801,Schurmeier; Kimberly,23,0,24,1
1713321497798,CHEM 7L,B03,488808,Schurmeier; Kimberly,23,0,24,1
1713321497798,CHEM 7L,B04,488811,Schurmeier; Kimberly,24,0,24,0
1713321498822,CHEM 11,A01,488897,Stallings; Dontarie M,96,0,100,4
1713321499851,CHEM 40A,A01,488913,Albizati; Kim F.,88,0,100,12
1713321500875,CHEM 40B,A01,488920,Weizman; Haim,44,0,50,6
1713321500875,CHEM 40B,A02,488938,Weizman; Haim,45,0,50,5
1713321501904,CHEM 41A,A01,489029,Klosterman; Jeremy K,57,0,60,3
1713321502928,CHEM 41C,A01,500436,Tor; Yitzhak,55,0,60,5
1713321503955,CHEM 43A,A01,500426,Weizman; Haim,0,0,24,24
1713321503955,CHEM 43A,A02,500430,Weizman; Haim,13,0,24,11
1713321503955,CHEM 43A,B01,514041,Klosterman; Jeremy K,15,0,24,9
1713321503955,CHEM 43A,B02,514047,Klosterman; Jeremy K,23,0,24,1
1713321504980,CHEM 108,A01,489140,Jennings; Patricia A.,11,0,24,13
1713321504980,CHEM 108,A02,489142,Jennings; Patricia A.,14,0,24,10
1713321506008,CHEM 114A,A01,489147,Stallings; Dontarie M,74,0,100,26
1713321507032,CHIN 169A,A00,489171,Wang; Xiao,19,0,20,1
1713321509082,COGS 3,A01,518827,Boyle; Mary E. T.,27,0,40,13
1713321510109,COGS 11,A01,489175,Staff,28,0,30,2
1713321511134,COGS 14A,A01,518829,Staff,51,0,60,9
1713321512159,COGS 14B,A01,489177,Hoffman; Drew Ellen,66,0,75,9
1713321513188,COGS 100,A01,489181,Allen; Michael Gordon,64,0,75,11
1713321514214,COGS 101A,A01,489183,Staff,47,0,60,13
1713321515238,COGS 101B,A01,489185,Allen; Michael Gordon,8,0,30,22
1713321516264,COGS 101C,A01,526786,Staff,24,0,30,6
1713321518311,COGS 107A,A01,489189,Boyle; Mary E. T.,19,0,35,16
1713321519340,COGS 107B,A01,627144,Mooshagian; Eric Frederick,60,0,60,0
1713321520366,COGS 118A,A01,489191,Staff,0,40,40,40
1713321522418,COGS 171GS,A01,489194,Pineda; Jaime A,21,0,28,7
1713321523442,COGS 172,A01,489196,Staff,3,0,30,27
1713321524470,COGS 174GS,A01,489264,Pineda; Jaime A,21,0,28,7
1713321525498,COGS 180,A01,627150,Staff,28,0,30,2
1713321526526,COGS 186,A01,489274,Staff,0,1,30,30
1713321527552,COMM 10,A01,489276,Staff,23,0,25,2
1713321527552,COMM 10,A02,489303,Staff,23,0,25,2
1713321528578,COMM 100A,A01,489312,Staff,14,0,25,11
1713321528578,COMM 100A,A02,489313,Staff,24,0,25,1
1713321529604,COMM 106T,A00,512540,Staff,33,0,35,2
1713321530629,COMM 107,A00,489347,Staff,28,0,35,7
1713321531658,COMM 109P,A00,489358,Staff,31,0,35,4
1713321532684,COMM 132,A00,489361,McKenna; Denise,28,0,30,2
1713321533710,COMM 146,A00,489362,Halm; Gavin Patrick,26,0,30,4
1713321534734,COMM 190,A00,489363,Abuelhiga; Soraya Jill,17,0,23,6
1713321535764,CSE 8A,A50,489366,Staff,22,0,25,3
1713321535764,CSE 8A,A51,489367,Staff,24,0,25,1
1713321536793,CSE 11,A01,489398,Cao; Yingjun,79,0,100,21
1713321537820,CSE 12,A01,489487,Staff,43,0,50,7
1713321538845,CSE 20,A01,489497,Staff,48,0,50,2
1713321539873,CSE 21,A01,489517,Braun; Oliver,42,0,50,8
1713321540899,CSE 101,A01,489524,Braun; Oliver,0,27,50,50
1713321541923,CSE 105,A01,512594,Jones; Miles E,74,0,100,26
1713321541923,CSE 105,B01,512598,Jones; Miles E,56,0,100,44
1713321542951,CSE 140,A01,489538,Staff,43,0,50,7
1713321543979,CSE 141,A01,489550,Eldon; John,71,0,100,29
1713321545006,CSE 141L,A01,489571,Eldon; John,69,0,100,31
1713321546035,CSE 151A,A01,489583,Solares; Edwin A,144,0,200,56
1713321547064,CSE 175,A01,510886,Kumar; Rakesh,30,0,30,0
1713321548088,CSE 190,A00,516828,Dubnov; Shlomo,38,0,49,11
1713321549112,DOC 100D,A00,489667,Pass; Natalye Joann,19,0,25,6
1713321550140,DSC 10,A01,624268,Staff,72,0,75,3
1713321551164,DSC 20,A01,624476,Staff,50,0,50,0
1713321552191,DSC 40A,A01,624608,Staff,39,0,40,1
1713321553215,DSGN 1,A01,489179,Rill; Bryan,36,0,50,14
1713321554240,ECE 17,A01,490489,Sahay; Rajeev,18,0,30,12
1713321555263,ECE 65,A50,490492,Staff,14,0,20,6
1713321555263,ECE 65,A51,490493,Staff,19,0,20,1
1713321556289,ECON 1,A01,489715,Famulari; Melissa,68,0,70,2
1713321557314,ECON 2,A01,489717,Levkoff; Steven B.,68,0,70,2
1713321558339,ECON 3,A01,489948,Staff,70,0,70,0
1713321560388,ECON 5,A01,490103,Staff,27,0,30,3
1713321560388,ECON 5,B01,626281,Dai; Yinlin,45,0,45,0
1713321561412,ECON 100A,A01,490127,Famulari; Melissa,66,0,70,4
1713321562436,ECON 100B,A01,490129,Staff,64,0,70,6
1713321563461,ECON 109,A01,490187,Shishkin; Denis,27,0,35,8
1713321564487,ECON 110A,A01,490190,Levkoff; Steven B.,60,0,70,10
1713321565511,ECON 120A,A01,490245,Dai; Yinlin,62,0,70,8
1713321566536,ECON 120B,A01,490247,Nieto-Barthaburu; Augusto,48,0,70,22
1713321567621,ECON 120C,A01,490253,Sun; Yixiao,30,0,35,5
1713321567621,ECON 120C,B01,490255,Sun; Yixiao,34,0,35,1
1713321568647,ECON 129,A00,490256,Eckert; Fabian Paul,24,0,35,11
1713321569672,ECON 131,A00,490257,Nieto-Barthaburu; Augusto,0,6,35,35
1713321570696,ECON 138,A00,490258,Bharadwaj; Prashant,17,0,35,18
1713321570696,ECON 138,B00,490259,Bharadwaj; Prashant,16,0,35,19
1713321571721,ECON 159,A00,490260,Hendrickson; Gerald M.,0,8,0,0
1713321572750,ECON 178,A01,553995,Zhu; Ying,24,0,35,11
1713321573780,EDS 40,A01,512576,Black; Alison Michelle,20,0,20,0
1713321574805,EDS 107,A01,515848,Staff,30,0,30,0
1713321575829,EDS 110R,A01,490262,Staff,26,0,30,4
1713321576852,EDS 112,A01,490264,Chapman; Thandeka K,41,0,50,9
1713321577876,EDS 113,A00,490266,Staff,26,0,30,4
1713321578905,EDS 118,A00,490267,Warstadt; Melissa Fawn,21,0,30,9
1713321579934,EDS 124BR,A00,490268,Eguchi; Emi,4,0,25,21
1713321579934,EDS 124BR,B00,490269,Eguchi; Emi,25,0,25,0
1713321580964,EDS 126,A01,490271,Jones; Makeba,44,0,50,6
1713321581990,EDS 135,A01,490316,Staff,19,0,20,1
1713321583016,ENVR 142GS,A00,519514,Chang; Edmond Yi-Teh,27,0,28,1
1713321584043,ETHN 103,A00,490504,Staff,27,0,36,9
1713321585075,ETHN 103A,A00,490505,Man; Simeon S,5,0,9,4
1713321586101,ETHN 109,A00,490506,Staff,30,0,30,0
1713321587125,ETHN 118,A00,490507,Staff,35,0,36,1
1713321588154,ETHN 119,A00,490508,Staff,33,0,36,3
1713321589180,ETHN 121R,A00,490518,Choi; Esther Min,25,0,36,11
1713321590207,ETHN 127,A00,490528,Staff,15,0,15,0
1713321591233,ETHN 139,A00,490573,Staff,10,0,10,0
1713321592257,ETHN 150,A00,490575,Staff,15,0,15,0
1713321593284,GLBH 20,A00,491705,Elwardani; Nile Regina,38,0,40,2
1713321594313,GLBH 101,A00,491706,Staff,20,0,20,0
1713321595340,GLBH 111,A01,491708,Burgos; Jose L.,15,0,15,0
1713321596369,GLBH 146,A00,491709,Staff,11,0,20,9
1713321597393,GLBH 148,A00,491710,Olivas Hernandez; Olga Lid,13,0,20,7
1713321598416,GLBH 150,A00,491711,Sloane; Julia Kathryn,20,0,20,0
1713321599442,HIEA 131,A00,491760,Staff,29,0,32,3
1713321600468,HIEA 153,A00,491762,Staff,29,0,30,1
1713321601491,HIEU 124,A00,491811,Staff,26,0,32,6
1713321602519,HIEU 124GS,A00,491812,Markman; Kristina,27,0,28,1
1713321603549,HIEU 147,A00,491813,Staff,30,0,32,2
1713321604573,HIEU 149GS,A00,491816,Caldwell; Michael Alan,28,0,28,0
1713321605600,HILD 2C,A01,491713,Hendrickson; Gerald M.,27,0,30,3
1713321606627,HILD 7B,A01,491715,Kwak; Nancy,2,0,30,28
1713321607652,HILD 10,A01,491717,Staff,13,0,20,7
1713321608676,HILD 30GS,A00,491719,Edington; Claire Ellen,24,0,28,4
1713321609703,HINE 109,A00,491818,Shafir; Nir,27,0,32,5
1713321610730,HINE 128,A00,491821,Shafir; Nir,31,0,32,1
1713321611753,HISC 117,A00,491830,Staff,28,0,32,4
1713321612777,HIUS 103,A00,491834,Man; Simeon S,15,0,23,8
1713321613802,HIUS 108B,A00,491835,Staff,28,0,30,2
1713321614828,HIUS 141,A00,491836,Hendrickson; Gerald M.,29,0,32,3
1713321615855,HIUS 149,A00,491839,Staff,27,0,32,5
1713321616886,HUM 3,A01,512617,Crum; Matthew Stephen,44,0,50,6
1713321616886,HUM 3,A02,512618,Crum; Matthew Stephen,48,0,50,2
1713321617914,HUM 3GS,A00,512663,Markman; Kristina,0,0,0,1
1713321617914,HUM 3GS,B00,512664,Staff,0,0,0,0
1713321618937,HUM 4,A01,512620,West; Geoffrey Scott,30,0,50,20
1713321619961,HUM 4GS,A00,512666,Lyon; Antony J.,0,0,0,4
1713321620986,HUM 4R,A01,512625,Watkins; Eric,49,0,50,1
1713321622011,HUM 5,A01,512649,Zavodny; Tatiana Sophia,27,0,50,23
1713321622011,HUM 5,B01,512661,Zroka; Ryan Edward,48,0,50,2
1713321623036,INTL 190,A00,490577,Segui; Alan S,0,0,0,5
1713321624064,JAPN 20AR,A01,491267,Ross; Kayoko F,8,0,20,12
1713321625090,JAPN 180,A00,491285,Berman; Michael David,33,0,40,7
1713321626120,LATI 50,A01,502536,Kokinis; Troy Andreas,16,0,22,6
1713321626120,LATI 50,A02,502551,Kokinis; Troy Andreas,22,0,22,0
1713321626120,LATI 50,A03,502650,Kokinis; Troy Andreas,22,0,22,0
1713321626120,LATI 50,A04,502909,Kokinis; Troy Andreas,22,0,22,0
1713321627143,LATI 160,A01,502920,Kokinis; Troy Andreas,30,0,30,0
1713321628173,LIFR 1A,A00,490494,Van Moer; Vinciane G,17,0,20,3
1713321629202,LIFR 1AX,A00,490495,Van Moer; Vinciane G,17,0,20,3
1713321630228,LIFR 1B,A00,490496,Van Moer; Vinciane G,18,0,20,2
1713321631254,LIFR 1BX,A00,490497,Van Moer; Vinciane G,18,0,20,2
1713321632281,LIGN 8,A00,505198,McIntosh; Justin Daniel,135,0,150,15
1713321633305,LIGN 9GS,A00,491239,Lott; Margaret S.,18,0,20,2
1713321634333,LIGN 101,A01,505200,McIntosh; Justin Daniel,24,0,30,6
1713321635358,LIGN 120,A01,491244,Staff,24,0,30,6
1713321636384,LIGN 149GS,A00,491245,Lott; Margaret S.,18,0,20,2
1713321637438,LIGN 170,A00,491247,Staff,23,0,30,7
1713321638462,LISP 1D,A00,490498,Munoz Sanchez; Alicia,10,0,14,4
1713321638462,LISP 1D,B00,490499,Munoz Sanchez; Alicia,6,0,14,8
1713321638462,LISP 1D,C00,490500,Munoz Sanchez; Alicia,8,0,14,6
1713321638462,LISP 1D,D00,490501,Munoz Sanchez; Alicia,10,0,14,4
1713321639488,LISP 1DX,A00,490502,Munoz Sanchez; Alicia,15,0,28,13
1713321639488,LISP 1DX,B00,490503,Munoz Sanchez; Alicia,17,0,28,11
1713321641538,LTAM 110,A00,491847,Staff,23,0,25,2
1713321642562,LTCS 119,A00,491848,Staff,11,0,15,4
1713321643586,LTCS 130,A00,491849,Staff,24,0,25,1
1713321645641,LTEA 120C,A00,491852,Staff,32,0,40,8
1713321646669,LTEN 130GS,A00,491853,Lyon; Antony J.,24,0,28,4
1713321647693,LTEN 148,A00,491855,Staff,23,0,25,2
1713321648721,LTEN 159,A00,491856,Staff,21,0,25,4
1713321649748,LTEN 180,A00,491857,Staff,8,0,15,7
1713321651804,LTSP 123GS,A00,505928,Bessett; Ryan Matthew,24,0,28,4
1713321652828,LTSP 174GS,A00,506037,Bessett; Ryan Matthew,24,0,28,4
1713321654876,LTWR 102,A00,491861,Staff,9,0,15,6
1713321655901,LTWR 106,A00,491862,Staff,10,0,15,5
1713321656926,MAE 11,A00,490930,Bahadori; Mohammad Yousef,96,0,100,4
1713321657949,MAE 30A,A00,490931,Qi; Huihui,37,0,40,3
1713321658979,MAE 101A,A00,491036,Sadeghizadeh; Zahra,96,0,100,4
1713321660002,MAE 101C,A00,491037,Seshadri; Kalyanasundaram,71,0,100,29
1713321661027,MAE 113,A00,491040,Seshadri; Kalyanasundaram,66,0,80,14
1713321662077,MAE 131A,A00,491041,Ghazinejad; Maziar,37,0,40,3
1713321663110,MAE 142,A00,491053,Staff,39,0,40,1
1713321664135,MAE 143A,A00,491054,Staff,34,0,50,16
1713321665164,MAE 150,A00,491092,Truong; Phuong Thi Ngoc,23,0,35,12
1713321666191,MATH 3C,A01,494031,Pardo Guerra; Sebastian,30,0,30,0
1713321666191,MATH 3C,A02,494032,Pardo Guerra; Sebastian,29,0,30,1
1713321667219,MATH 10A,A01,494034,Staff,27,0,30,3
1713321667219,MATH 10A,A02,494035,Staff,28,0,30,2
1713321667219,MATH 10A,B01,494037,Staff,27,0,30,3
1713321667219,MATH 10A,B02,494038,Staff,29,0,30,1
1713321668248,MATH 10B,A01,494040,Habib; Yousaf,22,0,30,8
1713321668248,MATH 10B,A02,494041,Habib; Yousaf,28,0,30,2
1713321668248,MATH 10B,A03,494042,Habib; Yousaf,29,0,30,1
1713321668248,MATH 10B,A04,494043,Habib; Yousaf,30,0,30,0
1713321668248,MATH 10B,B01,494045,Habib; Yousaf,26,0,30,4
1713321668248,MATH 10B,B02,494046,Habib; Yousaf,30,0,30,0
1713321668248,MATH 10B,B03,494047,Habib; Yousaf,30,0,30,0
1713321668248,MATH 10B,B04,494048,Habib; Yousaf,30,0,30,0
1713321669273,MATH 18,A01,494050,Kemp; Todd Aahron,25,0,30,5
1713321669273,MATH 18,A02,494051,Kemp; Todd Aahron,29,0,30,1
1713321669273,MATH 18,B01,494054,Kemp; Todd Aahron,27,0,30,3
1713321669273,MATH 18,B02,494055,Kemp; Todd Aahron,29,0,30,1
1713321670298,MATH 20A,A01,494059,Suk; Andrew Hoon,30,0,30,0
1713321671379,MATH 20B,A01,494061,Briones; Jor-el Thomas Caparas,33,0,35,2
1713321671379,MATH 20B,B01,494063,Bach; Quang Tran,34,0,35,1
1713321672407,MATH 20C,A01,494065,Staff,28,0,30,2
1713321672407,MATH 20C,A02,494066,Staff,30,0,30,0
1713321672407,MATH 20C,A03,494067,Staff,30,0,30,0
1713321672407,MATH 20C,A04,494068,Staff,30,0,30,0
1713321672407,MATH 20C,B01,494070,Zhang; Ming,26,0,30,4
1713321672407,MATH 20C,B02,494071,Zhang; Ming,28,0,30,2
1713321672407,MATH 20C,B03,494072,Zhang; Ming,29,0,30,1
1713321672407,MATH 20C,B04,494073,Zhang; Ming,29,0,30,1
1713321673434,MATH 20D,A01,494075,Staff,22,0,30,8
1713321673434,MATH 20D,A02,494076,Staff,30,0,30,0
1713321674463,MATH 20E,A01,494079,Staff,24,0,30,6
1713321674463,MATH 20E,A02,494080,Staff,26,0,30,4
1713321674463,MATH 20E,B01,494082,Staff,25,0,30,5
1713321674463,MATH 20E,B02,494083,Staff,25,0,30,5
1713321675491,MATH 103A,A01,494085,Aliabadi Sr.; Mohsen,14,0,30,16
1713321675491,MATH 103A,A02,494086,Aliabadi Sr.; Mohsen,28,0,30,2
1713321675491,MATH 103A,B01,494088,Aliabadi Sr.; Mohsen,22,0,30,8
1713321675491,MATH 103A,B02,494089,Aliabadi Sr.; Mohsen,28,0,30,2
1713321676520,MATH 109,A01,494091,Staff,30,0,30,0
1713321676520,MATH 109,A02,494092,Staff,29,0,30,1
1713321676520,MATH 109,B01,494094,Staff,27,0,30,3
1713321676520,MATH 109,B02,494095,Staff,29,0,30,1
1713321677546,MATH 142A,A01,494097,Chow; Bennett,16,0,30,14
1713321677546,MATH 142A,A02,494098,Chow; Bennett,24,0,30,6
1713321677546,MATH 142A,B01,494100,Chow; Bennett,19,0,30,11
1713321677546,MATH 142A,B02,494101,Chow; Bennett,29,0,30,1
1713321679597,MATH 168A,A01,516677,Dumitriu; Ioana,15,0,35,20
1713321680623,MATH 170A,A01,516679,Dumitriu; Ioana,19,0,30,11
1713321680623,MATH 170A,A02,516680,Dumitriu; Ioana,28,0,30,2
1713321681651,MATH 193A,A01,494107,Staff,15,0,30,15
1713321681651,MATH 193A,A02,494108,Staff,21,0,30,9
1713321681651,MATH 193A,A03,494109,Staff,29,0,30,1
1713321681651,MATH 193A,A04,494110,Staff,22,0,30,8
1713321684728,MGT 16,A00,491930,McKay; Michael J,91,0,98,7
1713321685752,MGT 18,A00,491992,McKay; Michael J,97,0,98,1
1713321686776,MGT 71,A00,492003,Staff,68,0,98,30
1713321687802,MGT 103,A00,505209,Eberhard; Craig A,81,0,98,17
1713321688827,MGT 131A,A00,505210,Anderson; John Charles,90,0,98,8
1713321690878,MGT 153,A00,492077,Perols; Johan Lars,23,0,90,67
1713321693949,MGT 164,A00,492222,McKay; Mary A,92,0,98,6
1713321694973,MGT 172,A00,492245,Staff,59,0,60,1
1713321694973,MGT 172,B00,505526,Hedges; Kathleen,68,0,98,30
1713321696000,MGT 181,A00,505669,Dunn; Louis Jean,84,0,98,14
1713321697029,MMW 14,A01,494399,Staff,20,0,28,8
1713321697029,MMW 14,A02,494400,Staff,25,0,28,3
1713321697029,MMW 14,A03,494401,Staff,28,0,28,0
1713321697029,MMW 14,A04,494402,Staff,28,0,28,0
1713321697029,MMW 14,B01,494404,Carreras; Maria Victoria,12,0,28,16
1713321697029,MMW 14,B02,494405,Carreras; Maria Victoria,26,0,28,2
1713321697029,MMW 14,B03,494406,Carreras; Maria Victoria,27,0,28,1
1713321697029,MMW 14,B04,494407,Carreras; Maria Victoria,28,0,28,0
1713321698053,MMW 14GS,A00,506250,Chang; Edmond Yi-Teh,0,0,0,0
1713321699077,MMW 121R,A01,494415,Adamiak; Patrick John,12,0,28,16
1713321699077,MMW 121R,A02,494416,Adamiak; Patrick John,24,0,28,4
1713321700102,MUS 1A,A01,494113,Staff,12,0,25,13
1713321700102,MUS 1A,A02,494114,Staff,24,0,25,1
1713321701129,MUS 4,A01,494116,Staff,24,0,25,1
1713321701129,MUS 4,A02,494117,Staff,22,0,25,3
1713321702157,MUS 5R,A01,494236,Dubnov; Shlomo,9,0,25,16
1713321702157,MUS 5R,A02,494237,Dubnov; Shlomo,25,0,25,0
1713321703180,MUS 6,A01,494122,Staff,11,0,25,14
1713321703180,MUS 6,A02,494123,Staff,24,0,25,1
1713321704205,MUS 7,A01,494125,Staff,16,0,25,9
1713321704205,MUS 7,A02,494126,Staff,24,0,25,1
1713321705231,MUS 11,A01,494128,Staff,23,0,25,2
1713321705231,MUS 11,A02,494129,Staff,24,0,25,1
1713321706254,MUS 13,A01,494131,Staff,25,0,25,0
1713321706254,MUS 13,A02,494132,Staff,25,0,25,0
1713321707279,MUS 15,A01,494134,Staff,17,0,25,8
1713321707279,MUS 15,A02,494135,Staff,25,0,25,0
1713321707279,MUS 15,B01,494137,Staff,24,0,25,1
1713321708304,MUS 80,A00,494232,Staff,24,0,25,1
1713321708304,MUS 80,B00,494233,Staff,25,0,25,0
1713321708304,MUS 80,C00,494234,Staff,23,0,25,2
1713321709332,MUS 95C,A00,494141,Staff,71,0,75,4
1713321710360,MUS 114,A00,494142,Staff,40,0,50,10
1713321711382,NANO 15,A01,490636,Drews; Aaron,7,0,7,0
1713321712407,PHIL 1,A00,490578,Grush; Rick Scott,49,0,50,1
1713321713436,PHIL 10,A01,490580,Grush; Rick Scott,33,0,35,2
1713321713436,PHIL 10,A02,490586,Grush; Rick Scott,32,0,35,3
1713321714461,PHIL 27,A01,490591,Staff,23,0,25,2
1713321714461,PHIL 27,A02,490592,Staff,25,0,25,0
1713321714461,PHIL 27,A03,490593,Staff,25,0,25,0
1713321714461,PHIL 27,A04,490598,Staff,25,0,25,0
1713321715486,PHIL 32,A01,490611,Staff,20,0,20,0
1713321715486,PHIL 32,A02,490618,Staff,20,0,20,0
1713321716510,PHIL 90,A00,490624,Staff,40,0,40,0
1713321717540,PHIL 136,A00,490627,Cohen; Jonathan David,37,0,40,3
1713321718568,PHIL 155,A00,490634,Staff,63,0,70,7
1713321719594,PHYS 1A,A00,491610,Staff,246,0,250,4
1713321720619,PHYS 1AL,001,491616,Tsai; Philbert S,28,0,30,2
1713321720619,PHYS 1AL,002,491618,Tsai; Philbert S,30,0,30,0
1713321721646,PHYS 1B,A00,491623,Staff,242,0,250,8
1713321722673,PHYS 1BL,001,491626,Tsai; Philbert S,25,0,30,5
1713321722673,PHYS 1BL,002,491628,Tsai; Philbert S,27,0,30,3
1713321723700,PHYS 1C,A00,491632,Staff,219,0,245,26
1713321724726,PHYS 1CL,001,491635,Tsai; Philbert S,9,0,30,21
1713321724726,PHYS 1CL,002,491643,Tsai; Philbert S,24,0,30,6
1713321725751,PHYS 2AR,A01,491651,Meyertholen; Andrew D.,44,0,50,6
1713321726778,PHYS 2B,A01,491659,Staff,105,0,115,10
1713321727807,PHYS 2BL,A01,491685,Staff,21,0,24,3
1713321727807,PHYS 2BL,A02,491700,Staff,21,0,24,3
1713321728832,PHYS 2C,A01,505161,Staff,106,0,115,9
1713321729860,PHYS 4A,A01,491704,Grinstein; Benjamin,99,0,100,1
1713321730888,POLI 5D,A01,494144,Staff,3,0,5,2
1713321730888,POLI 5D,B01,626283,Dai; Yinlin,5,0,5,0
1713321731913,POLI 12,A00,494145,Staff,44,0,45,1
1713321732938,POLI 13R,A00,494146,Forman; Fonna,45,0,50,5
1713321733963,POLI 27,A01,494148,Staff,57,0,60,3
1713321734986,POLI 30,A00,494149,Staff,49,0,50,1
1713321736011,POLI 100DA,A00,494150,Staff,21,0,25,4
1713321738063,POLI 100I,A00,494152,Staff,28,0,30,2
1713321739090,POLI 104B,A00,494153,Smith; Glenn Chatmas,53,0,55,2
1713321740115,POLI 104F,A00,494154,Staff,28,0,30,2
1713321741142,POLI 104I,A00,494155,Smith; Glenn Chatmas,30,0,30,0
1713321742167,POLI 110C,A00,494156,Ingham; Sean,23,0,25,2
1713321743195,POLI 117R,A00,494157,Forman; Fonna,8,0,20,12
1713321744217,POLI 118,A00,494158,Ingham; Sean,22,0,25,3
1713321745245,POLI 120H,A00,494159,Fisk; David Lee,40,0,45,5
1713321746271,POLI 131CR,A00,494160,Hoston; Germaine,36,0,45,9
1713321747295,POLI 133J,A00,494161,Staff,33,0,35,2
1713321748321,POLI 135,A00,494162,Fisk; David Lee,33,0,35,2
1713321749347,POLI 140A,A00,494164,Staff,21,0,30,9
1713321750369,POLI 142I,A00,494165,Staff,30,0,30,0
1713321751397,POLI 144D,A00,494166,Staff,23,0,25,2
1713321752422,POLI 151,A00,494167,Staff,30,0,30,0
1713321753446,POLI 153,A00,494168,Staff,33,0,35,2
1713321754472,POLI 160AA,A00,494169,Staff,35,0,40,5
1713321755498,POLI 162,A00,494170,Mignozzetti; Umberto,19,0,25,6
1713321756522,POLI 171,A00,494171,Mignozzetti; Umberto,21,0,25,4
1713321757552,PSYC 1,A00,494172,Staff,97,0,100,3
1713321758580,PSYC 2,A00,494173,Moranton; Nirelia Melbina-,39,0,50,11
1713321759604,PSYC 3,A00,494174,Staff,29,0,30,1
1713321760629,PSYC 6,A00,494175,Staff,17,0,20,3
1713321761659,PSYC 60,A01,494177,Staff,38,0,45,7
1713321762684,PSYC 70,A01,505724,Geller; Emma Harlan,42,0,45,3
1713321763710,PSYC 101,A00,494180,Heyman; Gail D.,84,0,100,16
1713321764734,PSYC 105,A00,494181,Geller; Emma Harlan,57,0,90,33
1713321765763,PSYC 106,A00,494182,Dobkins; Karen R.,29,0,45,16
1713321766787,PSYC 108,A00,494183,Adrian; Julia Anna,91,0,100,9
1713321767924,PSYC 114,A01,494185,Winkielman; Piotr,0,1,30,30
1713321768951,PSYC 122,A00,494186,Moranton; Nirelia Melbina-,32,0,50,18
1713321769979,PSYC 124,A00,494187,Chapman; Eddie Nathaniel,71,0,80,9
1713321771003,PSYC 131,A00,494188,Anagnostaras; Stephan,49,0,80,31
1713321772031,PSYC 144,A00,494189,Staff,10,0,50,40
1713321773054,PSYC 154,A00,494190,Lacefield; Katharine I,119,0,180,61
1713321774081,PSYC 162,A00,494191,Wixted; John T,75,0,100,25
1713321775159,PSYC 172,A00,494192,Gorman; Michael R.,36,0,45,9
1713321776185,PSYC 178,A00,494193,Glaser; Dale,34,0,45,11
1713321777210,PSYC 193,A00,505725,Chapman; Eddie Nathaniel,20,0,20,0
1713321778235,RELI 145GS,A00,519817,Rahimi; Babak,18,0,20,2
1713321779261,SE 101A,A01,490862,Chadha; Mayank,23,0,25,2
1713321780288,SE 101C,A01,490924,Krysl; Petr,16,0,20,4
1713321781312,SE 110A,A01,490928,Staff,19,0,20,1
1713321782337,SE 130A,A00,490929,Morrison; Machel Leigh,57,0,70,13
1713321783359,SIO 1,A01,519325,Staff,39,0,40,1
1713321784384,SIO 30,A01,519327,Staff,38,0,40,2
1713321785409,SIO 40,A00,519328,Staff,39,0,40,1
1713321786435,SIO 46GS,A00,519819,Cook; Geoffrey W,17,0,25,8
1713321787463,SIO 109R,A00,494197,Forman; Fonna,0,0,20,20
1713321788578,SIO 121GS,A00,519827,Cook; Geoffrey W,17,0,25,8
1713321789604,SIO 132,A01,519330,Staff,38,0,40,2
1713321790628,SIO 133,A01,519397,Staff,37,0,40,3
1713321791655,SIO 139,A00,519396,Kacev; David,31,0,40,9
1713321792687,SOCI 1,A01,494199,Thorpe; Charles Robert,22,0,30,8
1713321792687,SOCI 1,A02,494200,Thorpe; Charles Robert,30,0,30,0
1713321792687,SOCI 1,A03,494201,Thorpe; Charles Robert,29,0,30,1
1713321792687,SOCI 1,A04,494202,Thorpe; Charles Robert,29,0,30,1
1713321792687,SOCI 1,A05,494203,Thorpe; Charles Robert,29,0,30,1
1713321792687,SOCI 1,A06,494204,Thorpe; Charles Robert,30,0,30,0
1713321792687,SOCI 1,A07,494205,Thorpe; Charles Robert,28,0,30,2
1713321793717,SOCI 60,A01,494207,Staff,34,0,40,6
1713321793717,SOCI 60,A02,494208,Staff,39,0,40,1
1713321794746,SOCI 100,A01,494210,Payne; Christine Anna,27,0,30,3
1713321794746,SOCI 100,A02,494211,Payne; Christine Anna,26,0,30,4
1713321795771,SOCI 109M,A00,494212,Staff,20,0,20,0
1713321796797,SOCI 110,A00,494213,Staff,35,0,40,5
1713321798852,SOCI 118E,A00,494215,Ng; Kwai,37,0,40,3
1713321799876,SOCI 125,A00,494216,Calderon-Zaks; Michael Aar,42,0,45,3
1713321800901,SOCI 126,A01,494218,Jones; Makeba,3,0,5,2
1713321801931,SOCI 131,A00,494219,Thorpe; Charles Robert,28,0,30,2
1713321803983,SOCI 135,A00,494221,Payne; Christine Anna,31,0,50,19
1713321805007,SOCI 136E,A00,626690,Ruiz; Jonathan Joseph,25,0,25,0
1713321806036,SOCI 138GS,A00,494222,Navon; Daniel,24,0,28,4
1713321808090,SOCI 145,A00,494224,Staff,41,0,45,4
1713321809114,SOCI 153,A00,494225,Staff,28,0,30,2
1713321810140,SOCI 160E,A00,494226,Ng; Kwai,30,0,40,10
1713321811168,SOCI 180,A00,494227,Staff,29,0,30,1
1713321812195,SOCI 189GS,A00,494228,Ribas Norris; Janet Vanesa,11,0,11,0
1713321813220,SOCI 190GS,A00,553232,Ribas Norris; Janet Vanesa,11,0,11,0
1713321814246,SOMI 220,A00,627178,Schneid; Stephen David,30,0,30,0
1713321815271,SYN 2,001,490768,Staff,14,0,15,1
1713321815271,SYN 2,002,490769,Staff,15,0,15,0
1713321815271,SYN 2,004,490775,Staff,0,0,0,0
1713321815271,SYN 2,003,490774,Staff,0,0,0,0
1713321815271,SYN 2,005,490776,Staff,0,0,0,0
1713321816296,SYN 2R,001,490779,Staff,12,0,15,3
1713321816296,SYN 2R,002,514635,Staff,14,0,15,1
1713321817325,SYN 100,A01,490783,Staff,13,0,20,7
1713321817325,SYN 100,B01,490787,Staff,9,0,20,11
1713321817325,SYN 100,C01,490789,Staff,11,0,20,9
1713321818350,SYN 150,A00,490817,Staff,14,0,15,1
1713321818350,SYN 150,B00,514610,Staff,15,0,15,0
1713321819374,TDAC 1,A00,492753,Walsh; Kim C.,19,0,20,1
1713321819374,TDAC 1,B00,492754,Harting; Carla Kelso,19,0,20,1
1713321819374,TDAC 1,C00,513995,Salovey; Todd,15,0,20,5
1713321820398,TDAC 101,A00,492766,Harting; Carla Kelso,17,0,20,3
1713321821424,TDAC 102,A00,492768,Basso; Beatrice,19,0,20,1
1713321822451,TDDE 111,A00,492769,Staff,25,0,25,0
1713321823478,TDDE 131,A00,492770,Staff,15,0,15,0
1713321823478,TDDE 131,B00,492771,Staff,15,0,15,0
1713321824505,TDDE 131GS,A00,523716,Guirguis; Mark C,24,0,28,4
1713321825529,TDGE 1,A01,492756,Salovey; Todd,57,0,60,3
1713321826556,TDGE 5,A01,492758,Staff,23,0,25,2
1713321827586,TDGE 10,A00,492759,Fulton; Julia,206,0,220,14
1713321828611,TDGE 11,A00,492760,Castro; Robert Jess,198,0,200,2
1713321830664,TDGE 124,A00,492772,Fulton; Julia,189,0,220,31
1713321831691,TDGE 125,A00,492773,Meyer; Ursula,39,0,50,11
1713321831691,TDGE 125,B00,492774,Staff,49,0,50,1
1713321831691,TDGE 125,C00,523565,Staff,48,0,50,2
1713321832716,TDGE 125GS,A00,523580,Guirguis; Mark C,24,0,28,4
1713321833744,TDGE 127,A00,492775,Havis; Allan,38,0,50,12
1713321834769,TDHT 101,A00,492776,Staff,34,0,35,1
1713321835797,TDMV 1,A00,492762,Caligagan; Maria T.,30,0,30,0
1713321835797,TDMV 1,B00,492763,Arcidiacono; Kristin,25,0,30,5
1713321836823,TDMV 2,A00,492764,Weinberg; Sadie,29,0,30,1
1713321837853,TDMV 3,A00,492765,Mack; Kara Shanai',38,0,40,2
1713321838879,TDMV 138,A00,492777,Mack; Kara Shanai',35,0,40,5
1713321839908,TDMV 140,A00,492778,Lima; Paulo Henrique,40,0,40,0
1713321840936,TDMV 142,A00,492779,Caligagan; Maria T.,34,0,40,6
1713321840936,TDMV 142,B00,492780,Caligagan; Tony,37,0,40,3
1713321841961,TDMV 143,A00,492781,Fyall; Daunte Edward,39,0,40,1
1713321842987,USP 1,A01,492401,Kwak; Nancy,26,0,35,9
1713321844017,USP 2,A01,492453,Hinds; Juli Beth,35,0,35,0
1713321845047,USP 3,A01,492516,Staff,28,0,35,7
1713321846070,USP 4,A00,492522,McTague; Sarah,17,0,25,8
1713321847100,USP 100,A00,492523,Staff,32,0,35,3
1713321848123,USP 101,A00,492524,Staff,13,0,15,2
1713321849150,USP 105,A00,492525,Staff,21,0,25,4
1713321850178,USP 151,A00,492526,Shenkman; Michael Thomas,32,0,35,3
1713321851201,USP 170,A00,492545,Hinds; Juli Beth,33,0,35,2
1713321852228,USP 171GS,A00,492608,Bussell; Mirle Rabinowitz,24,0,28,4
1713321853255,USP 183GS,A00,492613,Peerson; Susan,24,0,28,4
1713321854279,VIS 30,A01,490693,Yoldas; Pinar,19,0,22,3
1713321854279,VIS 30,A02,490694,Yoldas; Pinar,18,0,22,4
1713321855307,VIS 83,A00,490695,Kester; Grant,63,0,75,12
1713321856332,VIS 105D,A00,490696,Staff,22,0,25,3
1713321857360,VIS 124CN,A00,490699,Rose; Jordan M,66,0,75,9
1713321858386,VIS 125GS,A00,511221,Williams; Alena J,21,0,22,1
1713321859411,VIS 128D,A00,490700,Staff,73,0,75,2
1713321860438,VIS 151,A01,490717,Staff,33,0,34,1
1713321860438,VIS 151,A02,490766,Staff,33,0,34,1
1713321861461,VIS 154GS,A00,511972,Williams; Alena J,21,0,22,1
1713321862485,VIS 160A,A00,490767,Stone; Patricia,7,0,10,3
1713321863511,WCWP 10A,A00,490638,Staff,14,0,15,1
1713321863511,WCWP 10A,B00,490640,Staff,15,0,15,0
1713321864538,WCWP 10B,A00,490641,Staff,0,0,0,0
1713321864538,WCWP 10B,B00,490642,Staff,14,0,15,1
1713321864538,WCWP 10B,C00,490644,Staff,13,0,15,2
1713321864538,WCWP 10B,D00,490647,Staff,0,0,0,0
1713321865562,WCWP 100,A00,490655,Staff,0,0,0,0
1713321865562,WCWP 100,B00,490687,Staff,10,0,15,5
1713321867665,ANAR 153,A00,487222,Braswell; Geoffrey E.,54,0,60,6
1713321868688,ANBI 134,A00,487223,Staff,7,0,20,13
1713321869715,ANBI 143GS,A00,487224,Noel; Geoffroy Pierre Jean,18,0,24,6
1713321870739,ANBI 144GS,A00,519548,Noel; Geoffroy Pierre Jean,18,0,24,6
1713321871763,ANSC 101,A00,487225,Staff,18,0,20,2
1713321872786,ANSC 125,A00,487227,Brenner; Suzanne A,39,0,40,1
1713321874835,ANSC 146,A00,487229,Staff,35,0,40,5
1713321875860,ANSC 148,A00,487230,Olivas Hernandez; Olga Lid,39,0,40,1
1713321876884,ANSC 150,A00,504165,Sloane; Julia Kathryn,19,0,20,1
1713321877910,ANSC 180,A00,487232,Staff,14,0,15,1
1713321878990,ANSC 188,A00,627155,Staff,39,0,40,1
1713321880019,ANTH 5,A00,519529,Semendeferi; Ekaterini,15,0,15,0
1713321881042,ANTH 10,A00,487219,Staff,58,0,60,2
1713321882070,ANTH 23,A01,487221,Staff,17,0,20,3
1713321883094,ANTH 102,A00,487233,Wilder; Linnea Lorene,51,0,60,9
1713321884123,ANTH 103,A00,487234,Varma; Saiba,55,0,60,5
1713321885148,ANTH 105,A00,487235,Stewart; Alexander B,55,0,60,5
1713321886175,BENG 100,A01,516685,Taylor Amos; Alyssa C,28,0,30,2
1713321887204,BIBC 102,A01,491316,Flagg; Matthew Paul,23,0,88,65
1713321887204,BIBC 102,A02,491366,Flagg; Matthew Paul,81,0,88,7
1713321888227,BIBC 103,A01,491486,Boumechache; Miyyada,16,0,24,8
1713321888227,BIBC 103,A02,491487,Boumechache; Miyyada,24,0,24,0
1713321889252,BICD 100,A01,516882,Staff,74,0,75,1
1713321889252,BICD 100,A02,516890,Staff,69,0,75,6
1713321890277,BICD 102GS,A00,491488,Lo; Stanley M.,26,0,28,2
1713321891302,BIEB 136GS,A00,516940,Holway; David A. & Shurin; Jonathan,19,0,24,5
1713321892331,BIEB 137GS,A01,517034,Holway; David A. & Shurin; Jonathan,19,0,24,5
1713321893360,BIEB 138GS,A01,491492,Pirino; Giorgia,21,0,28,7
1713321894387,BILD 1,A01,491296,Staff,61,0,63,2
1713321894387,BILD 1,A02,491297,Staff,63,0,63,0
1713321895413,BILD 4,A01,517099,Gonzalez Gamboa; Ivonne,22,0,24,2
1713321895413,BILD 4,A02,517100,Gonzalez Gamboa; Ivonne,24,0,24,0
1713321896438,BILD 60GS,A00,491309,Lo; Stanley M.,26,0,28,2
1713321897462,BIMM 100,A01,517136,Staff,87,0,100,13
1713321898488,BIMM 110,A01,517182,Staff,63,0,100,37
1713321899516,BIMM 120,A01,517228,Pickett; Brooke Elizabeth,33,0,63,30
1713321899516,BIMM 120,A02,517240,Pickett; Brooke Elizabeth,45,0,63,18
1713321900544,BIMM 132GS,A01,491498,Pirino; Giorgia,21,0,28,7
1713321901570,BIMM 143,A01,491589,Bozinovic; Goran,14,0,40,26
1713321902593,BIPN 100,A01,491594,Armour; Jon Christopher,90,0,100,10
1713321903624,BIPN 140,A01,491602,Marino; Marc J,27,0,50,23
1713321905679,CAT 125,A00,515973,Staff,18,0,20,2
1713321906705,CAT 125GS,A00,515974,Rahimi; Babak,17,0,20,3
1713321907735,CAT 125R,A00,515980,Staff,13,0,20,7
1713321907735,CAT 125R,B00,515981,Tosun; Adriana,19,0,20,1
1713321907735,CAT 125R,C00,515987,Hyland; Tina Mae,0,2,20,20
1713321907735,CAT 125R,D00,515988,Bronstein; Phoebe Malan,18,0,20,2
1713321908758,CENG 15,A01,488699,Drews; Aaron,25,0,25,0
1713321909787,CENG 100,A00,505196,Opatkiewicz; Justin Paul,25,0,25,0
1713321910812,CGS 2A,A01,489598,Staff,33,0,35,2
1713321911837,CGS 112,A00,489599,Staff,15,0,15,0
1713321912862,CGS 119,A00,489603,Staff,10,0,10,0
1713321913907,CGS 120,A00,489604,Staff,14,0,15,1
1713321914937,CGS 150,A00,489607,Staff,15,0,15,0
1713321915966,CHEM 6A,A01,488715,Staff,98,0,100,2
1713321916992,CHEM 6B,A01,488719,Piercy; Marc Anthony,100,0,100,0
1713321918022,CHEM 6C,A01,488723,Albizati; Kim F.,93,0,100,7
1713321919055,CHEM 7L,A01,488728,Schurmeier; Kimberly,18,0,24,6
1713321919055,CHEM 7L,A02,488730,Schurmeier; Kimberly,23,0,24,1
1713321919055,CHEM 7L,A03,488734,Schurmeier; Kimberly,22,0,24,2
1713321919055,CHEM 7L,A04,488763,Schurmeier; Kimberly,23,0,24,1
1713321919055,CHEM 7L,B01,488798,Schurmeier; Kimberly,17,0,24,7
1713321919055,CHEM 7L,B02,488801,Schurmeier; Kimberly,23,0,24,1
1713321919055,CHEM 7L,B03,488808,Schurmeier; Kimberly,23,0,24,1
1713321919055,CHEM 7L,B04,488811,Schurmeier; Kimberly,24,0,24,0
1713321920083,CHEM 11,A01,488897,Stallings; Dontarie M,96,0,100,4
1713321921106,CHEM 40A,A01,488913,Albizati; Kim F.,87,0,100,13
1713321922132,CHEM 40B,A01,488920,Weizman; Haim,44,0,50,6
1713321922132,CHEM 40B,A02,488938,Weizman; Haim,45,0,50,5
1713321923155,CHEM 41A,A01,489029,Klosterman; Jeremy K,57,0,60,3
1713321924179,CHEM 41C,A01,500436,Tor; Yitzhak,55,0,60,5
1713321925205,CHEM 43A,A01,500426,Weizman; Haim,0,0,24,24
1713321925205,CHEM 43A,A02,500430,Weizman; Haim,13,0,24,11
1713321925205,CHEM 43A,B01,514041,Klosterman; Jeremy K,15,0,24,9
1713321925205,CHEM 43A,B02,514047,Klosterman; Jeremy K,23,0,24,1
1713321926231,CHEM 108,A01,489140,Jennings; Patricia A.,11,0,24,13
1713321926231,CHEM 108,A02,489142,Jennings; Patricia A.,14,0,24,10
1713321927259,CHEM 114A,A01,489147,Stallings; Dontarie M,74,0,100,26
1713321928287,CHIN 169A,A00,489171,Wang; Xiao,19,0,20,1
1713321930341,COGS 3,A01,518827,Boyle; Mary E. T.,27,0,40,13
1713321931369,COGS 11,A01,489175,Staff,28,0,30,2
1713321932395,COGS 14A,A01,518829,Staff,51,0,60,9
1713321933420,COGS 14B,A01,489177,Hoffman; Drew Ellen,65,0,75,10
1713321934445,COGS 100,A01,489181,Allen; Michael Gordon,64,0,75,11
1713321935469,COGS 101A,A01,489183,Staff,47,0,60,13
1713321936494,COGS 101B,A01,489185,Allen; Michael Gordon,8,0,30,22
1713321937521,COGS 101C,A01,526786,Staff,24,0,30,6
1713321939568,COGS 107A,A01,489189,Boyle; Mary E. T.,19,0,35,16
1713321940592,COGS 107B,A01,627144,Mooshagian; Eric Frederick,60,0,60,0
1713321941621,COGS 118A,A01,489191,Staff,0,40,40,40
1713321943676,COGS 171GS,A01,489194,Pineda; Jaime A,21,0,28,7
1713321944706,COGS 172,A01,489196,Staff,3,0,30,27
1713321945731,COGS 174GS,A01,489264,Pineda; Jaime A,21,0,28,7
1713321946758,COGS 180,A01,627150,Staff,28,0,30,2
1713321947785,COGS 186,A01,489274,Staff,0,1,30,30
1713321948810,COMM 10,A01,489276,Staff,23,0,25,2
1713321948810,COMM 10,A02,489303,Staff,23,0,25,2
1713321949834,COMM 100A,A01,489312,Staff,14,0,25,11
1713321949834,COMM 100A,A02,489313,Staff,24,0,25,1
1713321950859,COMM 106T,A00,512540,Staff,33,0,35,2
1713321951887,COMM 107,A00,489347,Staff,28,0,35,7
1713321952913,COMM 109P,A00,489358,Staff,31,0,35,4
1713321953937,COMM 132,A00,489361,McKenna; Denise,28,0,30,2
1713321954964,COMM 146,A00,489362,Halm; Gavin Patrick,26,0,30,4
1713321955989,COMM 190,A00,489363,Abuelhiga; Soraya Jill,17,0,23,6
1713321957016,CSE 8A,A50,489366,Staff,22,0,25,3
1713321957016,CSE 8A,A51,489367,Staff,24,0,25,1
1713321958040,CSE 11,A01,489398,Cao; Yingjun,79,0,100,21
1713321959068,CSE 12,A01,489487,Staff,43,0,50,7
1713321960092,CSE 20,A01,489497,Staff,48,0,50,2
1713321961128,CSE 21,A01,489517,Braun; Oliver,42,0,50,8
1713321962154,CSE 101,A01,489524,Braun; Oliver,0,27,50,50
1713321963179,CSE 105,A01,512594,Jones; Miles E,74,0,100,26
1713321963179,CSE 105,B01,512598,Jones; Miles E,55,0,100,45
1713321964204,CSE 140,A01,489538,Staff,43,0,50,7
1713321965229,CSE 141,A01,489550,Eldon; John,71,0,100,29
1713321966253,CSE 141L,A01,489571,Eldon; John,69,0,100,31
1713321967282,CSE 151A,A01,489583,Solares; Edwin A,144,0,200,56
1713321968310,CSE 175,A01,510886,Kumar; Rakesh,30,0,30,0
1713321969338,CSE 190,A00,516828,Dubnov; Shlomo,38,0,49,11
1713321970363,DOC 100D,A00,489667,Pass; Natalye Joann,19,0,25,6
1713321971389,DSC 10,A01,624268,Staff,72,0,75,3
1713321972415,DSC 20,A01,624476,Staff,50,0,50,0
1713321973442,DSC 40A,A01,624608,Staff,39,0,40,1
1713321974469,DSGN 1,A01,489179,Rill; Bryan,35,0,50,15
1713321975498,ECE 17,A01,490489,Sahay; Rajeev,18,0,30,12
1713321976523,ECE 65,A50,490492,Staff,13,0,20,7
1713321976523,ECE 65,A51,490493,Staff,19,0,20,1
1713321977549,ECON 1,A01,489715,Famulari; Melissa,68,0,70,2
1713321978582,ECON 2,A01,489717,Levkoff; Steven B.,68,0,70,2
1713321979607,ECON 3,A01,489948,Staff,70,0,70,0
1713321981667,ECON 5,A01,490103,Staff,27,0,30,3
1713321981667,ECON 5,B01,626281,Dai; Yinlin,45,0,45,0
1713321982750,ECON 100A,A01,490127,Famulari; Melissa,66,0,70,4
1713321983775,ECON 100B,A01,490129,Staff,64,0,70,6
1713321984801,ECON 109,A01,490187,Shishkin; Denis,27,0,35,8
1713321985826,ECON 110A,A01,490190,Levkoff; Steven B.,60,0,70,10
1713321986857,ECON 120A,A01,490245,Dai; Yinlin,62,0,70,8
1713321987883,ECON 120B,A01,490247,Nieto-Barthaburu; Augusto,48,0,70,22
1713321988914,ECON 120C,A01,490253,Sun; Yixiao,30,0,35,5
1713321988914,ECON 120C,B01,490255,Sun; Yixiao,34,0,35,1
1713321989943,ECON 129,A00,490256,Eckert; Fabian Paul,24,0,35,11
1713321990971,ECON 131,A00,490257,Nieto-Barthaburu; Augusto,0,6,35,35
1713321991995,ECON 138,A00,490258,Bharadwaj; Prashant,16,0,35,19
1713321991995,ECON 138,B00,490259,Bharadwaj; Prashant,16,0,35,19
1713321993019,ECON 159,A00,490260,Hendrickson; Gerald M.,0,8,0,0
1713321994043,ECON 178,A01,553995,Zhu; Ying,24,0,35,11
1713321995070,EDS 40,A01,512576,Black; Alison Michelle,20,0,20,0
1713321996097,EDS 107,A01,515848,Staff,30,0,30,0
1713321997122,EDS 110R,A01,490262,Staff,26,0,30,4
1713321998147,EDS 112,A01,490264,Chapman; Thandeka K,41,0,50,9
1713321999175,EDS 113,A00,490266,Staff,26,0,30,4
1713322000200,EDS 118,A00,490267,Warstadt; Melissa Fawn,21,0,30,9
1713322001227,EDS 124BR,A00,490268,Eguchi; Emi,4,0,25,21
1713322001227,EDS 124BR,B00,490269,Eguchi; Emi,24,0,25,1
1713322002262,EDS 126,A01,490271,Jones; Makeba,44,0,50,6
1713322003286,EDS 135,A01,490316,Staff,19,0,20,1
1713322004315,ENVR 142GS,A00,519514,Chang; Edmond Yi-Teh,27,0,28,1
1713322005340,ETHN 103,A00,490504,Staff,27,0,36,9
1713322006365,ETHN 103A,A00,490505,Man; Simeon S,5,0,9,4
1713322007393,ETHN 109,A00,490506,Staff,29,0,30,1
1713322008420,ETHN 118,A00,490507,Staff,35,0,36,1
1713322009448,ETHN 119,A00,490508,Staff,33,0,36,3
1713322010475,ETHN 121R,A00,490518,Choi; Esther Min,24,0,36,12
1713322011499,ETHN 127,A00,490528,Staff,15,0,15,0
1713322012526,ETHN 139,A00,490573,Staff,10,0,10,0
1713322013555,ETHN 150,A00,490575,Staff,15,0,15,0
1713322014584,GLBH 20,A00,491705,Elwardani; Nile Regina,38,0,40,2
1713322015609,GLBH 101,A00,491706,Staff,20,0,20,0
1713322016634,GLBH 111,A01,491708,Burgos; Jose L.,15,0,15,0
1713322017659,GLBH 146,A00,491709,Staff,11,0,20,9
1713322018683,GLBH 148,A00,491710,Olivas Hernandez; Olga Lid,13,0,20,7
1713322019708,GLBH 150,A00,491711,Sloane; Julia Kathryn,20,0,20,0
1713322020733,HIEA 131,A00,491760,Staff,29,0,32,3
1713322021761,HIEA 153,A00,491762,Staff,29,0,30,1
1713322022785,HIEU 124,A00,491811,Staff,26,0,32,6
1713322023809,HIEU 124GS,A00,491812,Markman; Kristina,27,0,28,1
1713322024837,HIEU 147,A00,491813,Staff,30,0,32,2
1713322025862,HIEU 149GS,A00,491816,Caldwell; Michael Alan,28,0,28,0
1713322026889,HILD 2C,A01,491713,Hendrickson; Gerald M.,27,0,30,3
1713322027920,HILD 7B,A01,491715,Kwak; Nancy,1,0,30,29
1713322028945,HILD 10,A01,491717,Staff,13,0,20,7
1713322029971,HILD 30GS,A00,491719,Edington; Claire Ellen,24,0,28,4
1713322030998,HINE 109,A00,491818,Shafir; Nir,27,0,32,5
1713322032024,HINE 128,A00,491821,Shafir; Nir,31,0,32,1
1713322033049,HISC 117,A00,491830,Staff,27,0,32,5
1713322034073,HIUS 103,A00,491834,Man; Simeon S,15,0,23,8
1713322035102,HIUS 108B,A00,491835,Staff,28,0,30,2
1713322036125,HIUS 141,A00,491836,Hendrickson; Gerald M.,29,0,32,3
1713322037150,HIUS 149,A00,491839,Staff,27,0,32,5
1713322038179,HUM 3,A01,512617,Crum; Matthew Stephen,43,0,50,7
1713322038179,HUM 3,A02,512618,Crum; Matthew Stephen,48,0,50,2
1713322039202,HUM 3GS,A00,512663,Markman; Kristina,0,0,0,1
1713322039202,HUM 3GS,B00,512664,Staff,0,0,0,0
1713322040229,HUM 4,A01,512620,West; Geoffrey Scott,30,0,50,20
1713322041255,HUM 4GS,A00,512666,Lyon; Antony J.,0,0,0,4
1713322042287,HUM 4R,A01,512625,Watkins; Eric,49,0,50,1
1713322043316,HUM 5,A01,512649,Zavodny; Tatiana Sophia,26,0,50,24
1713322043316,HUM 5,B01,512661,Zroka; Ryan Edward,48,0,50,2
1713322044340,INTL 190,A00,490577,Segui; Alan S,0,0,0,5
1713322045367,JAPN 20AR,A01,491267,Ross; Kayoko F,8,0,20,12
1713322046392,JAPN 180,A00,491285,Berman; Michael David,33,0,40,7
1713322047420,LATI 50,A01,502536,Kokinis; Troy Andreas,16,0,22,6
1713322047420,LATI 50,A02,502551,Kokinis; Troy Andreas,22,0,22,0
1713322047420,LATI 50,A03,502650,Kokinis; Troy Andreas,22,0,22,0
1713322047420,LATI 50,A04,502909,Kokinis; Troy Andreas,22,0,22,0
1713322048443,LATI 160,A01,502920,Kokinis; Troy Andreas,30,0,30,0
1713322049467,LIFR 1A,A00,490494,Van Moer; Vinciane G,17,0,20,3
1713322050650,LIFR 1AX,A00,490495,Van Moer; Vinciane G,17,0,20,3
1713322051676,LIFR 1B,A00,490496,Van Moer; Vinciane G,18,0,20,2
1713322052701,LIFR 1BX,A00,490497,Van Moer; Vinciane G,18,0,20,2
1713322053727,LIGN 8,A00,505198,McIntosh; Justin Daniel,135,0,150,15
1713322054753,LIGN 9GS,A00,491239,Lott; Margaret S.,18,0,20,2
1713322055781,LIGN 101,A01,505200,McIntosh; Justin Daniel,24,0,30,6
1713322056809,LIGN 120,A01,491244,Staff,24,0,30,6
1713322057837,LIGN 149GS,A00,491245,Lott; Margaret S.,18,0,20,2
1713322058862,LIGN 170,A00,491247,Staff,23,0,30,7
1713322059886,LISP 1D,A00,490498,Munoz Sanchez; Alicia,10,0,14,4
1713322059886,LISP 1D,B00,490499,Munoz Sanchez; Alicia,6,0,14,8
1713322059886,LISP 1D,C00,490500,Munoz Sanchez; Alicia,8,0,14,6
1713322059886,LISP 1D,D00,490501,Munoz Sanchez; Alicia,10,0,14,4
1713322060912,LISP 1DX,A00,490502,Munoz Sanchez; Alicia,15,0,28,13
1713322060912,LISP 1DX,B00,490503,Munoz Sanchez; Alicia,17,0,28,11
1713322062965,LTAM 110,A00,491847,Staff,23,0,25,2
1713322063989,LTCS 119,A00,491848,Staff,11,0,15,4
1713322065017,LTCS 130,A00,491849,Staff,24,0,25,1
1713322067066,LTEA 120C,A00,491852,Staff,32,0,40,8
1713322068092,LTEN 130GS,A00,491853,Lyon; Antony J.,24,0,28,4
1713322069116,LTEN 148,A00,491855,Staff,23,0,25,2
1713322070141,LTEN 159,A00,491856,Staff,21,0,25,4
1713322071170,LTEN 180,A00,491857,Staff,8,0,15,7
1713322073225,LTSP 123GS,A00,505928,Bessett; Ryan Matthew,24,0,28,4
1713322074250,LTSP 174GS,A00,506037,Bessett; Ryan Matthew,24,0,28,4
1713322076299,LTWR 102,A00,491861,Staff,9,0,15,6
1713322077325,LTWR 106,A00,491862,Staff,10,0,15,5
1713322078354,MAE 11,A00,490930,Bahadori; Mohammad Yousef,96,0,100,4
1713322079379,MAE 30A,A00,490931,Qi; Huihui,37,0,40,3
1713322080406,MAE 101A,A00,491036,Sadeghizadeh; Zahra,96,0,100,4
1713322081430,MAE 101C,A00,491037,Seshadri; Kalyanasundaram,71,0,100,29
1713322082456,MAE 113,A00,491040,Seshadri; Kalyanasundaram,66,0,80,14
1713322083482,MAE 131A,A00,491041,Ghazinejad; Maziar,37,0,40,3
1713322084507,MAE 142,A00,491053,Staff,39,0,40,1
1713322085534,MAE 143A,A00,491054,Staff,34,0,50,16
1713322086614,MAE 150,A00,491092,Truong; Phuong Thi Ngoc,23,0,35,12
1713322087640,MATH 3C,A01,494031,Pardo Guerra; Sebastian,30,0,30,0
1713322087640,MATH 3C,A02,494032,Pardo Guerra; Sebastian,29,0,30,1
1713322088665,MATH 10A,A01,494034,Staff,27,0,30,3
1713322088665,MATH 10A,A02,494035,Staff,28,0,30,2
1713322088665,MATH 10A,B01,494037,Staff,27,0,30,3
1713322088665,MATH 10A,B02,494038,Staff,29,0,30,1
1713322089698,MATH 10B,A01,494040,Habib; Yousaf,22,0,30,8
1713322089698,MATH 10B,A02,494041,Habib; Yousaf,28,0,30,2
1713322089698,MATH 10B,A03,494042,Habib; Yousaf,29,0,30,1
1713322089698,MATH 10B,A04,494043,Habib; Yousaf,30,0,30,0
1713322089698,MATH 10B,B01,494045,Habib; Yousaf,26,0,30,4
1713322089698,MATH 10B,B02,494046,Habib; Yousaf,30,0,30,0
1713322089698,MATH 10B,B03,494047,Habib; Yousaf,30,0,30,0
1713322089698,MATH 10B,B04,494048,Habib; Yousaf,30,0,30,0
1713322090728,MATH 18,A01,494050,Kemp; Todd Aahron,25,0,30,5
1713322090728,MATH 18,A02,494051,Kemp; Todd Aahron,29,0,30,1
1713322090728,MATH 18,B01,494054,Kemp; Todd Aahron,27,0,30,3
1713322090728,MATH 18,B02,494055,Kemp; Todd Aahron,29,0,30,1
1713322091756,MATH 20A,A01,494059,Suk; Andrew Hoon,30,0,30,0
1713322092784,MATH 20B,A01,494061,Briones; Jor-el Thomas Caparas,33,0,35,2
1713322092784,MATH 20B,B01,494063,Bach; Quang Tran,34,0,35,1
1713322093812,MATH 20C,A01,494065,Staff,28,0,30,2
1713322093812,MATH 20C,A02,494066,Staff,30,0,30,0
1713322093812,MATH 20C,A03,494067,Staff,30,0,30,0
1713322093812,MATH 20C,A04,494068,Staff,30,0,30,0
1713322093812,MATH 20C,B01,494070,Zhang; Ming,26,0,30,4
1713322093812,MATH 20C,B02,494071,Zhang; Ming,27,0,30,3
1713322093812,MATH 20C,B03,494072,Zhang; Ming,29,0,30,1
1713322093812,MATH 20C,B04,494073,Zhang; Ming,29,0,30,1
1713322094837,MATH 20D,A01,494075,Staff,22,0,30,8
1713322094837,MATH 20D,A02,494076,Staff,30,0,30,0
1713322095867,MATH 20E,A01,494079,Staff,24,0,30,6
1713322095867,MATH 20E,A02,494080,Staff,26,0,30,4
1713322095867,MATH 20E,B01,494082,Staff,25,0,30,5
1713322095867,MATH 20E,B02,494083,Staff,25,0,30,5
1713322096895,MATH 103A,A01,494085,Aliabadi Sr.; Mohsen,14,0,30,16
1713322096895,MATH 103A,A02,494086,Aliabadi Sr.; Mohsen,28,0,30,2
1713322096895,MATH 103A,B01,494088,Aliabadi Sr.; Mohsen,22,0,30,8
1713322096895,MATH 103A,B02,494089,Aliabadi Sr.; Mohsen,28,0,30,2
1713322097921,MATH 109,A01,494091,Staff,30,0,30,0
1713322097921,MATH 109,A02,494092,Staff,29,0,30,1
1713322097921,MATH 109,B01,494094,Staff,27,0,30,3
1713322097921,MATH 109,B02,494095,Staff,29,0,30,1
1713322098953,MATH 142A,A01,494097,Chow; Bennett,16,0,30,14
1713322098953,MATH 142A,A02,494098,Chow; Bennett,24,0,30,6
1713322098953,MATH 142A,B01,494100,Chow; Bennett,19,0,30,11
1713322098953,MATH 142A,B02,494101,Chow; Bennett,29,0,30,1
1713322101004,MATH 168A,A01,516677,Dumitriu; Ioana,15,0,35,20
1713322102034,MATH 170A,A01,516679,Dumitriu; Ioana,19,0,30,11
1713322102034,MATH 170A,A02,516680,Dumitriu; Ioana,28,0,30,2
1713322103061,MATH 193A,A01,494107,Staff,15,0,30,15
1713322103061,MATH 193A,A02,494108,Staff,21,0,30,9
1713322103061,MATH 193A,A03,494109,Staff,29,0,30,1
1713322103061,MATH 193A,A04,494110,Staff,22,0,30,8
1713322106134,MGT 16,A00,491930,McKay; Michael J,92,0,98,6
1713322107163,MGT 18,A00,491992,McKay; Michael J,97,0,98,1
1713322108190,MGT 71,A00,492003,Staff,68,0,98,30
1713322109215,MGT 103,A00,505209,Eberhard; Craig A,81,0,98,17
1713322110243,MGT 131A,A00,505210,Anderson; John Charles,90,0,98,8
1713322112294,MGT 153,A00,492077,Perols; Johan Lars,23,0,90,67
1713322115370,MGT 164,A00,492222,McKay; Mary A,92,0,98,6
1713322116399,MGT 172,A00,492245,Staff,59,0,60,1
1713322116399,MGT 172,B00,505526,Hedges; Kathleen,67,0,98,31
1713322117424,MGT 181,A00,505669,Dunn; Louis Jean,84,0,98,14
1713322118450,MMW 14,A01,494399,Staff,20,0,28,8
1713322118450,MMW 14,A02,494400,Staff,25,0,28,3
1713322118450,MMW 14,A03,494401,Staff,28,0,28,0
1713322118450,MMW 14,A04,494402,Staff,28,0,28,0
1713322118450,MMW 14,B01,494404,Carreras; Maria Victoria,10,0,28,18
1713322118450,MMW 14,B02,494405,Carreras; Maria Victoria,26,0,28,2
1713322118450,MMW 14,B03,494406,Carreras; Maria Victoria,27,0,28,1
1713322118450,MMW 14,B04,494407,Carreras; Maria Victoria,28,0,28,0
1713322119473,MMW 14GS,A00,506250,Chang; Edmond Yi-Teh,0,0,0,0
1713322120498,MMW 121R,A01,494415,Adamiak; Patrick John,12,0,28,16
1713322120498,MMW 121R,A02,494416,Adamiak; Patrick John,24,0,28,4
1713322121526,MUS 1A,A01,494113,Staff,12,0,25,13
1713322121526,MUS 1A,A02,494114,Staff,24,0,25,1
1713322122551,MUS 4,A01,494116,Staff,24,0,25,1
1713322122551,MUS 4,A02,494117,Staff,22,0,25,3
1713322123576,MUS 5R,A01,494236,Dubnov; Shlomo,9,0,25,16
1713322123576,MUS 5R,A02,494237,Dubnov; Shlomo,25,0,25,0
1713322124599,MUS 6,A01,494122,Staff,11,0,25,14
1713322124599,MUS 6,A02,494123,Staff,24,0,25,1
1713322125625,MUS 7,A01,494125,Staff,16,0,25,9
1713322125625,MUS 7,A02,494126,Staff,24,0,25,1
1713322126649,MUS 11,A01,494128,Staff,23,0,25,2
1713322126649,MUS 11,A02,494129,Staff,24,0,25,1
1713322127675,MUS 13,A01,494131,Staff,25,0,25,0
1713322127675,MUS 13,A02,494132,Staff,25,0,25,0
1713322128703,MUS 15,A01,494134,Staff,17,0,25,8
1713322128703,MUS 15,A02,494135,Staff,25,0,25,0
1713322128703,MUS 15,B01,494137,Staff,24,0,25,1
1713322129728,MUS 80,A00,494232,Staff,24,0,25,1
1713322129728,MUS 80,B00,494233,Staff,25,0,25,0
1713322129728,MUS 80,C00,494234,Staff,23,0,25,2
1713322130754,MUS 95C,A00,494141,Staff,70,0,75,5
1713322131778,MUS 114,A00,494142,Staff,40,0,50,10
1713322132807,NANO 15,A01,490636,Drews; Aaron,7,0,7,0
1713322133833,PHIL 1,A00,490578,Grush; Rick Scott,49,0,50,1
1713322134857,PHIL 10,A01,490580,Grush; Rick Scott,33,0,35,2
1713322134857,PHIL 10,A02,490586,Grush; Rick Scott,32,0,35,3
1713322135881,PHIL 27,A01,490591,Staff,23,0,25,2
1713322135881,PHIL 27,A02,490592,Staff,25,0,25,0
1713322135881,PHIL 27,A03,490593,Staff,25,0,25,0
1713322135881,PHIL 27,A04,490598,Staff,25,0,25,0
1713322136906,PHIL 32,A01,490611,Staff,20,0,20,0
1713322136906,PHIL 32,A02,490618,Staff,20,0,20,0
1713322137931,PHIL 90,A00,490624,Staff,40,0,40,0
1713322138956,PHIL 136,A00,490627,Cohen; Jonathan David,37,0,40,3
1713322139981,PHIL 155,A00,490634,Staff,63,0,70,7
1713322141006,PHYS 1A,A00,491610,Staff,246,0,250,4
1713322142031,PHYS 1AL,001,491616,Tsai; Philbert S,28,0,30,2
1713322142031,PHYS 1AL,002,491618,Tsai; Philbert S,30,0,30,0
1713322143059,PHYS 1B,A00,491623,Staff,242,0,250,8
1713322144085,PHYS 1BL,001,491626,Tsai; Philbert S,25,0,30,5
1713322144085,PHYS 1BL,002,491628,Tsai; Philbert S,27,0,30,3
1713322145110,PHYS 1C,A00,491632,Staff,218,0,245,27
1713322146135,PHYS 1CL,001,491635,Tsai; Philbert S,9,0,30,21
1713322146135,PHYS 1CL,002,491643,Tsai; Philbert S,24,0,30,6
1713322147160,PHYS 2AR,A01,491651,Meyertholen; Andrew D.,44,0,50,6
1713322148190,PHYS 2B,A01,491659,Staff,105,0,115,10
1713322149217,PHYS 2BL,A01,491685,Staff,21,0,24,3
1713322149217,PHYS 2BL,A02,491700,Staff,21,0,24,3
1713322150243,PHYS 2C,A01,505161,Staff,105,0,115,10
1713322151272,PHYS 4A,A01,491704,Grinstein; Benjamin,99,0,100,1
1713322152295,POLI 5D,A01,494144,Staff,3,0,5,2
1713322152295,POLI 5D,B01,626283,Dai; Yinlin,5,0,5,0
1713322153320,POLI 12,A00,494145,Staff,44,0,45,1
1713322154345,POLI 13R,A00,494146,Forman; Fonna,45,0,50,5
1713322155370,POLI 27,A01,494148,Staff,57,0,60,3
1713322156397,POLI 30,A00,494149,Staff,49,0,50,1
1713322157425,POLI 100DA,A00,494150,Staff,21,0,25,4
1713322159473,POLI 100I,A00,494152,Staff,28,0,30,2
1713322160495,POLI 104B,A00,494153,Smith; Glenn Chatmas,53,0,55,2
1713322161519,POLI 104F,A00,494154,Staff,28,0,30,2
1713322162546,POLI 104I,A00,494155,Smith; Glenn Chatmas,30,0,30,0
1713322163576,POLI 110C,A00,494156,Ingham; Sean,23,0,25,2
1713322164600,POLI 117R,A00,494157,Forman; Fonna,8,0,20,12
1713322165626,POLI 118,A00,494158,Ingham; Sean,22,0,25,3
1713322166654,POLI 120H,A00,494159,Fisk; David Lee,40,0,45,5
1713322167680,POLI 131CR,A00,494160,Hoston; Germaine,36,0,45,9
1713322168708,POLI 133J,A00,494161,Staff,33,0,35,2
1713322169733,POLI 135,A00,494162,Fisk; David Lee,33,0,35,2
1713322170758,POLI 140A,A00,494164,Staff,21,0,30,9
1713322171783,POLI 142I,A00,494165,Staff,30,0,30,0
1713322172811,POLI 144D,A00,494166,Staff,23,0,25,2
1713322173837,POLI 151,A00,494167,Staff,30,0,30,0
1713322174866,POLI 153,A00,494168,Staff,33,0,35,2
1713322175892,POLI 160AA,A00,494169,Staff,35,0,40,5
1713322176920,POLI 162,A00,494170,Mignozzetti; Umberto,19,0,25,6
1713322177949,POLI 171,A00,494171,Mignozzetti; Umberto,21,0,25,4
1713322178974,PSYC 1,A00,494172,Staff,97,0,100,3
1713322180052,PSYC 2,A00,494173,Moranton; Nirelia Melbina-,39,0,50,11
1713322181079,PSYC 3,A00,494174,Staff,29,0,30,1
1713322182104,PSYC 6,A00,494175,Staff,17,0,20,3
1713322183132,PSYC 60,A01,494177,Staff,38,0,45,7
1713322184157,PSYC 70,A01,505724,Geller; Emma Harlan,42,0,45,3
1713322185183,PSYC 101,A00,494180,Heyman; Gail D.,84,0,100,16
1713322186209,PSYC 105,A00,494181,Geller; Emma Harlan,57,0,90,33
1713322187241,PSYC 106,A00,494182,Dobkins; Karen R.,29,0,45,16
1713322188264,PSYC 108,A00,494183,Adrian; Julia Anna,91,0,100,9
1713322189288,PSYC 114,A01,494185,Winkielman; Piotr,0,1,30,30
1713322190367,PSYC 122,A00,494186,Moranton; Nirelia Melbina-,32,0,50,18
1713322191394,PSYC 124,A00,494187,Chapman; Eddie Nathaniel,71,0,80,9
1713322192419,PSYC 131,A00,494188,Anagnostaras; Stephan,49,0,80,31
1713322193446,PSYC 144,A00,494189,Staff,10,0,50,40
1713322194474,PSYC 154,A00,494190,Lacefield; Katharine I,118,0,180,62
1713322195498,PSYC 162,A00,494191,Wixted; John T,75,0,100,25
1713322196522,PSYC 172,A00,494192,Gorman; Michael R.,36,0,45,9
1713322197547,PSYC 178,A00,494193,Glaser; Dale,34,0,45,11
1713322198571,PSYC 193,A00,505725,Chapman; Eddie Nathaniel,20,0,20,0
1713322199597,RELI 145GS,A00,519817,Rahimi; Babak,18,0,20,2
1713322200622,SE 101A,A01,490862,Chadha; Mayank,23,0,25,2
1713322201649,SE 101C,A01,490924,Krysl; Petr,16,0,20,4
1713322202673,SE 110A,A01,490928,Staff,19,0,20,1
1713322203698,SE 130A,A00,490929,Morrison; Machel Leigh,57,0,70,13
1713322204727,SIO 1,A01,519325,Staff,39,0,40,1
1713322205753,SIO 30,A01,519327,Staff,38,0,40,2
1713322206780,SIO 40,A00,519328,Staff,39,0,40,1
1713322207805,SIO 46GS,A00,519819,Cook; Geoffrey W,17,0,25,8
1713322208833,SIO 109R,A00,494197,Forman; Fonna,0,0,20,20
1713322209863,SIO 121GS,A00,519827,Cook; Geoffrey W,17,0,25,8
1713322210889,SIO 132,A01,519330,Staff,38,0,40,2
1713322211914,SIO 133,A01,519397,Staff,37,0,40,3
1713322212941,SIO 139,A00,519396,Kacev; David,31,0,40,9
1713322213966,SOCI 1,A01,494199,Thorpe; Charles Robert,22,0,30,8
1713322213966,SOCI 1,A02,494200,Thorpe; Charles Robert,30,0,30,0
1713322213966,SOCI 1,A03,494201,Thorpe; Charles Robert,29,0,30,1
1713322213966,SOCI 1,A04,494202,Thorpe; Charles Robert,29,0,30,1
1713322213966,SOCI 1,A05,494203,Thorpe; Charles Robert,29,0,30,1
1713322213966,SOCI 1,A06,494204,Thorpe; Charles Robert,30,0,30,0
1713322213966,SOCI 1,A07,494205,Thorpe; Charles Robert,28,0,30,2
1713322214991,SOCI 60,A01,494207,Staff,34,0,40,6
1713322214991,SOCI 60,A02,494208,Staff,39,0,40,1
1713322216014,SOCI 100,A01,494210,Payne; Christine Anna,27,0,30,3
1713322216014,SOCI 100,A02,494211,Payne; Christine Anna,26,0,30,4
1713322217038,SOCI 109M,A00,494212,Staff,20,0,20,0
1713322218066,SOCI 110,A00,494213,Staff,35,0,40,5
1713322220121,SOCI 118E,A00,494215,Ng; Kwai,37,0,40,3
1713322221149,SOCI 125,A00,494216,Calderon-Zaks; Michael Aar,42,0,45,3
1713322222178,SOCI 126,A01,494218,Jones; Makeba,3,0,5,2
1713322223203,SOCI 131,A00,494219,Thorpe; Charles Robert,28,0,30,2
1713322225254,SOCI 135,A00,494221,Payne; Christine Anna,31,0,50,19
1713322226281,SOCI 136E,A00,626690,Ruiz; Jonathan Joseph,25,0,25,0
1713322227307,SOCI 138GS,A00,494222,Navon; Daniel,24,0,28,4
1713322229365,SOCI 145,A00,494224,Staff,41,0,45,4
1713322230390,SOCI 153,A00,494225,Staff,28,0,30,2
1713322231414,SOCI 160E,A00,494226,Ng; Kwai,30,0,40,10
1713322232442,SOCI 180,A00,494227,Staff,29,0,30,1
1713322233469,SOCI 189GS,A00,494228,Ribas Norris; Janet Vanesa,11,0,11,0
1713322234495,SOCI 190GS,A00,553232,Ribas Norris; Janet Vanesa,11,0,11,0
1713322235521,SOMI 220,A00,627178,Schneid; Stephen David,30,0,30,0
1713322236548,SYN 2,001,490768,Staff,14,0,15,1
1713322236548,SYN 2,002,490769,Staff,15,0,15,0
1713322236548,SYN 2,004,490775,Staff,0,0,0,0
1713322236548,SYN 2,003,490774,Staff,0,0,0,0
1713322236548,SYN 2,005,490776,Staff,0,0,0,0
1713322237576,SYN 2R,001,490779,Staff,12,0,15,3
1713322237576,SYN 2R,002,514635,Staff,14,0,15,1
1713322238601,SYN 100,A01,490783,Staff,13,0,20,7
1713322238601,SYN 100,B01,490787,Staff,9,0,20,11
1713322238601,SYN 100,C01,490789,Staff,11,0,20,9
1713322239626,SYN 150,A00,490817,Staff,14,0,15,1
1713322239626,SYN 150,B00,514610,Staff,15,0,15,0
1713322240656,TDAC 1,A00,492753,Walsh; Kim C.,19,0,20,1
1713322240656,TDAC 1,B00,492754,Harting; Carla Kelso,19,0,20,1
1713322240656,TDAC 1,C00,513995,Salovey; Todd,15,0,20,5
1713322241684,TDAC 101,A00,492766,Harting; Carla Kelso,17,0,20,3
1713322242713,TDAC 102,A00,492768,Basso; Beatrice,19,0,20,1
1713322243741,TDDE 111,A00,492769,Staff,25,0,25,0
1713322244766,TDDE 131,A00,492770,Staff,15,0,15,0
1713322244766,TDDE 131,B00,492771,Staff,15,0,15,0
1713322245791,TDDE 131GS,A00,523716,Guirguis; Mark C,24,0,28,4
1713322246815,TDGE 1,A01,492756,Salovey; Todd,57,0,60,3
1713322247841,TDGE 5,A01,492758,Staff,23,0,25,2
1713322248865,TDGE 10,A00,492759,Fulton; Julia,206,0,220,14
1713322249890,TDGE 11,A00,492760,Castro; Robert Jess,198,0,200,2
1713322251941,TDGE 124,A00,492772,Fulton; Julia,189,0,220,31
1713322252966,TDGE 125,A00,492773,Meyer; Ursula,39,0,50,11
1713322252966,TDGE 125,B00,492774,Staff,49,0,50,1
1713322252966,TDGE 125,C00,523565,Staff,48,0,50,2
1713322253993,TDGE 125GS,A00,523580,Guirguis; Mark C,24,0,28,4
1713322255025,TDGE 127,A00,492775,Havis; Allan,38,0,50,12
1713322256049,TDHT 101,A00,492776,Staff,34,0,35,1
1713322257075,TDMV 1,A00,492762,Caligagan; Maria T.,30,0,30,0
1713322257075,TDMV 1,B00,492763,Arcidiacono; Kristin,25,0,30,5
1713322258101,TDMV 2,A00,492764,Weinberg; Sadie,29,0,30,1
1713322259125,TDMV 3,A00,492765,Mack; Kara Shanai',38,0,40,2
1713322260156,TDMV 138,A00,492777,Mack; Kara Shanai',35,0,40,5
1713322261181,TDMV 140,A00,492778,Lima; Paulo Henrique,40,0,40,0
1713322262209,TDMV 142,A00,492779,Caligagan; Maria T.,34,0,40,6
1713322262209,TDMV 142,B00,492780,Caligagan; Tony,37,0,40,3
1713322263234,TDMV 143,A00,492781,Fyall; Daunte Edward,39,0,40,1
1713322264262,USP 1,A01,492401,Kwak; Nancy,26,0,35,9
1713322265291,USP 2,A01,492453,Hinds; Juli Beth,35,0,35,0
1713322266316,USP 3,A01,492516,Staff,28,0,35,7
1713322267342,USP 4,A00,492522,McTague; Sarah,17,0,25,8
1713322268367,USP 100,A00,492523,Staff,32,0,35,3
1713322269391,USP 101,A00,492524,Staff,13,0,15,2
1713322270415,USP 105,A00,492525,Staff,21,0,25,4
1713322271442,USP 151,A00,492526,Shenkman; Michael Thomas,32,0,35,3
1713322272479,USP 170,A00,492545,Hinds; Juli Beth,33,0,35,2
1713322273508,USP 171GS,A00,492608,Bussell; Mirle Rabinowitz,24,0,28,4
1713322274534,USP 183GS,A00,492613,Peerson; Susan,24,0,28,4
1713322275560,VIS 30,A01,490693,Yoldas; Pinar,19,0,22,3
1713322275560,VIS 30,A02,490694,Yoldas; Pinar,18,0,22,4
1713322276584,VIS 83,A00,490695,Kester; Grant,63,0,75,12
1713322277611,VIS 105D,A00,490696,Staff,22,0,25,3
1713322278635,VIS 124CN,A00,490699,Rose; Jordan M,66,0,75,9
1713322279667,VIS 125GS,A00,511221,Williams; Alena J,21,0,22,1
1713322280692,VIS 128D,A00,490700,Staff,73,0,75,2
1713322281720,VIS 151,A01,490717,Staff,33,0,34,1
1713322281720,VIS 151,A02,490766,Staff,33,0,34,1
1713322282745,VIS 154GS,A00,511972,Williams; Alena J,21,0,22,1
1713322283774,VIS 160A,A00,490767,Stone; Patricia,7,0,10,3
1713322284798,WCWP 10A,A00,490638,Staff,14,0,15,1
1713322284798,WCWP 10A,B00,490640,Staff,15,0,15,0
1713322285828,WCWP 10B,A00,490641,Staff,0,0,0,0
1713322285828,WCWP 10B,B00,490642,Staff,14,0,15,1
1713322285828,WCWP 10B,C00,490644,Staff,13,0,15,2
1713322285828,WCWP 10B,D00,490647,Staff,0,0,0,0
1713322286856,WCWP 100,A00,490655,Staff,0,0,0,0
1713322286856,WCWP 100,B00,490687,Staff,10,0,15,5
1713322288924,ANAR 153,A00,487222,Braswell; Geoffrey E.,54,0,60,6
1713322289953,ANBI 134,A00,487223,Staff,7,0,20,13
1713322290977,ANBI 143GS,A00,487224,Noel; Geoffroy Pierre Jean,18,0,24,6
1713322292002,ANBI 144GS,A00,519548,Noel; Geoffroy Pierre Jean,18,0,24,6
1713322293028,ANSC 101,A00,487225,Staff,17,0,20,3
1713322294112,ANSC 125,A00,487227,Brenner; Suzanne A,39,0,40,1
1713322296167,ANSC 146,A00,487229,Staff,35,0,40,5
1713322297191,ANSC 148,A00,487230,Olivas Hernandez; Olga Lid,39,0,40,1
1713322298219,ANSC 150,A00,504165,Sloane; Julia Kathryn,19,0,20,1
1713322299245,ANSC 180,A00,487232,Staff,14,0,15,1
1713322300269,ANSC 188,A00,627155,Staff,39,0,40,1
1713322301295,ANTH 5,A00,519529,Semendeferi; Ekaterini,15,0,15,0
1713322302319,ANTH 10,A00,487219,Staff,58,0,60,2
1713322303346,ANTH 23,A01,487221,Staff,17,0,20,3
1713322304375,ANTH 102,A00,487233,Wilder; Linnea Lorene,51,0,60,9
1713322305400,ANTH 103,A00,487234,Varma; Saiba,55,0,60,5
1713322306428,ANTH 105,A00,487235,Stewart; Alexander B,55,0,60,5
1713322307455,BENG 100,A01,516685,Taylor Amos; Alyssa C,28,0,30,2
1713322308479,BIBC 102,A01,491316,Flagg; Matthew Paul,23,0,88,65
1713322308479,BIBC 102,A02,491366,Flagg; Matthew Paul,81,0,88,7
1713322309508,BIBC 103,A01,491486,Boumechache; Miyyada,16,0,24,8
1713322309508,BIBC 103,A02,491487,Boumechache; Miyyada,24,0,24,0
1713322310533,BICD 100,A01,516882,Staff,74,0,75,1
1713322310533,BICD 100,A02,516890,Staff,69,0,75,6
1713322311558,BICD 102GS,A00,491488,Lo; Stanley M.,26,0,28,2
1713322312585,BIEB 136GS,A00,516940,Holway; David A. & Shurin; Jonathan,19,0,24,5
1713322313608,BIEB 137GS,A01,517034,Holway; David A. & Shurin; Jonathan,19,0,24,5
1713322314633,BIEB 138GS,A01,491492,Pirino; Giorgia,21,0,28,7
1713322315661,BILD 1,A01,491296,Staff,61,0,63,2
1713322315661,BILD 1,A02,491297,Staff,63,0,63,0
1713322316686,BILD 4,A01,517099,Gonzalez Gamboa; Ivonne,22,0,24,2
1713322316686,BILD 4,A02,517100,Gonzalez Gamboa; Ivonne,24,0,24,0
1713322317713,BILD 60GS,A00,491309,Lo; Stanley M.,26,0,28,2
1713322318738,BIMM 100,A01,517136,Staff,87,0,100,13
1713322319762,BIMM 110,A01,517182,Staff,62,0,100,38
1713322320790,BIMM 120,A01,517228,Pickett; Brooke Elizabeth,32,0,63,31
1713322320790,BIMM 120,A02,517240,Pickett; Brooke Elizabeth,45,0,63,18
1713322321818,BIMM 132GS,A01,491498,Pirino; Giorgia,21,0,28,7
1713322322843,BIMM 143,A01,491589,Bozinovic; Goran,14,0,40,26
1713322323877,BIPN 100,A01,491594,Armour; Jon Christopher,90,0,100,10
1713322324905,BIPN 140,A01,491602,Marino; Marc J,27,0,50,23
1713322326958,CAT 125,A00,515973,Staff,18,0,20,2
1713322327982,CAT 125GS,A00,515974,Rahimi; Babak,17,0,20,3
1713322329012,CAT 125R,A00,515980,Staff,13,0,20,7
1713322329012,CAT 125R,B00,515981,Tosun; Adriana,19,0,20,1
1713322329012,CAT 125R,C00,515987,Hyland; Tina Mae,0,2,20,20
1713322329012,CAT 125R,D00,515988,Bronstein; Phoebe Malan,17,0,20,3
1713322330040,CENG 15,A01,488699,Drews; Aaron,25,0,25,0
1713322331069,CENG 100,A00,505196,Opatkiewicz; Justin Paul,25,0,25,0
1713322332096,CGS 2A,A01,489598,Staff,33,0,35,2
1713322333121,CGS 112,A00,489599,Staff,15,0,15,0
1713322334148,CGS 119,A00,489603,Staff,10,0,10,0
1713322335173,CGS 120,A00,489604,Staff,14,0,15,1
1713322336198,CGS 150,A00,489607,Staff,15,0,15,0
1713322337222,CHEM 6A,A01,488715,Staff,98,0,100,2
1713322338247,CHEM 6B,A01,488719,Piercy; Marc Anthony,100,0,100,0
1713322339273,CHEM 6C,A01,488723,Albizati; Kim F.,93,0,100,7
1713322340306,CHEM 7L,A01,488728,Schurmeier; Kimberly,18,0,24,6
1713322340306,CHEM 7L,A02,488730,Schurmeier; Kimberly,23,0,24,1
1713322340306,CHEM 7L,A03,488734,Schurmeier; Kimberly,22,0,24,2
1713322340306,CHEM 7L,A04,488763,Schurmeier; Kimberly,23,0,24,1
1713322340306,CHEM 7L,B01,488798,Schurmeier; Kimberly,17,0,24,7
1713322340306,CHEM 7L,B02,488801,Schurmeier; Kimberly,23,0,24,1
1713322340306,CHEM 7L,B03,488808,Schurmeier; Kimberly,23,0,24,1
1713322340306,CHEM 7L,B04,488811,Schurmeier; Kimberly,24,0,24,0
1713322341330,CHEM 11,A01,488897,Stallings; Dontarie M,96,0,100,4
1713322342357,CHEM 40A,A01,488913,Albizati; Kim F.,86,0,100,14
1713322343382,CHEM 40B,A01,488920,Weizman; Haim,44,0,50,6
1713322343382,CHEM 40B,A02,488938,Weizman; Haim,45,0,50,5
1713322344411,CHEM 41A,A01,489029,Klosterman; Jeremy K,57,0,60,3
1713322345437,CHEM 41C,A01,500436,Tor; Yitzhak,55,0,60,5
1713322346475,CHEM 43A,A01,500426,Weizman; Haim,0,0,24,24
1713322346475,CHEM 43A,A02,500430,Weizman; Haim,13,0,24,11
1713322346475,CHEM 43A,B01,514041,Klosterman; Jeremy K,15,0,24,9
1713322346475,CHEM 43A,B02,514047,Klosterman; Jeremy K,23,0,24,1
1713322347500,CHEM 108,A01,489140,Jennings; Patricia A.,11,0,24,13
1713322347500,CHEM 108,A02,489142,Jennings; Patricia A.,14,0,24,10
1713322348525,CHEM 114A,A01,489147,Stallings; Dontarie M,74,0,100,26
1713322349553,CHIN 169A,A00,489171,Wang; Xiao,19,0,20,1
1713322351606,COGS 3,A01,518827,Boyle; Mary E. T.,27,0,40,13
1713322352631,COGS 11,A01,489175,Staff,28,0,30,2
1713322353658,COGS 14A,A01,518829,Staff,51,0,60,9
1713322354685,COGS 14B,A01,489177,Hoffman; Drew Ellen,65,0,75,10
1713322355714,COGS 100,A01,489181,Allen; Michael Gordon,64,0,75,11
1713322356739,COGS 101A,A01,489183,Staff,47,0,60,13
1713322357764,COGS 101B,A01,489185,Allen; Michael Gordon,8,0,30,22
1713322358794,COGS 101C,A01,526786,Staff,24,0,30,6
1713322360849,COGS 107A,A01,489189,Boyle; Mary E. T.,19,0,35,16
1713322361877,COGS 107B,A01,627144,Mooshagian; Eric Frederick,60,0,60,0
1713322362903,COGS 118A,A01,489191,Staff,0,40,40,40
1713322364957,COGS 171GS,A01,489194,Pineda; Jaime A,21,0,28,7
1713322365984,COGS 172,A01,489196,Staff,3,0,30,27
1713322367012,COGS 174GS,A01,489264,Pineda; Jaime A,21,0,28,7
1713322368041,COGS 180,A01,627150,Staff,28,0,30,2
1713322369068,COGS 186,A01,489274,Staff,0,1,30,30
1713322370094,COMM 10,A01,489276,Staff,23,0,25,2
1713322370094,COMM 10,A02,489303,Staff,23,0,25,2
1713322371119,COMM 100A,A01,489312,Staff,14,0,25,11
1713322371119,COMM 100A,A02,489313,Staff,24,0,25,1
1713322372144,COMM 106T,A00,512540,Staff,33,0,35,2
1713322373170,COMM 107,A00,489347,Staff,28,0,35,7
1713322374197,COMM 109P,A00,489358,Staff,31,0,35,4
1713322375222,COMM 132,A00,489361,McKenna; Denise,28,0,30,2
1713322376249,COMM 146,A00,489362,Halm; Gavin Patrick,26,0,30,4
1713322377276,COMM 190,A00,489363,Abuelhiga; Soraya Jill,17,0,23,6
1713322378306,CSE 8A,A50,489366,Staff,22,0,25,3
1713322378306,CSE 8A,A51,489367,Staff,24,0,25,1
1713322379333,CSE 11,A01,489398,Cao; Yingjun,78,0,100,22
1713322380359,CSE 12,A01,489487,Staff,43,0,50,7
1713322381384,CSE 20,A01,489497,Staff,48,0,50,2
1713322382408,CSE 21,A01,489517,Braun; Oliver,42,0,50,8
1713322383432,CSE 101,A01,489524,Braun; Oliver,0,28,50,50
1713322384458,CSE 105,A01,512594,Jones; Miles E,74,0,100,26
1713322384458,CSE 105,B01,512598,Jones; Miles E,55,0,100,45
1713322385485,CSE 140,A01,489538,Staff,43,0,50,7
1713322386516,CSE 141,A01,489550,Eldon; John,70,0,100,30
1713322387543,CSE 141L,A01,489571,Eldon; John,68,0,100,32
1713322388574,CSE 151A,A01,489583,Solares; Edwin A,144,0,200,56
1713322389598,CSE 175,A01,510886,Kumar; Rakesh,30,0,30,0
1713322390626,CSE 190,A00,516828,Dubnov; Shlomo,38,0,49,11
1713322391654,DOC 100D,A00,489667,Pass; Natalye Joann,19,0,25,6
1713322392684,DSC 10,A01,624268,Staff,72,0,75,3
1713322393712,DSC 20,A01,624476,Staff,50,0,50,0
1713322394737,DSC 40A,A01,624608,Staff,39,0,40,1
1713322395763,DSGN 1,A01,489179,Rill; Bryan,35,0,50,15
1713322396793,ECE 17,A01,490489,Sahay; Rajeev,18,0,30,12
1713322397874,ECE 65,A50,490492,Staff,13,0,20,7
1713322397874,ECE 65,A51,490493,Staff,19,0,20,1
1713322398903,ECON 1,A01,489715,Famulari; Melissa,68,0,70,2
1713322399933,ECON 2,A01,489717,Levkoff; Steven B.,68,0,70,2
1713322400960,ECON 3,A01,489948,Staff,70,0,70,0
1713322403012,ECON 5,A01,490103,Staff,27,0,30,3
1713322403012,ECON 5,B01,626281,Dai; Yinlin,45,0,45,0
1713322404036,ECON 100A,A01,490127,Famulari; Melissa,66,0,70,4
1713322405062,ECON 100B,A01,490129,Staff,64,0,70,6
1713322406097,ECON 109,A01,490187,Shishkin; Denis,27,0,35,8
1713322407122,ECON 110A,A01,490190,Levkoff; Steven B.,60,0,70,10
1713322408150,ECON 120A,A01,490245,Dai; Yinlin,62,0,70,8
1713322409175,ECON 120B,A01,490247,Nieto-Barthaburu; Augusto,48,0,70,22
1713322410199,ECON 120C,A01,490253,Sun; Yixiao,30,0,35,5
1713322410199,ECON 120C,B01,490255,Sun; Yixiao,34,0,35,1
1713322411224,ECON 129,A00,490256,Eckert; Fabian Paul,24,0,35,11
1713322412249,ECON 131,A00,490257,Nieto-Barthaburu; Augusto,0,6,35,35
1713322413273,ECON 138,A00,490258,Bharadwaj; Prashant,16,0,35,19
1713322413273,ECON 138,B00,490259,Bharadwaj; Prashant,16,0,35,19
1713322414301,ECON 159,A00,490260,Hendrickson; Gerald M.,0,8,0,0
1713322415330,ECON 178,A01,553995,Zhu; Ying,24,0,35,11
1713322416356,EDS 40,A01,512576,Black; Alison Michelle,20,0,20,0
1713322417380,EDS 107,A01,515848,Staff,30,0,30,0
1713322418403,EDS 110R,A01,490262,Staff,26,0,30,4
1713322419429,EDS 112,A01,490264,Chapman; Thandeka K,41,0,50,9
1713322420453,EDS 113,A00,490266,Staff,26,0,30,4
1713322421480,EDS 118,A00,490267,Warstadt; Melissa Fawn,21,0,30,9
1713322422504,EDS 124BR,A00,490268,Eguchi; Emi,4,0,25,21
1713322422504,EDS 124BR,B00,490269,Eguchi; Emi,24,0,25,1
1713322423535,EDS 126,A01,490271,Jones; Makeba,44,0,50,6
1713322424562,EDS 135,A01,490316,Staff,19,0,20,1
1713322425587,ENVR 142GS,A00,519514,Chang; Edmond Yi-Teh,27,0,28,1
1713322426616,ETHN 103,A00,490504,Staff,27,0,36,9
1713322427644,ETHN 103A,A00,490505,Man; Simeon S,5,0,9,4
1713322428672,ETHN 109,A00,490506,Staff,29,0,30,1
1713322429697,ETHN 118,A00,490507,Staff,35,0,36,1
1713322430722,ETHN 119,A00,490508,Staff,33,0,36,3
1713322431746,ETHN 121R,A00,490518,Choi; Esther Min,24,0,36,12
1713322432774,ETHN 127,A00,490528,Staff,15,0,15,0
1713322433801,ETHN 139,A00,490573,Staff,10,0,10,0
1713322434828,ETHN 150,A00,490575,Staff,15,0,15,0
1713322435852,GLBH 20,A00,491705,Elwardani; Nile Regina,38,0,40,2
1713322436880,GLBH 101,A00,491706,Staff,20,0,20,0
1713322437905,GLBH 111,A01,491708,Burgos; Jose L.,15,0,15,0
1713322438928,GLBH 146,A00,491709,Staff,11,0,20,9
1713322439954,GLBH 148,A00,491710,Olivas Hernandez; Olga Lid,13,0,20,7
1713322440982,GLBH 150,A00,491711,Sloane; Julia Kathryn,20,0,20,0
1713322442010,HIEA 131,A00,491760,Staff,29,0,32,3
1713322443035,HIEA 153,A00,491762,Staff,29,0,30,1
1713322444058,HIEU 124,A00,491811,Staff,26,0,32,6
1713322445085,HIEU 124GS,A00,491812,Markman; Kristina,27,0,28,1
1713322446110,HIEU 147,A00,491813,Staff,30,0,32,2
1713322447133,HIEU 149GS,A00,491816,Caldwell; Michael Alan,28,0,28,0
1713322448161,HILD 2C,A01,491713,Hendrickson; Gerald M.,27,0,30,3
1713322449185,HILD 7B,A01,491715,Kwak; Nancy,1,0,30,29
1713322450210,HILD 10,A01,491717,Staff,13,0,20,7
1713322451232,HILD 30GS,A00,491719,Edington; Claire Ellen,24,0,28,4
1713322452256,HINE 109,A00,491818,Shafir; Nir,27,0,32,5
1713322453282,HINE 128,A00,491821,Shafir; Nir,31,0,32,1
1713322454309,HISC 117,A00,491830,Staff,27,0,32,5
1713322455334,HIUS 103,A00,491834,Man; Simeon S,15,0,23,8
1713322456359,HIUS 108B,A00,491835,Staff,28,0,30,2
1713322457388,HIUS 141,A00,491836,Hendrickson; Gerald M.,29,0,32,3
1713322458414,HIUS 149,A00,491839,Staff,27,0,32,5
1713322459439,HUM 3,A01,512617,Crum; Matthew Stephen,43,0,50,7
1713322459439,HUM 3,A02,512618,Crum; Matthew Stephen,48,0,50,2
1713322460463,HUM 3GS,A00,512663,Markman; Kristina,0,0,0,1
1713322460463,HUM 3GS,B00,512664,Staff,0,0,0,0
1713322461489,HUM 4,A01,512620,West; Geoffrey Scott,30,0,50,20
1713322462516,HUM 4GS,A00,512666,Lyon; Antony J.,0,0,0,4
1713322463542,HUM 4R,A01,512625,Watkins; Eric,49,0,50,1
1713322464569,HUM 5,A01,512649,Zavodny; Tatiana Sophia,26,0,50,24
1713322464569,HUM 5,B01,512661,Zroka; Ryan Edward,48,0,50,2
1713322465594,INTL 190,A00,490577,Segui; Alan S,0,0,0,5
1713322466622,JAPN 20AR,A01,491267,Ross; Kayoko F,8,0,20,12
1713322467647,JAPN 180,A00,491285,Berman; Michael David,33,0,40,7
1713322468674,LATI 50,A01,502536,Kokinis; Troy Andreas,16,0,22,6
1713322468674,LATI 50,A02,502551,Kokinis; Troy Andreas,22,0,22,0
1713322468674,LATI 50,A03,502650,Kokinis; Troy Andreas,22,0,22,0
1713322468674,LATI 50,A04,502909,Kokinis; Troy Andreas,22,0,22,0
1713322469701,LATI 160,A01,502920,Kokinis; Troy Andreas,30,0,30,0
1713322470729,LIFR 1A,A00,490494,Van Moer; Vinciane G,17,0,20,3
1713322471754,LIFR 1AX,A00,490495,Van Moer; Vinciane G,17,0,20,3
1713322472779,LIFR 1B,A00,490496,Van Moer; Vinciane G,18,0,20,2
1713322473805,LIFR 1BX,A00,490497,Van Moer; Vinciane G,18,0,20,2
1713322474830,LIGN 8,A00,505198,McIntosh; Justin Daniel,135,0,150,15
1713322475856,LIGN 9GS,A00,491239,Lott; Margaret S.,18,0,20,2
1713322476884,LIGN 101,A01,505200,McIntosh; Justin Daniel,24,0,30,6
1713322477910,LIGN 120,A01,491244,Staff,23,0,30,7
1713322478934,LIGN 149GS,A00,491245,Lott; Margaret S.,18,0,20,2
1713322479960,LIGN 170,A00,491247,Staff,22,0,30,8
1713322480984,LISP 1D,A00,490498,Munoz Sanchez; Alicia,10,0,14,4
1713322480984,LISP 1D,B00,490499,Munoz Sanchez; Alicia,6,0,14,8
1713322480984,LISP 1D,C00,490500,Munoz Sanchez; Alicia,8,0,14,6
1713322480984,LISP 1D,D00,490501,Munoz Sanchez; Alicia,10,0,14,4
1713322482008,LISP 1DX,A00,490502,Munoz Sanchez; Alicia,15,0,28,13
1713322482008,LISP 1DX,B00,490503,Munoz Sanchez; Alicia,17,0,28,11
1713322484058,LTAM 110,A00,491847,Staff,23,0,25,2
1713322485086,LTCS 119,A00,491848,Staff,11,0,15,4
1713322486112,LTCS 130,A00,491849,Staff,24,0,25,1
1713322488165,LTEA 120C,A00,491852,Staff,32,0,40,8
1713322489193,LTEN 130GS,A00,491853,Lyon; Antony J.,24,0,28,4
1713322490221,LTEN 148,A00,491855,Staff,23,0,25,2
1713322491245,LTEN 159,A00,491856,Staff,21,0,25,4
1713322492271,LTEN 180,A00,491857,Staff,8,0,15,7
1713322494329,LTSP 123GS,A00,505928,Bessett; Ryan Matthew,24,0,28,4
1713322495354,LTSP 174GS,A00,506037,Bessett; Ryan Matthew,24,0,28,4
1713322497405,LTWR 102,A00,491861,Staff,9,0,15,6
1713322498428,LTWR 106,A00,491862,Staff,10,0,15,5
1713322499451,MAE 11,A00,490930,Bahadori; Mohammad Yousef,96,0,100,4
1713322500476,MAE 30A,A00,490931,Qi; Huihui,37,0,40,3
1713322501561,MAE 101A,A00,491036,Sadeghizadeh; Zahra,96,0,100,4
1713322502602,MAE 101C,A00,491037,Seshadri; Kalyanasundaram,71,0,100,29
1713322503629,MAE 113,A00,491040,Seshadri; Kalyanasundaram,66,0,80,14
1713322504657,MAE 131A,A00,491041,Ghazinejad; Maziar,37,0,40,3
1713322505685,MAE 142,A00,491053,Staff,39,0,40,1
1713322506709,MAE 143A,A00,491054,Staff,34,0,50,16
1713322507737,MAE 150,A00,491092,Truong; Phuong Thi Ngoc,23,0,35,12
1713322508763,MATH 3C,A01,494031,Pardo Guerra; Sebastian,30,0,30,0
1713322508763,MATH 3C,A02,494032,Pardo Guerra; Sebastian,29,0,30,1
1713322509792,MATH 10A,A01,494034,Staff,27,0,30,3
1713322509792,MATH 10A,A02,494035,Staff,28,0,30,2
1713322509792,MATH 10A,B01,494037,Staff,27,0,30,3
1713322509792,MATH 10A,B02,494038,Staff,29,0,30,1
1713322510817,MATH 10B,A01,494040,Habib; Yousaf,22,0,30,8
1713322510817,MATH 10B,A02,494041,Habib; Yousaf,28,0,30,2
1713322510817,MATH 10B,A03,494042,Habib; Yousaf,29,0,30,1
1713322510817,MATH 10B,A04,494043,Habib; Yousaf,30,0,30,0
1713322510817,MATH 10B,B01,494045,Habib; Yousaf,26,0,30,4
1713322510817,MATH 10B,B02,494046,Habib; Yousaf,30,0,30,0
1713322510817,MATH 10B,B03,494047,Habib; Yousaf,30,0,30,0
1713322510817,MATH 10B,B04,494048,Habib; Yousaf,30,0,30,0
1713322511844,MATH 18,A01,494050,Kemp; Todd Aahron,25,0,30,5
1713322511844,MATH 18,A02,494051,Kemp; Todd Aahron,29,0,30,1
1713322511844,MATH 18,B01,494054,Kemp; Todd Aahron,27,0,30,3
1713322511844,MATH 18,B02,494055,Kemp; Todd Aahron,29,0,30,1
1713322512868,MATH 20A,A01,494059,Suk; Andrew Hoon,30,0,30,0
1713322513897,MATH 20B,A01,494061,Briones; Jor-el Thomas Caparas,33,0,35,2
1713322513897,MATH 20B,B01,494063,Bach; Quang Tran,34,0,35,1
1713322514933,MATH 20C,A01,494065,Staff,28,0,30,2
1713322514933,MATH 20C,A02,494066,Staff,30,0,30,0
1713322514933,MATH 20C,A03,494067,Staff,30,0,30,0
1713322514933,MATH 20C,A04,494068,Staff,30,0,30,0
1713322514933,MATH 20C,B01,494070,Zhang; Ming,26,0,30,4
1713322514933,MATH 20C,B02,494071,Zhang; Ming,27,0,30,3
1713322514933,MATH 20C,B03,494072,Zhang; Ming,29,0,30,1
1713322514933,MATH 20C,B04,494073,Zhang; Ming,29,0,30,1
1713322515962,MATH 20D,A01,494075,Staff,22,0,30,8
1713322515962,MATH 20D,A02,494076,Staff,30,0,30,0
1713322516991,MATH 20E,A01,494079,Staff,24,0,30,6
1713322516991,MATH 20E,A02,494080,Staff,26,0,30,4
1713322516991,MATH 20E,B01,494082,Staff,25,0,30,5
1713322516991,MATH 20E,B02,494083,Staff,25,0,30,5
1713322518018,MATH 103A,A01,494085,Aliabadi Sr.; Mohsen,14,0,30,16
1713322518018,MATH 103A,A02,494086,Aliabadi Sr.; Mohsen,28,0,30,2
1713322518018,MATH 103A,B01,494088,Aliabadi Sr.; Mohsen,22,0,30,8
1713322518018,MATH 103A,B02,494089,Aliabadi Sr.; Mohsen,28,0,30,2
1713322519042,MATH 109,A01,494091,Staff,30,0,30,0
1713322519042,MATH 109,A02,494092,Staff,29,0,30,1
1713322519042,MATH 109,B01,494094,Staff,27,0,30,3
1713322519042,MATH 109,B02,494095,Staff,29,0,30,1
1713322520072,MATH 142A,A01,494097,Chow; Bennett,15,0,30,15
1713322520072,MATH 142A,A02,494098,Chow; Bennett,24,0,30,6
1713322520072,MATH 142A,B01,494100,Chow; Bennett,19,0,30,11
1713322520072,MATH 142A,B02,494101,Chow; Bennett,29,0,30,1
1713322522121,MATH 168A,A01,516677,Dumitriu; Ioana,15,0,35,20
1713322523151,MATH 170A,A01,516679,Dumitriu; Ioana,19,0,30,11
1713322523151,MATH 170A,A02,516680,Dumitriu; Ioana,28,0,30,2
1713322524175,MATH 193A,A01,494107,Staff,14,0,30,16
1713322524175,MATH 193A,A02,494108,Staff,21,0,30,9
1713322524175,MATH 193A,A03,494109,Staff,29,0,30,1
1713322524175,MATH 193A,A04,494110,Staff,22,0,30,8
1713322527254,MGT 16,A00,491930,McKay; Michael J,92,0,98,6
1713322528282,MGT 18,A00,491992,McKay; Michael J,97,0,98,1
1713322529306,MGT 71,A00,492003,Staff,68,0,98,30
1713322530330,MGT 103,A00,505209,Eberhard; Craig A,81,0,98,17
1713322531360,MGT 131A,A00,505210,Anderson; John Charles,90,0,98,8
1713322533407,MGT 153,A00,492077,Perols; Johan Lars,23,0,90,67
1713322536485,MGT 164,A00,492222,McKay; Mary A,92,0,98,6
1713322537513,MGT 172,A00,492245,Staff,59,0,60,1
1713322537513,MGT 172,B00,505526,Hedges; Kathleen,66,0,98,32
1713322538537,MGT 181,A00,505669,Dunn; Louis Jean,84,0,98,14
1713322539564,MMW 14,A01,494399,Staff,20,0,28,8
1713322539564,MMW 14,A02,494400,Staff,25,0,28,3
1713322539564,MMW 14,A03,494401,Staff,28,0,28,0
1713322539564,MMW 14,A04,494402,Staff,28,0,28,0
1713322539564,MMW 14,B01,494404,Carreras; Maria Victoria,10,0,28,18
1713322539564,MMW 14,B02,494405,Carreras; Maria Victoria,25,0,28,3
1713322539564,MMW 14,B03,494406,Carreras; Maria Victoria,27,0,28,1
1713322539564,MMW 14,B04,494407,Carreras; Maria Victoria,28,0,28,0
1713322540588,MMW 14GS,A00,506250,Chang; Edmond Yi-Teh,0,0,0,0
1713322541617,MMW 121R,A01,494415,Adamiak; Patrick John,12,0,28,16
1713322541617,MMW 121R,A02,494416,Adamiak; Patrick John,24,0,28,4
1713322542643,MUS 1A,A01,494113,Staff,12,0,25,13
1713322542643,MUS 1A,A02,494114,Staff,24,0,25,1
1713322543667,MUS 4,A01,494116,Staff,24,0,25,1
1713322543667,MUS 4,A02,494117,Staff,22,0,25,3
1713322544692,MUS 5R,A01,494236,Dubnov; Shlomo,9,0,25,16
1713322544692,MUS 5R,A02,494237,Dubnov; Shlomo,25,0,25,0
1713322545718,MUS 6,A01,494122,Staff,11,0,25,14
1713322545718,MUS 6,A02,494123,Staff,24,0,25,1
1713322546743,MUS 7,A01,494125,Staff,16,0,25,9
1713322546743,MUS 7,A02,494126,Staff,24,0,25,1
1713322547770,MUS 11,A01,494128,Staff,23,0,25,2
1713322547770,MUS 11,A02,494129,Staff,24,0,25,1
1713322548794,MUS 13,A01,494131,Staff,25,0,25,0
1713322548794,MUS 13,A02,494132,Staff,25,0,25,0
1713322549818,MUS 15,A01,494134,Staff,17,0,25,8
1713322549818,MUS 15,A02,494135,Staff,25,0,25,0
1713322549818,MUS 15,B01,494137,Staff,24,0,25,1
1713322550846,MUS 80,A00,494232,Staff,24,0,25,1
1713322550846,MUS 80,B00,494233,Staff,25,0,25,0
1713322550846,MUS 80,C00,494234,Staff,23,0,25,2
1713322551873,MUS 95C,A00,494141,Staff,70,0,75,5
1713322552900,MUS 114,A00,494142,Staff,39,0,50,11
1713322553928,NANO 15,A01,490636,Drews; Aaron,7,0,7,0
1713322554953,PHIL 1,A00,490578,Grush; Rick Scott,49,0,50,1
1713322555979,PHIL 10,A01,490580,Grush; Rick Scott,33,0,35,2
1713322555979,PHIL 10,A02,490586,Grush; Rick Scott,32,0,35,3
1713322557005,PHIL 27,A01,490591,Staff,23,0,25,2
1713322557005,PHIL 27,A02,490592,Staff,25,0,25,0
1713322557005,PHIL 27,A03,490593,Staff,25,0,25,0
1713322557005,PHIL 27,A04,490598,Staff,25,0,25,0
1713322558029,PHIL 32,A01,490611,Staff,20,0,20,0
1713322558029,PHIL 32,A02,490618,Staff,20,0,20,0
1713322559060,PHIL 90,A00,490624,Staff,40,0,40,0
1713322560086,PHIL 136,A00,490627,Cohen; Jonathan David,37,0,40,3
1713322561110,PHIL 155,A00,490634,Staff,63,0,70,7
1713322562135,PHYS 1A,A00,491610,Staff,245,0,250,5
1713322563164,PHYS 1AL,001,491616,Tsai; Philbert S,28,0,30,2
1713322563164,PHYS 1AL,002,491618,Tsai; Philbert S,30,0,30,0
1713322564192,PHYS 1B,A00,491623,Staff,242,0,250,8
1713322565218,PHYS 1BL,001,491626,Tsai; Philbert S,25,0,30,5
1713322565218,PHYS 1BL,002,491628,Tsai; Philbert S,27,0,30,3
1713322566242,PHYS 1C,A00,491632,Staff,218,0,245,27
1713322567267,PHYS 1CL,001,491635,Tsai; Philbert S,7,0,30,23
1713322567267,PHYS 1CL,002,491643,Tsai; Philbert S,24,0,30,6
1713322568290,PHYS 2AR,A01,491651,Meyertholen; Andrew D.,44,0,50,6
1713322569314,PHYS 2B,A01,491659,Staff,105,0,115,10
1713322570340,PHYS 2BL,A01,491685,Staff,21,0,24,3
1713322570340,PHYS 2BL,A02,491700,Staff,21,0,24,3
1713322571369,PHYS 2C,A01,505161,Staff,105,0,115,10
1713322572396,PHYS 4A,A01,491704,Grinstein; Benjamin,99,0,100,1
1713322573424,POLI 5D,A01,494144,Staff,3,0,5,2
1713322573424,POLI 5D,B01,626283,Dai; Yinlin,5,0,5,0
1713322574452,POLI 12,A00,494145,Staff,44,0,45,1
1713322575479,POLI 13R,A00,494146,Forman; Fonna,45,0,50,5
1713322576506,POLI 27,A01,494148,Staff,57,0,60,3
1713322577534,POLI 30,A00,494149,Staff,49,0,50,1
1713322578562,POLI 100DA,A00,494150,Staff,21,0,25,4
1713322580615,POLI 100I,A00,494152,Staff,28,0,30,2
1713322581643,POLI 104B,A00,494153,Smith; Glenn Chatmas,53,0,55,2
1713322582668,POLI 104F,A00,494154,Staff,28,0,30,2
1713322583692,POLI 104I,A00,494155,Smith; Glenn Chatmas,30,0,30,0
1713322584719,POLI 110C,A00,494156,Ingham; Sean,23,0,25,2
1713322585745,POLI 117R,A00,494157,Forman; Fonna,8,0,20,12
1713322586770,POLI 118,A00,494158,Ingham; Sean,22,0,25,3
1713322587795,POLI 120H,A00,494159,Fisk; David Lee,40,0,45,5
1713322588819,POLI 131CR,A00,494160,Hoston; Germaine,36,0,45,9
1713322589844,POLI 133J,A00,494161,Staff,33,0,35,2
1713322590870,POLI 135,A00,494162,Fisk; David Lee,33,0,35,2
1713322591896,POLI 140A,A00,494164,Staff,21,0,30,9
1713322592924,POLI 142I,A00,494165,Staff,30,0,30,0
1713322593948,POLI 144D,A00,494166,Staff,23,0,25,2
1713322594976,POLI 151,A00,494167,Staff,30,0,30,0
1713322596001,POLI 153,A00,494168,Staff,33,0,35,2
1713322597029,POLI 160AA,A00,494169,Staff,35,0,40,5
1713322598057,POLI 162,A00,494170,Mignozzetti; Umberto,19,0,25,6
1713322599082,POLI 171,A00,494171,Mignozzetti; Umberto,21,0,25,4
1713322600108,PSYC 1,A00,494172,Staff,97,0,100,3
1713322601133,PSYC 2,A00,494173,Moranton; Nirelia Melbina-,38,0,50,12
1713322602162,PSYC 3,A00,494174,Staff,29,0,30,1
1713322603187,PSYC 6,A00,494175,Staff,17,0,20,3
1713322604213,PSYC 60,A01,494177,Staff,38,0,45,7
1713322605293,PSYC 70,A01,505724,Geller; Emma Harlan,42,0,45,3
1713322606320,PSYC 101,A00,494180,Heyman; Gail D.,84,0,100,16
1713322607347,PSYC 105,A00,494181,Geller; Emma Harlan,56,0,90,34
1713322608373,PSYC 106,A00,494182,Dobkins; Karen R.,29,0,45,16
1713322609400,PSYC 108,A00,494183,Adrian; Julia Anna,91,0,100,9
1713322610426,PSYC 114,A01,494185,Winkielman; Piotr,0,1,30,30
1713322611452,PSYC 122,A00,494186,Moranton; Nirelia Melbina-,31,0,50,19
1713322612480,PSYC 124,A00,494187,Chapman; Eddie Nathaniel,71,0,80,9
1713322613505,PSYC 131,A00,494188,Anagnostaras; Stephan,47,0,80,33
1713322614533,PSYC 144,A00,494189,Staff,9,0,50,41
1713322615560,PSYC 154,A00,494190,Lacefield; Katharine I,118,0,180,62
1713322616588,PSYC 162,A00,494191,Wixted; John T,74,0,100,26
1713322617615,PSYC 172,A00,494192,Gorman; Michael R.,36,0,45,9
1713322618640,PSYC 178,A00,494193,Glaser; Dale,34,0,45,11
1713322619665,PSYC 193,A00,505725,Chapman; Eddie Nathaniel,20,0,20,0
1713322620688,RELI 145GS,A00,519817,Rahimi; Babak,18,0,20,2
1713322621712,SE 101A,A01,490862,Chadha; Mayank,23,0,25,2
1713322622737,SE 101C,A01,490924,Krysl; Petr,16,0,20,4
1713322623761,SE 110A,A01,490928,Staff,19,0,20,1
1713322624786,SE 130A,A00,490929,Morrison; Machel Leigh,57,0,70,13
1713322625812,SIO 1,A01,519325,Staff,39,0,40,1
1713322626838,SIO 30,A01,519327,Staff,38,0,40,2
1713322627862,SIO 40,A00,519328,Staff,39,0,40,1
1713322628888,SIO 46GS,A00,519819,Cook; Geoffrey W,17,0,25,8
1713322629915,SIO 109R,A00,494197,Forman; Fonna,0,0,20,20
1713322630941,SIO 121GS,A00,519827,Cook; Geoffrey W,17,0,25,8
1713322631968,SIO 132,A01,519330,Staff,38,0,40,2
1713322632993,SIO 133,A01,519397,Staff,37,0,40,3
1713322634016,SIO 139,A00,519396,Kacev; David,31,0,40,9
1713322635043,SOCI 1,A01,494199,Thorpe; Charles Robert,22,0,30,8
1713322635043,SOCI 1,A02,494200,Thorpe; Charles Robert,30,0,30,0
1713322635043,SOCI 1,A03,494201,Thorpe; Charles Robert,29,0,30,1
1713322635043,SOCI 1,A04,494202,Thorpe; Charles Robert,29,0,30,1
1713322635043,SOCI 1,A05,494203,Thorpe; Charles Robert,29,0,30,1
1713322635043,SOCI 1,A06,494204,Thorpe; Charles Robert,30,0,30,0
1713322635043,SOCI 1,A07,494205,Thorpe; Charles Robert,28,0,30,2
1713322636067,SOCI 60,A01,494207,Staff,34,0,40,6
1713322636067,SOCI 60,A02,494208,Staff,39,0,40,1
1713322637096,SOCI 100,A01,494210,Payne; Christine Anna,27,0,30,3
1713322637096,SOCI 100,A02,494211,Payne; Christine Anna,26,0,30,4
1713322638120,SOCI 109M,A00,494212,Staff,20,0,20,0
1713322639148,SOCI 110,A00,494213,Staff,35,0,40,5
1713322641200,SOCI 118E,A00,494215,Ng; Kwai,37,0,40,3
1713322642226,SOCI 125,A00,494216,Calderon-Zaks; Michael Aar,42,0,45,3
1713322643254,SOCI 126,A01,494218,Jones; Makeba,3,0,5,2
1713322644278,SOCI 131,A00,494219,Thorpe; Charles Robert,28,0,30,2
1713322646329,SOCI 135,A00,494221,Payne; Christine Anna,31,0,50,19
1713322647357,SOCI 136E,A00,626690,Ruiz; Jonathan Joseph,25,0,25,0
1713322648384,SOCI 138GS,A00,494222,Navon; Daniel,24,0,28,4
1713322650437,SOCI 145,A00,494224,Staff,41,0,45,4
1713322651462,SOCI 153,A00,494225,Staff,28,0,30,2
1713322652485,SOCI 160E,A00,494226,Ng; Kwai,30,0,40,10
1713322653509,SOCI 180,A00,494227,Staff,29,0,30,1
1713322654537,SOCI 189GS,A00,494228,Ribas Norris; Janet Vanesa,11,0,11,0
1713322655560,SOCI 190GS,A00,553232,Ribas Norris; Janet Vanesa,11,0,11,0
1713322656585,SOMI 220,A00,627178,Schneid; Stephen David,30,0,30,0
1713322657614,SYN 2,001,490768,Staff,14,0,15,1
1713322657614,SYN 2,002,490769,Staff,15,0,15,0
1713322657614,SYN 2,004,490775,Staff,0,0,0,0
1713322657614,SYN 2,003,490774,Staff,0,0,0,0
1713322657614,SYN 2,005,490776,Staff,0,0,0,0
1713322658638,SYN 2R,001,490779,Staff,12,0,15,3
1713322658638,SYN 2R,002,514635,Staff,14,0,15,1
1713322659666,SYN 100,A01,490783,Staff,13,0,20,7
1713322659666,SYN 100,B01,490787,Staff,9,0,20,11
1713322659666,SYN 100,C01,490789,Staff,11,0,20,9
1713322660690,SYN 150,A00,490817,Staff,14,0,15,1
1713322660690,SYN 150,B00,514610,Staff,15,0,15,0
1713322661715,TDAC 1,A00,492753,Walsh; Kim C.,19,0,20,1
1713322661715,TDAC 1,B00,492754,Harting; Carla Kelso,19,0,20,1
1713322661715,TDAC 1,C00,513995,Salovey; Todd,15,0,20,5
1713322662744,TDAC 101,A00,492766,Harting; Carla Kelso,17,0,20,3
1713322663769,TDAC 102,A00,492768,Basso; Beatrice,19,0,20,1
1713322664797,TDDE 111,A00,492769,Staff,25,0,25,0
1713322665824,TDDE 131,A00,492770,Staff,15,0,15,0
1713322665824,TDDE 131,B00,492771,Staff,15,0,15,0
1713322666849,TDDE 131GS,A00,523716,Guirguis; Mark C,24,0,28,4
1713322667874,TDGE 1,A01,492756,Salovey; Todd,57,0,60,3
1713322668899,TDGE 5,A01,492758,Staff,23,0,25,2
1713322669927,TDGE 10,A00,492759,Fulton; Julia,205,0,220,15
1713322670953,TDGE 11,A00,492760,Castro; Robert Jess,198,0,200,2
1713322673004,TDGE 124,A00,492772,Fulton; Julia,189,0,220,31
1713322674029,TDGE 125,A00,492773,Meyer; Ursula,38,0,50,12
1713322674029,TDGE 125,B00,492774,Staff,49,0,50,1
1713322674029,TDGE 125,C00,523565,Staff,48,0,50,2
1713322675054,TDGE 125GS,A00,523580,Guirguis; Mark C,24,0,28,4
1713322676082,TDGE 127,A00,492775,Havis; Allan,38,0,50,12
1713322677108,TDHT 101,A00,492776,Staff,34,0,35,1
1713322678135,TDMV 1,A00,492762,Caligagan; Maria T.,30,0,30,0
1713322678135,TDMV 1,B00,492763,Arcidiacono; Kristin,25,0,30,5
1713322679161,TDMV 2,A00,492764,Weinberg; Sadie,29,0,30,1
1713322680187,TDMV 3,A00,492765,Mack; Kara Shanai',38,0,40,2
1713322681213,TDMV 138,A00,492777,Mack; Kara Shanai',34,0,40,6
1713322682241,TDMV 140,A00,492778,Lima; Paulo Henrique,40,0,40,0
1713322683271,TDMV 142,A00,492779,Caligagan; Maria T.,34,0,40,6
1713322683271,TDMV 142,B00,492780,Caligagan; Tony,37,0,40,3
1713322684294,TDMV 143,A00,492781,Fyall; Daunte Edward,39,0,40,1
1713322685319,USP 1,A01,492401,Kwak; Nancy,26,0,35,9
1713322686343,USP 2,A01,492453,Hinds; Juli Beth,35,0,35,0
1713322687371,USP 3,A01,492516,Staff,28,0,35,7
1713322688395,USP 4,A00,492522,McTague; Sarah,17,0,25,8
1713322689421,USP 100,A00,492523,Staff,32,0,35,3
1713322690447,USP 101,A00,492524,Staff,13,0,15,2
1713322691470,USP 105,A00,492525,Staff,21,0,25,4
1713322692494,USP 151,A00,492526,Shenkman; Michael Thomas,32,0,35,3
1713322693523,USP 170,A00,492545,Hinds; Juli Beth,33,0,35,2
1713322694550,USP 171GS,A00,492608,Bussell; Mirle Rabinowitz,24,0,28,4
1713322695575,USP 183GS,A00,492613,Peerson; Susan,24,0,28,4
1713322696600,VIS 30,A01,490693,Yoldas; Pinar,19,0,22,3
1713322696600,VIS 30,A02,490694,Yoldas; Pinar,18,0,22,4
1713322697627,VIS 83,A00,490695,Kester; Grant,63,0,75,12
1713322698651,VIS 105D,A00,490696,Staff,22,0,25,3
1713322699676,VIS 124CN,A00,490699,Rose; Jordan M,66,0,75,9
1713322700703,VIS 125GS,A00,511221,Williams; Alena J,21,0,22,1
1713322701727,VIS 128D,A00,490700,Staff,73,0,75,2
1713322702752,VIS 151,A01,490717,Staff,33,0,34,1
1713322702752,VIS 151,A02,490766,Staff,33,0,34,1
1713322703776,VIS 154GS,A00,511972,Williams; Alena J,21,0,22,1
1713322704803,VIS 160A,A00,490767,Stone; Patricia,7,0,10,3
1713322705829,WCWP 10A,A00,490638,Staff,14,0,15,1
1713322705829,WCWP 10A,B00,490640,Staff,15,0,15,0
1713322706857,WCWP 10B,A00,490641,Staff,0,0,0,0
1713322706857,WCWP 10B,B00,490642,Staff,14,0,15,1
1713322706857,WCWP 10B,C00,490644,Staff,13,0,15,2
1713322706857,WCWP 10B,D00,490647,Staff,0,0,0,0
1713322707883,WCWP 100,A00,490655,Staff,0,0,0,0
1713322707883,WCWP 100,B00,490687,Staff,10,0,15,5
1713322710002,ANAR 153,A00,487222,Braswell; Geoffrey E.,54,0,60,6
1713322711027,ANBI 134,A00,487223,Staff,7,0,20,13
1713322712054,ANBI 143GS,A00,487224,Noel; Geoffroy Pierre Jean,18,0,24,6
1713322713079,ANBI 144GS,A00,519548,Noel; Geoffroy Pierre Jean,18,0,24,6
1713322714105,ANSC 101,A00,487225,Staff,18,0,20,2
1713322715132,ANSC 125,A00,487227,Brenner; Suzanne A,39,0,40,1
1713322717187,ANSC 146,A00,487229,Staff,35,0,40,5
1713322718212,ANSC 148,A00,487230,Olivas Hernandez; Olga Lid,39,0,40,1
1713322719239,ANSC 150,A00,504165,Sloane; Julia Kathryn,19,0,20,1
1713322720266,ANSC 180,A00,487232,Staff,14,0,15,1
1713322721293,ANSC 188,A00,627155,Staff,39,0,40,1
1713322722316,ANTH 5,A00,519529,Semendeferi; Ekaterini,15,0,15,0
1713322723342,ANTH 10,A00,487219,Staff,58,0,60,2
1713322724371,ANTH 23,A01,487221,Staff,17,0,20,3
1713322725396,ANTH 102,A00,487233,Wilder; Linnea Lorene,51,0,60,9
1713322726419,ANTH 103,A00,487234,Varma; Saiba,55,0,60,5
1713322739065,ANTH 105,A00,487235,Stewart; Alexander B,55,0,60,5
1713322740093,BENG 100,A01,516685,Taylor Amos; Alyssa C,27,0,30,3
1713322741122,BIBC 102,A01,491316,Flagg; Matthew Paul,22,0,88,66
1713322741122,BIBC 102,A02,491366,Flagg; Matthew Paul,81,0,88,7
1713322742149,BIBC 103,A01,491486,Boumechache; Miyyada,16,0,24,8
1713322742149,BIBC 103,A02,491487,Boumechache; Miyyada,24,0,24,0
1713322743175,BICD 100,A01,516882,Staff,74,0,75,1
1713322743175,BICD 100,A02,516890,Staff,69,0,75,6
1713322744206,BICD 102GS,A00,491488,Lo; Stanley M.,26,0,28,2
1713322745234,BIEB 136GS,A00,516940,Holway; David A. & Shurin; Jonathan,19,0,24,5
1713322746258,BIEB 137GS,A01,517034,Holway; David A. & Shurin; Jonathan,19,0,24,5
1713322747286,BIEB 138GS,A01,491492,Pirino; Giorgia,21,0,28,7
1713322748313,BILD 1,A01,491296,Staff,61,0,63,2
1713322748313,BILD 1,A02,491297,Staff,63,0,63,0
1713322749338,BILD 4,A01,517099,Gonzalez Gamboa; Ivonne,22,0,24,2
1713322749338,BILD 4,A02,517100,Gonzalez Gamboa; Ivonne,24,0,24,0
1713322750366,BILD 60GS,A00,491309,Lo; Stanley M.,26,0,28,2
1713322751394,BIMM 100,A01,517136,Staff,87,0,100,13
1713322752418,BIMM 110,A01,517182,Staff,61,0,100,39
1713322753446,BIMM 120,A01,517228,Pickett; Brooke Elizabeth,31,0,63,32
1713322753446,BIMM 120,A02,517240,Pickett; Brooke Elizabeth,45,0,63,18
1713322754469,BIMM 132GS,A01,491498,Pirino; Giorgia,21,0,28,7
1713322755493,BIMM 143,A01,491589,Bozinovic; Goran,14,0,40,26
1713322756519,BIPN 100,A01,491594,Armour; Jon Christopher,90,0,100,10
1713322757549,BIPN 140,A01,491602,Marino; Marc J,27,0,50,23
1713322759599,CAT 125,A00,515973,Staff,18,0,20,2
1713322760625,CAT 125GS,A00,515974,Rahimi; Babak,17,0,20,3
1713322761651,CAT 125R,A00,515980,Staff,13,0,20,7
1713322761651,CAT 125R,B00,515981,Tosun; Adriana,19,0,20,1
1713322761651,CAT 125R,C00,515987,Hyland; Tina Mae,0,2,20,20
1713322761651,CAT 125R,D00,515988,Bronstein; Phoebe Malan,17,0,20,3
1713322762679,CENG 15,A01,488699,Drews; Aaron,25,0,25,0
1713322763704,CENG 100,A00,505196,Opatkiewicz; Justin Paul,25,0,25,0
1713322764732,CGS 2A,A01,489598,Staff,33,0,35,2
1713322765758,CGS 112,A00,489599,Staff,15,0,15,0
1713322766784,CGS 119,A00,489603,Staff,10,0,10,0
1713322767809,CGS 120,A00,489604,Staff,14,0,15,1
1713322768839,CGS 150,A00,489607,Staff,15,0,15,0
1713322769869,CHEM 6A,A01,488715,Staff,98,0,100,2
1713322770899,CHEM 6B,A01,488719,Piercy; Marc Anthony,100,0,100,0
1713322771922,CHEM 6C,A01,488723,Albizati; Kim F.,93,0,100,7
1713322772954,CHEM 7L,A01,488728,Schurmeier; Kimberly,18,0,24,6
1713322772954,CHEM 7L,A02,488730,Schurmeier; Kimberly,23,0,24,1
1713322772954,CHEM 7L,A03,488734,Schurmeier; Kimberly,22,0,24,2
1713322772954,CHEM 7L,A04,488763,Schurmeier; Kimberly,23,0,24,1
1713322772954,CHEM 7L,B01,488798,Schurmeier; Kimberly,17,0,24,7
1713322772954,CHEM 7L,B02,488801,Schurmeier; Kimberly,23,0,24,1
1713322772954,CHEM 7L,B03,488808,Schurmeier; Kimberly,23,0,24,1
1713322772954,CHEM 7L,B04,488811,Schurmeier; Kimberly,24,0,24,0
1713322773979,CHEM 11,A01,488897,Stallings; Dontarie M,96,0,100,4
1713322775009,CHEM 40A,A01,488913,Albizati; Kim F.,86,0,100,14
1713322776035,CHEM 40B,A01,488920,Weizman; Haim,44,0,50,6
1713322776035,CHEM 40B,A02,488938,Weizman; Haim,45,0,50,5
1713322777059,CHEM 41A,A01,489029,Klosterman; Jeremy K,57,0,60,3
1713322778084,CHEM 41C,A01,500436,Tor; Yitzhak,55,0,60,5
1713322779114,CHEM 43A,A01,500426,Weizman; Haim,0,0,24,24
1713322779114,CHEM 43A,A02,500430,Weizman; Haim,13,0,24,11
1713322779114,CHEM 43A,B01,514041,Klosterman; Jeremy K,15,0,24,9
1713322779114,CHEM 43A,B02,514047,Klosterman; Jeremy K,23,0,24,1
1713322780140,CHEM 108,A01,489140,Jennings; Patricia A.,11,0,24,13
1713322780140,CHEM 108,A02,489142,Jennings; Patricia A.,14,0,24,10
1713322781166,CHEM 114A,A01,489147,Stallings; Dontarie M,74,0,100,26
1713322782191,CHIN 169A,A00,489171,Wang; Xiao,19,0,20,1
1713322784242,COGS 3,A01,518827,Boyle; Mary E. T.,27,0,40,13
1713322785267,COGS 11,A01,489175,Staff,28,0,30,2
1713322786293,COGS 14A,A01,518829,Staff,51,0,60,9
1713322787322,COGS 14B,A01,489177,Hoffman; Drew Ellen,65,0,75,10
1713322788348,COGS 100,A01,489181,Allen; Michael Gordon,64,0,75,11
1713322789377,COGS 101A,A01,489183,Staff,47,0,60,13
1713322790407,COGS 101B,A01,489185,Allen; Michael Gordon,8,0,30,22
1713322791434,COGS 101C,A01,526786,Staff,24,0,30,6
1713322793490,COGS 107A,A01,489189,Boyle; Mary E. T.,19,0,35,16
1713322794515,COGS 107B,A01,627144,Mooshagian; Eric Frederick,60,0,60,0
1713322795541,COGS 118A,A01,489191,Staff,0,40,40,40
1713322797596,COGS 171GS,A01,489194,Pineda; Jaime A,21,0,28,7
1713322798622,COGS 172,A01,489196,Staff,3,0,30,27
1713322799647,COGS 174GS,A01,489264,Pineda; Jaime A,21,0,28,7
1713322800677,COGS 180,A01,627150,Staff,28,0,30,2
1713322801701,COGS 186,A01,489274,Staff,0,1,30,30
1713322802729,COMM 10,A01,489276,Staff,23,0,25,2
1713322802729,COMM 10,A02,489303,Staff,23,0,25,2
1713322803759,COMM 100A,A01,489312,Staff,14,0,25,11
1713322803759,COMM 100A,A02,489313,Staff,24,0,25,1
1713322804788,COMM 106T,A00,512540,Staff,33,0,35,2
1713322805815,COMM 107,A00,489347,Staff,28,0,35,7
1713322806844,COMM 109P,A00,489358,Staff,31,0,35,4
1713322807874,COMM 132,A00,489361,McKenna; Denise,28,0,30,2
1713322808898,COMM 146,A00,489362,Halm; Gavin Patrick,26,0,30,4
1713322809926,COMM 190,A00,489363,Abuelhiga; Soraya Jill,17,0,23,6
1713322810956,CSE 8A,A50,489366,Staff,21,0,25,4
1713322810956,CSE 8A,A51,489367,Staff,24,0,25,1
1713322811980,CSE 11,A01,489398,Cao; Yingjun,78,0,100,22
1713322813009,CSE 12,A01,489487,Staff,43,0,50,7
1713322814037,CSE 20,A01,489497,Staff,48,0,50,2
1713322815065,CSE 21,A01,489517,Braun; Oliver,42,0,50,8
1713322816096,CSE 101,A01,489524,Braun; Oliver,0,28,50,50
1713322817125,CSE 105,A01,512594,Jones; Miles E,74,0,100,26
1713322817125,CSE 105,B01,512598,Jones; Miles E,55,0,100,45
1713322818156,CSE 140,A01,489538,Staff,43,0,50,7
1713322819184,CSE 141,A01,489550,Eldon; John,70,0,100,30
1713322820208,CSE 141L,A01,489571,Eldon; John,68,0,100,32
1713322821231,CSE 151A,A01,489583,Solares; Edwin A,143,0,200,57
1713322822260,CSE 175,A01,510886,Kumar; Rakesh,30,0,30,0
1713322823285,CSE 190,A00,516828,Dubnov; Shlomo,38,0,49,11
1713322824362,DOC 100D,A00,489667,Pass; Natalye Joann,19,0,25,6
1713322825388,DSC 10,A01,624268,Staff,72,0,75,3
1713322826412,DSC 20,A01,624476,Staff,50,0,50,0
1713322827436,DSC 40A,A01,624608,Staff,39,0,40,1
1713322828461,DSGN 1,A01,489179,Rill; Bryan,35,0,50,15
1713322829489,ECE 17,A01,490489,Sahay; Rajeev,18,0,30,12
1713322830513,ECE 65,A50,490492,Staff,13,0,20,7
1713322830513,ECE 65,A51,490493,Staff,19,0,20,1
1713322831537,ECON 1,A01,489715,Famulari; Melissa,68,0,70,2
1713322832565,ECON 2,A01,489717,Levkoff; Steven B.,68,0,70,2
1713322833594,ECON 3,A01,489948,Staff,70,0,70,0
1713322835649,ECON 5,A01,490103,Staff,27,0,30,3
1713322835649,ECON 5,B01,626281,Dai; Yinlin,45,0,45,0
1713322836674,ECON 100A,A01,490127,Famulari; Melissa,66,0,70,4
1713322837699,ECON 100B,A01,490129,Staff,64,0,70,6
1713322838724,ECON 109,A01,490187,Shishkin; Denis,27,0,35,8
1713322839753,ECON 110A,A01,490190,Levkoff; Steven B.,60,0,70,10
1713322840779,ECON 120A,A01,490245,Dai; Yinlin,62,0,70,8
1713322841805,ECON 120B,A01,490247,Nieto-Barthaburu; Augusto,48,0,70,22
1713322842832,ECON 120C,A01,490253,Sun; Yixiao,30,0,35,5
1713322842832,ECON 120C,B01,490255,Sun; Yixiao,34,0,35,1
1713322843868,ECON 129,A00,490256,Eckert; Fabian Paul,24,0,35,11
1713322844893,ECON 131,A00,490257,Nieto-Barthaburu; Augusto,0,6,35,35
1713322845921,ECON 138,A00,490258,Bharadwaj; Prashant,16,0,35,19
1713322845921,ECON 138,B00,490259,Bharadwaj; Prashant,16,0,35,19
1713322846945,ECON 159,A00,490260,Hendrickson; Gerald M.,0,8,0,0
1713322847973,ECON 178,A01,553995,Zhu; Ying,24,0,35,11
1713322848998,EDS 40,A01,512576,Black; Alison Michelle,20,0,20,0
1713322850022,EDS 107,A01,515848,Staff,30,0,30,0
1713322851050,EDS 110R,A01,490262,Staff,26,0,30,4
1713322852074,EDS 112,A01,490264,Chapman; Thandeka K,41,0,50,9
1713322853101,EDS 113,A00,490266,Staff,26,0,30,4
1713322854130,EDS 118,A00,490267,Warstadt; Melissa Fawn,21,0,30,9
1713322855157,EDS 124BR,A00,490268,Eguchi; Emi,4,0,25,21
1713322855157,EDS 124BR,B00,490269,Eguchi; Emi,24,0,25,1
1713322856180,EDS 126,A01,490271,Jones; Makeba,44,0,50,6
1713322857203,EDS 135,A01,490316,Staff,19,0,20,1
1713322858229,ENVR 142GS,A00,519514,Chang; Edmond Yi-Teh,27,0,28,1
1713322859254,ETHN 103,A00,490504,Staff,27,0,36,9
1713322860277,ETHN 103A,A00,490505,Man; Simeon S,5,0,9,4
1713322861307,ETHN 109,A00,490506,Staff,29,0,30,1
1713322862333,ETHN 118,A00,490507,Staff,35,0,36,1
1713322863360,ETHN 119,A00,490508,Staff,33,0,36,3
1713322864390,ETHN 121R,A00,490518,Choi; Esther Min,24,0,36,12
1713322865416,ETHN 127,A00,490528,Staff,15,0,15,0
1713322866440,ETHN 139,A00,490573,Staff,10,0,10,0
1713322867465,ETHN 150,A00,490575,Staff,15,0,15,0
1713322868489,GLBH 20,A00,491705,Elwardani; Nile Regina,38,0,40,2
1713322869512,GLBH 101,A00,491706,Staff,20,0,20,0
1713322870540,GLBH 111,A01,491708,Burgos; Jose L.,15,0,15,0
1713322871564,GLBH 146,A00,491709,Staff,11,0,20,9
1713322872589,GLBH 148,A00,491710,Olivas Hernandez; Olga Lid,13,0,20,7
1713322873614,GLBH 150,A00,491711,Sloane; Julia Kathryn,20,0,20,0
1713322874641,HIEA 131,A00,491760,Staff,29,0,32,3
1713322875670,HIEA 153,A00,491762,Staff,29,0,30,1
1713322876694,HIEU 124,A00,491811,Staff,26,0,32,6
1713322877722,HIEU 124GS,A00,491812,Markman; Kristina,27,0,28,1
1713322878750,HIEU 147,A00,491813,Staff,30,0,32,2
1713322879779,HIEU 149GS,A00,491816,Caldwell; Michael Alan,28,0,28,0
1713322880805,HILD 2C,A01,491713,Hendrickson; Gerald M.,27,0,30,3
1713322881830,HILD 7B,A01,491715,Kwak; Nancy,1,0,30,29
1713322882854,HILD 10,A01,491717,Staff,13,0,20,7
1713322883883,HILD 30GS,A00,491719,Edington; Claire Ellen,24,0,28,4
1713322884906,HINE 109,A00,491818,Shafir; Nir,27,0,32,5
1713322885932,HINE 128,A00,491821,Shafir; Nir,31,0,32,1
1713322886957,HISC 117,A00,491830,Staff,27,0,32,5
1713322887987,HIUS 103,A00,491834,Man; Simeon S,15,0,23,8
1713322889015,HIUS 108B,A00,491835,Staff,28,0,30,2
1713322890040,HIUS 141,A00,491836,Hendrickson; Gerald M.,29,0,32,3
1713322891069,HIUS 149,A00,491839,Staff,27,0,32,5
1713322892099,HUM 3,A01,512617,Crum; Matthew Stephen,43,0,50,7
1713322892099,HUM 3,A02,512618,Crum; Matthew Stephen,48,0,50,2
1713322893126,HUM 3GS,A00,512663,Markman; Kristina,0,0,0,1
1713322893126,HUM 3GS,B00,512664,Staff,0,0,0,0
1713322894156,HUM 4,A01,512620,West; Geoffrey Scott,30,0,50,20
1713322895180,HUM 4GS,A00,512666,Lyon; Antony J.,0,0,0,4
1713322896211,HUM 4R,A01,512625,Watkins; Eric,49,0,50,1
1713322897240,HUM 5,A01,512649,Zavodny; Tatiana Sophia,26,0,50,24
1713322897240,HUM 5,B01,512661,Zroka; Ryan Edward,48,0,50,2
1713322898266,INTL 190,A00,490577,Segui; Alan S,0,0,0,5
1713322899290,JAPN 20AR,A01,491267,Ross; Kayoko F,8,0,20,12
1713322900318,JAPN 180,A00,491285,Berman; Michael David,33,0,40,7
1713322901348,LATI 50,A01,502536,Kokinis; Troy Andreas,16,0,22,6
1713322901348,LATI 50,A02,502551,Kokinis; Troy Andreas,22,0,22,0
1713322901348,LATI 50,A03,502650,Kokinis; Troy Andreas,22,0,22,0
1713322901348,LATI 50,A04,502909,Kokinis; Troy Andreas,22,0,22,0
1713322902374,LATI 160,A01,502920,Kokinis; Troy Andreas,30,0,30,0
1713322903405,LIFR 1A,A00,490494,Van Moer; Vinciane G,17,0,20,3
1713322904432,LIFR 1AX,A00,490495,Van Moer; Vinciane G,17,0,20,3
1713322905456,LIFR 1B,A00,490496,Van Moer; Vinciane G,18,0,20,2
1713322906479,LIFR 1BX,A00,490497,Van Moer; Vinciane G,18,0,20,2
1713322907507,LIGN 8,A00,505198,McIntosh; Justin Daniel,135,0,150,15
1713322908532,LIGN 9GS,A00,491239,Lott; Margaret S.,18,0,20,2
1713322909556,LIGN 101,A01,505200,McIntosh; Justin Daniel,23,0,30,7
1713322910584,LIGN 120,A01,491244,Staff,23,0,30,7
1713322911613,LIGN 149GS,A00,491245,Lott; Margaret S.,18,0,20,2
1713322912637,LIGN 170,A00,491247,Staff,22,0,30,8
1713322913661,LISP 1D,A00,490498,Munoz Sanchez; Alicia,10,0,14,4
1713322913661,LISP 1D,B00,490499,Munoz Sanchez; Alicia,6,0,14,8
1713322913661,LISP 1D,C00,490500,Munoz Sanchez; Alicia,8,0,14,6
1713322913661,LISP 1D,D00,490501,Munoz Sanchez; Alicia,10,0,14,4
1713322914688,LISP 1DX,A00,490502,Munoz Sanchez; Alicia,15,0,28,13
1713322914688,LISP 1DX,B00,490503,Munoz Sanchez; Alicia,17,0,28,11
1713322916740,LTAM 110,A00,491847,Staff,23,0,25,2
1713322917768,LTCS 119,A00,491848,Staff,11,0,15,4
1713322918796,LTCS 130,A00,491849,Staff,24,0,25,1
1713322920849,LTEA 120C,A00,491852,Staff,32,0,40,8
1713322921871,LTEN 130GS,A00,491853,Lyon; Antony J.,24,0,28,4
1713322922895,LTEN 148,A00,491855,Staff,23,0,25,2
1713322923926,LTEN 159,A00,491856,Staff,21,0,25,4
1713322924953,LTEN 180,A00,491857,Staff,8,0,15,7
1713322927003,LTSP 123GS,A00,505928,Bessett; Ryan Matthew,24,0,28,4
1713322928082,LTSP 174GS,A00,506037,Bessett; Ryan Matthew,24,0,28,4
1713322930133,LTWR 102,A00,491861,Staff,9,0,15,6
1713322931157,LTWR 106,A00,491862,Staff,10,0,15,5
1713322932181,MAE 11,A00,490930,Bahadori; Mohammad Yousef,96,0,100,4
1713322933204,MAE 30A,A00,490931,Qi; Huihui,37,0,40,3
1713322934230,MAE 101A,A00,491036,Sadeghizadeh; Zahra,96,0,100,4
1713322935254,MAE 101C,A00,491037,Seshadri; Kalyanasundaram,71,0,100,29
1713322936278,MAE 113,A00,491040,Seshadri; Kalyanasundaram,66,0,80,14
1713322937301,MAE 131A,A00,491041,Ghazinejad; Maziar,37,0,40,3
1713322938333,MAE 142,A00,491053,Staff,39,0,40,1
1713322939356,MAE 143A,A00,491054,Staff,34,0,50,16
1713322940380,MAE 150,A00,491092,Truong; Phuong Thi Ngoc,23,0,35,12
1713322941408,MATH 3C,A01,494031,Pardo Guerra; Sebastian,30,0,30,0
1713322941408,MATH 3C,A02,494032,Pardo Guerra; Sebastian,29,0,30,1
1713322942434,MATH 10A,A01,494034,Staff,27,0,30,3
1713322942434,MATH 10A,A02,494035,Staff,28,0,30,2
1713322942434,MATH 10A,B01,494037,Staff,27,0,30,3
1713322942434,MATH 10A,B02,494038,Staff,29,0,30,1
1713322943459,MATH 10B,A01,494040,Habib; Yousaf,22,0,30,8
1713322943459,MATH 10B,A02,494041,Habib; Yousaf,28,0,30,2
1713322943459,MATH 10B,A03,494042,Habib; Yousaf,29,0,30,1
1713322943459,MATH 10B,A04,494043,Habib; Yousaf,30,0,30,0
1713322943459,MATH 10B,B01,494045,Habib; Yousaf,26,0,30,4
1713322943459,MATH 10B,B02,494046,Habib; Yousaf,30,0,30,0
1713322943459,MATH 10B,B03,494047,Habib; Yousaf,30,0,30,0
1713322943459,MATH 10B,B04,494048,Habib; Yousaf,30,0,30,0
1713322944482,MATH 18,A01,494050,Kemp; Todd Aahron,25,0,30,5
1713322944482,MATH 18,A02,494051,Kemp; Todd Aahron,29,0,30,1
1713322944482,MATH 18,B01,494054,Kemp; Todd Aahron,27,0,30,3
1713322944482,MATH 18,B02,494055,Kemp; Todd Aahron,29,0,30,1
1713322945508,MATH 20A,A01,494059,Suk; Andrew Hoon,30,0,30,0
1713322946532,MATH 20B,A01,494061,Briones; Jor-el Thomas Caparas,33,0,35,2
1713322946532,MATH 20B,B01,494063,Bach; Quang Tran,34,0,35,1
1713322947562,MATH 20C,A01,494065,Staff,28,0,30,2
1713322947562,MATH 20C,A02,494066,Staff,30,0,30,0
1713322947562,MATH 20C,A03,494067,Staff,30,0,30,0
1713322947562,MATH 20C,A04,494068,Staff,30,0,30,0
1713322947562,MATH 20C,B01,494070,Zhang; Ming,26,0,30,4
1713322947562,MATH 20C,B02,494071,Zhang; Ming,27,0,30,3
1713322947562,MATH 20C,B03,494072,Zhang; Ming,29,0,30,1
1713322947562,MATH 20C,B04,494073,Zhang; Ming,29,0,30,1
1713322948587,MATH 20D,A01,494075,Staff,22,0,30,8
1713322948587,MATH 20D,A02,494076,Staff,30,0,30,0
1713322949610,MATH 20E,A01,494079,Staff,24,0,30,6
1713322949610,MATH 20E,A02,494080,Staff,26,0,30,4
1713322949610,MATH 20E,B01,494082,Staff,25,0,30,5
1713322949610,MATH 20E,B02,494083,Staff,25,0,30,5
1713322950636,MATH 103A,A01,494085,Aliabadi Sr.; Mohsen,14,0,30,16
1713322950636,MATH 103A,A02,494086,Aliabadi Sr.; Mohsen,28,0,30,2
1713322950636,MATH 103A,B01,494088,Aliabadi Sr.; Mohsen,22,0,30,8
1713322950636,MATH 103A,B02,494089,Aliabadi Sr.; Mohsen,28,0,30,2
1713322951666,MATH 109,A01,494091,Staff,30,0,30,0
1713322951666,MATH 109,A02,494092,Staff,29,0,30,1
1713322951666,MATH 109,B01,494094,Staff,27,0,30,3
1713322951666,MATH 109,B02,494095,Staff,29,0,30,1
1713322952691,MATH 142A,A01,494097,Chow; Bennett,15,0,30,15
1713322952691,MATH 142A,A02,494098,Chow; Bennett,24,0,30,6
1713322952691,MATH 142A,B01,494100,Chow; Bennett,19,0,30,11
1713322952691,MATH 142A,B02,494101,Chow; Bennett,29,0,30,1
1713322954745,MATH 168A,A01,516677,Dumitriu; Ioana,15,0,35,20
1713322955769,MATH 170A,A01,516679,Dumitriu; Ioana,19,0,30,11
1713322955769,MATH 170A,A02,516680,Dumitriu; Ioana,28,0,30,2
1713322956793,MATH 193A,A01,494107,Staff,14,0,30,16
1713322956793,MATH 193A,A02,494108,Staff,21,0,30,9
1713322956793,MATH 193A,A03,494109,Staff,29,0,30,1
1713322956793,MATH 193A,A04,494110,Staff,22,0,30,8
1713322959867,MGT 16,A00,491930,McKay; Michael J,92,0,98,6
1713322960897,MGT 18,A00,491992,McKay; Michael J,96,0,98,2
1713322961924,MGT 71,A00,492003,Staff,67,0,98,31
1713322962947,MGT 103,A00,505209,Eberhard; Craig A,81,0,98,17
1713322963972,MGT 131A,A00,505210,Anderson; John Charles,90,0,98,8
1713322966024,MGT 153,A00,492077,Perols; Johan Lars,23,0,90,67
1713322969105,MGT 164,A00,492222,McKay; Mary A,91,0,98,7
1713322970136,MGT 172,A00,492245,Staff,59,0,60,1
1713322970136,MGT 172,B00,505526,Hedges; Kathleen,66,0,98,32
1713322971161,MGT 181,A00,505669,Dunn; Louis Jean,84,0,98,14
1713322972190,MMW 14,A01,494399,Staff,19,0,28,9
1713322972190,MMW 14,A02,494400,Staff,25,0,28,3
1713322972190,MMW 14,A03,494401,Staff,28,0,28,0
1713322972190,MMW 14,A04,494402,Staff,28,0,28,0
1713322972190,MMW 14,B01,494404,Carreras; Maria Victoria,10,0,28,18
1713322972190,MMW 14,B02,494405,Carreras; Maria Victoria,25,0,28,3
1713322972190,MMW 14,B03,494406,Carreras; Maria Victoria,27,0,28,1
1713322972190,MMW 14,B04,494407,Carreras; Maria Victoria,28,0,28,0
1713322973216,MMW 14GS,A00,506250,Chang; Edmond Yi-Teh,0,0,0,0
1713322974239,MMW 121R,A01,494415,Adamiak; Patrick John,12,0,28,16
1713322974239,MMW 121R,A02,494416,Adamiak; Patrick John,24,0,28,4
1713322975262,MUS 1A,A01,494113,Staff,12,0,25,13
1713322975262,MUS 1A,A02,494114,Staff,24,0,25,1
1713322976289,MUS 4,A01,494116,Staff,24,0,25,1
1713322976289,MUS 4,A02,494117,Staff,22,0,25,3
1713322977314,MUS 5R,A01,494236,Dubnov; Shlomo,9,0,25,16
1713322977314,MUS 5R,A02,494237,Dubnov; Shlomo,25,0,25,0
1713322978340,MUS 6,A01,494122,Staff,11,0,25,14
1713322978340,MUS 6,A02,494123,Staff,24,0,25,1
1713322979366,MUS 7,A01,494125,Staff,16,0,25,9
1713322979366,MUS 7,A02,494126,Staff,24,0,25,1
1713322980395,MUS 11,A01,494128,Staff,23,0,25,2
1713322980395,MUS 11,A02,494129,Staff,24,0,25,1
1713322981422,MUS 13,A01,494131,Staff,25,0,25,0
1713322981422,MUS 13,A02,494132,Staff,25,0,25,0
1713322982448,MUS 15,A01,494134,Staff,17,0,25,8
1713322982448,MUS 15,A02,494135,Staff,25,0,25,0
1713322982448,MUS 15,B01,494137,Staff,24,0,25,1
1713322983478,MUS 80,A00,494232,Staff,24,0,25,1
1713322983478,MUS 80,B00,494233,Staff,25,0,25,0
1713322983478,MUS 80,C00,494234,Staff,23,0,25,2
1713322984508,MUS 95C,A00,494141,Staff,70,0,75,5
1713322985536,MUS 114,A00,494142,Staff,40,0,50,10
1713322986561,NANO 15,A01,490636,Drews; Aaron,7,0,7,0
1713322987592,PHIL 1,A00,490578,Grush; Rick Scott,49,0,50,1
1713322988616,PHIL 10,A01,490580,Grush; Rick Scott,33,0,35,2
1713322988616,PHIL 10,A02,490586,Grush; Rick Scott,32,0,35,3
1713322989643,PHIL 27,A01,490591,Staff,23,0,25,2
1713322989643,PHIL 27,A02,490592,Staff,25,0,25,0
1713322989643,PHIL 27,A03,490593,Staff,25,0,25,0
1713322989643,PHIL 27,A04,490598,Staff,25,0,25,0
1713322990668,PHIL 32,A01,490611,Staff,20,0,20,0
1713322990668,PHIL 32,A02,490618,Staff,20,0,20,0
1713322991692,PHIL 90,A00,490624,Staff,40,0,40,0
1713322992719,PHIL 136,A00,490627,Cohen; Jonathan David,37,0,40,3
1713322993747,PHIL 155,A00,490634,Staff,63,0,70,7
1713322994770,PHYS 1A,A00,491610,Staff,245,0,250,5
1713322995794,PHYS 1AL,001,491616,Tsai; Philbert S,27,0,30,3
1713322995794,PHYS 1AL,002,491618,Tsai; Philbert S,30,0,30,0
1713322996823,PHYS 1B,A00,491623,Staff,238,0,250,12
1713322997852,PHYS 1BL,001,491626,Tsai; Philbert S,23,0,30,7
1713322997852,PHYS 1BL,002,491628,Tsai; Philbert S,27,0,30,3
1713322998877,PHYS 1C,A00,491632,Staff,218,0,245,27
1713322999905,PHYS 1CL,001,491635,Tsai; Philbert S,7,0,30,23
1713322999905,PHYS 1CL,002,491643,Tsai; Philbert S,24,0,30,6
1713323000931,PHYS 2AR,A01,491651,Meyertholen; Andrew D.,44,0,50,6
1713323001959,PHYS 2B,A01,491659,Staff,105,0,115,10
1713323002983,PHYS 2BL,A01,491685,Staff,21,0,24,3
1713323002983,PHYS 2BL,A02,491700,Staff,21,0,24,3
1713323004016,PHYS 2C,A01,505161,Staff,104,0,115,11
1713323005043,PHYS 4A,A01,491704,Grinstein; Benjamin,99,0,100,1
1713323006068,POLI 5D,A01,494144,Staff,3,0,5,2
1713323006068,POLI 5D,B01,626283,Dai; Yinlin,5,0,5,0
1713323007094,POLI 12,A00,494145,Staff,44,0,45,1
1713323008120,POLI 13R,A00,494146,Forman; Fonna,45,0,50,5
1713323009146,POLI 27,A01,494148,Staff,57,0,60,3
1713323010169,POLI 30,A00,494149,Staff,49,0,50,1
1713323011195,POLI 100DA,A00,494150,Staff,21,0,25,4
1713323013246,POLI 100I,A00,494152,Staff,27,0,30,3
1713323014272,POLI 104B,A00,494153,Smith; Glenn Chatmas,53,0,55,2
1713323015298,POLI 104F,A00,494154,Staff,28,0,30,2
1713323016325,POLI 104I,A00,494155,Smith; Glenn Chatmas,30,0,30,0
1713323017351,POLI 110C,A00,494156,Ingham; Sean,23,0,25,2
1713323018374,POLI 117R,A00,494157,Forman; Fonna,8,0,20,12
1713323019397,POLI 118,A00,494158,Ingham; Sean,21,0,25,4
1713323020423,POLI 120H,A00,494159,Fisk; David Lee,40,0,45,5
1713323021451,POLI 131CR,A00,494160,Hoston; Germaine,36,0,45,9
1713323022475,POLI 133J,A00,494161,Staff,33,0,35,2
1713323023501,POLI 135,A00,494162,Fisk; David Lee,33,0,35,2
1713323024529,POLI 140A,A00,494164,Staff,21,0,30,9
1713323025555,POLI 142I,A00,494165,Staff,30,0,30,0
1713323026583,POLI 144D,A00,494166,Staff,23,0,25,2
1713323027611,POLI 151,A00,494167,Staff,30,0,30,0
1713323028639,POLI 153,A00,494168,Staff,33,0,35,2
1713323029668,POLI 160AA,A00,494169,Staff,34,0,40,6
1713323030695,POLI 162,A00,494170,Mignozzetti; Umberto,19,0,25,6
1713323031775,POLI 171,A00,494171,Mignozzetti; Umberto,20,0,25,5
1713323032800,PSYC 1,A00,494172,Staff,97,0,100,3
1713323033829,PSYC 2,A00,494173,Moranton; Nirelia Melbina-,37,0,50,13
1713323034854,PSYC 3,A00,494174,Staff,29,0,30,1
1713323035879,PSYC 6,A00,494175,Staff,17,0,20,3
1713323036904,PSYC 60,A01,494177,Staff,38,0,45,7
1713323037927,PSYC 70,A01,505724,Geller; Emma Harlan,42,0,45,3
1713323038955,PSYC 101,A00,494180,Heyman; Gail D.,84,0,100,16
1713323039978,PSYC 105,A00,494181,Geller; Emma Harlan,55,0,90,35
1713323041003,PSYC 106,A00,494182,Dobkins; Karen R.,29,0,45,16
1713323042028,PSYC 108,A00,494183,Adrian; Julia Anna,91,0,100,9
1713323043054,PSYC 114,A01,494185,Winkielman; Piotr,0,1,30,30
1713323044081,PSYC 122,A00,494186,Moranton; Nirelia Melbina-,31,0,50,19
1713323045105,PSYC 124,A00,494187,Chapman; Eddie Nathaniel,71,0,80,9
1713323046129,PSYC 131,A00,494188,Anagnostaras; Stephan,48,0,80,32
1713323047158,PSYC 144,A00,494189,Staff,9,0,50,41
1713323048181,PSYC 154,A00,494190,Lacefield; Katharine I,117,0,180,63
1713323049206,PSYC 162,A00,494191,Wixted; John T,74,0,100,26
1713323050236,PSYC 172,A00,494192,Gorman; Michael R.,35,0,45,10
1713323051260,PSYC 178,A00,494193,Glaser; Dale,34,0,45,11
1713323052285,PSYC 193,A00,505725,Chapman; Eddie Nathaniel,20,0,20,0
1713323053311,RELI 145GS,A00,519817,Rahimi; Babak,18,0,20,2
1713323054337,SE 101A,A01,490862,Chadha; Mayank,23,0,25,2
1713323055369,SE 101C,A01,490924,Krysl; Petr,16,0,20,4
1713323056394,SE 110A,A01,490928,Staff,19,0,20,1
1713323057421,SE 130A,A00,490929,Morrison; Machel Leigh,57,0,70,13
1713323058447,SIO 1,A01,519325,Staff,39,0,40,1
1713323059473,SIO 30,A01,519327,Staff,38,0,40,2
1713323060500,SIO 40,A00,519328,Staff,39,0,40,1
1713323061529,SIO 46GS,A00,519819,Cook; Geoffrey W,17,0,25,8
1713323062555,SIO 109R,A00,494197,Forman; Fonna,0,0,20,20
1713323063582,SIO 121GS,A00,519827,Cook; Geoffrey W,17,0,25,8
1713323064609,SIO 132,A01,519330,Staff,38,0,40,2
1713323065633,SIO 133,A01,519397,Staff,37,0,40,3
1713323066660,SIO 139,A00,519396,Kacev; David,31,0,40,9
1713323067686,SOCI 1,A01,494199,Thorpe; Charles Robert,22,0,30,8
1713323067686,SOCI 1,A02,494200,Thorpe; Charles Robert,30,0,30,0
1713323067686,SOCI 1,A03,494201,Thorpe; Charles Robert,29,0,30,1
1713323067686,SOCI 1,A04,494202,Thorpe; Charles Robert,29,0,30,1
1713323067686,SOCI 1,A05,494203,Thorpe; Charles Robert,29,0,30,1
1713323067686,SOCI 1,A06,494204,Thorpe; Charles Robert,30,0,30,0
1713323067686,SOCI 1,A07,494205,Thorpe; Charles Robert,28,0,30,2
1713323068712,SOCI 60,A01,494207,Staff,34,0,40,6
1713323068712,SOCI 60,A02,494208,Staff,39,0,40,1
1713323069738,SOCI 100,A01,494210,Payne; Christine Anna,27,0,30,3
1713323069738,SOCI 100,A02,494211,Payne; Christine Anna,26,0,30,4
1713323070764,SOCI 109M,A00,494212,Staff,20,0,20,0
1713323071789,SOCI 110,A00,494213,Staff,34,0,40,6
1713323073838,SOCI 118E,A00,494215,Ng; Kwai,37,0,40,3
1713323074863,SOCI 125,A00,494216,Calderon-Zaks; Michael Aar,41,0,45,4
1713323075886,SOCI 126,A01,494218,Jones; Makeba,3,0,5,2
1713323076911,SOCI 131,A00,494219,Thorpe; Charles Robert,27,0,30,3
1713323078965,SOCI 135,A00,494221,Payne; Christine Anna,31,0,50,19
1713323079994,SOCI 136E,A00,626690,Ruiz; Jonathan Joseph,25,0,25,0
1713323081019,SOCI 138GS,A00,494222,Navon; Daniel,24,0,28,4
1713323083072,SOCI 145,A00,494224,Staff,41,0,45,4
1713323084094,SOCI 153,A00,494225,Staff,28,0,30,2
1713323085120,SOCI 160E,A00,494226,Ng; Kwai,30,0,40,10
1713323086150,SOCI 180,A00,494227,Staff,29,0,30,1
1713323087174,SOCI 189GS,A00,494228,Ribas Norris; Janet Vanesa,11,0,11,0
1713323088198,SOCI 190GS,A00,553232,Ribas Norris; Janet Vanesa,11,0,11,0
1713323089223,SOMI 220,A00,627178,Schneid; Stephen David,30,0,30,0
1713323090250,SYN 2,001,490768,Staff,14,0,15,1
1713323090250,SYN 2,002,490769,Staff,15,0,15,0
1713323090250,SYN 2,004,490775,Staff,0,0,0,0
1713323090250,SYN 2,003,490774,Staff,0,0,0,0
1713323090250,SYN 2,005,490776,Staff,0,0,0,0
1713323091274,SYN 2R,001,490779,Staff,11,0,15,4
1713323091274,SYN 2R,002,514635,Staff,14,0,15,1
1713323092302,SYN 100,A01,490783,Staff,13,0,20,7
1713323092302,SYN 100,B01,490787,Staff,9,0,20,11
1713323092302,SYN 100,C01,490789,Staff,11,0,20,9
1713323093327,SYN 150,A00,490817,Staff,14,0,15,1
1713323093327,SYN 150,B00,514610,Staff,15,0,15,0
1713323094352,TDAC 1,A00,492753,Walsh; Kim C.,19,0,20,1
1713323094352,TDAC 1,B00,492754,Harting; Carla Kelso,19,0,20,1
1713323094352,TDAC 1,C00,513995,Salovey; Todd,15,0,20,5
1713323095377,TDAC 101,A00,492766,Harting; Carla Kelso,17,0,20,3
1713323096405,TDAC 102,A00,492768,Basso; Beatrice,19,0,20,1
1713323097429,TDDE 111,A00,492769,Staff,25,0,25,0
1713323098455,TDDE 131,A00,492770,Staff,15,0,15,0
1713323098455,TDDE 131,B00,492771,Staff,15,0,15,0
1713323099482,TDDE 131GS,A00,523716,Guirguis; Mark C,23,0,28,5
1713323100509,TDGE 1,A01,492756,Salovey; Todd,57,0,60,3
1713323101538,TDGE 5,A01,492758,Staff,23,0,25,2
1713323102563,TDGE 10,A00,492759,Fulton; Julia,205,0,220,15
1713323103590,TDGE 11,A00,492760,Castro; Robert Jess,198,0,200,2
1713323105642,TDGE 124,A00,492772,Fulton; Julia,188,0,220,32
1713323106667,TDGE 125,A00,492773,Meyer; Ursula,38,0,50,12
1713323106667,TDGE 125,B00,492774,Staff,49,0,50,1
1713323106667,TDGE 125,C00,523565,Staff,48,0,50,2
1713323107697,TDGE 125GS,A00,523580,Guirguis; Mark C,23,0,28,5
1713323108725,TDGE 127,A00,492775,Havis; Allan,38,0,50,12
1713323109751,TDHT 101,A00,492776,Staff,34,0,35,1
1713323110779,TDMV 1,A00,492762,Caligagan; Maria T.,30,0,30,0
1713323110779,TDMV 1,B00,492763,Arcidiacono; Kristin,25,0,30,5
1713323111804,TDMV 2,A00,492764,Weinberg; Sadie,29,0,30,1
1713323112834,TDMV 3,A00,492765,Mack; Kara Shanai',38,0,40,2
1713323113859,TDMV 138,A00,492777,Mack; Kara Shanai',34,0,40,6
1713323114885,TDMV 140,A00,492778,Lima; Paulo Henrique,40,0,40,0
1713323115909,TDMV 142,A00,492779,Caligagan; Maria T.,33,0,40,7
1713323115909,TDMV 142,B00,492780,Caligagan; Tony,37,0,40,3
1713323116945,TDMV 143,A00,492781,Fyall; Daunte Edward,39,0,40,1
1713323117971,USP 1,A01,492401,Kwak; Nancy,26,0,35,9
1713323119000,USP 2,A01,492453,Hinds; Juli Beth,35,0,35,0
1713323120027,USP 3,A01,492516,Staff,28,0,35,7
1713323121055,USP 4,A00,492522,McTague; Sarah,17,0,25,8
1713323122081,USP 100,A00,492523,Staff,32,0,35,3
1713323123106,USP 101,A00,492524,Staff,13,0,15,2
1713323124133,USP 105,A00,492525,Staff,21,0,25,4
1713323125161,USP 151,A00,492526,Shenkman; Michael Thomas,32,0,35,3
1713323126188,USP 170,A00,492545,Hinds; Juli Beth,33,0,35,2
1713323127215,USP 171GS,A00,492608,Bussell; Mirle Rabinowitz,24,0,28,4
1713323128242,USP 183GS,A00,492613,Peerson; Susan,24,0,28,4
1713323129272,VIS 30,A01,490693,Yoldas; Pinar,19,0,22,3
1713323129272,VIS 30,A02,490694,Yoldas; Pinar,18,0,22,4
1713323130296,VIS 83,A00,490695,Kester; Grant,63,0,75,12
1713323131325,VIS 105D,A00,490696,Staff,22,0,25,3
1713323132349,VIS 124CN,A00,490699,Rose; Jordan M,66,0,75,9
1713323133380,VIS 125GS,A00,511221,Williams; Alena J,21,0,22,1
1713323134408,VIS 128D,A00,490700,Staff,73,0,75,2
1713323135487,VIS 151,A01,490717,Staff,33,0,34,1
1713323135487,VIS 151,A02,490766,Staff,33,0,34,1
1713323136515,VIS 154GS,A00,511972,Williams; Alena J,21,0,22,1
1713323137540,VIS 160A,A00,490767,Stone; Patricia,7,0,10,3
1713323138562,WCWP 10A,A00,490638,Staff,14,0,15,1
1713323138562,WCWP 10A,B00,490640,Staff,15,0,15,0
1713323139586,WCWP 10B,A00,490641,Staff,0,0,0,0
1713323139586,WCWP 10B,B00,490642,Staff,14,0,15,1
1713323139586,WCWP 10B,C00,490644,Staff,13,0,15,2
1713323139586,WCWP 10B,D00,490647,Staff,0,0,0,0
1713323140611,WCWP 100,A00,490655,Staff,0,0,0,0
1713323140611,WCWP 100,B00,490687,Staff,10,0,15,5
1713323142677,ANAR 153,A00,487222,Braswell; Geoffrey E.,54,0,60,6
1713323143705,ANBI 134,A00,487223,Staff,7,0,20,13
1713323144733,ANBI 143GS,A00,487224,Noel; Geoffroy Pierre Jean,18,0,24,6
1713323145757,ANBI 144GS,A00,519548,Noel; Geoffroy Pierre Jean,18,0,24,6
1713323146783,ANSC 101,A00,487225,Staff,17,0,20,3
1713323147811,ANSC 125,A00,487227,Brenner; Suzanne A,39,0,40,1
1713323149862,ANSC 146,A00,487229,Staff,35,0,40,5
1713323150890,ANSC 148,A00,487230,Olivas Hernandez; Olga Lid,39,0,40,1
1713323151915,ANSC 150,A00,504165,Sloane; Julia Kathryn,19,0,20,1
1713323152939,ANSC 180,A00,487232,Staff,14,0,15,1
1713323153965,ANSC 188,A00,627155,Staff,39,0,40,1
1713323154990,ANTH 5,A00,519529,Semendeferi; Ekaterini,15,0,15,0
1713323156015,ANTH 10,A00,487219,Staff,58,0,60,2
1713323157039,ANTH 23,A01,487221,Staff,17,0,20,3
1713323158064,ANTH 102,A00,487233,Wilder; Linnea Lorene,51,0,60,9
1713323159093,ANTH 103,A00,487234,Varma; Saiba,55,0,60,5
1713323160119,ANTH 105,A00,487235,Stewart; Alexander B,55,0,60,5
1713323161143,BENG 100,A01,516685,Taylor Amos; Alyssa C,27,0,30,3
1713323162168,BIBC 102,A01,491316,Flagg; Matthew Paul,22,0,88,66
1713323162168,BIBC 102,A02,491366,Flagg; Matthew Paul,80,0,88,8
1713323163197,BIBC 103,A01,491486,Boumechache; Miyyada,16,0,24,8
1713323163197,BIBC 103,A02,491487,Boumechache; Miyyada,24,0,24,0
1713323164222,BICD 100,A01,516882,Staff,73,0,75,2
1713323164222,BICD 100,A02,516890,Staff,69,0,75,6
1713323165246,BICD 102GS,A00,491488,Lo; Stanley M.,26,0,28,2
1713323166274,BIEB 136GS,A00,516940,Holway; David A. & Shurin; Jonathan,19,0,24,5
1713323167299,BIEB 137GS,A01,517034,Holway; David A. & Shurin; Jonathan,19,0,24,5
1713323168328,BIEB 138GS,A01,491492,Pirino; Giorgia,21,0,28,7
1713323169355,BILD 1,A01,491296,Staff,61,0,63,2
1713323169355,BILD 1,A02,491297,Staff,63,0,63,0
1713323170379,BILD 4,A01,517099,Gonzalez Gamboa; Ivonne,22,0,24,2
1713323170379,BILD 4,A02,517100,Gonzalez Gamboa; Ivonne,24,0,24,0
1713323171418,BILD 60GS,A00,491309,Lo; Stanley M.,26,0,28,2
1713323172446,BIMM 100,A01,517136,Staff,86,0,100,14
1713323173472,BIMM 110,A01,517182,Staff,61,0,100,39
1713323174497,BIMM 120,A01,517228,Pickett; Brooke Elizabeth,30,0,63,33
1713323174497,BIMM 120,A02,517240,Pickett; Brooke Elizabeth,45,0,63,18
1713323175524,BIMM 132GS,A01,491498,Pirino; Giorgia,21,0,28,7
1713323176553,BIMM 143,A01,491589,Bozinovic; Goran,13,0,40,27
1713323177581,BIPN 100,A01,491594,Armour; Jon Christopher,90,0,100,10
1713323178610,BIPN 140,A01,491602,Marino; Marc J,26,0,50,24
1713323180662,CAT 125,A00,515973,Staff,18,0,20,2
1713323181687,CAT 125GS,A00,515974,Rahimi; Babak,17,0,20,3
1713323182712,CAT 125R,A00,515980,Staff,13,0,20,7
1713323182712,CAT 125R,B00,515981,Tosun; Adriana,19,0,20,1
1713323182712,CAT 125R,C00,515987,Hyland; Tina Mae,0,2,20,20
1713323182712,CAT 125R,D00,515988,Bronstein; Phoebe Malan,17,0,20,3
1713323183739,CENG 15,A01,488699,Drews; Aaron,25,0,25,0
1713323184767,CENG 100,A00,505196,Opatkiewicz; Justin Paul,25,0,25,0
1713323185792,CGS 2A,A01,489598,Staff,33,0,35,2
1713323186817,CGS 112,A00,489599,Staff,15,0,15,0
1713323187842,CGS 119,A00,489603,Staff,10,0,10,0
1713323188871,CGS 120,A00,489604,Staff,14,0,15,1
1713323189896,CGS 150,A00,489607,Staff,15,0,15,0
1713323190920,CHEM 6A,A01,488715,Staff,98,0,100,2
1713323191946,CHEM 6B,A01,488719,Piercy; Marc Anthony,100,0,100,0
1713323192970,CHEM 6C,A01,488723,Albizati; Kim F.,93,0,100,7
1713323193997,CHEM 7L,A01,488728,Schurmeier; Kimberly,18,0,24,6
1713323193997,CHEM 7L,A02,488730,Schurmeier; Kimberly,23,0,24,1
1713323193997,CHEM 7L,A03,488734,Schurmeier; Kimberly,22,0,24,2
1713323193997,CHEM 7L,A04,488763,Schurmeier; Kimberly,23,0,24,1
1713323193997,CHEM 7L,B01,488798,Schurmeier; Kimberly,17,0,24,7
1713323193997,CHEM 7L,B02,488801,Schurmeier; Kimberly,23,0,24,1
1713323193997,CHEM 7L,B03,488808,Schurmeier; Kimberly,23,0,24,1
1713323193997,CHEM 7L,B04,488811,Schurmeier; Kimberly,24,0,24,0
1713323195022,CHEM 11,A01,488897,Stallings; Dontarie M,95,0,100,5
1713323196052,CHEM 40A,A01,488913,Albizati; Kim F.,85,0,100,15
1713323197082,CHEM 40B,A01,488920,Weizman; Haim,44,0,50,6
1713323197082,CHEM 40B,A02,488938,Weizman; Haim,45,0,50,5
1713323198107,CHEM 41A,A01,489029,Klosterman; Jeremy K,57,0,60,3
1713323199132,CHEM 41C,A01,500436,Tor; Yitzhak,55,0,60,5
1713323200162,CHEM 43A,A01,500426,Weizman; Haim,0,0,24,24
1713323200162,CHEM 43A,A02,500430,Weizman; Haim,12,0,24,12
1713323200162,CHEM 43A,B01,514041,Klosterman; Jeremy K,15,0,24,9
1713323200162,CHEM 43A,B02,514047,Klosterman; Jeremy K,23,0,24,1
1713323201189,CHEM 108,A01,489140,Jennings; Patricia A.,11,0,24,13
1713323201189,CHEM 108,A02,489142,Jennings; Patricia A.,14,0,24,10
1713323202213,CHEM 114A,A01,489147,Stallings; Dontarie M,74,0,100,26
1713323203238,CHIN 169A,A00,489171,Wang; Xiao,19,0,20,1
1713323205289,COGS 3,A01,518827,Boyle; Mary E. T.,27,0,40,13
1713323206313,COGS 11,A01,489175,Staff,28,0,30,2
1713323207344,COGS 14A,A01,518829,Staff,51,0,60,9
1713323208369,COGS 14B,A01,489177,Hoffman; Drew Ellen,65,0,75,10
1713323209401,COGS 100,A01,489181,Allen; Michael Gordon,64,0,75,11
1713323210426,COGS 101A,A01,489183,Staff,47,0,60,13
1713323211451,COGS 101B,A01,489185,Allen; Michael Gordon,8,0,30,22
1713323212479,COGS 101C,A01,526786,Staff,24,0,30,6
1713323214531,COGS 107A,A01,489189,Boyle; Mary E. T.,19,0,35,16
1713323215559,COGS 107B,A01,627144,Mooshagian; Eric Frederick,60,0,60,0
1713323216587,COGS 118A,A01,489191,Staff,0,40,40,40
1713323218643,COGS 171GS,A01,489194,Pineda; Jaime A,21,0,28,7
1713323219670,COGS 172,A01,489196,Staff,3,0,30,27
1713323220694,COGS 174GS,A01,489264,Pineda; Jaime A,21,0,28,7
1713323221719,COGS 180,A01,627150,Staff,28,0,30,2
1713323222749,COGS 186,A01,489274,Staff,0,1,30,30
1713323223777,COMM 10,A01,489276,Staff,23,0,25,2
1713323223777,COMM 10,A02,489303,Staff,23,0,25,2
1713323224805,COMM 100A,A01,489312,Staff,14,0,25,11
1713323224805,COMM 100A,A02,489313,Staff,24,0,25,1
1713323225830,COMM 106T,A00,512540,Staff,33,0,35,2
1713323226856,COMM 107,A00,489347,Staff,28,0,35,7
1713323227887,COMM 109P,A00,489358,Staff,31,0,35,4
1713323228915,COMM 132,A00,489361,McKenna; Denise,28,0,30,2
1713323229940,COMM 146,A00,489362,Halm; Gavin Patrick,26,0,30,4
1713323230965,COMM 190,A00,489363,Abuelhiga; Soraya Jill,17,0,23,6
1713323231989,CSE 8A,A50,489366,Staff,21,0,25,4
1713323231989,CSE 8A,A51,489367,Staff,24,0,25,1
1713323233013,CSE 11,A01,489398,Cao; Yingjun,77,0,100,23
1713323234042,CSE 12,A01,489487,Staff,43,0,50,7
1713323235067,CSE 20,A01,489497,Staff,48,0,50,2
1713323236093,CSE 21,A01,489517,Braun; Oliver,42,0,50,8
1713323237121,CSE 101,A01,489524,Braun; Oliver,0,28,50,50
1713323238152,CSE 105,A01,512594,Jones; Miles E,74,0,100,26
1713323238152,CSE 105,B01,512598,Jones; Miles E,55,0,100,45
1713323239229,CSE 140,A01,489538,Staff,42,0,50,8
1713323240254,CSE 141,A01,489550,Eldon; John,70,0,100,30
1713323241280,CSE 141L,A01,489571,Eldon; John,68,0,100,32
1713323242310,CSE 151A,A01,489583,Solares; Edwin A,142,0,200,58
1713323243337,CSE 175,A01,510886,Kumar; Rakesh,30,0,30,0
1713323244362,CSE 190,A00,516828,Dubnov; Shlomo,38,0,49,11
1713323245389,DOC 100D,A00,489667,Pass; Natalye Joann,19,0,25,6
1713323246416,DSC 10,A01,624268,Staff,72,0,75,3
1713323247445,DSC 20,A01,624476,Staff,50,0,50,0
1713323248473,DSC 40A,A01,624608,Staff,39,0,40,1
1713323249499,DSGN 1,A01,489179,Rill; Bryan,35,0,50,15
1713323250527,ECE 17,A01,490489,Sahay; Rajeev,18,0,30,12
1713323251552,ECE 65,A50,490492,Staff,12,0,20,8
1713323251552,ECE 65,A51,490493,Staff,19,0,20,1
1713323252581,ECON 1,A01,489715,Famulari; Melissa,68,0,70,2
1713323253606,ECON 2,A01,489717,Levkoff; Steven B.,68,0,70,2
1713323254630,ECON 3,A01,489948,Staff,70,0,70,0
1713323256684,ECON 5,A01,490103,Staff,27,0,30,3
1713323256684,ECON 5,B01,626281,Dai; Yinlin,45,0,45,0
1713323257710,ECON 100A,A01,490127,Famulari; Melissa,66,0,70,4
1713323258734,ECON 100B,A01,490129,Staff,64,0,70,6
1713323259759,ECON 109,A01,490187,Shishkin; Denis,27,0,35,8
1713323260788,ECON 110A,A01,490190,Levkoff; Steven B.,60,0,70,10
1713323261813,ECON 120A,A01,490245,Dai; Yinlin,62,0,70,8
1713323262837,ECON 120B,A01,490247,Nieto-Barthaburu; Augusto,48,0,70,22
1713323263864,ECON 120C,A01,490253,Sun; Yixiao,30,0,35,5
1713323263864,ECON 120C,B01,490255,Sun; Yixiao,34,0,35,1
1713323264889,ECON 129,A00,490256,Eckert; Fabian Paul,24,0,35,11
1713323265914,ECON 131,A00,490257,Nieto-Barthaburu; Augusto,0,6,35,35
1713323266942,ECON 138,A00,490258,Bharadwaj; Prashant,15,0,35,20
1713323266942,ECON 138,B00,490259,Bharadwaj; Prashant,16,0,35,19
1713323267968,ECON 159,A00,490260,Hendrickson; Gerald M.,0,8,0,0
1713323268995,ECON 178,A01,553995,Zhu; Ying,24,0,35,11
1713323270020,EDS 40,A01,512576,Black; Alison Michelle,20,0,20,0
1713323271048,EDS 107,A01,515848,Staff,30,0,30,0
1713323272072,EDS 110R,A01,490262,Staff,26,0,30,4
1713323273108,EDS 112,A01,490264,Chapman; Thandeka K,40,0,50,10
1713323274138,EDS 113,A00,490266,Staff,26,0,30,4
1713323275163,EDS 118,A00,490267,Warstadt; Melissa Fawn,21,0,30,9
1713323276188,EDS 124BR,A00,490268,Eguchi; Emi,4,0,25,21
1713323276188,EDS 124BR,B00,490269,Eguchi; Emi,24,0,25,1
1713323277214,EDS 126,A01,490271,Jones; Makeba,43,0,50,7
1713323278240,EDS 135,A01,490316,Staff,19,0,20,1
1713323279266,ENVR 142GS,A00,519514,Chang; Edmond Yi-Teh,27,0,28,1
1713323280290,ETHN 103,A00,490504,Staff,27,0,36,9
1713323281319,ETHN 103A,A00,490505,Man; Simeon S,5,0,9,4
1713323282347,ETHN 109,A00,490506,Staff,29,0,30,1
1713323283378,ETHN 118,A00,490507,Staff,35,0,36,1
1713323284401,ETHN 119,A00,490508,Staff,33,0,36,3
1713323285429,ETHN 121R,A00,490518,Choi; Esther Min,24,0,36,12
1713323286455,ETHN 127,A00,490528,Staff,14,0,15,1
1713323287479,ETHN 139,A00,490573,Staff,10,0,10,0
1713323288507,ETHN 150,A00,490575,Staff,15,0,15,0
1713323289531,GLBH 20,A00,491705,Elwardani; Nile Regina,38,0,40,2
1713323290555,GLBH 101,A00,491706,Staff,20,0,20,0
1713323291589,GLBH 111,A01,491708,Burgos; Jose L.,15,0,15,0
1713323292617,GLBH 146,A00,491709,Staff,10,0,20,10
1713323293642,GLBH 148,A00,491710,Olivas Hernandez; Olga Lid,13,0,20,7
1713323294666,GLBH 150,A00,491711,Sloane; Julia Kathryn,20,0,20,0
1713323295693,HIEA 131,A00,491760,Staff,29,0,32,3
1713323296720,HIEA 153,A00,491762,Staff,29,0,30,1
1713323297746,HIEU 124,A00,491811,Staff,26,0,32,6
1713323298771,HIEU 124GS,A00,491812,Markman; Kristina,27,0,28,1
1713323299799,HIEU 147,A00,491813,Staff,30,0,32,2
1713323300824,HIEU 149GS,A00,491816,Caldwell; Michael Alan,28,0,28,0
1713323301855,HILD 2C,A01,491713,Hendrickson; Gerald M.,27,0,30,3
1713323302882,HILD 7B,A01,491715,Kwak; Nancy,1,0,30,29
1713323303913,HILD 10,A01,491717,Staff,13,0,20,7
1713323304936,HILD 30GS,A00,491719,Edington; Claire Ellen,24,0,28,4
1713323305965,HINE 109,A00,491818,Shafir; Nir,27,0,32,5
1713323306989,HINE 128,A00,491821,Shafir; Nir,31,0,32,1
1713323308017,HISC 117,A00,491830,Staff,27,0,32,5
1713323309047,HIUS 103,A00,491834,Man; Simeon S,15,0,23,8
1713323310071,HIUS 108B,A00,491835,Staff,28,0,30,2
1713323311096,HIUS 141,A00,491836,Hendrickson; Gerald M.,29,0,32,3
1713323312123,HIUS 149,A00,491839,Staff,26,0,32,6
1713323313150,HUM 3,A01,512617,Crum; Matthew Stephen,43,0,50,7
1713323313150,HUM 3,A02,512618,Crum; Matthew Stephen,48,0,50,2
1713323314177,HUM 3GS,A00,512663,Markman; Kristina,0,0,0,1
1713323314177,HUM 3GS,B00,512664,Staff,0,0,0,0
1713323315206,HUM 4,A01,512620,West; Geoffrey Scott,29,0,50,21
1713323316234,HUM 4GS,A00,512666,Lyon; Antony J.,0,0,0,4
1713323317264,HUM 4R,A01,512625,Watkins; Eric,49,0,50,1
1713323318291,HUM 5,A01,512649,Zavodny; Tatiana Sophia,26,0,50,24
1713323318291,HUM 5,B01,512661,Zroka; Ryan Edward,48,0,50,2
1713323319318,INTL 190,A00,490577,Segui; Alan S,0,0,0,5
1713323320344,JAPN 20AR,A01,491267,Ross; Kayoko F,8,0,20,12
1713323321369,JAPN 180,A00,491285,Berman; Michael David,33,0,40,7
1713323322398,LATI 50,A01,502536,Kokinis; Troy Andreas,16,0,22,6
1713323322398,LATI 50,A02,502551,Kokinis; Troy Andreas,22,0,22,0
1713323322398,LATI 50,A03,502650,Kokinis; Troy Andreas,22,0,22,0
1713323322398,LATI 50,A04,502909,Kokinis; Troy Andreas,22,0,22,0
1713323323423,LATI 160,A01,502920,Kokinis; Troy Andreas,30,0,30,0
1713323324451,LIFR 1A,A00,490494,Van Moer; Vinciane G,17,0,20,3
1713323325476,LIFR 1AX,A00,490495,Van Moer; Vinciane G,17,0,20,3
1713323326505,LIFR 1B,A00,490496,Van Moer; Vinciane G,18,0,20,2
1713323327535,LIFR 1BX,A00,490497,Van Moer; Vinciane G,18,0,20,2
1713323328559,LIGN 8,A00,505198,McIntosh; Justin Daniel,135,0,150,15
1713323329584,LIGN 9GS,A00,491239,Lott; Margaret S.,18,0,20,2
1713323330609,LIGN 101,A01,505200,McIntosh; Justin Daniel,23,0,30,7
1713323331635,LIGN 120,A01,491244,Staff,23,0,30,7
1713323332663,LIGN 149GS,A00,491245,Lott; Margaret S.,18,0,20,2
1713323333693,LIGN 170,A00,491247,Staff,22,0,30,8
1713323334717,LISP 1D,A00,490498,Munoz Sanchez; Alicia,10,0,14,4
1713323334717,LISP 1D,B00,490499,Munoz Sanchez; Alicia,6,0,14,8
1713323334717,LISP 1D,C00,490500,Munoz Sanchez; Alicia,8,0,14,6
1713323334717,LISP 1D,D00,490501,Munoz Sanchez; Alicia,10,0,14,4
1713323335742,LISP 1DX,A00,490502,Munoz Sanchez; Alicia,15,0,28,13
1713323335742,LISP 1DX,B00,490503,Munoz Sanchez; Alicia,17,0,28,11
1713323337793,LTAM 110,A00,491847,Staff,23,0,25,2
1713323338818,LTCS 119,A00,491848,Staff,11,0,15,4
1713323339843,LTCS 130,A00,491849,Staff,24,0,25,1
1713323341895,LTEA 120C,A00,491852,Staff,32,0,40,8
1713323342982,LTEN 130GS,A00,491853,Lyon; Antony J.,24,0,28,4
1713323344007,LTEN 148,A00,491855,Staff,23,0,25,2
1713323345031,LTEN 159,A00,491856,Staff,21,0,25,4
1713323346055,LTEN 180,A00,491857,Staff,8,0,15,7
1713323348110,LTSP 123GS,A00,505928,Bessett; Ryan Matthew,24,0,28,4
1713323349136,LTSP 174GS,A00,506037,Bessett; Ryan Matthew,24,0,28,4
1713323351209,LTWR 102,A00,491861,Staff,9,0,15,6
1713323352235,LTWR 106,A00,491862,Staff,10,0,15,5
1713323353265,MAE 11,A00,490930,Bahadori; Mohammad Yousef,96,0,100,4
1713323354296,MAE 30A,A00,490931,Qi; Huihui,37,0,40,3
1713323355320,MAE 101A,A00,491036,Sadeghizadeh; Zahra,95,0,100,5
1713323356348,MAE 101C,A00,491037,Seshadri; Kalyanasundaram,71,0,100,29
1713323357374,MAE 113,A00,491040,Seshadri; Kalyanasundaram,66,0,80,14
1713323358400,MAE 131A,A00,491041,Ghazinejad; Maziar,37,0,40,3
1713323359425,MAE 142,A00,491053,Staff,39,0,40,1
1713323360450,MAE 143A,A00,491054,Staff,33,0,50,17
1713323361473,MAE 150,A00,491092,Truong; Phuong Thi Ngoc,23,0,35,12
1713323362499,MATH 3C,A01,494031,Pardo Guerra; Sebastian,30,0,30,0
1713323362499,MATH 3C,A02,494032,Pardo Guerra; Sebastian,29,0,30,1
1713323363524,MATH 10A,A01,494034,Staff,27,0,30,3
1713323363524,MATH 10A,A02,494035,Staff,28,0,30,2
1713323363524,MATH 10A,B01,494037,Staff,27,0,30,3
1713323363524,MATH 10A,B02,494038,Staff,29,0,30,1
1713323364551,MATH 10B,A01,494040,Habib; Yousaf,22,0,30,8
1713323364551,MATH 10B,A02,494041,Habib; Yousaf,28,0,30,2
1713323364551,MATH 10B,A03,494042,Habib; Yousaf,29,0,30,1
1713323364551,MATH 10B,A04,494043,Habib; Yousaf,30,0,30,0
1713323364551,MATH 10B,B01,494045,Habib; Yousaf,26,0,30,4
1713323364551,MATH 10B,B02,494046,Habib; Yousaf,30,0,30,0
1713323364551,MATH 10B,B03,494047,Habib; Yousaf,30,0,30,0
1713323364551,MATH 10B,B04,494048,Habib; Yousaf,30,0,30,0
1713323365582,MATH 18,A01,494050,Kemp; Todd Aahron,25,0,30,5
1713323365582,MATH 18,A02,494051,Kemp; Todd Aahron,29,0,30,1
1713323365582,MATH 18,B01,494054,Kemp; Todd Aahron,27,0,30,3
1713323365582,MATH 18,B02,494055,Kemp; Todd Aahron,29,0,30,1
1713323366607,MATH 20A,A01,494059,Suk; Andrew Hoon,30,0,30,0
1713323367633,MATH 20B,A01,494061,Briones; Jor-el Thomas Caparas,33,0,35,2
1713323367633,MATH 20B,B01,494063,Bach; Quang Tran,34,0,35,1
1713323368664,MATH 20C,A01,494065,Staff,28,0,30,2
1713323368664,MATH 20C,A02,494066,Staff,30,0,30,0
1713323368664,MATH 20C,A03,494067,Staff,30,0,30,0
1713323368664,MATH 20C,A04,494068,Staff,30,0,30,0
1713323368664,MATH 20C,B01,494070,Zhang; Ming,26,0,30,4
1713323368664,MATH 20C,B02,494071,Zhang; Ming,27,0,30,3
1713323368664,MATH 20C,B03,494072,Zhang; Ming,29,0,30,1
1713323368664,MATH 20C,B04,494073,Zhang; Ming,29,0,30,1
1713323369691,MATH 20D,A01,494075,Staff,22,0,30,8
1713323369691,MATH 20D,A02,494076,Staff,30,0,30,0
1713323370715,MATH 20E,A01,494079,Staff,24,0,30,6
1713323370715,MATH 20E,A02,494080,Staff,26,0,30,4
1713323370715,MATH 20E,B01,494082,Staff,25,0,30,5
1713323370715,MATH 20E,B02,494083,Staff,25,0,30,5
1713323371741,MATH 103A,A01,494085,Aliabadi Sr.; Mohsen,14,0,30,16
1713323371741,MATH 103A,A02,494086,Aliabadi Sr.; Mohsen,28,0,30,2
1713323371741,MATH 103A,B01,494088,Aliabadi Sr.; Mohsen,22,0,30,8
1713323371741,MATH 103A,B02,494089,Aliabadi Sr.; Mohsen,28,0,30,2
1713323372765,MATH 109,A01,494091,Staff,30,0,30,0
1713323372765,MATH 109,A02,494092,Staff,29,0,30,1
1713323372765,MATH 109,B01,494094,Staff,27,0,30,3
1713323372765,MATH 109,B02,494095,Staff,29,0,30,1
1713323373792,MATH 142A,A01,494097,Chow; Bennett,15,0,30,15
1713323373792,MATH 142A,A02,494098,Chow; Bennett,24,0,30,6
1713323373792,MATH 142A,B01,494100,Chow; Bennett,19,0,30,11
1713323373792,MATH 142A,B02,494101,Chow; Bennett,29,0,30,1
1713323375843,MATH 168A,A01,516677,Dumitriu; Ioana,15,0,35,20
1713323376869,MATH 170A,A01,516679,Dumitriu; Ioana,19,0,30,11
1713323376869,MATH 170A,A02,516680,Dumitriu; Ioana,28,0,30,2
1713323377894,MATH 193A,A01,494107,Staff,14,0,30,16
1713323377894,MATH 193A,A02,494108,Staff,21,0,30,9
1713323377894,MATH 193A,A03,494109,Staff,29,0,30,1
1713323377894,MATH 193A,A04,494110,Staff,22,0,30,8
1713323380967,MGT 16,A00,491930,McKay; Michael J,92,0,98,6
1713323381994,MGT 18,A00,491992,McKay; Michael J,96,0,98,2
1713323383020,MGT 71,A00,492003,Staff,67,0,98,31
1713323384045,MGT 103,A00,505209,Eberhard; Craig A,81,0,98,17
1713323385071,MGT 131A,A00,505210,Anderson; John Charles,90,0,98,8
1713323387128,MGT 153,A00,492077,Perols; Johan Lars,23,0,90,67
1713323390205,MGT 164,A00,492222,McKay; Mary A,91,0,98,7
1713323391229,MGT 172,A00,492245,Staff,59,0,60,1
1713323391229,MGT 172,B00,505526,Hedges; Kathleen,66,0,98,32
1713323392264,MGT 181,A00,505669,Dunn; Louis Jean,84,0,98,14
1713323393289,MMW 14,A01,494399,Staff,18,0,28,10
1713323393289,MMW 14,A02,494400,Staff,25,0,28,3
1713323393289,MMW 14,A03,494401,Staff,28,0,28,0
1713323393289,MMW 14,A04,494402,Staff,28,0,28,0
1713323393289,MMW 14,B01,494404,Carreras; Maria Victoria,9,0,28,19
1713323393289,MMW 14,B02,494405,Carreras; Maria Victoria,25,0,28,3
1713323393289,MMW 14,B03,494406,Carreras; Maria Victoria,27,0,28,1
1713323393289,MMW 14,B04,494407,Carreras; Maria Victoria,28,0,28,0
1713323394314,MMW 14GS,A00,506250,Chang; Edmond Yi-Teh,0,0,0,0
1713323395342,MMW 121R,A01,494415,Adamiak; Patrick John,12,0,28,16
1713323395342,MMW 121R,A02,494416,Adamiak; Patrick John,24,0,28,4
1713323396369,MUS 1A,A01,494113,Staff,12,0,25,13
1713323396369,MUS 1A,A02,494114,Staff,24,0,25,1
1713323397397,MUS 4,A01,494116,Staff,24,0,25,1
1713323397397,MUS 4,A02,494117,Staff,22,0,25,3
1713323398425,MUS 5R,A01,494236,Dubnov; Shlomo,9,0,25,16
1713323398425,MUS 5R,A02,494237,Dubnov; Shlomo,25,0,25,0
1713323399449,MUS 6,A01,494122,Staff,11,0,25,14
1713323399449,MUS 6,A02,494123,Staff,24,0,25,1
1713323400474,MUS 7,A01,494125,Staff,16,0,25,9
1713323400474,MUS 7,A02,494126,Staff,24,0,25,1
1713323401499,MUS 11,A01,494128,Staff,23,0,25,2
1713323401499,MUS 11,A02,494129,Staff,24,0,25,1
1713323402529,MUS 13,A01,494131,Staff,24,0,25,1
1713323402529,MUS 13,A02,494132,Staff,25,0,25,0
1713323403556,MUS 15,A01,494134,Staff,17,0,25,8
1713323403556,MUS 15,A02,494135,Staff,25,0,25,0
1713323403556,MUS 15,B01,494137,Staff,24,0,25,1
1713323404585,MUS 80,A00,494232,Staff,24,0,25,1
1713323404585,MUS 80,B00,494233,Staff,25,0,25,0
1713323404585,MUS 80,C00,494234,Staff,23,0,25,2
1713323405610,MUS 95C,A00,494141,Staff,70,0,75,5
1713323406636,MUS 114,A00,494142,Staff,40,0,50,10
1713323407661,NANO 15,A01,490636,Drews; Aaron,7,0,7,0
1713323408688,PHIL 1,A00,490578,Grush; Rick Scott,49,0,50,1
1713323409714,PHIL 10,A01,490580,Grush; Rick Scott,33,0,35,2
1713323409714,PHIL 10,A02,490586,Grush; Rick Scott,32,0,35,3
1713323410845,PHIL 27,A01,490591,Staff,23,0,25,2
1713323410845,PHIL 27,A02,490592,Staff,25,0,25,0
1713323410845,PHIL 27,A03,490593,Staff,25,0,25,0
1713323410845,PHIL 27,A04,490598,Staff,25,0,25,0
1713323411874,PHIL 32,A01,490611,Staff,20,0,20,0
1713323411874,PHIL 32,A02,490618,Staff,20,0,20,0
1713323412900,PHIL 90,A00,490624,Staff,40,0,40,0
1713323413926,PHIL 136,A00,490627,Cohen; Jonathan David,37,0,40,3
1713323414950,PHIL 155,A00,490634,Staff,63,0,70,7
1713323415973,PHYS 1A,A00,491610,Staff,245,0,250,5
1713323417000,PHYS 1AL,001,491616,Tsai; Philbert S,27,0,30,3
1713323417000,PHYS 1AL,002,491618,Tsai; Philbert S,30,0,30,0
1713323418027,PHYS 1B,A00,491623,Staff,238,0,250,12
1713323419054,PHYS 1BL,001,491626,Tsai; Philbert S,23,0,30,7
1713323419054,PHYS 1BL,002,491628,Tsai; Philbert S,27,0,30,3
1713323420083,PHYS 1C,A00,491632,Staff,218,0,245,27
1713323421108,PHYS 1CL,001,491635,Tsai; Philbert S,8,0,30,22
1713323421108,PHYS 1CL,002,491643,Tsai; Philbert S,22,0,30,8
1713323422141,PHYS 2AR,A01,491651,Meyertholen; Andrew D.,44,0,50,6
1713323423165,PHYS 2B,A01,491659,Staff,105,0,115,10
1713323424192,PHYS 2BL,A01,491685,Staff,21,0,24,3
1713323424192,PHYS 2BL,A02,491700,Staff,21,0,24,3
1713323425220,PHYS 2C,A01,505161,Staff,103,0,115,12
1713323426246,PHYS 4A,A01,491704,Grinstein; Benjamin,99,0,100,1
1713323427270,POLI 5D,A01,494144,Staff,3,0,5,2
1713323427270,POLI 5D,B01,626283,Dai; Yinlin,5,0,5,0
1713323428295,POLI 12,A00,494145,Staff,44,0,45,1
1713323429320,POLI 13R,A00,494146,Forman; Fonna,45,0,50,5
1713323430347,POLI 27,A01,494148,Staff,57,0,60,3
1713323431371,POLI 30,A00,494149,Staff,49,0,50,1
1713323432395,POLI 100DA,A00,494150,Staff,21,0,25,4
1713323434444,POLI 100I,A00,494152,Staff,27,0,30,3
1713323435469,POLI 104B,A00,494153,Smith; Glenn Chatmas,53,0,55,2
1713323436496,POLI 104F,A00,494154,Staff,28,0,30,2
1713323437524,POLI 104I,A00,494155,Smith; Glenn Chatmas,30,0,30,0
1713323438549,POLI 110C,A00,494156,Ingham; Sean,23,0,25,2
1713323439576,POLI 117R,A00,494157,Forman; Fonna,8,0,20,12
1713323440601,POLI 118,A00,494158,Ingham; Sean,21,0,25,4
1713323441630,POLI 120H,A00,494159,Fisk; David Lee,40,0,45,5
1713323442655,POLI 131CR,A00,494160,Hoston; Germaine,36,0,45,9
1713323443681,POLI 133J,A00,494161,Staff,33,0,35,2
1713323444706,POLI 135,A00,494162,Fisk; David Lee,33,0,35,2
1713323445731,POLI 140A,A00,494164,Staff,21,0,30,9
1713323446811,POLI 142I,A00,494165,Staff,30,0,30,0
1713323447836,POLI 144D,A00,494166,Staff,23,0,25,2
1713323448861,POLI 151,A00,494167,Staff,30,0,30,0
1713323449890,POLI 153,A00,494168,Staff,33,0,35,2
1713323450914,POLI 160AA,A00,494169,Staff,34,0,40,6
1713323451940,POLI 162,A00,494170,Mignozzetti; Umberto,19,0,25,6
1713323452968,POLI 171,A00,494171,Mignozzetti; Umberto,20,0,25,5
1713323453993,PSYC 1,A00,494172,Staff,97,0,100,3
1713323455021,PSYC 2,A00,494173,Moranton; Nirelia Melbina-,37,0,50,13
1713323456045,PSYC 3,A00,494174,Staff,29,0,30,1
1713323457074,PSYC 6,A00,494175,Staff,17,0,20,3
1713323458099,PSYC 60,A01,494177,Staff,38,0,45,7
1713323459125,PSYC 70,A01,505724,Geller; Emma Harlan,42,0,45,3
1713323460150,PSYC 101,A00,494180,Heyman; Gail D.,84,0,100,16
1713323461180,PSYC 105,A00,494181,Geller; Emma Harlan,55,0,90,35
1713323462205,PSYC 106,A00,494182,Dobkins; Karen R.,29,0,45,16
1713323463251,PSYC 108,A00,494183,Adrian; Julia Anna,91,0,100,9
1713323464276,PSYC 114,A01,494185,Winkielman; Piotr,0,1,30,30
1713323465306,PSYC 122,A00,494186,Moranton; Nirelia Melbina-,31,0,50,19
1713323466331,PSYC 124,A00,494187,Chapman; Eddie Nathaniel,71,0,80,9
1713323467356,PSYC 131,A00,494188,Anagnostaras; Stephan,46,0,80,34
1713323468382,PSYC 144,A00,494189,Staff,8,0,50,42
1713323469410,PSYC 154,A00,494190,Lacefield; Katharine I,117,0,180,63
1713323470434,PSYC 162,A00,494191,Wixted; John T,74,0,100,26
1713323471462,PSYC 172,A00,494192,Gorman; Michael R.,36,0,45,9
1713323472487,PSYC 178,A00,494193,Glaser; Dale,34,0,45,11
1713323473516,PSYC 193,A00,505725,Chapman; Eddie Nathaniel,20,0,20,0
1713323474540,RELI 145GS,A00,519817,Rahimi; Babak,18,0,20,2
1713323475568,SE 101A,A01,490862,Chadha; Mayank,23,0,25,2
1713323476596,SE 101C,A01,490924,Krysl; Petr,16,0,20,4
1713323477626,SE 110A,A01,490928,Staff,19,0,20,1
1713323478652,SE 130A,A00,490929,Morrison; Machel Leigh,57,0,70,13
1713323479681,SIO 1,A01,519325,Staff,39,0,40,1
1713323480705,SIO 30,A01,519327,Staff,38,0,40,2
1713323481733,SIO 40,A00,519328,Staff,39,0,40,1
1713323482759,SIO 46GS,A00,519819,Cook; Geoffrey W,17,0,25,8
1713323483784,SIO 109R,A00,494197,Forman; Fonna,0,1,20,20
1713323484814,SIO 121GS,A00,519827,Cook; Geoffrey W,17,0,25,8
1713323485919,SIO 132,A01,519330,Staff,38,0,40,2
1713323486943,SIO 133,A01,519397,Staff,37,0,40,3
1713323487967,SIO 139,A00,519396,Kacev; David,31,0,40,9
1713323488992,SOCI 1,A01,494199,Thorpe; Charles Robert,22,0,30,8
1713323488992,SOCI 1,A02,494200,Thorpe; Charles Robert,30,0,30,0
1713323488992,SOCI 1,A03,494201,Thorpe; Charles Robert,29,0,30,1
1713323488992,SOCI 1,A04,494202,Thorpe; Charles Robert,29,0,30,1
1713323488992,SOCI 1,A05,494203,Thorpe; Charles Robert,29,0,30,1
1713323488992,SOCI 1,A06,494204,Thorpe; Charles Robert,30,0,30,0
1713323488992,SOCI 1,A07,494205,Thorpe; Charles Robert,28,0,30,2
1713323490021,SOCI 60,A01,494207,Staff,34,0,40,6
1713323490021,SOCI 60,A02,494208,Staff,39,0,40,1
1713323491050,SOCI 100,A01,494210,Payne; Christine Anna,26,0,30,4
1713323491050,SOCI 100,A02,494211,Payne; Christine Anna,26,0,30,4
1713323492080,SOCI 109M,A00,494212,Staff,20,0,20,0
1713323493114,SOCI 110,A00,494213,Staff,34,0,40,6
1713323495164,SOCI 118E,A00,494215,Ng; Kwai,37,0,40,3
1713323496190,SOCI 125,A00,494216,Calderon-Zaks; Michael Aar,41,0,45,4
1713323497218,SOCI 126,A01,494218,Jones; Makeba,3,0,5,2
1713323498245,SOCI 131,A00,494219,Thorpe; Charles Robert,27,0,30,3
1713323500295,SOCI 135,A00,494221,Payne; Christine Anna,30,0,50,20
1713323501319,SOCI 136E,A00,626690,Ruiz; Jonathan Joseph,25,0,25,0
1713323502347,SOCI 138GS,A00,494222,Navon; Daniel,24,0,28,4
1713323504398,SOCI 145,A00,494224,Staff,41,0,45,4
1713323505423,SOCI 153,A00,494225,Staff,28,0,30,2
1713323506448,SOCI 160E,A00,494226,Ng; Kwai,30,0,40,10
1713323507474,SOCI 180,A00,494227,Staff,29,0,30,1
1713323508503,SOCI 189GS,A00,494228,Ribas Norris; Janet Vanesa,11,0,11,0
1713323509532,SOCI 190GS,A00,553232,Ribas Norris; Janet Vanesa,11,0,11,0
1713323510561,SOMI 220,A00,627178,Schneid; Stephen David,30,0,30,0
1713323511590,SYN 2,001,490768,Staff,14,0,15,1
1713323511590,SYN 2,002,490769,Staff,15,0,15,0
1713323511590,SYN 2,004,490775,Staff,0,0,0,0
1713323511590,SYN 2,003,490774,Staff,0,0,0,0
1713323511590,SYN 2,005,490776,Staff,0,0,0,0
1713323512614,SYN 2R,001,490779,Staff,11,0,15,4
1713323512614,SYN 2R,002,514635,Staff,14,0,15,1
1713323513643,SYN 100,A01,490783,Staff,12,0,20,8
1713323513643,SYN 100,B01,490787,Staff,9,0,20,11
1713323513643,SYN 100,C01,490789,Staff,11,0,20,9
1713323514671,SYN 150,A00,490817,Staff,14,0,15,1
1713323514671,SYN 150,B00,514610,Staff,15,0,15,0
1713323515696,TDAC 1,A00,492753,Walsh; Kim C.,19,0,20,1
1713323515696,TDAC 1,B00,492754,Harting; Carla Kelso,19,0,20,1
1713323515696,TDAC 1,C00,513995,Salovey; Todd,15,0,20,5
1713323516718,TDAC 101,A00,492766,Harting; Carla Kelso,17,0,20,3
1713323517743,TDAC 102,A00,492768,Basso; Beatrice,19,0,20,1
1713323518768,TDDE 111,A00,492769,Staff,25,0,25,0
1713323519796,TDDE 131,A00,492770,Staff,15,0,15,0
1713323519796,TDDE 131,B00,492771,Staff,15,0,15,0
1713323520821,TDDE 131GS,A00,523716,Guirguis; Mark C,23,0,28,5
1713323521847,TDGE 1,A01,492756,Salovey; Todd,57,0,60,3
1713323522874,TDGE 5,A01,492758,Staff,23,0,25,2
1713323523905,TDGE 10,A00,492759,Fulton; Julia,204,0,220,16
1713323524928,TDGE 11,A00,492760,Castro; Robert Jess,198,0,200,2
1713323526983,TDGE 124,A00,492772,Fulton; Julia,187,0,220,33
1713323528012,TDGE 125,A00,492773,Meyer; Ursula,38,0,50,12
1713323528012,TDGE 125,B00,492774,Staff,49,0,50,1
1713323528012,TDGE 125,C00,523565,Staff,48,0,50,2
1713323529038,TDGE 125GS,A00,523580,Guirguis; Mark C,23,0,28,5
1713323530067,TDGE 127,A00,492775,Havis; Allan,38,0,50,12
1713323531096,TDHT 101,A00,492776,Staff,34,0,35,1
1713323532125,TDMV 1,A00,492762,Caligagan; Maria T.,30,0,30,0
1713323532125,TDMV 1,B00,492763,Arcidiacono; Kristin,25,0,30,5
1713323533155,TDMV 2,A00,492764,Weinberg; Sadie,28,0,30,2
1713323534182,TDMV 3,A00,492765,Mack; Kara Shanai',38,0,40,2
1713323535207,TDMV 138,A00,492777,Mack; Kara Shanai',34,0,40,6
1713323536235,TDMV 140,A00,492778,Lima; Paulo Henrique,40,0,40,0
1713323537259,TDMV 142,A00,492779,Caligagan; Maria T.,33,0,40,7
1713323537259,TDMV 142,B00,492780,Caligagan; Tony,37,0,40,3
1713323538286,TDMV 143,A00,492781,Fyall; Daunte Edward,39,0,40,1
1713323539314,USP 1,A01,492401,Kwak; Nancy,26,0,35,9
1713323540338,USP 2,A01,492453,Hinds; Juli Beth,35,0,35,0
1713323541367,USP 3,A01,492516,Staff,28,0,35,7
1713323542395,USP 4,A00,492522,McTague; Sarah,17,0,25,8
1713323543424,USP 100,A00,492523,Staff,32,0,35,3
1713323544451,USP 101,A00,492524,Staff,13,0,15,2
1713323545476,USP 105,A00,492525,Staff,21,0,25,4
1713323546501,USP 151,A00,492526,Shenkman; Michael Thomas,32,0,35,3
1713323547526,USP 170,A00,492545,Hinds; Juli Beth,33,0,35,2
1713323548551,USP 171GS,A00,492608,Bussell; Mirle Rabinowitz,24,0,28,4
1713323549577,USP 183GS,A00,492613,Peerson; Susan,24,0,28,4
1713323550655,VIS 30,A01,490693,Yoldas; Pinar,19,0,22,3
1713323550655,VIS 30,A02,490694,Yoldas; Pinar,18,0,22,4
1713323551679,VIS 83,A00,490695,Kester; Grant,63,0,75,12
1713323552704,VIS 105D,A00,490696,Staff,22,0,25,3
1713323553729,VIS 124CN,A00,490699,Rose; Jordan M,66,0,75,9
1713323554753,VIS 125GS,A00,511221,Williams; Alena J,21,0,22,1
1713323555781,VIS 128D,A00,490700,Staff,73,0,75,2
1713323556811,VIS 151,A01,490717,Staff,33,0,34,1
1713323556811,VIS 151,A02,490766,Staff,33,0,34,1
1713323557835,VIS 154GS,A00,511972,Williams; Alena J,21,0,22,1
1713323558862,VIS 160A,A00,490767,Stone; Patricia,7,0,10,3
1713323559885,WCWP 10A,A00,490638,Staff,14,0,15,1
1713323559885,WCWP 10A,B00,490640,Staff,15,0,15,0
1713323560910,WCWP 10B,A00,490641,Staff,0,0,0,0
1713323560910,WCWP 10B,B00,490642,Staff,14,0,15,1
1713323560910,WCWP 10B,C00,490644,Staff,13,0,15,2
1713323560910,WCWP 10B,D00,490647,Staff,0,0,0,0
1713323561935,WCWP 100,A00,490655,Staff,0,0,0,0
1713323561935,WCWP 100,B00,490687,Staff,10,0,15,5
1713323563997,ANAR 153,A00,487222,Braswell; Geoffrey E.,54,0,60,6
1713323565025,ANBI 134,A00,487223,Staff,7,0,20,13
1713323566050,ANBI 143GS,A00,487224,Noel; Geoffroy Pierre Jean,18,0,24,6
1713323567077,ANBI 144GS,A00,519548,Noel; Geoffroy Pierre Jean,18,0,24,6
1713323568101,ANSC 101,A00,487225,Staff,18,0,20,2
1713323569124,ANSC 125,A00,487227,Brenner; Suzanne A,39,0,40,1
1713323571173,ANSC 146,A00,487229,Staff,35,0,40,5
1713323572197,ANSC 148,A00,487230,Olivas Hernandez; Olga Lid,39,0,40,1
1713323573223,ANSC 150,A00,504165,Sloane; Julia Kathryn,19,0,20,1
1713323574249,ANSC 180,A00,487232,Staff,14,0,15,1
1713323575273,ANSC 188,A00,627155,Staff,39,0,40,1
1713323576298,ANTH 5,A00,519529,Semendeferi; Ekaterini,15,0,15,0
1713323577321,ANTH 10,A00,487219,Staff,58,0,60,2
1713323578350,ANTH 23,A01,487221,Staff,17,0,20,3
1713323579373,ANTH 102,A00,487233,Wilder; Linnea Lorene,51,0,60,9
1713323580398,ANTH 103,A00,487234,Varma; Saiba,55,0,60,5
1713323581429,ANTH 105,A00,487235,Stewart; Alexander B,55,0,60,5
1713323582458,BENG 100,A01,516685,Taylor Amos; Alyssa C,27,0,30,3
1713323583482,BIBC 102,A01,491316,Flagg; Matthew Paul,18,0,88,70
1713323583482,BIBC 102,A02,491366,Flagg; Matthew Paul,80,0,88,8
1713323584511,BIBC 103,A01,491486,Boumechache; Miyyada,16,0,24,8
1713323584511,BIBC 103,A02,491487,Boumechache; Miyyada,24,0,24,0
1713323585536,BICD 100,A01,516882,Staff,73,0,75,2
1713323585536,BICD 100,A02,516890,Staff,69,0,75,6
1713323586561,BICD 102GS,A00,491488,Lo; Stanley M.,26,0,28,2
1713323587589,BIEB 136GS,A00,516940,Holway; David A. & Shurin; Jonathan,19,0,24,5
1713323588616,BIEB 137GS,A01,517034,Holway; David A. & Shurin; Jonathan,19,0,24,5
1713323589644,BIEB 138GS,A01,491492,Pirino; Giorgia,21,0,28,7
1713323590669,BILD 1,A01,491296,Staff,60,0,63,3
1713323590669,BILD 1,A02,491297,Staff,63,0,63,0
1713323591698,BILD 4,A01,517099,Gonzalez Gamboa; Ivonne,22,0,24,2
1713323591698,BILD 4,A02,517100,Gonzalez Gamboa; Ivonne,24,0,24,0
1713323592725,BILD 60GS,A00,491309,Lo; Stanley M.,26,0,28,2
1713323593750,BIMM 100,A01,517136,Staff,86,0,100,14
1713323594775,BIMM 110,A01,517182,Staff,61,0,100,39
1713323595800,BIMM 120,A01,517228,Pickett; Brooke Elizabeth,30,0,63,33
1713323595800,BIMM 120,A02,517240,Pickett; Brooke Elizabeth,45,0,63,18
1713323596828,BIMM 132GS,A01,491498,Pirino; Giorgia,21,0,28,7
1713323597853,BIMM 143,A01,491589,Bozinovic; Goran,13,0,40,27
1713323598882,BIPN 100,A01,491594,Armour; Jon Christopher,90,0,100,10
1713323599906,BIPN 140,A01,491602,Marino; Marc J,26,0,50,24
1713323601958,CAT 125,A00,515973,Staff,18,0,20,2
1713323602986,CAT 125GS,A00,515974,Rahimi; Babak,17,0,20,3
1713323604012,CAT 125R,A00,515980,Staff,13,0,20,7
1713323604012,CAT 125R,B00,515981,Tosun; Adriana,19,0,20,1
1713323604012,CAT 125R,C00,515987,Hyland; Tina Mae,0,2,20,20
1713323604012,CAT 125R,D00,515988,Bronstein; Phoebe Malan,17,0,20,3
1713323605041,CENG 15,A01,488699,Drews; Aaron,25,0,25,0
1713323606069,CENG 100,A00,505196,Opatkiewicz; Justin Paul,25,0,25,0
1713323607094,CGS 2A,A01,489598,Staff,33,0,35,2
1713323608119,CGS 112,A00,489599,Staff,15,0,15,0
1713323609141,CGS 119,A00,489603,Staff,10,0,10,0
1713323610169,CGS 120,A00,489604,Staff,14,0,15,1
1713323611194,CGS 150,A00,489607,Staff,15,0,15,0
1713323612222,CHEM 6A,A01,488715,Staff,98,0,100,2
1713323613248,CHEM 6B,A01,488719,Piercy; Marc Anthony,100,0,100,0
1713323614274,CHEM 6C,A01,488723,Albizati; Kim F.,93,0,100,7
1713323615306,CHEM 7L,A01,488728,Schurmeier; Kimberly,18,0,24,6
1713323615306,CHEM 7L,A02,488730,Schurmeier; Kimberly,23,0,24,1
1713323615306,CHEM 7L,A03,488734,Schurmeier; Kimberly,22,0,24,2
1713323615306,CHEM 7L,A04,488763,Schurmeier; Kimberly,23,0,24,1
1713323615306,CHEM 7L,B01,488798,Schurmeier; Kimberly,17,0,24,7
1713323615306,CHEM 7L,B02,488801,Schurmeier; Kimberly,23,0,24,1
1713323615306,CHEM 7L,B03,488808,Schurmeier; Kimberly,23,0,24,1
1713323615306,CHEM 7L,B04,488811,Schurmeier; Kimberly,24,0,24,0
1713323616330,CHEM 11,A01,488897,Stallings; Dontarie M,95,0,100,5
1713323617355,CHEM 40A,A01,488913,Albizati; Kim F.,84,0,100,16
1713323618380,CHEM 40B,A01,488920,Weizman; Haim,44,0,50,6
1713323618380,CHEM 40B,A02,488938,Weizman; Haim,45,0,50,5
1713323619404,CHEM 41A,A01,489029,Klosterman; Jeremy K,57,0,60,3
1713323620430,CHEM 41C,A01,500436,Tor; Yitzhak,55,0,60,5
1713323621456,CHEM 43A,A01,500426,Weizman; Haim,0,0,24,24
1713323621456,CHEM 43A,A02,500430,Weizman; Haim,12,0,24,12
1713323621456,CHEM 43A,B01,514041,Klosterman; Jeremy K,15,0,24,9
1713323621456,CHEM 43A,B02,514047,Klosterman; Jeremy K,23,0,24,1
1713323622485,CHEM 108,A01,489140,Jennings; Patricia A.,11,0,24,13
1713323622485,CHEM 108,A02,489142,Jennings; Patricia A.,14,0,24,10
1713323623514,CHEM 114A,A01,489147,Stallings; Dontarie M,73,0,100,27
1713323624540,CHIN 169A,A00,489171,Wang; Xiao,19,0,20,1
1713323626595,COGS 3,A01,518827,Boyle; Mary E. T.,26,0,40,14
1713323627624,COGS 11,A01,489175,Staff,28,0,30,2
1713323628648,COGS 14A,A01,518829,Staff,51,0,60,9
1713323629674,COGS 14B,A01,489177,Hoffman; Drew Ellen,65,0,75,10
1713323630700,COGS 100,A01,489181,Allen; Michael Gordon,64,0,75,11
1713323631726,COGS 101A,A01,489183,Staff,47,0,60,13
1713323632755,COGS 101B,A01,489185,Allen; Michael Gordon,8,0,30,22
1713323633785,COGS 101C,A01,526786,Staff,24,0,30,6
1713323635840,COGS 107A,A01,489189,Boyle; Mary E. T.,19,0,35,16
1713323636865,COGS 107B,A01,627144,Mooshagian; Eric Frederick,60,0,60,0
1713323637891,COGS 118A,A01,489191,Staff,0,40,40,40
1713323639942,COGS 171GS,A01,489194,Pineda; Jaime A,21,0,28,7
1713323640971,COGS 172,A01,489196,Staff,3,0,30,27
1713323642002,COGS 174GS,A01,489264,Pineda; Jaime A,21,0,28,7
1713323643030,COGS 180,A01,627150,Staff,28,0,30,2
1713323644060,COGS 186,A01,489274,Staff,0,1,30,30
1713323645087,COMM 10,A01,489276,Staff,23,0,25,2
1713323645087,COMM 10,A02,489303,Staff,23,0,25,2
1713323646115,COMM 100A,A01,489312,Staff,14,0,25,11
1713323646115,COMM 100A,A02,489313,Staff,24,0,25,1
1713323647144,COMM 106T,A00,512540,Staff,33,0,35,2
1713323648172,COMM 107,A00,489347,Staff,27,0,35,8
1713323649198,COMM 109P,A00,489358,Staff,31,0,35,4
1713323650224,COMM 132,A00,489361,McKenna; Denise,27,0,30,3
1713323651254,COMM 146,A00,489362,Halm; Gavin Patrick,26,0,30,4
1713323652278,COMM 190,A00,489363,Abuelhiga; Soraya Jill,17,0,23,6
1713323653307,CSE 8A,A50,489366,Staff,21,0,25,4
1713323653307,CSE 8A,A51,489367,Staff,24,0,25,1
1713323654391,CSE 11,A01,489398,Cao; Yingjun,75,0,100,25
1713323655558,CSE 12,A01,489487,Staff,43,0,50,7
1713323656583,CSE 20,A01,489497,Staff,48,0,50,2
1713323657612,CSE 21,A01,489517,Braun; Oliver,42,0,50,8
1713323658638,CSE 101,A01,489524,Braun; Oliver,0,28,50,50
1713323659667,CSE 105,A01,512594,Jones; Miles E,73,0,100,27
1713323659667,CSE 105,B01,512598,Jones; Miles E,55,0,100,45
1713323660697,CSE 140,A01,489538,Staff,42,0,50,8
1713323661722,CSE 141,A01,489550,Eldon; John,70,0,100,30
1713323662749,CSE 141L,A01,489571,Eldon; John,68,0,100,32
1713323663775,CSE 151A,A01,489583,Solares; Edwin A,142,0,200,58
1713323664807,CSE 175,A01,510886,Kumar; Rakesh,30,0,30,0
1713323665831,CSE 190,A00,516828,Dubnov; Shlomo,38,0,49,11
1713323666856,DOC 100D,A00,489667,Pass; Natalye Joann,19,0,25,6
1713323667882,DSC 10,A01,624268,Staff,72,0,75,3
1713323668907,DSC 20,A01,624476,Staff,50,0,50,0
1713323669933,DSC 40A,A01,624608,Staff,39,0,40,1
1713323670959,DSGN 1,A01,489179,Rill; Bryan,35,0,50,15
1713323671983,ECE 17,A01,490489,Sahay; Rajeev,18,0,30,12
1713323673010,ECE 65,A50,490492,Staff,12,0,20,8
1713323673010,ECE 65,A51,490493,Staff,19,0,20,1
1713323674038,ECON 1,A01,489715,Famulari; Melissa,68,0,70,2
1713323675062,ECON 2,A01,489717,Levkoff; Steven B.,68,0,70,2
1713323676088,ECON 3,A01,489948,Staff,70,0,70,0
1713323678138,ECON 5,A01,490103,Staff,27,0,30,3
1713323678138,ECON 5,B01,626281,Dai; Yinlin,45,0,45,0
1713323679169,ECON 100A,A01,490127,Famulari; Melissa,66,0,70,4
1713323680194,ECON 100B,A01,490129,Staff,64,0,70,6
1713323681220,ECON 109,A01,490187,Shishkin; Denis,27,0,35,8
1713323682244,ECON 110A,A01,490190,Levkoff; Steven B.,60,0,70,10
1713323683275,ECON 120A,A01,490245,Dai; Yinlin,62,0,70,8
1713323684306,ECON 120B,A01,490247,Nieto-Barthaburu; Augusto,48,0,70,22
1713323685330,ECON 120C,A01,490253,Sun; Yixiao,30,0,35,5
1713323685330,ECON 120C,B01,490255,Sun; Yixiao,34,0,35,1
1713323686355,ECON 129,A00,490256,Eckert; Fabian Paul,24,0,35,11
1713323687380,ECON 131,A00,490257,Nieto-Barthaburu; Augusto,0,6,35,35
1713323688405,ECON 138,A00,490258,Bharadwaj; Prashant,15,0,35,20
1713323688405,ECON 138,B00,490259,Bharadwaj; Prashant,16,0,35,19
1713323689433,ECON 159,A00,490260,Hendrickson; Gerald M.,0,8,0,0
1713323690457,ECON 178,A01,553995,Zhu; Ying,24,0,35,11
1713323691486,EDS 40,A01,512576,Black; Alison Michelle,20,0,20,0
1713323692515,EDS 107,A01,515848,Staff,30,0,30,0
1713323693543,EDS 110R,A01,490262,Staff,26,0,30,4
1713323694568,EDS 112,A01,490264,Chapman; Thandeka K,40,0,50,10
1713323695593,EDS 113,A00,490266,Staff,26,0,30,4
1713323696619,EDS 118,A00,490267,Warstadt; Melissa Fawn,21,0,30,9
1713323697647,EDS 124BR,A00,490268,Eguchi; Emi,4,0,25,21
1713323697647,EDS 124BR,B00,490269,Eguchi; Emi,24,0,25,1
1713323698678,EDS 126,A01,490271,Jones; Makeba,43,0,50,7
1713323699703,EDS 135,A01,490316,Staff,19,0,20,1
1713323700728,ENVR 142GS,A00,519514,Chang; Edmond Yi-Teh,27,0,28,1
1713323701760,ETHN 103,A00,490504,Staff,26,0,36,10
1713323702787,ETHN 103A,A00,490505,Man; Simeon S,5,0,9,4
1713323703810,ETHN 109,A00,490506,Staff,29,0,30,1
1713323704835,ETHN 118,A00,490507,Staff,35,0,36,1
1713323705859,ETHN 119,A00,490508,Staff,33,0,36,3
1713323706883,ETHN 121R,A00,490518,Choi; Esther Min,24,0,36,12
1713323707907,ETHN 127,A00,490528,Staff,14,0,15,1
1713323708932,ETHN 139,A00,490573,Staff,10,0,10,0
1713323709957,ETHN 150,A00,490575,Staff,15,0,15,0
1713323710982,GLBH 20,A00,491705,Elwardani; Nile Regina,38,0,40,2
1713323712009,GLBH 101,A00,491706,Staff,20,0,20,0
1713323713036,GLBH 111,A01,491708,Burgos; Jose L.,15,0,15,0
1713323714062,GLBH 146,A00,491709,Staff,10,0,20,10
1713323715087,GLBH 148,A00,491710,Olivas Hernandez; Olga Lid,13,0,20,7
1713323716113,GLBH 150,A00,491711,Sloane; Julia Kathryn,20,0,20,0
1713323717137,HIEA 131,A00,491760,Staff,29,0,32,3
1713323718162,HIEA 153,A00,491762,Staff,29,0,30,1
1713323719187,HIEU 124,A00,491811,Staff,26,0,32,6
1713323720214,HIEU 124GS,A00,491812,Markman; Kristina,27,0,28,1
1713323721239,HIEU 147,A00,491813,Staff,30,0,32,2
1713323722267,HIEU 149GS,A00,491816,Caldwell; Michael Alan,28,0,28,0
1713323723298,HILD 2C,A01,491713,Hendrickson; Gerald M.,27,0,30,3
1713323724325,HILD 7B,A01,491715,Kwak; Nancy,1,0,30,29
1713323725351,HILD 10,A01,491717,Staff,12,0,20,8
1713323726377,HILD 30GS,A00,491719,Edington; Claire Ellen,24,0,28,4
1713323727401,HINE 109,A00,491818,Shafir; Nir,27,0,32,5
1713323728427,HINE 128,A00,491821,Shafir; Nir,31,0,32,1
1713323729452,HISC 117,A00,491830,Staff,27,0,32,5
1713323730475,HIUS 103,A00,491834,Man; Simeon S,14,0,23,9
1713323731500,HIUS 108B,A00,491835,Staff,28,0,30,2
1713323732527,HIUS 141,A00,491836,Hendrickson; Gerald M.,29,0,32,3
1713323733559,HIUS 149,A00,491839,Staff,26,0,32,6
1713323734584,HUM 3,A01,512617,Crum; Matthew Stephen,43,0,50,7
1713323734584,HUM 3,A02,512618,Crum; Matthew Stephen,48,0,50,2
1713323735608,HUM 3GS,A00,512663,Markman; Kristina,0,0,0,1
1713323735608,HUM 3GS,B00,512664,Staff,0,0,0,0
1713323736633,HUM 4,A01,512620,West; Geoffrey Scott,28,0,50,22
1713323737660,HUM 4GS,A00,512666,Lyon; Antony J.,0,0,0,4
1713323738686,HUM 4R,A01,512625,Watkins; Eric,48,0,50,2
1713323739713,HUM 5,A01,512649,Zavodny; Tatiana Sophia,25,0,50,25
1713323739713,HUM 5,B01,512661,Zroka; Ryan Edward,48,0,50,2
1713323740742,INTL 190,A00,490577,Segui; Alan S,0,0,0,5
1713323741771,JAPN 20AR,A01,491267,Ross; Kayoko F,8,0,20,12
1713323742793,JAPN 180,A00,491285,Berman; Michael David,33,0,40,7
1713323743820,LATI 50,A01,502536,Kokinis; Troy Andreas,16,0,22,6
1713323743820,LATI 50,A02,502551,Kokinis; Troy Andreas,22,0,22,0
1713323743820,LATI 50,A03,502650,Kokinis; Troy Andreas,22,0,22,0
1713323743820,LATI 50,A04,502909,Kokinis; Troy Andreas,22,0,22,0
1713323744847,LATI 160,A01,502920,Kokinis; Troy Andreas,30,0,30,0
1713323745872,LIFR 1A,A00,490494,Van Moer; Vinciane G,17,0,20,3
1713323746901,LIFR 1AX,A00,490495,Van Moer; Vinciane G,17,0,20,3
1713323747926,LIFR 1B,A00,490496,Van Moer; Vinciane G,18,0,20,2
1713323748951,LIFR 1BX,A00,490497,Van Moer; Vinciane G,18,0,20,2
1713323749977,LIGN 8,A00,505198,McIntosh; Justin Daniel,135,0,150,15
1713323751005,LIGN 9GS,A00,491239,Lott; Margaret S.,18,0,20,2
1713323752031,LIGN 101,A01,505200,McIntosh; Justin Daniel,23,0,30,7
1713323753061,LIGN 120,A01,491244,Staff,23,0,30,7
1713323754085,LIGN 149GS,A00,491245,Lott; Margaret S.,18,0,20,2
1713323755114,LIGN 170,A00,491247,Staff,22,0,30,8
1713323756141,LISP 1D,A00,490498,Munoz Sanchez; Alicia,10,0,14,4
1713323756141,LISP 1D,B00,490499,Munoz Sanchez; Alicia,6,0,14,8
1713323756141,LISP 1D,C00,490500,Munoz Sanchez; Alicia,8,0,14,6
1713323756141,LISP 1D,D00,490501,Munoz Sanchez; Alicia,10,0,14,4
1713323757166,LISP 1DX,A00,490502,Munoz Sanchez; Alicia,15,0,28,13
1713323757166,LISP 1DX,B00,490503,Munoz Sanchez; Alicia,17,0,28,11
1713323759269,LTAM 110,A00,491847,Staff,23,0,25,2
1713323760298,LTCS 119,A00,491848,Staff,11,0,15,4
1713323761329,LTCS 130,A00,491849,Staff,24,0,25,1
1713323763381,LTEA 120C,A00,491852,Staff,32,0,40,8
1713323764409,LTEN 130GS,A00,491853,Lyon; Antony J.,24,0,28,4
1713323765436,LTEN 148,A00,491855,Staff,23,0,25,2
1713323766460,LTEN 159,A00,491856,Staff,21,0,25,4
1713323767484,LTEN 180,A00,491857,Staff,8,0,15,7
1713323769535,LTSP 123GS,A00,505928,Bessett; Ryan Matthew,24,0,28,4
1713323770558,LTSP 174GS,A00,506037,Bessett; Ryan Matthew,24,0,28,4
1713323772611,LTWR 102,A00,491861,Staff,9,0,15,6
1713323773635,LTWR 106,A00,491862,Staff,10,0,15,5
1713323774660,MAE 11,A00,490930,Bahadori; Mohammad Yousef,96,0,100,4
1713323775684,MAE 30A,A00,490931,Qi; Huihui,37,0,40,3
1713323776709,MAE 101A,A00,491036,Sadeghizadeh; Zahra,95,0,100,5
1713323777735,MAE 101C,A00,491037,Seshadri; Kalyanasundaram,70,0,100,30
1713323778762,MAE 113,A00,491040,Seshadri; Kalyanasundaram,66,0,80,14
1713323779785,MAE 131A,A00,491041,Ghazinejad; Maziar,37,0,40,3
1713323780812,MAE 142,A00,491053,Staff,39,0,40,1
1713323781838,MAE 143A,A00,491054,Staff,33,0,50,17
1713323782864,MAE 150,A00,491092,Truong; Phuong Thi Ngoc,23,0,35,12
1713323783889,MATH 3C,A01,494031,Pardo Guerra; Sebastian,30,0,30,0
1713323783889,MATH 3C,A02,494032,Pardo Guerra; Sebastian,29,0,30,1
1713323784918,MATH 10A,A01,494034,Staff,27,0,30,3
1713323784918,MATH 10A,A02,494035,Staff,28,0,30,2
1713323784918,MATH 10A,B01,494037,Staff,27,0,30,3
1713323784918,MATH 10A,B02,494038,Staff,29,0,30,1
1713323785945,MATH 10B,A01,494040,Habib; Yousaf,22,0,30,8
1713323785945,MATH 10B,A02,494041,Habib; Yousaf,28,0,30,2
1713323785945,MATH 10B,A03,494042,Habib; Yousaf,29,0,30,1
1713323785945,MATH 10B,A04,494043,Habib; Yousaf,30,0,30,0
1713323785945,MATH 10B,B01,494045,Habib; Yousaf,26,0,30,4
1713323785945,MATH 10B,B02,494046,Habib; Yousaf,30,0,30,0
1713323785945,MATH 10B,B03,494047,Habib; Yousaf,30,0,30,0
1713323785945,MATH 10B,B04,494048,Habib; Yousaf,30,0,30,0
1713323786971,MATH 18,A01,494050,Kemp; Todd Aahron,25,0,30,5
1713323786971,MATH 18,A02,494051,Kemp; Todd Aahron,29,0,30,1
1713323786971,MATH 18,B01,494054,Kemp; Todd Aahron,27,0,30,3
1713323786971,MATH 18,B02,494055,Kemp; Todd Aahron,29,0,30,1
1713323787994,MATH 20A,A01,494059,Suk; Andrew Hoon,30,0,30,0
1713323789024,MATH 20B,A01,494061,Briones; Jor-el Thomas Caparas,33,0,35,2
1713323789024,MATH 20B,B01,494063,Bach; Quang Tran,34,0,35,1
1713323790059,MATH 20C,A01,494065,Staff,28,0,30,2
1713323790059,MATH 20C,A02,494066,Staff,30,0,30,0
1713323790059,MATH 20C,A03,494067,Staff,30,0,30,0
1713323790059,MATH 20C,A04,494068,Staff,30,0,30,0
1713323790059,MATH 20C,B01,494070,Zhang; Ming,26,0,30,4
1713323790059,MATH 20C,B02,494071,Zhang; Ming,27,0,30,3
1713323790059,MATH 20C,B03,494072,Zhang; Ming,29,0,30,1
1713323790059,MATH 20C,B04,494073,Zhang; Ming,29,0,30,1
1713323791088,MATH 20D,A01,494075,Staff,22,0,30,8
1713323791088,MATH 20D,A02,494076,Staff,30,0,30,0
1713323792117,MATH 20E,A01,494079,Staff,24,0,30,6
1713323792117,MATH 20E,A02,494080,Staff,26,0,30,4
1713323792117,MATH 20E,B01,494082,Staff,25,0,30,5
1713323792117,MATH 20E,B02,494083,Staff,25,0,30,5
1713323793141,MATH 103A,A01,494085,Aliabadi Sr.; Mohsen,14,0,30,16
1713323793141,MATH 103A,A02,494086,Aliabadi Sr.; Mohsen,28,0,30,2
1713323793141,MATH 103A,B01,494088,Aliabadi Sr.; Mohsen,21,0,30,9
1713323793141,MATH 103A,B02,494089,Aliabadi Sr.; Mohsen,28,0,30,2
1713323794167,MATH 109,A01,494091,Staff,30,0,30,0
1713323794167,MATH 109,A02,494092,Staff,29,0,30,1
1713323794167,MATH 109,B01,494094,Staff,27,0,30,3
1713323794167,MATH 109,B02,494095,Staff,29,0,30,1
1713323795192,MATH 142A,A01,494097,Chow; Bennett,15,0,30,15
1713323795192,MATH 142A,A02,494098,Chow; Bennett,24,0,30,6
1713323795192,MATH 142A,B01,494100,Chow; Bennett,19,0,30,11
1713323795192,MATH 142A,B02,494101,Chow; Bennett,29,0,30,1
1713323797246,MATH 168A,A01,516677,Dumitriu; Ioana,15,0,35,20
1713323798273,MATH 170A,A01,516679,Dumitriu; Ioana,19,0,30,11
1713323798273,MATH 170A,A02,516680,Dumitriu; Ioana,28,0,30,2
1713323799296,MATH 193A,A01,494107,Staff,14,0,30,16
1713323799296,MATH 193A,A02,494108,Staff,21,0,30,9
1713323799296,MATH 193A,A03,494109,Staff,29,0,30,1
1713323799296,MATH 193A,A04,494110,Staff,22,0,30,8
1713323802378,MGT 16,A00,491930,McKay; Michael J,92,0,98,6
1713323803404,MGT 18,A00,491992,McKay; Michael J,96,0,98,2
1713323804429,MGT 71,A00,492003,Staff,66,0,98,32
1713323805453,MGT 103,A00,505209,Eberhard; Craig A,81,0,98,17
1713323806482,MGT 131A,A00,505210,Anderson; John Charles,90,0,98,8
1713323808535,MGT 153,A00,492077,Perols; Johan Lars,23,0,90,67
1713323811651,MGT 164,A00,492222,McKay; Mary A,91,0,98,7
1713323812678,MGT 172,A00,492245,Staff,59,0,60,1
1713323812678,MGT 172,B00,505526,Hedges; Kathleen,66,0,98,32
1713323813701,MGT 181,A00,505669,Dunn; Louis Jean,83,0,98,15
1713323814727,MMW 14,A01,494399,Staff,18,0,28,10
1713323814727,MMW 14,A02,494400,Staff,25,0,28,3
1713323814727,MMW 14,A03,494401,Staff,28,0,28,0
1713323814727,MMW 14,A04,494402,Staff,28,0,28,0
1713323814727,MMW 14,B01,494404,Carreras; Maria Victoria,9,0,28,19
1713323814727,MMW 14,B02,494405,Carreras; Maria Victoria,25,0,28,3
1713323814727,MMW 14,B03,494406,Carreras; Maria Victoria,27,0,28,1
1713323814727,MMW 14,B04,494407,Carreras; Maria Victoria,28,0,28,0
1713323815755,MMW 14GS,A00,506250,Chang; Edmond Yi-Teh,0,0,0,0
1713323816780,MMW 121R,A01,494415,Adamiak; Patrick John,12,0,28,16
1713323816780,MMW 121R,A02,494416,Adamiak; Patrick John,24,0,28,4
1713323817808,MUS 1A,A01,494113,Staff,12,0,25,13
1713323817808,MUS 1A,A02,494114,Staff,24,0,25,1
1713323818837,MUS 4,A01,494116,Staff,23,0,25,2
1713323818837,MUS 4,A02,494117,Staff,22,0,25,3
1713323819862,MUS 5R,A01,494236,Dubnov; Shlomo,9,0,25,16
1713323819862,MUS 5R,A02,494237,Dubnov; Shlomo,25,0,25,0
1713323820891,MUS 6,A01,494122,Staff,10,0,25,15
1713323820891,MUS 6,A02,494123,Staff,23,0,25,2
1713323821916,MUS 7,A01,494125,Staff,16,0,25,9
1713323821916,MUS 7,A02,494126,Staff,24,0,25,1
1713323822945,MUS 11,A01,494128,Staff,23,0,25,2
1713323822945,MUS 11,A02,494129,Staff,24,0,25,1
1713323823969,MUS 13,A01,494131,Staff,25,0,25,0
1713323823969,MUS 13,A02,494132,Staff,25,0,25,0
1713323824995,MUS 15,A01,494134,Staff,17,0,25,8
1713323824995,MUS 15,A02,494135,Staff,25,0,25,0
1713323824995,MUS 15,B01,494137,Staff,24,0,25,1
1713323826021,MUS 80,A00,494232,Staff,24,0,25,1
1713323826021,MUS 80,B00,494233,Staff,25,0,25,0
1713323826021,MUS 80,C00,494234,Staff,23,0,25,2
1713323827047,MUS 95C,A00,494141,Staff,70,0,75,5
1713323828072,MUS 114,A00,494142,Staff,40,0,50,10
1713323829100,NANO 15,A01,490636,Drews; Aaron,7,0,7,0
1713323830126,PHIL 1,A00,490578,Grush; Rick Scott,49,0,50,1
1713323831151,PHIL 10,A01,490580,Grush; Rick Scott,33,0,35,2
1713323831151,PHIL 10,A02,490586,Grush; Rick Scott,32,0,35,3
1713323832176,PHIL 27,A01,490591,Staff,22,0,25,3
1713323832176,PHIL 27,A02,490592,Staff,25,0,25,0
1713323832176,PHIL 27,A03,490593,Staff,25,0,25,0
1713323832176,PHIL 27,A04,490598,Staff,25,0,25,0
1713323833201,PHIL 32,A01,490611,Staff,20,0,20,0
1713323833201,PHIL 32,A02,490618,Staff,20,0,20,0
1713323834228,PHIL 90,A00,490624,Staff,40,0,40,0
1713323835257,PHIL 136,A00,490627,Cohen; Jonathan David,37,0,40,3
1713323836285,PHIL 155,A00,490634,Staff,63,0,70,7
1713323837313,PHYS 1A,A00,491610,Staff,245,0,250,5
1713323838341,PHYS 1AL,001,491616,Tsai; Philbert S,27,0,30,3
1713323838341,PHYS 1AL,002,491618,Tsai; Philbert S,30,0,30,0
1713323839365,PHYS 1B,A00,491623,Staff,237,0,250,13
1713323840391,PHYS 1BL,001,491626,Tsai; Philbert S,22,0,30,8
1713323840391,PHYS 1BL,002,491628,Tsai; Philbert S,26,0,30,4
1713323841415,PHYS 1C,A00,491632,Staff,217,0,245,28
1713323842440,PHYS 1CL,001,491635,Tsai; Philbert S,8,0,30,22
1713323842440,PHYS 1CL,002,491643,Tsai; Philbert S,21,0,30,9
1713323843469,PHYS 2AR,A01,491651,Meyertholen; Andrew D.,44,0,50,6
1713323844498,PHYS 2B,A01,491659,Staff,105,0,115,10
1713323845523,PHYS 2BL,A01,491685,Staff,21,0,24,3
1713323845523,PHYS 2BL,A02,491700,Staff,21,0,24,3
1713323846549,PHYS 2C,A01,505161,Staff,103,0,115,12
1713323847574,PHYS 4A,A01,491704,Grinstein; Benjamin,99,0,100,1
1713323848603,POLI 5D,A01,494144,Staff,3,0,5,2
1713323848603,POLI 5D,B01,626283,Dai; Yinlin,5,0,5,0
1713323849627,POLI 12,A00,494145,Staff,43,0,45,2
1713323850657,POLI 13R,A00,494146,Forman; Fonna,45,0,50,5
1713323851686,POLI 27,A01,494148,Staff,54,0,60,6
1713323852710,POLI 30,A00,494149,Staff,49,0,50,1
1713323853735,POLI 100DA,A00,494150,Staff,21,0,25,4
1713323855783,POLI 100I,A00,494152,Staff,27,0,30,3
1713323856808,POLI 104B,A00,494153,Smith; Glenn Chatmas,53,0,55,2
1713323857837,POLI 104F,A00,494154,Staff,28,0,30,2
1713323858863,POLI 104I,A00,494155,Smith; Glenn Chatmas,30,0,30,0
1713323859891,POLI 110C,A00,494156,Ingham; Sean,23,0,25,2
1713323860918,POLI 117R,A00,494157,Forman; Fonna,8,0,20,12
1713323861997,POLI 118,A00,494158,Ingham; Sean,21,0,25,4
1713323863022,POLI 120H,A00,494159,Fisk; David Lee,40,0,45,5
1713323864047,POLI 131CR,A00,494160,Hoston; Germaine,36,0,45,9
1713323865072,POLI 133J,A00,494161,Staff,33,0,35,2
1713323866097,POLI 135,A00,494162,Fisk; David Lee,33,0,35,2
1713323867122,POLI 140A,A00,494164,Staff,20,0,30,10
1713323868147,POLI 142I,A00,494165,Staff,30,0,30,0
1713323869176,POLI 144D,A00,494166,Staff,23,0,25,2
1713323870202,POLI 151,A00,494167,Staff,30,0,30,0
1713323871226,POLI 153,A00,494168,Staff,33,0,35,2
1713323872250,POLI 160AA,A00,494169,Staff,34,0,40,6
1713323873273,POLI 162,A00,494170,Mignozzetti; Umberto,19,0,25,6
1713323874302,POLI 171,A00,494171,Mignozzetti; Umberto,20,0,25,5
1713323875326,PSYC 1,A00,494172,Staff,97,0,100,3
1713323876351,PSYC 2,A00,494173,Moranton; Nirelia Melbina-,37,0,50,13
1713323877375,PSYC 3,A00,494174,Staff,29,0,30,1
1713323878404,PSYC 6,A00,494175,Staff,17,0,20,3
1713323879431,PSYC 60,A01,494177,Staff,38,0,45,7
1713323880454,PSYC 70,A01,505724,Geller; Emma Harlan,42,0,45,3
1713323881479,PSYC 101,A00,494180,Heyman; Gail D.,84,0,100,16
1713323882506,PSYC 105,A00,494181,Geller; Emma Harlan,55,0,90,35
1713323883542,PSYC 106,A00,494182,Dobkins; Karen R.,29,0,45,16
1713323884570,PSYC 108,A00,494183,Adrian; Julia Anna,90,0,100,10
1713323885599,PSYC 114,A01,494185,Winkielman; Piotr,0,1,30,30
1713323886627,PSYC 122,A00,494186,Moranton; Nirelia Melbina-,31,0,50,19
1713323887650,PSYC 124,A00,494187,Chapman; Eddie Nathaniel,71,0,80,9
1713323888677,PSYC 131,A00,494188,Anagnostaras; Stephan,46,0,80,34
1713323889704,PSYC 144,A00,494189,Staff,8,0,50,42
1713323890732,PSYC 154,A00,494190,Lacefield; Katharine I,116,0,180,64
1713323891757,PSYC 162,A00,494191,Wixted; John T,74,0,100,26
1713323892784,PSYC 172,A00,494192,Gorman; Michael R.,36,0,45,9
1713323893812,PSYC 178,A00,494193,Glaser; Dale,34,0,45,11
1713323894836,PSYC 193,A00,505725,Chapman; Eddie Nathaniel,20,0,20,0
1713323895861,RELI 145GS,A00,519817,Rahimi; Babak,18,0,20,2
1713323896885,SE 101A,A01,490862,Chadha; Mayank,23,0,25,2
1713323897909,SE 101C,A01,490924,Krysl; Petr,16,0,20,4
1713323898936,SE 110A,A01,490928,Staff,19,0,20,1
1713323899966,SE 130A,A00,490929,Morrison; Machel Leigh,57,0,70,13
1713323900994,SIO 1,A01,519325,Staff,39,0,40,1
1713323902018,SIO 30,A01,519327,Staff,38,0,40,2
1713323903044,SIO 40,A00,519328,Staff,39,0,40,1
1713323904070,SIO 46GS,A00,519819,Cook; Geoffrey W,17,0,25,8
1713323905095,SIO 109R,A00,494197,Forman; Fonna,0,1,20,20
1713323906120,SIO 121GS,A00,519827,Cook; Geoffrey W,17,0,25,8
1713323907147,SIO 132,A01,519330,Staff,38,0,40,2
1713323908173,SIO 133,A01,519397,Staff,37,0,40,3
1713323909201,SIO 139,A00,519396,Kacev; David,31,0,40,9
1713323910228,SOCI 1,A01,494199,Thorpe; Charles Robert,22,0,30,8
1713323910228,SOCI 1,A02,494200,Thorpe; Charles Robert,30,0,30,0
1713323910228,SOCI 1,A03,494201,Thorpe; Charles Robert,29,0,30,1
1713323910228,SOCI 1,A04,494202,Thorpe; Charles Robert,29,0,30,1
1713323910228,SOCI 1,A05,494203,Thorpe; Charles Robert,29,0,30,1
1713323910228,SOCI 1,A06,494204,Thorpe; Charles Robert,30,0,30,0
1713323910228,SOCI 1,A07,494205,Thorpe; Charles Robert,28,0,30,2
1713323911252,SOCI 60,A01,494207,Staff,34,0,40,6
1713323911252,SOCI 60,A02,494208,Staff,39,0,40,1
1713323912277,SOCI 100,A01,494210,Payne; Christine Anna,26,0,30,4
1713323912277,SOCI 100,A02,494211,Payne; Christine Anna,26,0,30,4
1713323913305,SOCI 109M,A00,494212,Staff,20,0,20,0
1713323914329,SOCI 110,A00,494213,Staff,34,0,40,6
1713323916379,SOCI 118E,A00,494215,Ng; Kwai,37,0,40,3
1713323917406,SOCI 125,A00,494216,Calderon-Zaks; Michael Aar,41,0,45,4
1713323918431,SOCI 126,A01,494218,Jones; Makeba,3,0,5,2
1713323919455,SOCI 131,A00,494219,Thorpe; Charles Robert,27,0,30,3
1713323921503,SOCI 135,A00,494221,Payne; Christine Anna,30,0,50,20
1713323922530,SOCI 136E,A00,626690,Ruiz; Jonathan Joseph,25,0,25,0
1713323923577,SOCI 138GS,A00,494222,Navon; Daniel,24,0,28,4
1713323925632,SOCI 145,A00,494224,Staff,41,0,45,4
1713323926660,SOCI 153,A00,494225,Staff,28,0,30,2
1713323927688,SOCI 160E,A00,494226,Ng; Kwai,29,0,40,11
1713323928714,SOCI 180,A00,494227,Staff,29,0,30,1
1713323929739,SOCI 189GS,A00,494228,Ribas Norris; Janet Vanesa,11,0,11,0
1713323930766,SOCI 190GS,A00,553232,Ribas Norris; Janet Vanesa,11,0,11,0
1713323931795,SOMI 220,A00,627178,Schneid; Stephen David,30,0,30,0
1713323932823,SYN 2,001,490768,Staff,14,0,15,1
1713323932823,SYN 2,002,490769,Staff,15,0,15,0
1713323932823,SYN 2,004,490775,Staff,0,0,0,0
1713323932823,SYN 2,003,490774,Staff,0,0,0,0
1713323932823,SYN 2,005,490776,Staff,0,0,0,0
1713323933847,SYN 2R,001,490779,Staff,11,0,15,4
1713323933847,SYN 2R,002,514635,Staff,14,0,15,1
1713323934872,SYN 100,A01,490783,Staff,12,0,20,8
1713323934872,SYN 100,B01,490787,Staff,9,0,20,11
1713323934872,SYN 100,C01,490789,Staff,11,0,20,9
1713323935899,SYN 150,A00,490817,Staff,14,0,15,1
1713323935899,SYN 150,B00,514610,Staff,15,0,15,0
1713323936926,TDAC 1,A00,492753,Walsh; Kim C.,19,0,20,1
1713323936926,TDAC 1,B00,492754,Harting; Carla Kelso,19,0,20,1
1713323936926,TDAC 1,C00,513995,Salovey; Todd,15,0,20,5
1713323937954,TDAC 101,A00,492766,Harting; Carla Kelso,17,0,20,3
1713323938982,TDAC 102,A00,492768,Basso; Beatrice,19,0,20,1
1713323940009,TDDE 111,A00,492769,Staff,25,0,25,0
1713323941035,TDDE 131,A00,492770,Staff,15,0,15,0
1713323941035,TDDE 131,B00,492771,Staff,15,0,15,0
1713323942059,TDDE 131GS,A00,523716,Guirguis; Mark C,23,0,28,5
1713323943084,TDGE 1,A01,492756,Salovey; Todd,57,0,60,3
1713323944110,TDGE 5,A01,492758,Staff,23,0,25,2
1713323945135,TDGE 10,A00,492759,Fulton; Julia,203,0,220,17
1713323946165,TDGE 11,A00,492760,Castro; Robert Jess,198,0,200,2
1713323948217,TDGE 124,A00,492772,Fulton; Julia,187,0,220,33
1713323949247,TDGE 125,A00,492773,Meyer; Ursula,38,0,50,12
1713323949247,TDGE 125,B00,492774,Staff,49,0,50,1
1713323949247,TDGE 125,C00,523565,Staff,48,0,50,2
1713323950274,TDGE 125GS,A00,523580,Guirguis; Mark C,23,0,28,5
1713323951303,TDGE 127,A00,492775,Havis; Allan,37,0,50,13
1713323952327,TDHT 101,A00,492776,Staff,34,0,35,1
1713323953356,TDMV 1,A00,492762,Caligagan; Maria T.,30,0,30,0
1713323953356,TDMV 1,B00,492763,Arcidiacono; Kristin,26,0,30,4
1713323954381,TDMV 2,A00,492764,Weinberg; Sadie,28,0,30,2
1713323955405,TDMV 3,A00,492765,Mack; Kara Shanai',37,0,40,3
1713323956430,TDMV 138,A00,492777,Mack; Kara Shanai',34,0,40,6
1713323957455,TDMV 140,A00,492778,Lima; Paulo Henrique,40,0,40,0
1713323958482,TDMV 142,A00,492779,Caligagan; Maria T.,33,0,40,7
1713323958482,TDMV 142,B00,492780,Caligagan; Tony,37,0,40,3
1713323959510,TDMV 143,A00,492781,Fyall; Daunte Edward,39,0,40,1
1713323960534,USP 1,A01,492401,Kwak; Nancy,26,0,35,9
1713323961561,USP 2,A01,492453,Hinds; Juli Beth,35,0,35,0
1713323962586,USP 3,A01,492516,Staff,28,0,35,7
1713323963610,USP 4,A00,492522,McTague; Sarah,17,0,25,8
1713323964635,USP 100,A00,492523,Staff,32,0,35,3
1713323965717,USP 101,A00,492524,Staff,13,0,15,2
1713323966744,USP 105,A00,492525,Staff,21,0,25,4
1713323967769,USP 151,A00,492526,Shenkman; Michael Thomas,32,0,35,3
1713323968797,USP 170,A00,492545,Hinds; Juli Beth,33,0,35,2
1713323969820,USP 171GS,A00,492608,Bussell; Mirle Rabinowitz,24,0,28,4
1713323970848,USP 183GS,A00,492613,Peerson; Susan,24,0,28,4
1713323971874,VIS 30,A01,490693,Yoldas; Pinar,19,0,22,3
1713323971874,VIS 30,A02,490694,Yoldas; Pinar,18,0,22,4
1713323972903,VIS 83,A00,490695,Kester; Grant,63,0,75,12
1713323973928,VIS 105D,A00,490696,Staff,22,0,25,3
1713323974952,VIS 124CN,A00,490699,Rose; Jordan M,66,0,75,9
1713323975980,VIS 125GS,A00,511221,Williams; Alena J,21,0,22,1
1713323977007,VIS 128D,A00,490700,Staff,73,0,75,2
1713323978033,VIS 151,A01,490717,Staff,33,0,34,1
1713323978033,VIS 151,A02,490766,Staff,33,0,34,1
1713323979059,VIS 154GS,A00,511972,Williams; Alena J,21,0,22,1
1713323980084,VIS 160A,A00,490767,Stone; Patricia,7,0,10,3
1713323981110,WCWP 10A,A00,490638,Staff,14,0,15,1
1713323981110,WCWP 10A,B00,490640,Staff,15,0,15,0
1713323982135,WCWP 10B,A00,490641,Staff,0,0,0,0
1713323982135,WCWP 10B,B00,490642,Staff,14,0,15,1
1713323982135,WCWP 10B,C00,490644,Staff,13,0,15,2
1713323982135,WCWP 10B,D00,490647,Staff,0,0,0,0
1713323983164,WCWP 100,A00,490655,Staff,0,0,0,0
1713323983164,WCWP 100,B00,490687,Staff,10,0,15,5
1713323985272,ANAR 153,A00,487222,Braswell; Geoffrey E.,54,0,60,6
1713323986298,ANBI 134,A00,487223,Staff,7,0,20,13
1713323987322,ANBI 143GS,A00,487224,Noel; Geoffroy Pierre Jean,18,0,24,6
1713323988350,ANBI 144GS,A00,519548,Noel; Geoffroy Pierre Jean,18,0,24,6
1713323989376,ANSC 101,A00,487225,Staff,18,0,20,2
1713323990400,ANSC 125,A00,487227,Brenner; Suzanne A,39,0,40,1
1713323992450,ANSC 146,A00,487229,Staff,35,0,40,5
1713323993473,ANSC 148,A00,487230,Olivas Hernandez; Olga Lid,39,0,40,1
1713323994500,ANSC 150,A00,504165,Sloane; Julia Kathryn,18,0,20,2
1713323995526,ANSC 180,A00,487232,Staff,14,0,15,1
1713323996549,ANSC 188,A00,627155,Staff,39,0,40,1
1713323997575,ANTH 5,A00,519529,Semendeferi; Ekaterini,15,0,15,0
1713323998603,ANTH 10,A00,487219,Staff,58,0,60,2
1713323999632,ANTH 23,A01,487221,Staff,17,0,20,3
1713324000657,ANTH 102,A00,487233,Wilder; Linnea Lorene,51,0,60,9
1713324001682,ANTH 103,A00,487234,Varma; Saiba,55,0,60,5
1713324002707,ANTH 105,A00,487235,Stewart; Alexander B,55,0,60,5
1713324003735,BENG 100,A01,516685,Taylor Amos; Alyssa C,27,0,30,3
1713324004763,BIBC 102,A01,491316,Flagg; Matthew Paul,18,0,88,70
1713324004763,BIBC 102,A02,491366,Flagg; Matthew Paul,80,0,88,8
1713324005794,BIBC 103,A01,491486,Boumechache; Miyyada,16,0,24,8
1713324005794,BIBC 103,A02,491487,Boumechache; Miyyada,24,0,24,0
1713324006823,BICD 100,A01,516882,Staff,73,0,75,2
1713324006823,BICD 100,A02,516890,Staff,69,0,75,6
1713324007850,BICD 102GS,A00,491488,Lo; Stanley M.,26,0,28,2
1713324008877,BIEB 136GS,A00,516940,Holway; David A. & Shurin; Jonathan,19,0,24,5
1713324009902,BIEB 137GS,A01,517034,Holway; David A. & Shurin; Jonathan,19,0,24,5
1713324010930,BIEB 138GS,A01,491492,Pirino; Giorgia,21,0,28,7
1713324011958,BILD 1,A01,491296,Staff,60,0,63,3
1713324011958,BILD 1,A02,491297,Staff,63,0,63,0
1713324012984,BILD 4,A01,517099,Gonzalez Gamboa; Ivonne,22,0,24,2
1713324012984,BILD 4,A02,517100,Gonzalez Gamboa; Ivonne,24,0,24,0
1713324014009,BILD 60GS,A00,491309,Lo; Stanley M.,26,0,28,2
1713324015034,BIMM 100,A01,517136,Staff,86,0,100,14
1713324016062,BIMM 110,A01,517182,Staff,61,0,100,39
1713324017088,BIMM 120,A01,517228,Pickett; Brooke Elizabeth,30,0,63,33
1713324017088,BIMM 120,A02,517240,Pickett; Brooke Elizabeth,45,0,63,18
1713324018112,BIMM 132GS,A01,491498,Pirino; Giorgia,21,0,28,7
1713324019140,BIMM 143,A01,491589,Bozinovic; Goran,13,0,40,27
1713324020169,BIPN 100,A01,491594,Armour; Jon Christopher,90,0,100,10
1713324021196,BIPN 140,A01,491602,Marino; Marc J,26,0,50,24
1713324023247,CAT 125,A00,515973,Staff,18,0,20,2
1713324024273,CAT 125GS,A00,515974,Rahimi; Babak,17,0,20,3
1713324025298,CAT 125R,A00,515980,Staff,13,0,20,7
1713324025298,CAT 125R,B00,515981,Tosun; Adriana,19,0,20,1
1713324025298,CAT 125R,C00,515987,Hyland; Tina Mae,0,2,20,20
1713324025298,CAT 125R,D00,515988,Bronstein; Phoebe Malan,17,0,20,3
1713324026326,CENG 15,A01,488699,Drews; Aaron,25,0,25,0
1713324027352,CENG 100,A00,505196,Opatkiewicz; Justin Paul,25,0,25,0
1713324028378,CGS 2A,A01,489598,Staff,33,0,35,2
1713324029402,CGS 112,A00,489599,Staff,15,0,15,0
1713324030427,CGS 119,A00,489603,Staff,10,0,10,0
1713324031453,CGS 120,A00,489604,Staff,14,0,15,1
1713324032477,CGS 150,A00,489607,Staff,15,0,15,0
1713324033504,CHEM 6A,A01,488715,Staff,98,0,100,2
1713324034531,CHEM 6B,A01,488719,Piercy; Marc Anthony,99,0,100,1
1713324035561,CHEM 6C,A01,488723,Albizati; Kim F.,93,0,100,7
1713324036587,CHEM 7L,A01,488728,Schurmeier; Kimberly,18,0,24,6
1713324036587,CHEM 7L,A02,488730,Schurmeier; Kimberly,23,0,24,1
1713324036587,CHEM 7L,A03,488734,Schurmeier; Kimberly,22,0,24,2
1713324036587,CHEM 7L,A04,488763,Schurmeier; Kimberly,23,0,24,1
1713324036587,CHEM 7L,B01,488798,Schurmeier; Kimberly,17,0,24,7
1713324036587,CHEM 7L,B02,488801,Schurmeier; Kimberly,23,0,24,1
1713324036587,CHEM 7L,B03,488808,Schurmeier; Kimberly,23,0,24,1
1713324036587,CHEM 7L,B04,488811,Schurmeier; Kimberly,24,0,24,0
1713324037611,CHEM 11,A01,488897,Stallings; Dontarie M,95,0,100,5
1713324038640,CHEM 40A,A01,488913,Albizati; Kim F.,84,0,100,16
1713324039664,CHEM 40B,A01,488920,Weizman; Haim,44,0,50,6
1713324039664,CHEM 40B,A02,488938,Weizman; Haim,45,0,50,5
1713324040693,CHEM 41A,A01,489029,Klosterman; Jeremy K,57,0,60,3
1713324041721,CHEM 41C,A01,500436,Tor; Yitzhak,55,0,60,5
1713324042749,CHEM 43A,A01,500426,Weizman; Haim,0,0,24,24
1713324042749,CHEM 43A,A02,500430,Weizman; Haim,12,0,24,12
1713324042749,CHEM 43A,B01,514041,Klosterman; Jeremy K,15,0,24,9
1713324042749,CHEM 43A,B02,514047,Klosterman; Jeremy K,23,0,24,1
1713324043777,CHEM 108,A01,489140,Jennings; Patricia A.,11,0,24,13
1713324043777,CHEM 108,A02,489142,Jennings; Patricia A.,14,0,24,10
1713324044801,CHEM 114A,A01,489147,Stallings; Dontarie M,73,0,100,27
1713324045827,CHIN 169A,A00,489171,Wang; Xiao,19,0,20,1
1713324047876,COGS 3,A01,518827,Boyle; Mary E. T.,26,0,40,14
1713324048903,COGS 11,A01,489175,Staff,27,0,30,3
1713324049928,COGS 14A,A01,518829,Staff,51,0,60,9
1713324050956,COGS 14B,A01,489177,Hoffman; Drew Ellen,65,0,75,10
1713324051984,COGS 100,A01,489181,Allen; Michael Gordon,64,0,75,11
1713324053009,COGS 101A,A01,489183,Staff,47,0,60,13
1713324054037,COGS 101B,A01,489185,Allen; Michael Gordon,8,0,30,22
1713324055064,COGS 101C,A01,526786,Staff,23,0,30,7
1713324057116,COGS 107A,A01,489189,Boyle; Mary E. T.,19,0,35,16
1713324058143,COGS 107B,A01,627144,Mooshagian; Eric Frederick,60,0,60,0
1713324059172,COGS 118A,A01,489191,Staff,0,40,40,40
1713324061224,COGS 171GS,A01,489194,Pineda; Jaime A,21,0,28,7
1713324062249,COGS 172,A01,489196,Staff,3,0,30,27
1713324063274,COGS 174GS,A01,489264,Pineda; Jaime A,21,0,28,7
1713324064300,COGS 180,A01,627150,Staff,28,0,30,2
1713324065324,COGS 186,A01,489274,Staff,0,1,30,30
1713324066354,COMM 10,A01,489276,Staff,23,0,25,2
1713324066354,COMM 10,A02,489303,Staff,23,0,25,2
1713324067382,COMM 100A,A01,489312,Staff,14,0,25,11
1713324067382,COMM 100A,A02,489313,Staff,24,0,25,1
1713324068408,COMM 106T,A00,512540,Staff,33,0,35,2
1713324069489,COMM 107,A00,489347,Staff,27,0,35,8
1713324070515,COMM 109P,A00,489358,Staff,31,0,35,4
1713324071540,COMM 132,A00,489361,McKenna; Denise,27,0,30,3
1713324072565,COMM 146,A00,489362,Halm; Gavin Patrick,26,0,30,4
1713324073591,COMM 190,A00,489363,Abuelhiga; Soraya Jill,17,0,23,6
1713324074619,CSE 8A,A50,489366,Staff,21,0,25,4
1713324074619,CSE 8A,A51,489367,Staff,24,0,25,1
1713324075648,CSE 11,A01,489398,Cao; Yingjun,75,0,100,25
1713324076672,CSE 12,A01,489487,Staff,43,0,50,7
1713324077696,CSE 20,A01,489497,Staff,48,0,50,2
1713324078722,CSE 21,A01,489517,Braun; Oliver,42,0,50,8
1713324079746,CSE 101,A01,489524,Braun; Oliver,0,28,50,50
1713324080775,CSE 105,A01,512594,Jones; Miles E,73,0,100,27
1713324080775,CSE 105,B01,512598,Jones; Miles E,54,0,100,46
1713324081803,CSE 140,A01,489538,Staff,42,0,50,8
1713324082826,CSE 141,A01,489550,Eldon; John,70,0,100,30
1713324083852,CSE 141L,A01,489571,Eldon; John,68,0,100,32
1713324084875,CSE 151A,A01,489583,Solares; Edwin A,142,0,200,58
1713324085901,CSE 175,A01,510886,Kumar; Rakesh,30,0,30,0
1713324086927,CSE 190,A00,516828,Dubnov; Shlomo,38,0,49,11
1713324087954,DOC 100D,A00,489667,Pass; Natalye Joann,19,0,25,6
1713324088982,DSC 10,A01,624268,Staff,72,0,75,3
1713324090009,DSC 20,A01,624476,Staff,50,0,50,0
1713324091034,DSC 40A,A01,624608,Staff,39,0,40,1
1713324092059,DSGN 1,A01,489179,Rill; Bryan,35,0,50,15
1713324093087,ECE 17,A01,490489,Sahay; Rajeev,18,0,30,12
1713324094113,ECE 65,A50,490492,Staff,12,0,20,8
1713324094113,ECE 65,A51,490493,Staff,19,0,20,1
1713324095140,ECON 1,A01,489715,Famulari; Melissa,68,0,70,2
1713324096166,ECON 2,A01,489717,Levkoff; Steven B.,68,0,70,2
1713324097191,ECON 3,A01,489948,Staff,70,0,70,0
1713324099238,ECON 5,A01,490103,Staff,27,0,30,3
1713324099238,ECON 5,B01,626281,Dai; Yinlin,45,0,45,0
1713324100262,ECON 100A,A01,490127,Famulari; Melissa,66,0,70,4
1713324101290,ECON 100B,A01,490129,Staff,64,0,70,6
1713324102318,ECON 109,A01,490187,Shishkin; Denis,27,0,35,8
1713324103343,ECON 110A,A01,490190,Levkoff; Steven B.,60,0,70,10
1713324104367,ECON 120A,A01,490245,Dai; Yinlin,62,0,70,8
1713324105396,ECON 120B,A01,490247,Nieto-Barthaburu; Augusto,45,0,70,25
1713324106426,ECON 120C,A01,490253,Sun; Yixiao,30,0,35,5
1713324106426,ECON 120C,B01,490255,Sun; Yixiao,34,0,35,1
1713324107455,ECON 129,A00,490256,Eckert; Fabian Paul,24,0,35,11
1713324108482,ECON 131,A00,490257,Nieto-Barthaburu; Augusto,0,6,35,35
1713324109506,ECON 138,A00,490258,Bharadwaj; Prashant,14,0,35,21
1713324109506,ECON 138,B00,490259,Bharadwaj; Prashant,15,0,35,20
1713324110530,ECON 159,A00,490260,Hendrickson; Gerald M.,0,9,0,0
1713324111554,ECON 178,A01,553995,Zhu; Ying,24,0,35,11
1713324112580,EDS 40,A01,512576,Black; Alison Michelle,20,0,20,0
1713324113608,EDS 107,A01,515848,Staff,30,0,30,0
1713324114635,EDS 110R,A01,490262,Staff,26,0,30,4
1713324115659,EDS 112,A01,490264,Chapman; Thandeka K,40,0,50,10
1713324116687,EDS 113,A00,490266,Staff,26,0,30,4
1713324117711,EDS 118,A00,490267,Warstadt; Melissa Fawn,21,0,30,9
1713324118735,EDS 124BR,A00,490268,Eguchi; Emi,4,0,25,21
1713324118735,EDS 124BR,B00,490269,Eguchi; Emi,24,0,25,1
1713324119760,EDS 126,A01,490271,Jones; Makeba,43,0,50,7
1713324120783,EDS 135,A01,490316,Staff,19,0,20,1
1713324121807,ENVR 142GS,A00,519514,Chang; Edmond Yi-Teh,27,0,28,1
1713324122834,ETHN 103,A00,490504,Staff,26,0,36,10
1713324123866,ETHN 103A,A00,490505,Man; Simeon S,5,0,9,4
1713324124894,ETHN 109,A00,490506,Staff,29,0,30,1
1713324125919,ETHN 118,A00,490507,Staff,35,0,36,1
1713324126944,ETHN 119,A00,490508,Staff,33,0,36,3
1713324127969,ETHN 121R,A00,490518,Choi; Esther Min,24,0,36,12
1713324128993,ETHN 127,A00,490528,Staff,14,0,15,1
1713324130021,ETHN 139,A00,490573,Staff,10,0,10,0
1713324131047,ETHN 150,A00,490575,Staff,15,0,15,0
1713324132072,GLBH 20,A00,491705,Elwardani; Nile Regina,38,0,40,2
1713324133096,GLBH 101,A00,491706,Staff,20,0,20,0
1713324134120,GLBH 111,A01,491708,Burgos; Jose L.,15,0,15,0
1713324135146,GLBH 146,A00,491709,Staff,10,0,20,10
1713324136171,GLBH 148,A00,491710,Olivas Hernandez; Olga Lid,12,0,20,8
1713324137197,GLBH 150,A00,491711,Sloane; Julia Kathryn,20,0,20,0
1713324138221,HIEA 131,A00,491760,Staff,29,0,32,3
1713324139244,HIEA 153,A00,491762,Staff,29,0,30,1
1713324140269,HIEU 124,A00,491811,Staff,26,0,32,6
1713324141299,HIEU 124GS,A00,491812,Markman; Kristina,27,0,28,1
1713324142329,HIEU 147,A00,491813,Staff,30,0,32,2
1713324143354,HIEU 149GS,A00,491816,Caldwell; Michael Alan,28,0,28,0
1713324144379,HILD 2C,A01,491713,Hendrickson; Gerald M.,27,0,30,3
1713324145405,HILD 7B,A01,491715,Kwak; Nancy,0,0,30,30
1713324146428,HILD 10,A01,491717,Staff,11,0,20,9
1713324147452,HILD 30GS,A00,491719,Edington; Claire Ellen,24,0,28,4
1713324148476,HINE 109,A00,491818,Shafir; Nir,27,0,32,5
1713324149500,HINE 128,A00,491821,Shafir; Nir,31,0,32,1
1713324150524,HISC 117,A00,491830,Staff,27,0,32,5
1713324151548,HIUS 103,A00,491834,Man; Simeon S,14,0,23,9
1713324152573,HIUS 108B,A00,491835,Staff,28,0,30,2
1713324153598,HIUS 141,A00,491836,Hendrickson; Gerald M.,29,0,32,3
1713324154623,HIUS 149,A00,491839,Staff,25,0,32,7
1713324155648,HUM 3,A01,512617,Crum; Matthew Stephen,43,0,50,7
1713324155648,HUM 3,A02,512618,Crum; Matthew Stephen,48,0,50,2
1713324156676,HUM 3GS,A00,512663,Markman; Kristina,0,0,0,1
1713324156676,HUM 3GS,B00,512664,Staff,0,0,0,0
1713324157705,HUM 4,A01,512620,West; Geoffrey Scott,28,0,50,22
1713324158729,HUM 4GS,A00,512666,Lyon; Antony J.,0,0,0,4
1713324159754,HUM 4R,A01,512625,Watkins; Eric,48,0,50,2
1713324160785,HUM 5,A01,512649,Zavodny; Tatiana Sophia,25,0,50,25
1713324160785,HUM 5,B01,512661,Zroka; Ryan Edward,48,0,50,2
1713324161810,INTL 190,A00,490577,Segui; Alan S,0,0,0,5
1713324162834,JAPN 20AR,A01,491267,Ross; Kayoko F,8,0,20,12
1713324163860,JAPN 180,A00,491285,Berman; Michael David,33,0,40,7
1713324164885,LATI 50,A01,502536,Kokinis; Troy Andreas,16,0,22,6
1713324164885,LATI 50,A02,502551,Kokinis; Troy Andreas,22,0,22,0
1713324164885,LATI 50,A03,502650,Kokinis; Troy Andreas,22,0,22,0
1713324164885,LATI 50,A04,502909,Kokinis; Troy Andreas,22,0,22,0
1713324165909,LATI 160,A01,502920,Kokinis; Troy Andreas,30,0,30,0
1713324166934,LIFR 1A,A00,490494,Van Moer; Vinciane G,17,0,20,3
1713324167963,LIFR 1AX,A00,490495,Van Moer; Vinciane G,17,0,20,3
1713324168993,LIFR 1B,A00,490496,Van Moer; Vinciane G,18,0,20,2
1713324170024,LIFR 1BX,A00,490497,Van Moer; Vinciane G,18,0,20,2
1713324171051,LIGN 8,A00,505198,McIntosh; Justin Daniel,135,0,150,15
1713324172075,LIGN 9GS,A00,491239,Lott; Margaret S.,18,0,20,2
1713324173155,LIGN 101,A01,505200,McIntosh; Justin Daniel,23,0,30,7
1713324174177,LIGN 120,A01,491244,Staff,23,0,30,7
1713324175202,LIGN 149GS,A00,491245,Lott; Margaret S.,18,0,20,2
1713324176226,LIGN 170,A00,491247,Staff,22,0,30,8
1713324177250,LISP 1D,A00,490498,Munoz Sanchez; Alicia,10,0,14,4
1713324177250,LISP 1D,B00,490499,Munoz Sanchez; Alicia,6,0,14,8
1713324177250,LISP 1D,C00,490500,Munoz Sanchez; Alicia,7,0,14,7
1713324177250,LISP 1D,D00,490501,Munoz Sanchez; Alicia,10,0,14,4
1713324178275,LISP 1DX,A00,490502,Munoz Sanchez; Alicia,15,0,28,13
1713324178275,LISP 1DX,B00,490503,Munoz Sanchez; Alicia,16,0,28,12
1713324180326,LTAM 110,A00,491847,Staff,23,0,25,2
1713324181353,LTCS 119,A00,491848,Staff,11,0,15,4
1713324182380,LTCS 130,A00,491849,Staff,24,0,25,1
1713324184430,LTEA 120C,A00,491852,Staff,32,0,40,8
1713324185454,LTEN 130GS,A00,491853,Lyon; Antony J.,24,0,28,4
1713324186481,LTEN 148,A00,491855,Staff,23,0,25,2
1713324187506,LTEN 159,A00,491856,Staff,21,0,25,4
1713324188530,LTEN 180,A00,491857,Staff,8,0,15,7
1713324190580,LTSP 123GS,A00,505928,Bessett; Ryan Matthew,24,0,28,4
1713324191608,LTSP 174GS,A00,506037,Bessett; Ryan Matthew,24,0,28,4
1713324193656,LTWR 102,A00,491861,Staff,9,0,15,6
1713324194680,LTWR 106,A00,491862,Staff,10,0,15,5
1713324195709,MAE 11,A00,490930,Bahadori; Mohammad Yousef,96,0,100,4
1713324196738,MAE 30A,A00,490931,Qi; Huihui,37,0,40,3
1713324197763,MAE 101A,A00,491036,Sadeghizadeh; Zahra,95,0,100,5
1713324198789,MAE 101C,A00,491037,Seshadri; Kalyanasundaram,69,0,100,31
1713324199815,MAE 113,A00,491040,Seshadri; Kalyanasundaram,66,0,80,14
1713324200840,MAE 131A,A00,491041,Ghazinejad; Maziar,37,0,40,3
1713324201864,MAE 142,A00,491053,Staff,39,0,40,1
1713324202891,MAE 143A,A00,491054,Staff,33,0,50,17
1713324203915,MAE 150,A00,491092,Truong; Phuong Thi Ngoc,23,0,35,12
1713324204940,MATH 3C,A01,494031,Pardo Guerra; Sebastian,30,0,30,0
1713324204940,MATH 3C,A02,494032,Pardo Guerra; Sebastian,29,0,30,1
1713324205966,MATH 10A,A01,494034,Staff,27,0,30,3
1713324205966,MATH 10A,A02,494035,Staff,28,0,30,2
1713324205966,MATH 10A,B01,494037,Staff,27,0,30,3
1713324205966,MATH 10A,B02,494038,Staff,29,0,30,1
1713324206998,MATH 10B,A01,494040,Habib; Yousaf,22,0,30,8
1713324206998,MATH 10B,A02,494041,Habib; Yousaf,28,0,30,2
1713324206998,MATH 10B,A03,494042,Habib; Yousaf,29,0,30,1
1713324206998,MATH 10B,A04,494043,Habib; Yousaf,30,0,30,0
1713324206998,MATH 10B,B01,494045,Habib; Yousaf,26,0,30,4
1713324206998,MATH 10B,B02,494046,Habib; Yousaf,30,0,30,0
1713324206998,MATH 10B,B03,494047,Habib; Yousaf,30,0,30,0
1713324206998,MATH 10B,B04,494048,Habib; Yousaf,30,0,30,0
1713324208023,MATH 18,A01,494050,Kemp; Todd Aahron,25,0,30,5
1713324208023,MATH 18,A02,494051,Kemp; Todd Aahron,29,0,30,1
1713324208023,MATH 18,B01,494054,Kemp; Todd Aahron,27,0,30,3
1713324208023,MATH 18,B02,494055,Kemp; Todd Aahron,29,0,30,1
1713324209047,MATH 20A,A01,494059,Suk; Andrew Hoon,30,0,30,0
1713324210078,MATH 20B,A01,494061,Briones; Jor-el Thomas Caparas,33,0,35,2
1713324210078,MATH 20B,B01,494063,Bach; Quang Tran,34,0,35,1
1713324211106,MATH 20C,A01,494065,Staff,28,0,30,2
1713324211106,MATH 20C,A02,494066,Staff,30,0,30,0
1713324211106,MATH 20C,A03,494067,Staff,30,0,30,0
1713324211106,MATH 20C,A04,494068,Staff,30,0,30,0
1713324211106,MATH 20C,B01,494070,Zhang; Ming,26,0,30,4
1713324211106,MATH 20C,B02,494071,Zhang; Ming,27,0,30,3
1713324211106,MATH 20C,B03,494072,Zhang; Ming,29,0,30,1
1713324211106,MATH 20C,B04,494073,Zhang; Ming,29,0,30,1
1713324212133,MATH 20D,A01,494075,Staff,22,0,30,8
1713324212133,MATH 20D,A02,494076,Staff,30,0,30,0
1713324213156,MATH 20E,A01,494079,Staff,24,0,30,6
1713324213156,MATH 20E,A02,494080,Staff,26,0,30,4
1713324213156,MATH 20E,B01,494082,Staff,25,0,30,5
1713324213156,MATH 20E,B02,494083,Staff,25,0,30,5
1713324214186,MATH 103A,A01,494085,Aliabadi Sr.; Mohsen,14,0,30,16
1713324214186,MATH 103A,A02,494086,Aliabadi Sr.; Mohsen,28,0,30,2
1713324214186,MATH 103A,B01,494088,Aliabadi Sr.; Mohsen,21,0,30,9
1713324214186,MATH 103A,B02,494089,Aliabadi Sr.; Mohsen,28,0,30,2
1713324215211,MATH 109,A01,494091,Staff,30,0,30,0
1713324215211,MATH 109,A02,494092,Staff,29,0,30,1
1713324215211,MATH 109,B01,494094,Staff,27,0,30,3
1713324215211,MATH 109,B02,494095,Staff,29,0,30,1
1713324216235,MATH 142A,A01,494097,Chow; Bennett,15,0,30,15
1713324216235,MATH 142A,A02,494098,Chow; Bennett,24,0,30,6
1713324216235,MATH 142A,B01,494100,Chow; Bennett,19,0,30,11
1713324216235,MATH 142A,B02,494101,Chow; Bennett,29,0,30,1
1713324218288,MATH 168A,A01,516677,Dumitriu; Ioana,15,0,35,20
1713324219313,MATH 170A,A01,516679,Dumitriu; Ioana,19,0,30,11
1713324219313,MATH 170A,A02,516680,Dumitriu; Ioana,28,0,30,2
1713324220338,MATH 193A,A01,494107,Staff,14,0,30,16
1713324220338,MATH 193A,A02,494108,Staff,21,0,30,9
1713324220338,MATH 193A,A03,494109,Staff,29,0,30,1
1713324220338,MATH 193A,A04,494110,Staff,22,0,30,8
1713324223413,MGT 16,A00,491930,McKay; Michael J,92,0,98,6
1713324224438,MGT 18,A00,491992,McKay; Michael J,96,0,98,2
1713324225465,MGT 71,A00,492003,Staff,66,0,98,32
1713324226490,MGT 103,A00,505209,Eberhard; Craig A,81,0,98,17
1713324227518,MGT 131A,A00,505210,Anderson; John Charles,90,0,98,8
1713324229569,MGT 153,A00,492077,Perols; Johan Lars,23,0,90,67
1713324232646,MGT 164,A00,492222,McKay; Mary A,91,0,98,7
1713324233670,MGT 172,A00,492245,Staff,59,0,60,1
1713324233670,MGT 172,B00,505526,Hedges; Kathleen,66,0,98,32
1713324234698,MGT 181,A00,505669,Dunn; Louis Jean,82,0,98,16
1713324235723,MMW 14,A01,494399,Staff,18,0,28,10
1713324235723,MMW 14,A02,494400,Staff,25,0,28,3
1713324235723,MMW 14,A03,494401,Staff,28,0,28,0
1713324235723,MMW 14,A04,494402,Staff,28,0,28,0
1713324235723,MMW 14,B01,494404,Carreras; Maria Victoria,9,0,28,19
1713324235723,MMW 14,B02,494405,Carreras; Maria Victoria,25,0,28,3
1713324235723,MMW 14,B03,494406,Carreras; Maria Victoria,27,0,28,1
1713324235723,MMW 14,B04,494407,Carreras; Maria Victoria,28,0,28,0
1713324236751,MMW 14GS,A00,506250,Chang; Edmond Yi-Teh,0,0,0,0
1713324237780,MMW 121R,A01,494415,Adamiak; Patrick John,12,0,28,16
1713324237780,MMW 121R,A02,494416,Adamiak; Patrick John,24,0,28,4
1713324238805,MUS 1A,A01,494113,Staff,12,0,25,13
1713324238805,MUS 1A,A02,494114,Staff,24,0,25,1
1713324239834,MUS 4,A01,494116,Staff,23,0,25,2
1713324239834,MUS 4,A02,494117,Staff,22,0,25,3
1713324240864,MUS 5R,A01,494236,Dubnov; Shlomo,9,0,25,16
1713324240864,MUS 5R,A02,494237,Dubnov; Shlomo,25,0,25,0
1713324241890,MUS 6,A01,494122,Staff,10,0,25,15
1713324241890,MUS 6,A02,494123,Staff,23,0,25,2
1713324242915,MUS 7,A01,494125,Staff,16,0,25,9
1713324242915,MUS 7,A02,494126,Staff,24,0,25,1
1713324243938,MUS 11,A01,494128,Staff,23,0,25,2
1713324243938,MUS 11,A02,494129,Staff,24,0,25,1
1713324244966,MUS 13,A01,494131,Staff,25,0,25,0
1713324244966,MUS 13,A02,494132,Staff,25,0,25,0
1713324245996,MUS 15,A01,494134,Staff,17,0,25,8
1713324245996,MUS 15,A02,494135,Staff,25,0,25,0
1713324245996,MUS 15,B01,494137,Staff,24,0,25,1
1713324247020,MUS 80,A00,494232,Staff,24,0,25,1
1713324247020,MUS 80,B00,494233,Staff,25,0,25,0
1713324247020,MUS 80,C00,494234,Staff,23,0,25,2
1713324248046,MUS 95C,A00,494141,Staff,70,0,75,5
1713324249069,MUS 114,A00,494142,Staff,40,0,50,10
1713324250098,NANO 15,A01,490636,Drews; Aaron,7,0,7,0
1713324251123,PHIL 1,A00,490578,Grush; Rick Scott,49,0,50,1
1713324252153,PHIL 10,A01,490580,Grush; Rick Scott,33,0,35,2
1713324252153,PHIL 10,A02,490586,Grush; Rick Scott,32,0,35,3
1713324253182,PHIL 27,A01,490591,Staff,22,0,25,3
1713324253182,PHIL 27,A02,490592,Staff,25,0,25,0
1713324253182,PHIL 27,A03,490593,Staff,25,0,25,0
1713324253182,PHIL 27,A04,490598,Staff,25,0,25,0
1713324254207,PHIL 32,A01,490611,Staff,20,0,20,0
1713324254207,PHIL 32,A02,490618,Staff,20,0,20,0
1713324255233,PHIL 90,A00,490624,Staff,40,0,40,0
1713324256256,PHIL 136,A00,490627,Cohen; Jonathan David,37,0,40,3
1713324257283,PHIL 155,A00,490634,Staff,63,0,70,7
1713324258310,PHYS 1A,A00,491610,Staff,245,0,250,5
1713324259335,PHYS 1AL,001,491616,Tsai; Philbert S,27,0,30,3
1713324259335,PHYS 1AL,002,491618,Tsai; Philbert S,30,0,30,0
1713324260360,PHYS 1B,A00,491623,Staff,236,0,250,14
1713324261388,PHYS 1BL,001,491626,Tsai; Philbert S,22,0,30,8
1713324261388,PHYS 1BL,002,491628,Tsai; Philbert S,26,0,30,4
1713324262411,PHYS 1C,A00,491632,Staff,216,0,245,29
1713324263440,PHYS 1CL,001,491635,Tsai; Philbert S,6,0,30,24
1713324263440,PHYS 1CL,002,491643,Tsai; Philbert S,22,0,30,8
1713324264466,PHYS 2AR,A01,491651,Meyertholen; Andrew D.,44,0,50,6
1713324265495,PHYS 2B,A01,491659,Staff,105,0,115,10
1713324266520,PHYS 2BL,A01,491685,Staff,21,0,24,3
1713324266520,PHYS 2BL,A02,491700,Staff,21,0,24,3
1713324267548,PHYS 2C,A01,505161,Staff,103,0,115,12
1713324268577,PHYS 4A,A01,491704,Grinstein; Benjamin,99,0,100,1
1713324269606,POLI 5D,A01,494144,Staff,3,0,5,2
1713324269606,POLI 5D,B01,626283,Dai; Yinlin,5,0,5,0
1713324270632,POLI 12,A00,494145,Staff,43,0,45,2
1713324271661,POLI 13R,A00,494146,Forman; Fonna,45,0,50,5
1713324272687,POLI 27,A01,494148,Staff,54,0,60,6
1713324273712,POLI 30,A00,494149,Staff,49,0,50,1
1713324274740,POLI 100DA,A00,494150,Staff,21,0,25,4
1713324276849,POLI 100I,A00,494152,Staff,27,0,30,3
1713324277874,POLI 104B,A00,494153,Smith; Glenn Chatmas,53,0,55,2
1713324278902,POLI 104F,A00,494154,Staff,28,0,30,2
1713324279932,POLI 104I,A00,494155,Smith; Glenn Chatmas,30,0,30,0
1713324280956,POLI 110C,A00,494156,Ingham; Sean,23,0,25,2
1713324281985,POLI 117R,A00,494157,Forman; Fonna,8,0,20,12
1713324283009,POLI 118,A00,494158,Ingham; Sean,21,0,25,4
1713324284037,POLI 120H,A00,494159,Fisk; David Lee,40,0,45,5
1713324285065,POLI 131CR,A00,494160,Hoston; Germaine,36,0,45,9
1713324286094,POLI 133J,A00,494161,Staff,33,0,35,2
1713324287119,POLI 135,A00,494162,Fisk; David Lee,33,0,35,2
1713324288144,POLI 140A,A00,494164,Staff,20,0,30,10
1713324289169,POLI 142I,A00,494165,Staff,30,0,30,0
1713324290195,POLI 144D,A00,494166,Staff,23,0,25,2
1713324291223,POLI 151,A00,494167,Staff,30,0,30,0
1713324292248,POLI 153,A00,494168,Staff,33,0,35,2
1713324293271,POLI 160AA,A00,494169,Staff,34,0,40,6
1713324294295,POLI 162,A00,494170,Mignozzetti; Umberto,19,0,25,6
1713324295321,POLI 171,A00,494171,Mignozzetti; Umberto,20,0,25,5
1713324296351,PSYC 1,A00,494172,Staff,96,0,100,4
1713324297376,PSYC 2,A00,494173,Moranton; Nirelia Melbina-,36,0,50,14
1713324298401,PSYC 3,A00,494174,Staff,29,0,30,1
1713324299426,PSYC 6,A00,494175,Staff,17,0,20,3
1713324300454,PSYC 60,A01,494177,Staff,38,0,45,7
1713324301483,PSYC 70,A01,505724,Geller; Emma Harlan,42,0,45,3
1713324302509,PSYC 101,A00,494180,Heyman; Gail D.,84,0,100,16
1713324303533,PSYC 105,A00,494181,Geller; Emma Harlan,53,0,90,37
1713324304559,PSYC 106,A00,494182,Dobkins; Karen R.,29,0,45,16
1713324305583,PSYC 108,A00,494183,Adrian; Julia Anna,90,0,100,10
1713324306610,PSYC 114,A01,494185,Winkielman; Piotr,0,1,30,30
1713324307634,PSYC 122,A00,494186,Moranton; Nirelia Melbina-,31,0,50,19
1713324308658,PSYC 124,A00,494187,Chapman; Eddie Nathaniel,71,0,80,9
1713324309683,PSYC 131,A00,494188,Anagnostaras; Stephan,44,0,80,36
1713324310711,PSYC 144,A00,494189,Staff,6,0,50,44
1713324311736,PSYC 154,A00,494190,Lacefield; Katharine I,113,0,180,67
1713324312764,PSYC 162,A00,494191,Wixted; John T,73,0,100,27
1713324313842,PSYC 172,A00,494192,Gorman; Michael R.,36,0,45,9
1713324314870,PSYC 178,A00,494193,Glaser; Dale,34,0,45,11
1713324315898,PSYC 193,A00,505725,Chapman; Eddie Nathaniel,20,0,20,0
1713324316926,RELI 145GS,A00,519817,Rahimi; Babak,18,0,20,2
1713324317955,SE 101A,A01,490862,Chadha; Mayank,23,0,25,2
1713324318983,SE 101C,A01,490924,Krysl; Petr,16,0,20,4
1713324320007,SE 110A,A01,490928,Staff,19,0,20,1
1713324321033,SE 130A,A00,490929,Morrison; Machel Leigh,57,0,70,13
1713324322058,SIO 1,A01,519325,Staff,39,0,40,1
1713324323082,SIO 30,A01,519327,Staff,38,0,40,2
1713324324113,SIO 40,A00,519328,Staff,39,0,40,1
1713324325141,SIO 46GS,A00,519819,Cook; Geoffrey W,17,0,25,8
1713324326165,SIO 109R,A00,494197,Forman; Fonna,0,2,20,20
1713324327190,SIO 121GS,A00,519827,Cook; Geoffrey W,17,0,25,8
1713324328215,SIO 132,A01,519330,Staff,38,0,40,2
1713324329244,SIO 133,A01,519397,Staff,37,0,40,3
1713324330270,SIO 139,A00,519396,Kacev; David,31,0,40,9
1713324331298,SOCI 1,A01,494199,Thorpe; Charles Robert,22,0,30,8
1713324331298,SOCI 1,A02,494200,Thorpe; Charles Robert,30,0,30,0
1713324331298,SOCI 1,A03,494201,Thorpe; Charles Robert,29,0,30,1
1713324331298,SOCI 1,A04,494202,Thorpe; Charles Robert,29,0,30,1
1713324331298,SOCI 1,A05,494203,Thorpe; Charles Robert,29,0,30,1
1713324331298,SOCI 1,A06,494204,Thorpe; Charles Robert,30,0,30,0
1713324331298,SOCI 1,A07,494205,Thorpe; Charles Robert,28,0,30,2
1713324332324,SOCI 60,A01,494207,Staff,34,0,40,6
1713324332324,SOCI 60,A02,494208,Staff,39,0,40,1
1713324333352,SOCI 100,A01,494210,Payne; Christine Anna,26,0,30,4
1713324333352,SOCI 100,A02,494211,Payne; Christine Anna,26,0,30,4
1713324334379,SOCI 109M,A00,494212,Staff,20,0,20,0
1713324335403,SOCI 110,A00,494213,Staff,34,0,40,6
1713324337456,SOCI 118E,A00,494215,Ng; Kwai,37,0,40,3
1713324338484,SOCI 125,A00,494216,Calderon-Zaks; Michael Aar,41,0,45,4
1713324339513,SOCI 126,A01,494218,Jones; Makeba,3,0,5,2
1713324340541,SOCI 131,A00,494219,Thorpe; Charles Robert,27,0,30,3
1713324342592,SOCI 135,A00,494221,Payne; Christine Anna,30,0,50,20
1713324343616,SOCI 136E,A00,626690,Ruiz; Jonathan Joseph,25,0,25,0
1713324344642,SOCI 138GS,A00,494222,Navon; Daniel,24,0,28,4
1713324346697,SOCI 145,A00,494224,Staff,40,0,45,5
1713324347720,SOCI 153,A00,494225,Staff,28,0,30,2
1713324348748,SOCI 160E,A00,494226,Ng; Kwai,29,0,40,11
1713324349776,SOCI 180,A00,494227,Staff,29,0,30,1
1713324350809,SOCI 189GS,A00,494228,Ribas Norris; Janet Vanesa,11,0,11,0
1713324351833,SOCI 190GS,A00,553232,Ribas Norris; Janet Vanesa,11,0,11,0
1713324352862,SOMI 220,A00,627178,Schneid; Stephen David,30,0,30,0
1713324353898,SYN 2,001,490768,Staff,14,0,15,1
1713324353898,SYN 2,002,490769,Staff,15,0,15,0
1713324353898,SYN 2,004,490775,Staff,0,0,0,0
1713324353898,SYN 2,003,490774,Staff,0,0,0,0
1713324353898,SYN 2,005,490776,Staff,0,0,0,0
1713324354927,SYN 2R,001,490779,Staff,11,0,15,4
1713324354927,SYN 2R,002,514635,Staff,14,0,15,1
1713324355955,SYN 100,A01,490783,Staff,12,0,20,8
1713324355955,SYN 100,B01,490787,Staff,9,0,20,11
1713324355955,SYN 100,C01,490789,Staff,11,0,20,9
1713324356984,SYN 150,A00,490817,Staff,14,0,15,1
1713324356984,SYN 150,B00,514610,Staff,15,0,15,0
1713324358010,TDAC 1,A00,492753,Walsh; Kim C.,19,0,20,1
1713324358010,TDAC 1,B00,492754,Harting; Carla Kelso,19,0,20,1
1713324358010,TDAC 1,C00,513995,Salovey; Todd,15,0,20,5
1713324359039,TDAC 101,A00,492766,Harting; Carla Kelso,17,0,20,3
1713324360066,TDAC 102,A00,492768,Basso; Beatrice,19,0,20,1
1713324361095,TDDE 111,A00,492769,Staff,25,0,25,0
1713324362121,TDDE 131,A00,492770,Staff,15,0,15,0
1713324362121,TDDE 131,B00,492771,Staff,15,0,15,0
1713324363146,TDDE 131GS,A00,523716,Guirguis; Mark C,23,0,28,5
1713324364174,TDGE 1,A01,492756,Salovey; Todd,57,0,60,3
1713324365201,TDGE 5,A01,492758,Staff,23,0,25,2
1713324366227,TDGE 10,A00,492759,Fulton; Julia,203,0,220,17
1713324367256,TDGE 11,A00,492760,Castro; Robert Jess,198,0,200,2
1713324369306,TDGE 124,A00,492772,Fulton; Julia,186,0,220,34
1713324370335,TDGE 125,A00,492773,Meyer; Ursula,38,0,50,12
1713324370335,TDGE 125,B00,492774,Staff,49,0,50,1
1713324370335,TDGE 125,C00,523565,Staff,48,0,50,2
1713324371359,TDGE 125GS,A00,523580,Guirguis; Mark C,23,0,28,5
1713324372383,TDGE 127,A00,492775,Havis; Allan,35,0,50,15
1713324373412,TDHT 101,A00,492776,Staff,34,0,35,1
1713324374438,TDMV 1,A00,492762,Caligagan; Maria T.,30,0,30,0
1713324374438,TDMV 1,B00,492763,Arcidiacono; Kristin,26,0,30,4
1713324375467,TDMV 2,A00,492764,Weinberg; Sadie,28,0,30,2
1713324376492,TDMV 3,A00,492765,Mack; Kara Shanai',37,0,40,3
1713324377520,TDMV 138,A00,492777,Mack; Kara Shanai',34,0,40,6
1713324378547,TDMV 140,A00,492778,Lima; Paulo Henrique,40,0,40,0
1713324379572,TDMV 142,A00,492779,Caligagan; Maria T.,33,0,40,7
1713324379572,TDMV 142,B00,492780,Caligagan; Tony,37,0,40,3
1713324380655,TDMV 143,A00,492781,Fyall; Daunte Edward,39,0,40,1
1713324381683,USP 1,A01,492401,Kwak; Nancy,26,0,35,9
1713324382709,USP 2,A01,492453,Hinds; Juli Beth,35,0,35,0
1713324383734,USP 3,A01,492516,Staff,28,0,35,7
1713324384761,USP 4,A00,492522,McTague; Sarah,17,0,25,8
1713324385787,USP 100,A00,492523,Staff,32,0,35,3
1713324386811,USP 101,A00,492524,Staff,13,0,15,2
1713324387834,USP 105,A00,492525,Staff,21,0,25,4
1713324388860,USP 151,A00,492526,Shenkman; Michael Thomas,32,0,35,3
1713324389888,USP 170,A00,492545,Hinds; Juli Beth,33,0,35,2
1713324390918,USP 171GS,A00,492608,Bussell; Mirle Rabinowitz,24,0,28,4
1713324391945,USP 183GS,A00,492613,Peerson; Susan,24,0,28,4
1713324392970,VIS 30,A01,490693,Yoldas; Pinar,19,0,22,3
1713324392970,VIS 30,A02,490694,Yoldas; Pinar,18,0,22,4
1713324393999,VIS 83,A00,490695,Kester; Grant,63,0,75,12
1713324395027,VIS 105D,A00,490696,Staff,22,0,25,3
1713324396056,VIS 124CN,A00,490699,Rose; Jordan M,66,0,75,9
1713324397081,VIS 125GS,A00,511221,Williams; Alena J,21,0,22,1
1713324398110,VIS 128D,A00,490700,Staff,73,0,75,2
1713324399133,VIS 151,A01,490717,Staff,33,0,34,1
1713324399133,VIS 151,A02,490766,Staff,33,0,34,1
1713324400161,VIS 154GS,A00,511972,Williams; Alena J,21,0,22,1
1713324401186,VIS 160A,A00,490767,Stone; Patricia,7,0,10,3
1713324402211,WCWP 10A,A00,490638,Staff,14,0,15,1
1713324402211,WCWP 10A,B00,490640,Staff,15,0,15,0
1713324403237,WCWP 10B,A00,490641,Staff,0,0,0,0
1713324403237,WCWP 10B,B00,490642,Staff,14,0,15,1
1713324403237,WCWP 10B,C00,490644,Staff,13,0,15,2
1713324403237,WCWP 10B,D00,490647,Staff,0,0,0,0
1713324404261,WCWP 100,A00,490655,Staff,0,0,0,0
1713324404261,WCWP 100,B00,490687,Staff,10,0,15,5
1713324406365,ANAR 153,A00,487222,Braswell; Geoffrey E.,54,0,60,6
1713324407391,ANBI 134,A00,487223,Staff,7,0,20,13
1713324408417,ANBI 143GS,A00,487224,Noel; Geoffroy Pierre Jean,18,0,24,6
1713324409443,ANBI 144GS,A00,519548,Noel; Geoffroy Pierre Jean,18,0,24,6
1713324410472,ANSC 101,A00,487225,Staff,18,0,20,2
1713324411494,ANSC 125,A00,487227,Brenner; Suzanne A,39,0,40,1
1713324413547,ANSC 146,A00,487229,Staff,35,0,40,5
1713324414572,ANSC 148,A00,487230,Olivas Hernandez; Olga Lid,39,0,40,1
1713324415598,ANSC 150,A00,504165,Sloane; Julia Kathryn,18,0,20,2
1713324416627,ANSC 180,A00,487232,Staff,14,0,15,1
1713324417653,ANSC 188,A00,627155,Staff,39,0,40,1
1713324418677,ANTH 5,A00,519529,Semendeferi; Ekaterini,15,0,15,0
1713324419703,ANTH 10,A00,487219,Staff,58,0,60,2
1713324420728,ANTH 23,A01,487221,Staff,17,0,20,3
1713324421752,ANTH 102,A00,487233,Wilder; Linnea Lorene,51,0,60,9
1713324422779,ANTH 103,A00,487234,Varma; Saiba,55,0,60,5
1713324423805,ANTH 105,A00,487235,Stewart; Alexander B,55,0,60,5
1713324424836,BENG 100,A01,516685,Taylor Amos; Alyssa C,27,0,30,3
1713324425860,BIBC 102,A01,491316,Flagg; Matthew Paul,18,0,88,70
1713324425860,BIBC 102,A02,491366,Flagg; Matthew Paul,80,0,88,8
1713324426886,BIBC 103,A01,491486,Boumechache; Miyyada,16,0,24,8
1713324426886,BIBC 103,A02,491487,Boumechache; Miyyada,24,0,24,0
1713324427914,BICD 100,A01,516882,Staff,73,0,75,2
1713324427914,BICD 100,A02,516890,Staff,69,0,75,6
1713324428941,BICD 102GS,A00,491488,Lo; Stanley M.,26,0,28,2
1713324429966,BIEB 136GS,A00,516940,Holway; David A. & Shurin; Jonathan,19,0,24,5
1713324430994,BIEB 137GS,A01,517034,Holway; David A. & Shurin; Jonathan,19,0,24,5
1713324432021,BIEB 138GS,A01,491492,Pirino; Giorgia,21,0,28,7
1713324433049,BILD 1,A01,491296,Staff,60,0,63,3
1713324433049,BILD 1,A02,491297,Staff,63,0,63,0
1713324434078,BILD 4,A01,517099,Gonzalez Gamboa; Ivonne,22,0,24,2
1713324434078,BILD 4,A02,517100,Gonzalez Gamboa; Ivonne,24,0,24,0
1713324435102,BILD 60GS,A00,491309,Lo; Stanley M.,26,0,28,2
1713324436129,BIMM 100,A01,517136,Staff,85,0,100,15
1713324437159,BIMM 110,A01,517182,Staff,59,0,100,41
1713324438185,BIMM 120,A01,517228,Pickett; Brooke Elizabeth,29,0,63,34
1713324438185,BIMM 120,A02,517240,Pickett; Brooke Elizabeth,45,0,63,18
1713324439213,BIMM 132GS,A01,491498,Pirino; Giorgia,21,0,28,7
1713324440242,BIMM 143,A01,491589,Bozinovic; Goran,13,0,40,27
1713324441271,BIPN 100,A01,491594,Armour; Jon Christopher,90,0,100,10
1713324442297,BIPN 140,A01,491602,Marino; Marc J,26,0,50,24
1713324444348,CAT 125,A00,515973,Staff,18,0,20,2
1713324445374,CAT 125GS,A00,515974,Rahimi; Babak,17,0,20,3
1713324446399,CAT 125R,A00,515980,Staff,12,0,20,8
1713324446399,CAT 125R,B00,515981,Tosun; Adriana,19,0,20,1
1713324446399,CAT 125R,C00,515987,Hyland; Tina Mae,0,2,20,20
1713324446399,CAT 125R,D00,515988,Bronstein; Phoebe Malan,17,0,20,3
1713324447425,CENG 15,A01,488699,Drews; Aaron,25,0,25,0
1713324448449,CENG 100,A00,505196,Opatkiewicz; Justin Paul,25,0,25,0
1713324449473,CGS 2A,A01,489598,Staff,33,0,35,2
1713324450501,CGS 112,A00,489599,Staff,15,0,15,0
1713324451529,CGS 119,A00,489603,Staff,10,0,10,0
1713324452554,CGS 120,A00,489604,Staff,14,0,15,1
1713324453581,CGS 150,A00,489607,Staff,15,0,15,0
1713324454609,CHEM 6A,A01,488715,Staff,98,0,100,2
1713324455640,CHEM 6B,A01,488719,Piercy; Marc Anthony,99,0,100,1
1713324456665,CHEM 6C,A01,488723,Albizati; Kim F.,93,0,100,7
1713324457698,CHEM 7L,A01,488728,Schurmeier; Kimberly,18,0,24,6
1713324457698,CHEM 7L,A02,488730,Schurmeier; Kimberly,23,0,24,1
1713324457698,CHEM 7L,A03,488734,Schurmeier; Kimberly,22,0,24,2
1713324457698,CHEM 7L,A04,488763,Schurmeier; Kimberly,23,0,24,1
1713324457698,CHEM 7L,B01,488798,Schurmeier; Kimberly,17,0,24,7
1713324457698,CHEM 7L,B02,488801,Schurmeier; Kimberly,23,0,24,1
1713324457698,CHEM 7L,B03,488808,Schurmeier; Kimberly,23,0,24,1
1713324457698,CHEM 7L,B04,488811,Schurmeier; Kimberly,24,0,24,0
1713324458724,CHEM 11,A01,488897,Stallings; Dontarie M,95,0,100,5
1713324459748,CHEM 40A,A01,488913,Albizati; Kim F.,84,0,100,16
1713324460776,CHEM 40B,A01,488920,Weizman; Haim,44,0,50,6
1713324460776,CHEM 40B,A02,488938,Weizman; Haim,45,0,50,5
1713324461800,CHEM 41A,A01,489029,Klosterman; Jeremy K,57,0,60,3
1713324462824,CHEM 41C,A01,500436,Tor; Yitzhak,55,0,60,5
1713324463855,CHEM 43A,A01,500426,Weizman; Haim,0,0,24,24
1713324463855,CHEM 43A,A02,500430,Weizman; Haim,10,0,24,14
1713324463855,CHEM 43A,B01,514041,Klosterman; Jeremy K,15,0,24,9
1713324463855,CHEM 43A,B02,514047,Klosterman; Jeremy K,23,0,24,1
1713324464883,CHEM 108,A01,489140,Jennings; Patricia A.,11,0,24,13
1713324464883,CHEM 108,A02,489142,Jennings; Patricia A.,14,0,24,10
1713324465911,CHEM 114A,A01,489147,Stallings; Dontarie M,73,0,100,27
1713324466940,CHIN 169A,A00,489171,Wang; Xiao,19,0,20,1
1713324468992,COGS 3,A01,518827,Boyle; Mary E. T.,26,0,40,14
1713324470022,COGS 11,A01,489175,Staff,27,0,30,3
1713324471047,COGS 14A,A01,518829,Staff,51,0,60,9
1713324472073,COGS 14B,A01,489177,Hoffman; Drew Ellen,65,0,75,10
1713324473097,COGS 100,A01,489181,Allen; Michael Gordon,63,0,75,12
1713324474127,COGS 101A,A01,489183,Staff,46,0,60,14
1713324475152,COGS 101B,A01,489185,Allen; Michael Gordon,8,0,30,22
1713324476177,COGS 101C,A01,526786,Staff,23,0,30,7
1713324478224,COGS 107A,A01,489189,Boyle; Mary E. T.,19,0,35,16
1713324479252,COGS 107B,A01,627144,Mooshagian; Eric Frederick,60,0,60,0
1713324480276,COGS 118A,A01,489191,Staff,0,41,40,40
1713324482323,COGS 171GS,A01,489194,Pineda; Jaime A,21,0,28,7
1713324483351,COGS 172,A01,489196,Staff,3,0,30,27
1713324484436,COGS 174GS,A01,489264,Pineda; Jaime A,21,0,28,7
1713324485464,COGS 180,A01,627150,Staff,28,0,30,2
1713324486492,COGS 186,A01,489274,Staff,0,1,30,30
1713324487520,COMM 10,A01,489276,Staff,23,0,25,2
1713324487520,COMM 10,A02,489303,Staff,23,0,25,2
1713324488545,COMM 100A,A01,489312,Staff,14,0,25,11
1713324488545,COMM 100A,A02,489313,Staff,24,0,25,1
1713324489570,COMM 106T,A00,512540,Staff,33,0,35,2
1713324490593,COMM 107,A00,489347,Staff,27,0,35,8
1713324491618,COMM 109P,A00,489358,Staff,31,0,35,4
1713324492643,COMM 132,A00,489361,McKenna; Denise,27,0,30,3
1713324493669,COMM 146,A00,489362,Halm; Gavin Patrick,26,0,30,4
1713324494697,COMM 190,A00,489363,Abuelhiga; Soraya Jill,17,0,23,6
1713324495722,CSE 8A,A50,489366,Staff,21,0,25,4
1713324495722,CSE 8A,A51,489367,Staff,24,0,25,1
1713324496748,CSE 11,A01,489398,Cao; Yingjun,75,0,100,25
1713324497775,CSE 12,A01,489487,Staff,43,0,50,7
1713324498800,CSE 20,A01,489497,Staff,48,0,50,2
1713324499823,CSE 21,A01,489517,Braun; Oliver,42,0,50,8
1713324500851,CSE 101,A01,489524,Braun; Oliver,0,28,50,50
1713324501876,CSE 105,A01,512594,Jones; Miles E,73,0,100,27
1713324501876,CSE 105,B01,512598,Jones; Miles E,53,0,100,47
1713324502900,CSE 140,A01,489538,Staff,42,0,50,8
1713324503931,CSE 141,A01,489550,Eldon; John,69,0,100,31
1713324504956,CSE 141L,A01,489571,Eldon; John,67,0,100,33
1713324505980,CSE 151A,A01,489583,Solares; Edwin A,142,0,200,58
1713324507004,CSE 175,A01,510886,Kumar; Rakesh,30,0,30,0
1713324508031,CSE 190,A00,516828,Dubnov; Shlomo,38,0,49,11
1713324509055,DOC 100D,A00,489667,Pass; Natalye Joann,19,0,25,6
1713324510081,DSC 10,A01,624268,Staff,72,0,75,3
1713324511174,DSC 20,A01,624476,Staff,50,0,50,0
1713324512199,DSC 40A,A01,624608,Staff,39,0,40,1
1713324513223,DSGN 1,A01,489179,Rill; Bryan,35,0,50,15
1713324514249,ECE 17,A01,490489,Sahay; Rajeev,18,0,30,12
1713324515278,ECE 65,A50,490492,Staff,12,0,20,8
1713324515278,ECE 65,A51,490493,Staff,19,0,20,1
1713324516302,ECON 1,A01,489715,Famulari; Melissa,68,0,70,2
1713324517331,ECON 2,A01,489717,Levkoff; Steven B.,68,0,70,2
1713324518358,ECON 3,A01,489948,Staff,70,0,70,0
1713324520411,ECON 5,A01,490103,Staff,27,0,30,3
1713324520411,ECON 5,B01,626281,Dai; Yinlin,45,0,45,0
1713324521441,ECON 100A,A01,490127,Famulari; Melissa,66,0,70,4
1713324522466,ECON 100B,A01,490129,Staff,64,0,70,6
1713324523493,ECON 109,A01,490187,Shishkin; Denis,27,0,35,8
1713324524521,ECON 110A,A01,490190,Levkoff; Steven B.,60,0,70,10
1713324525546,ECON 120A,A01,490245,Dai; Yinlin,62,0,70,8
1713324526574,ECON 120B,A01,490247,Nieto-Barthaburu; Augusto,45,0,70,25
1713324527599,ECON 120C,A01,490253,Sun; Yixiao,30,0,35,5
1713324527599,ECON 120C,B01,490255,Sun; Yixiao,34,0,35,1
1713324528623,ECON 129,A00,490256,Eckert; Fabian Paul,24,0,35,11
1713324529651,ECON 131,A00,490257,Nieto-Barthaburu; Augusto,0,6,35,35
1713324530682,ECON 138,A00,490258,Bharadwaj; Prashant,14,0,35,21
1713324530682,ECON 138,B00,490259,Bharadwaj; Prashant,15,0,35,20
1713324531707,ECON 159,A00,490260,Hendrickson; Gerald M.,0,9,0,0
1713324532732,ECON 178,A01,553995,Zhu; Ying,24,0,35,11
1713324533756,EDS 40,A01,512576,Black; Alison Michelle,20,0,20,0
1713324534782,EDS 107,A01,515848,Staff,30,0,30,0
1713324535808,EDS 110R,A01,490262,Staff,26,0,30,4
1713324536837,EDS 112,A01,490264,Chapman; Thandeka K,40,0,50,10
1713324537861,EDS 113,A00,490266,Staff,26,0,30,4
1713324538893,EDS 118,A00,490267,Warstadt; Melissa Fawn,21,0,30,9
1713324539918,EDS 124BR,A00,490268,Eguchi; Emi,4,0,25,21
1713324539918,EDS 124BR,B00,490269,Eguchi; Emi,24,0,25,1
1713324540942,EDS 126,A01,490271,Jones; Makeba,43,0,50,7
1713324541975,EDS 135,A01,490316,Staff,19,0,20,1
1713324543004,ENVR 142GS,A00,519514,Chang; Edmond Yi-Teh,27,0,28,1
1713324544031,ETHN 103,A00,490504,Staff,26,0,36,10
1713324545059,ETHN 103A,A00,490505,Man; Simeon S,5,0,9,4
1713324546085,ETHN 109,A00,490506,Staff,29,0,30,1
1713324547111,ETHN 118,A00,490507,Staff,35,0,36,1
1713324548136,ETHN 119,A00,490508,Staff,33,0,36,3
1713324549161,ETHN 121R,A00,490518,Choi; Esther Min,24,0,36,12
1713324550188,ETHN 127,A00,490528,Staff,14,0,15,1
1713324551217,ETHN 139,A00,490573,Staff,10,0,10,0
1713324552243,ETHN 150,A00,490575,Staff,15,0,15,0
1713324553269,GLBH 20,A00,491705,Elwardani; Nile Regina,38,0,40,2
1713324554298,GLBH 101,A00,491706,Staff,20,0,20,0
1713324555324,GLBH 111,A01,491708,Burgos; Jose L.,15,0,15,0
1713324556352,GLBH 146,A00,491709,Staff,10,0,20,10
1713324557377,GLBH 148,A00,491710,Olivas Hernandez; Olga Lid,12,0,20,8
1713324558405,GLBH 150,A00,491711,Sloane; Julia Kathryn,20,0,20,0
1713324559434,HIEA 131,A00,491760,Staff,29,0,32,3
1713324560458,HIEA 153,A00,491762,Staff,29,0,30,1
1713324561481,HIEU 124,A00,491811,Staff,26,0,32,6
1713324562511,HIEU 124GS,A00,491812,Markman; Kristina,27,0,28,1
1713324563537,HIEU 147,A00,491813,Staff,30,0,32,2
1713324564566,HIEU 149GS,A00,491816,Caldwell; Michael Alan,28,0,28,0
1713324565595,HILD 2C,A01,491713,Hendrickson; Gerald M.,27,0,30,3
1713324566621,HILD 7B,A01,491715,Kwak; Nancy,0,0,30,30
1713324567648,HILD 10,A01,491717,Staff,11,0,20,9
1713324568677,HILD 30GS,A00,491719,Edington; Claire Ellen,24,0,28,4
1713324569702,HINE 109,A00,491818,Shafir; Nir,27,0,32,5
1713324570726,HINE 128,A00,491821,Shafir; Nir,31,0,32,1
1713324571753,HISC 117,A00,491830,Staff,27,0,32,5
1713324572781,HIUS 103,A00,491834,Man; Simeon S,14,0,23,9
1713324573808,HIUS 108B,A00,491835,Staff,28,0,30,2
1713324574835,HIUS 141,A00,491836,Hendrickson; Gerald M.,29,0,32,3
1713324575861,HIUS 149,A00,491839,Staff,25,0,32,7
1713324576889,HUM 3,A01,512617,Crum; Matthew Stephen,43,0,50,7
1713324576889,HUM 3,A02,512618,Crum; Matthew Stephen,48,0,50,2
1713324577913,HUM 3GS,A00,512663,Markman; Kristina,0,0,0,1
1713324577913,HUM 3GS,B00,512664,Staff,0,0,0,0
1713324578938,HUM 4,A01,512620,West; Geoffrey Scott,28,0,50,22
1713324579965,HUM 4GS,A00,512666,Lyon; Antony J.,0,0,0,4
1713324580995,HUM 4R,A01,512625,Watkins; Eric,48,0,50,2
1713324582019,HUM 5,A01,512649,Zavodny; Tatiana Sophia,25,0,50,25
1713324582019,HUM 5,B01,512661,Zroka; Ryan Edward,48,0,50,2
1713324583045,INTL 190,A00,490577,Segui; Alan S,0,0,0,5
1713324584069,JAPN 20AR,A01,491267,Ross; Kayoko F,8,0,20,12
1713324585094,JAPN 180,A00,491285,Berman; Michael David,33,0,40,7
1713324586124,LATI 50,A01,502536,Kokinis; Troy Andreas,16,0,22,6
1713324586124,LATI 50,A02,502551,Kokinis; Troy Andreas,22,0,22,0
1713324586124,LATI 50,A03,502650,Kokinis; Troy Andreas,22,0,22,0
1713324586124,LATI 50,A04,502909,Kokinis; Troy Andreas,22,0,22,0
1713324587148,LATI 160,A01,502920,Kokinis; Troy Andreas,30,0,30,0
1713324588233,LIFR 1A,A00,490494,Van Moer; Vinciane G,17,0,20,3
1713324589256,LIFR 1AX,A00,490495,Van Moer; Vinciane G,17,0,20,3
1713324590281,LIFR 1B,A00,490496,Van Moer; Vinciane G,18,0,20,2
1713324591310,LIFR 1BX,A00,490497,Van Moer; Vinciane G,18,0,20,2
1713324592339,LIGN 8,A00,505198,McIntosh; Justin Daniel,135,0,150,15
1713324593365,LIGN 9GS,A00,491239,Lott; Margaret S.,18,0,20,2
1713324594394,LIGN 101,A01,505200,McIntosh; Justin Daniel,23,0,30,7
1713324595419,LIGN 120,A01,491244,Staff,23,0,30,7
1713324596444,LIGN 149GS,A00,491245,Lott; Margaret S.,18,0,20,2
1713324597468,LIGN 170,A00,491247,Staff,22,0,30,8
1713324598491,LISP 1D,A00,490498,Munoz Sanchez; Alicia,10,0,14,4
1713324598491,LISP 1D,B00,490499,Munoz Sanchez; Alicia,6,0,14,8
1713324598491,LISP 1D,C00,490500,Munoz Sanchez; Alicia,7,0,14,7
1713324598491,LISP 1D,D00,490501,Munoz Sanchez; Alicia,10,0,14,4
1713324599519,LISP 1DX,A00,490502,Munoz Sanchez; Alicia,15,0,28,13
1713324599519,LISP 1DX,B00,490503,Munoz Sanchez; Alicia,16,0,28,12
1713324601568,LTAM 110,A00,491847,Staff,23,0,25,2
1713324602592,LTCS 119,A00,491848,Staff,11,0,15,4
1713324603619,LTCS 130,A00,491849,Staff,24,0,25,1
1713324605673,LTEA 120C,A00,491852,Staff,32,0,40,8
1713324606701,LTEN 130GS,A00,491853,Lyon; Antony J.,24,0,28,4
1713324607727,LTEN 148,A00,491855,Staff,23,0,25,2
1713324608753,LTEN 159,A00,491856,Staff,21,0,25,4
1713324609781,LTEN 180,A00,491857,Staff,8,0,15,7
1713324611835,LTSP 123GS,A00,505928,Bessett; Ryan Matthew,24,0,28,4
1713324612859,LTSP 174GS,A00,506037,Bessett; Ryan Matthew,24,0,28,4
1713324614912,LTWR 102,A00,491861,Staff,9,0,15,6
1713324615939,LTWR 106,A00,491862,Staff,10,0,15,5
1713324616968,MAE 11,A00,490930,Bahadori; Mohammad Yousef,96,0,100,4
1713324617999,MAE 30A,A00,490931,Qi; Huihui,37,0,40,3
1713324619028,MAE 101A,A00,491036,Sadeghizadeh; Zahra,95,0,100,5
1713324620057,MAE 101C,A00,491037,Seshadri; Kalyanasundaram,68,0,100,32
1713324621082,MAE 113,A00,491040,Seshadri; Kalyanasundaram,66,0,80,14
1713324622111,MAE 131A,A00,491041,Ghazinejad; Maziar,37,0,40,3
1713324623137,MAE 142,A00,491053,Staff,39,0,40,1
1713324624166,MAE 143A,A00,491054,Staff,33,0,50,17
1713324625190,MAE 150,A00,491092,Truong; Phuong Thi Ngoc,23,0,35,12
1713324626213,MATH 3C,A01,494031,Pardo Guerra; Sebastian,30,0,30,0
1713324626213,MATH 3C,A02,494032,Pardo Guerra; Sebastian,29,0,30,1
1713324627238,MATH 10A,A01,494034,Staff,27,0,30,3
1713324627238,MATH 10A,A02,494035,Staff,28,0,30,2
1713324627238,MATH 10A,B01,494037,Staff,27,0,30,3
1713324627238,MATH 10A,B02,494038,Staff,29,0,30,1
1713324628265,MATH 10B,A01,494040,Habib; Yousaf,22,0,30,8
1713324628265,MATH 10B,A02,494041,Habib; Yousaf,28,0,30,2
1713324628265,MATH 10B,A03,494042,Habib; Yousaf,29,0,30,1
1713324628265,MATH 10B,A04,494043,Habib; Yousaf,30,0,30,0
1713324628265,MATH 10B,B01,494045,Habib; Yousaf,26,0,30,4
1713324628265,MATH 10B,B02,494046,Habib; Yousaf,30,0,30,0
1713324628265,MATH 10B,B03,494047,Habib; Yousaf,30,0,30,0
1713324628265,MATH 10B,B04,494048,Habib; Yousaf,30,0,30,0
1713324629297,MATH 18,A01,494050,Kemp; Todd Aahron,25,0,30,5
1713324629297,MATH 18,A02,494051,Kemp; Todd Aahron,29,0,30,1
1713324629297,MATH 18,B01,494054,Kemp; Todd Aahron,27,0,30,3
1713324629297,MATH 18,B02,494055,Kemp; Todd Aahron,29,0,30,1
1713324630326,MATH 20A,A01,494059,Suk; Andrew Hoon,30,0,30,0
1713324631350,MATH 20B,A01,494061,Briones; Jor-el Thomas Caparas,33,0,35,2
1713324631350,MATH 20B,B01,494063,Bach; Quang Tran,34,0,35,1
1713324632377,MATH 20C,A01,494065,Staff,28,0,30,2
1713324632377,MATH 20C,A02,494066,Staff,30,0,30,0
1713324632377,MATH 20C,A03,494067,Staff,30,0,30,0
1713324632377,MATH 20C,A04,494068,Staff,30,0,30,0
1713324632377,MATH 20C,B01,494070,Zhang; Ming,26,0,30,4
1713324632377,MATH 20C,B02,494071,Zhang; Ming,27,0,30,3
1713324632377,MATH 20C,B03,494072,Zhang; Ming,29,0,30,1
1713324632377,MATH 20C,B04,494073,Zhang; Ming,29,0,30,1
1713324633404,MATH 20D,A01,494075,Staff,22,0,30,8
1713324633404,MATH 20D,A02,494076,Staff,30,0,30,0
1713324634433,MATH 20E,A01,494079,Staff,24,0,30,6
1713324634433,MATH 20E,A02,494080,Staff,26,0,30,4
1713324634433,MATH 20E,B01,494082,Staff,25,0,30,5
1713324634433,MATH 20E,B02,494083,Staff,25,0,30,5
1713324635463,MATH 103A,A01,494085,Aliabadi Sr.; Mohsen,14,0,30,16
1713324635463,MATH 103A,A02,494086,Aliabadi Sr.; Mohsen,28,0,30,2
1713324635463,MATH 103A,B01,494088,Aliabadi Sr.; Mohsen,21,0,30,9
1713324635463,MATH 103A,B02,494089,Aliabadi Sr.; Mohsen,28,0,30,2
1713324636488,MATH 109,A01,494091,Staff,30,0,30,0
1713324636488,MATH 109,A02,494092,Staff,29,0,30,1
1713324636488,MATH 109,B01,494094,Staff,27,0,30,3
1713324636488,MATH 109,B02,494095,Staff,29,0,30,1
1713324637514,MATH 142A,A01,494097,Chow; Bennett,15,0,30,15
1713324637514,MATH 142A,A02,494098,Chow; Bennett,24,0,30,6
1713324637514,MATH 142A,B01,494100,Chow; Bennett,19,0,30,11
1713324637514,MATH 142A,B02,494101,Chow; Bennett,29,0,30,1
1713324639566,MATH 168A,A01,516677,Dumitriu; Ioana,15,0,35,20
1713324640592,MATH 170A,A01,516679,Dumitriu; Ioana,19,0,30,11
1713324640592,MATH 170A,A02,516680,Dumitriu; Ioana,28,0,30,2
1713324641620,MATH 193A,A01,494107,Staff,14,0,30,16
1713324641620,MATH 193A,A02,494108,Staff,21,0,30,9
1713324641620,MATH 193A,A03,494109,Staff,29,0,30,1
1713324641620,MATH 193A,A04,494110,Staff,22,0,30,8
1713324644701,MGT 16,A00,491930,McKay; Michael J,92,0,98,6
1713324645726,MGT 18,A00,491992,McKay; Michael J,96,0,98,2
1713324646752,MGT 71,A00,492003,Staff,66,0,98,32
1713324647781,MGT 103,A00,505209,Eberhard; Craig A,81,0,98,17
1713324648808,MGT 131A,A00,505210,Anderson; John Charles,90,0,98,8
1713324650859,MGT 153,A00,492077,Perols; Johan Lars,22,0,90,68
1713324653936,MGT 164,A00,492222,McKay; Mary A,91,0,98,7
1713324654965,MGT 172,A00,492245,Staff,59,0,60,1
1713324654965,MGT 172,B00,505526,Hedges; Kathleen,66,0,98,32
1713324655990,MGT 181,A00,505669,Dunn; Louis Jean,82,0,98,16
1713324657017,MMW 14,A01,494399,Staff,15,0,28,13
1713324657017,MMW 14,A02,494400,Staff,25,0,28,3
1713324657017,MMW 14,A03,494401,Staff,28,0,28,0
1713324657017,MMW 14,A04,494402,Staff,28,0,28,0
1713324657017,MMW 14,B01,494404,Carreras; Maria Victoria,10,0,28,18
1713324657017,MMW 14,B02,494405,Carreras; Maria Victoria,25,0,28,3
1713324657017,MMW 14,B03,494406,Carreras; Maria Victoria,27,0,28,1
1713324657017,MMW 14,B04,494407,Carreras; Maria Victoria,28,0,28,0
1713324658042,MMW 14GS,A00,506250,Chang; Edmond Yi-Teh,0,0,0,0
1713324659067,MMW 121R,A01,494415,Adamiak; Patrick John,12,0,28,16
1713324659067,MMW 121R,A02,494416,Adamiak; Patrick John,24,0,28,4
1713324660097,MUS 1A,A01,494113,Staff,12,0,25,13
1713324660097,MUS 1A,A02,494114,Staff,24,0,25,1
1713324661124,MUS 4,A01,494116,Staff,23,0,25,2
1713324661124,MUS 4,A02,494117,Staff,22,0,25,3
1713324662153,MUS 5R,A01,494236,Dubnov; Shlomo,9,0,25,16
1713324662153,MUS 5R,A02,494237,Dubnov; Shlomo,25,0,25,0
1713324663182,MUS 6,A01,494122,Staff,10,0,25,15
1713324663182,MUS 6,A02,494123,Staff,23,0,25,2
1713324664208,MUS 7,A01,494125,Staff,16,0,25,9
1713324664208,MUS 7,A02,494126,Staff,24,0,25,1
1713324665239,MUS 11,A01,494128,Staff,23,0,25,2
1713324665239,MUS 11,A02,494129,Staff,24,0,25,1
1713324666266,MUS 13,A01,494131,Staff,25,0,25,0
1713324666266,MUS 13,A02,494132,Staff,25,0,25,0
1713324667293,MUS 15,A01,494134,Staff,17,0,25,8
1713324667293,MUS 15,A02,494135,Staff,25,0,25,0
1713324667293,MUS 15,B01,494137,Staff,24,0,25,1
1713324668320,MUS 80,A00,494232,Staff,24,0,25,1
1713324668320,MUS 80,B00,494233,Staff,25,0,25,0
1713324668320,MUS 80,C00,494234,Staff,23,0,25,2
1713324669346,MUS 95C,A00,494141,Staff,70,0,75,5
1713324670371,MUS 114,A00,494142,Staff,40,0,50,10
1713324671396,NANO 15,A01,490636,Drews; Aaron,7,0,7,0
1713324672420,PHIL 1,A00,490578,Grush; Rick Scott,49,0,50,1
1713324673445,PHIL 10,A01,490580,Grush; Rick Scott,33,0,35,2
1713324673445,PHIL 10,A02,490586,Grush; Rick Scott,32,0,35,3
1713324674472,PHIL 27,A01,490591,Staff,22,0,25,3
1713324674472,PHIL 27,A02,490592,Staff,25,0,25,0
1713324674472,PHIL 27,A03,490593,Staff,25,0,25,0
1713324674472,PHIL 27,A04,490598,Staff,25,0,25,0
1713324675499,PHIL 32,A01,490611,Staff,20,0,20,0
1713324675499,PHIL 32,A02,490618,Staff,20,0,20,0
1713324676527,PHIL 90,A00,490624,Staff,40,0,40,0
1713324677550,PHIL 136,A00,490627,Cohen; Jonathan David,37,0,40,3
1713324678575,PHIL 155,A00,490634,Staff,63,0,70,7
1713324679600,PHYS 1A,A00,491610,Staff,245,0,250,5
1713324680628,PHYS 1AL,001,491616,Tsai; Philbert S,27,0,30,3
1713324680628,PHYS 1AL,002,491618,Tsai; Philbert S,30,0,30,0
1713324681656,PHYS 1B,A00,491623,Staff,236,0,250,14
1713324682678,PHYS 1BL,001,491626,Tsai; Philbert S,22,0,30,8
1713324682678,PHYS 1BL,002,491628,Tsai; Philbert S,26,0,30,4
1713324683705,PHYS 1C,A00,491632,Staff,216,0,245,29
1713324684730,PHYS 1CL,001,491635,Tsai; Philbert S,5,0,30,25
1713324684730,PHYS 1CL,002,491643,Tsai; Philbert S,22,0,30,8
1713324685755,PHYS 2AR,A01,491651,Meyertholen; Andrew D.,44,0,50,6
1713324686783,PHYS 2B,A01,491659,Staff,105,0,115,10
1713324687809,PHYS 2BL,A01,491685,Staff,21,0,24,3
1713324687809,PHYS 2BL,A02,491700,Staff,21,0,24,3
1713324688836,PHYS 2C,A01,505161,Staff,103,0,115,12
1713324689860,PHYS 4A,A01,491704,Grinstein; Benjamin,99,0,100,1
1713324690886,POLI 5D,A01,494144,Staff,3,0,5,2
1713324690886,POLI 5D,B01,626283,Dai; Yinlin,5,0,5,0
1713324691967,POLI 12,A00,494145,Staff,43,0,45,2
1713324692991,POLI 13R,A00,494146,Forman; Fonna,45,0,50,5
1713324694016,POLI 27,A01,494148,Staff,54,0,60,6
1713324695046,POLI 30,A00,494149,Staff,49,0,50,1
1713324696070,POLI 100DA,A00,494150,Staff,21,0,25,4
1713324698117,POLI 100I,A00,494152,Staff,27,0,30,3
1713324699141,POLI 104B,A00,494153,Smith; Glenn Chatmas,53,0,55,2
1713324700164,POLI 104F,A00,494154,Staff,28,0,30,2
1713324701191,POLI 104I,A00,494155,Smith; Glenn Chatmas,30,0,30,0
1713324702215,POLI 110C,A00,494156,Ingham; Sean,23,0,25,2
1713324703240,POLI 117R,A00,494157,Forman; Fonna,8,0,20,12
1713324704265,POLI 118,A00,494158,Ingham; Sean,21,0,25,4
1713324705290,POLI 120H,A00,494159,Fisk; David Lee,40,0,45,5
1713324706316,POLI 131CR,A00,494160,Hoston; Germaine,36,0,45,9
1713324707342,POLI 133J,A00,494161,Staff,33,0,35,2
1713324708369,POLI 135,A00,494162,Fisk; David Lee,33,0,35,2
1713324709394,POLI 140A,A00,494164,Staff,20,0,30,10
1713324710420,POLI 142I,A00,494165,Staff,30,0,30,0
1713324711444,POLI 144D,A00,494166,Staff,23,0,25,2
1713324712468,POLI 151,A00,494167,Staff,30,0,30,0
1713324713492,POLI 153,A00,494168,Staff,33,0,35,2
1713324714516,POLI 160AA,A00,494169,Staff,34,0,40,6
1713324715545,POLI 162,A00,494170,Mignozzetti; Umberto,19,0,25,6
1713324716571,POLI 171,A00,494171,Mignozzetti; Umberto,20,0,25,5
1713324717596,PSYC 1,A00,494172,Staff,96,0,100,4
1713324718621,PSYC 2,A00,494173,Moranton; Nirelia Melbina-,36,0,50,14
1713324719648,PSYC 3,A00,494174,Staff,29,0,30,1
1713324720673,PSYC 6,A00,494175,Staff,17,0,20,3
1713324721697,PSYC 60,A01,494177,Staff,38,0,45,7
1713324722725,PSYC 70,A01,505724,Geller; Emma Harlan,42,0,45,3
1713324723752,PSYC 101,A00,494180,Heyman; Gail D.,84,0,100,16
1713324724776,PSYC 105,A00,494181,Geller; Emma Harlan,53,0,90,37
1713324725804,PSYC 106,A00,494182,Dobkins; Karen R.,29,0,45,16
1713324726829,PSYC 108,A00,494183,Adrian; Julia Anna,90,0,100,10
1713324727857,PSYC 114,A01,494185,Winkielman; Piotr,0,2,30,30
1713324728885,PSYC 122,A00,494186,Moranton; Nirelia Melbina-,31,0,50,19
1713324729909,PSYC 124,A00,494187,Chapman; Eddie Nathaniel,71,0,80,9
1713324730933,PSYC 131,A00,494188,Anagnostaras; Stephan,44,0,80,36
1713324731958,PSYC 144,A00,494189,Staff,5,0,50,45
1713324732983,PSYC 154,A00,494190,Lacefield; Katharine I,111,0,180,69
1713324734013,PSYC 162,A00,494191,Wixted; John T,73,0,100,27
1713324735039,PSYC 172,A00,494192,Gorman; Michael R.,36,0,45,9
1713324736063,PSYC 178,A00,494193,Glaser; Dale,34,0,45,11
1713324737091,PSYC 193,A00,505725,Chapman; Eddie Nathaniel,20,0,20,0
1713324738118,RELI 145GS,A00,519817,Rahimi; Babak,18,0,20,2
1713324739146,SE 101A,A01,490862,Chadha; Mayank,23,0,25,2
1713324740176,SE 101C,A01,490924,Krysl; Petr,16,0,20,4
1713324741200,SE 110A,A01,490928,Staff,19,0,20,1
1713324742225,SE 130A,A00,490929,Morrison; Machel Leigh,56,0,70,14
1713324743251,SIO 1,A01,519325,Staff,39,0,40,1
1713324744280,SIO 30,A01,519327,Staff,38,0,40,2
1713324745306,SIO 40,A00,519328,Staff,39,0,40,1
1713324746330,SIO 46GS,A00,519819,Cook; Geoffrey W,17,0,25,8
1713324747355,SIO 109R,A00,494197,Forman; Fonna,0,3,20,20
1713324748379,SIO 121GS,A00,519827,Cook; Geoffrey W,17,0,25,8
1713324749406,SIO 132,A01,519330,Staff,38,0,40,2
1713324750432,SIO 133,A01,519397,Staff,37,0,40,3
1713324751458,SIO 139,A00,519396,Kacev; David,31,0,40,9
1713324752483,SOCI 1,A01,494199,Thorpe; Charles Robert,22,0,30,8
1713324752483,SOCI 1,A02,494200,Thorpe; Charles Robert,30,0,30,0
1713324752483,SOCI 1,A03,494201,Thorpe; Charles Robert,29,0,30,1
1713324752483,SOCI 1,A04,494202,Thorpe; Charles Robert,29,0,30,1
1713324752483,SOCI 1,A05,494203,Thorpe; Charles Robert,29,0,30,1
1713324752483,SOCI 1,A06,494204,Thorpe; Charles Robert,30,0,30,0
1713324752483,SOCI 1,A07,494205,Thorpe; Charles Robert,28,0,30,2
1713324753509,SOCI 60,A01,494207,Staff,34,0,40,6
1713324753509,SOCI 60,A02,494208,Staff,39,0,40,1
1713324754538,SOCI 100,A01,494210,Payne; Christine Anna,26,0,30,4
1713324754538,SOCI 100,A02,494211,Payne; Christine Anna,26,0,30,4
1713324755563,SOCI 109M,A00,494212,Staff,20,0,20,0
1713324756591,SOCI 110,A00,494213,Staff,34,0,40,6
1713324758641,SOCI 118E,A00,494215,Ng; Kwai,37,0,40,3
1713324759668,SOCI 125,A00,494216,Calderon-Zaks; Michael Aar,40,0,45,5
1713324760692,SOCI 126,A01,494218,Jones; Makeba,3,0,5,2
1713324761730,SOCI 131,A00,494219,Thorpe; Charles Robert,27,0,30,3
1713324763787,SOCI 135,A00,494221,Payne; Christine Anna,29,0,50,21
1713324764814,SOCI 136E,A00,626690,Ruiz; Jonathan Joseph,25,0,25,0
1713324765837,SOCI 138GS,A00,494222,Navon; Daniel,24,0,28,4
1713324767893,SOCI 145,A00,494224,Staff,40,0,45,5
1713324768920,SOCI 153,A00,494225,Staff,28,0,30,2
1713324769944,SOCI 160E,A00,494226,Ng; Kwai,29,0,40,11
1713324770971,SOCI 180,A00,494227,Staff,29,0,30,1
1713324771999,SOCI 189GS,A00,494228,Ribas Norris; Janet Vanesa,11,0,11,0
1713324773023,SOCI 190GS,A00,553232,Ribas Norris; Janet Vanesa,11,0,11,0
1713324774050,SOMI 220,A00,627178,Schneid; Stephen David,30,0,30,0
1713324775074,SYN 2,001,490768,Staff,14,0,15,1
1713324775074,SYN 2,002,490769,Staff,15,0,15,0
1713324775074,SYN 2,004,490775,Staff,0,0,0,0
1713324775074,SYN 2,003,490774,Staff,0,0,0,0
1713324775074,SYN 2,005,490776,Staff,0,0,0,0
1713324776101,SYN 2R,001,490779,Staff,11,0,15,4
1713324776101,SYN 2R,002,514635,Staff,14,0,15,1
1713324777126,SYN 100,A01,490783,Staff,12,0,20,8
1713324777126,SYN 100,B01,490787,Staff,9,0,20,11
1713324777126,SYN 100,C01,490789,Staff,11,0,20,9
1713324778153,SYN 150,A00,490817,Staff,14,0,15,1
1713324778153,SYN 150,B00,514610,Staff,15,0,15,0
1713324779182,TDAC 1,A00,492753,Walsh; Kim C.,19,0,20,1
1713324779182,TDAC 1,B00,492754,Harting; Carla Kelso,19,0,20,1
1713324779182,TDAC 1,C00,513995,Salovey; Todd,15,0,20,5
1713324780205,TDAC 101,A00,492766,Harting; Carla Kelso,17,0,20,3
1713324781232,TDAC 102,A00,492768,Basso; Beatrice,19,0,20,1
1713324782255,TDDE 111,A00,492769,Staff,25,0,25,0
1713324783285,TDDE 131,A00,492770,Staff,15,0,15,0
1713324783285,TDDE 131,B00,492771,Staff,15,0,15,0
1713324784309,TDDE 131GS,A00,523716,Guirguis; Mark C,23,0,28,5
1713324785337,TDGE 1,A01,492756,Salovey; Todd,57,0,60,3
1713324786362,TDGE 5,A01,492758,Staff,23,0,25,2
1713324787386,TDGE 10,A00,492759,Fulton; Julia,203,0,220,17
1713324788413,TDGE 11,A00,492760,Castro; Robert Jess,198,0,200,2
1713324790464,TDGE 124,A00,492772,Fulton; Julia,186,0,220,34
1713324791492,TDGE 125,A00,492773,Meyer; Ursula,38,0,50,12
1713324791492,TDGE 125,B00,492774,Staff,49,0,50,1
1713324791492,TDGE 125,C00,523565,Staff,48,0,50,2
1713324792516,TDGE 125GS,A00,523580,Guirguis; Mark C,23,0,28,5
1713324793539,TDGE 127,A00,492775,Havis; Allan,35,0,50,15
1713324794565,TDHT 101,A00,492776,Staff,34,0,35,1
1713324795643,TDMV 1,A00,492762,Caligagan; Maria T.,30,0,30,0
1713324795643,TDMV 1,B00,492763,Arcidiacono; Kristin,26,0,30,4
1713324796668,TDMV 2,A00,492764,Weinberg; Sadie,28,0,30,2
1713324797693,TDMV 3,A00,492765,Mack; Kara Shanai',37,0,40,3
1713324798723,TDMV 138,A00,492777,Mack; Kara Shanai',34,0,40,6
1713324799751,TDMV 140,A00,492778,Lima; Paulo Henrique,40,0,40,0
1713324800776,TDMV 142,A00,492779,Caligagan; Maria T.,33,0,40,7
1713324800776,TDMV 142,B00,492780,Caligagan; Tony,37,0,40,3
1713324801801,TDMV 143,A00,492781,Fyall; Daunte Edward,39,0,40,1
1713324802823,USP 1,A01,492401,Kwak; Nancy,26,0,35,9
1713324803861,USP 2,A01,492453,Hinds; Juli Beth,35,0,35,0
1713324804888,USP 3,A01,492516,Staff,28,0,35,7
1713324805914,USP 4,A00,492522,McTague; Sarah,17,0,25,8
1713324806937,USP 100,A00,492523,Staff,32,0,35,3
1713324807962,USP 101,A00,492524,Staff,13,0,15,2
1713324808985,USP 105,A00,492525,Staff,21,0,25,4
1713324810013,USP 151,A00,492526,Shenkman; Michael Thomas,32,0,35,3
1713324811037,USP 170,A00,492545,Hinds; Juli Beth,33,0,35,2
1713324812061,USP 171GS,A00,492608,Bussell; Mirle Rabinowitz,24,0,28,4
1713324813089,USP 183GS,A00,492613,Peerson; Susan,24,0,28,4
1713324814117,VIS 30,A01,490693,Yoldas; Pinar,19,0,22,3
1713324814117,VIS 30,A02,490694,Yoldas; Pinar,18,0,22,4
1713324815141,VIS 83,A00,490695,Kester; Grant,63,0,75,12
1713324816169,VIS 105D,A00,490696,Staff,22,0,25,3
1713324817191,VIS 124CN,A00,490699,Rose; Jordan M,66,0,75,9
1713324818216,VIS 125GS,A00,511221,Williams; Alena J,21,0,22,1
1713324819240,VIS 128D,A00,490700,Staff,73,0,75,2
1713324820265,VIS 151,A01,490717,Staff,33,0,34,1
1713324820265,VIS 151,A02,490766,Staff,33,0,34,1
1713324821288,VIS 154GS,A00,511972,Williams; Alena J,21,0,22,1
1713324822313,VIS 160A,A00,490767,Stone; Patricia,7,0,10,3
1713324823338,WCWP 10A,A00,490638,Staff,14,0,15,1
1713324823338,WCWP 10A,B00,490640,Staff,15,0,15,0
1713324824363,WCWP 10B,A00,490641,Staff,0,0,0,0
1713324824363,WCWP 10B,B00,490642,Staff,14,0,15,1
1713324824363,WCWP 10B,C00,490644,Staff,13,0,15,2
1713324824363,WCWP 10B,D00,490647,Staff,0,0,0,0
1713324825391,WCWP 100,A00,490655,Staff,0,0,0,0
1713324825391,WCWP 100,B00,490687,Staff,10,0,15,5
1713324827496,ANAR 153,A00,487222,Braswell; Geoffrey E.,54,0,60,6
1713324828521,ANBI 134,A00,487223,Staff,7,0,20,13
1713324829550,ANBI 143GS,A00,487224,Noel; Geoffroy Pierre Jean,18,0,24,6
1713324830574,ANBI 144GS,A00,519548,Noel; Geoffroy Pierre Jean,18,0,24,6
1713324831598,ANSC 101,A00,487225,Staff,18,0,20,2
1713324832623,ANSC 125,A00,487227,Brenner; Suzanne A,39,0,40,1
1713324834677,ANSC 146,A00,487229,Staff,35,0,40,5
1713324835705,ANSC 148,A00,487230,Olivas Hernandez; Olga Lid,39,0,40,1
1713324836727,ANSC 150,A00,504165,Sloane; Julia Kathryn,18,0,20,2
1713324837755,ANSC 180,A00,487232,Staff,14,0,15,1
1713324838784,ANSC 188,A00,627155,Staff,39,0,40,1
1713324839811,ANTH 5,A00,519529,Semendeferi; Ekaterini,15,0,15,0
1713324840838,ANTH 10,A00,487219,Staff,58,0,60,2
1713324841873,ANTH 23,A01,487221,Staff,17,0,20,3
1713324842897,ANTH 102,A00,487233,Wilder; Linnea Lorene,51,0,60,9
1713324843924,ANTH 103,A00,487234,Varma; Saiba,55,0,60,5
1713324844950,ANTH 105,A00,487235,Stewart; Alexander B,55,0,60,5
1713324845975,BENG 100,A01,516685,Taylor Amos; Alyssa C,27,0,30,3
1713324847000,BIBC 102,A01,491316,Flagg; Matthew Paul,17,0,88,71
1713324847000,BIBC 102,A02,491366,Flagg; Matthew Paul,80,0,88,8
1713324848026,BIBC 103,A01,491486,Boumechache; Miyyada,16,0,24,8
1713324848026,BIBC 103,A02,491487,Boumechache; Miyyada,24,0,24,0
1713324849050,BICD 100,A01,516882,Staff,73,0,75,2
1713324849050,BICD 100,A02,516890,Staff,69,0,75,6
1713324850075,BICD 102GS,A00,491488,Lo; Stanley M.,26,0,28,2
1713324851098,BIEB 136GS,A00,516940,Holway; David A. & Shurin; Jonathan,19,0,24,5
1713324852127,BIEB 137GS,A01,517034,Holway; David A. & Shurin; Jonathan,19,0,24,5
1713324853154,BIEB 138GS,A01,491492,Pirino; Giorgia,21,0,28,7
1713324854182,BILD 1,A01,491296,Staff,60,0,63,3
1713324854182,BILD 1,A02,491297,Staff,63,0,63,0
1713324855210,BILD 4,A01,517099,Gonzalez Gamboa; Ivonne,22,0,24,2
1713324855210,BILD 4,A02,517100,Gonzalez Gamboa; Ivonne,24,0,24,0
1713324856233,BILD 60GS,A00,491309,Lo; Stanley M.,26,0,28,2
1713324857258,BIMM 100,A01,517136,Staff,85,0,100,15
1713324858284,BIMM 110,A01,517182,Staff,59,0,100,41
1713324859308,BIMM 120,A01,517228,Pickett; Brooke Elizabeth,29,0,63,34
1713324859308,BIMM 120,A02,517240,Pickett; Brooke Elizabeth,45,0,63,18
1713324860333,BIMM 132GS,A01,491498,Pirino; Giorgia,21,0,28,7
1713324861357,BIMM 143,A01,491589,Bozinovic; Goran,13,0,40,27
1713324862385,BIPN 100,A01,491594,Armour; Jon Christopher,89,0,100,11
1713324863412,BIPN 140,A01,491602,Marino; Marc J,26,0,50,24
1713324865461,CAT 125,A00,515973,Staff,18,0,20,2
1713324866486,CAT 125GS,A00,515974,Rahimi; Babak,17,0,20,3
1713324867510,CAT 125R,A00,515980,Staff,12,0,20,8
1713324867510,CAT 125R,B00,515981,Tosun; Adriana,19,0,20,1
1713324867510,CAT 125R,C00,515987,Hyland; Tina Mae,0,2,20,20
1713324867510,CAT 125R,D00,515988,Bronstein; Phoebe Malan,17,0,20,3
1713324868538,CENG 15,A01,488699,Drews; Aaron,25,0,25,0
1713324869566,CENG 100,A00,505196,Opatkiewicz; Justin Paul,25,0,25,0
1713324870591,CGS 2A,A01,489598,Staff,33,0,35,2
1713324871616,CGS 112,A00,489599,Staff,15,0,15,0
1713324872641,CGS 119,A00,489603,Staff,10,0,10,0
1713324873666,CGS 120,A00,489604,Staff,14,0,15,1
1713324874694,CGS 150,A00,489607,Staff,15,0,15,0
1713324875722,CHEM 6A,A01,488715,Staff,98,0,100,2
1713324876750,CHEM 6B,A01,488719,Piercy; Marc Anthony,99,0,100,1
1713324877782,CHEM 6C,A01,488723,Albizati; Kim F.,93,0,100,7
1713324878813,CHEM 7L,A01,488728,Schurmeier; Kimberly,17,0,24,7
1713324878813,CHEM 7L,A02,488730,Schurmeier; Kimberly,23,0,24,1
1713324878813,CHEM 7L,A03,488734,Schurmeier; Kimberly,22,0,24,2
1713324878813,CHEM 7L,A04,488763,Schurmeier; Kimberly,23,0,24,1
1713324878813,CHEM 7L,B01,488798,Schurmeier; Kimberly,17,0,24,7
1713324878813,CHEM 7L,B02,488801,Schurmeier; Kimberly,23,0,24,1
1713324878813,CHEM 7L,B03,488808,Schurmeier; Kimberly,23,0,24,1
1713324878813,CHEM 7L,B04,488811,Schurmeier; Kimberly,24,0,24,0
1713324879838,CHEM 11,A01,488897,Stallings; Dontarie M,95,0,100,5
1713324880863,CHEM 40A,A01,488913,Albizati; Kim F.,84,0,100,16
1713324881892,CHEM 40B,A01,488920,Weizman; Haim,44,0,50,6
1713324881892,CHEM 40B,A02,488938,Weizman; Haim,45,0,50,5
1713324882916,CHEM 41A,A01,489029,Klosterman; Jeremy K,57,0,60,3
1713324883943,CHEM 41C,A01,500436,Tor; Yitzhak,55,0,60,5
1713324884970,CHEM 43A,A01,500426,Weizman; Haim,0,0,24,24
1713324884970,CHEM 43A,A02,500430,Weizman; Haim,9,0,24,15
1713324884970,CHEM 43A,B01,514041,Klosterman; Jeremy K,16,0,24,8
1713324884970,CHEM 43A,B02,514047,Klosterman; Jeremy K,23,0,24,1
1713324885999,CHEM 108,A01,489140,Jennings; Patricia A.,11,0,24,13
1713324885999,CHEM 108,A02,489142,Jennings; Patricia A.,14,0,24,10
1713324887027,CHEM 114A,A01,489147,Stallings; Dontarie M,72,0,100,28
1713324888053,CHIN 169A,A00,489171,Wang; Xiao,19,0,20,1
1713324890106,COGS 3,A01,518827,Boyle; Mary E. T.,26,0,40,14
1713324891129,COGS 11,A01,489175,Staff,27,0,30,3
1713324892158,COGS 14A,A01,518829,Staff,51,0,60,9
1713324893181,COGS 14B,A01,489177,Hoffman; Drew Ellen,65,0,75,10
1713324894208,COGS 100,A01,489181,Allen; Michael Gordon,63,0,75,12
1713324895231,COGS 101A,A01,489183,Staff,46,0,60,14
1713324896258,COGS 101B,A01,489185,Allen; Michael Gordon,8,0,30,22
1713324897282,COGS 101C,A01,526786,Staff,23,0,30,7
1713324899385,COGS 107A,A01,489189,Boyle; Mary E. T.,18,0,35,17
1713324900413,COGS 107B,A01,627144,Mooshagian; Eric Frederick,60,0,60,0
1713324901439,COGS 118A,A01,489191,Staff,0,42,40,40
1713324903498,COGS 171GS,A01,489194,Pineda; Jaime A,21,0,28,7
1713324904523,COGS 172,A01,489196,Staff,3,0,30,27
1713324905551,COGS 174GS,A01,489264,Pineda; Jaime A,21,0,28,7
1713324906578,COGS 180,A01,627150,Staff,28,0,30,2
1713324907603,COGS 186,A01,489274,Staff,0,1,30,30
1713324908631,COMM 10,A01,489276,Staff,23,0,25,2
1713324908631,COMM 10,A02,489303,Staff,23,0,25,2
1713324909660,COMM 100A,A01,489312,Staff,14,0,25,11
1713324909660,COMM 100A,A02,489313,Staff,24,0,25,1
1713324910685,COMM 106T,A00,512540,Staff,33,0,35,2
1713324911710,COMM 107,A00,489347,Staff,27,0,35,8
1713324912735,COMM 109P,A00,489358,Staff,31,0,35,4
1713324913759,COMM 132,A00,489361,McKenna; Denise,27,0,30,3
1713324914782,COMM 146,A00,489362,Halm; Gavin Patrick,26,0,30,4
1713324915807,COMM 190,A00,489363,Abuelhiga; Soraya Jill,17,0,23,6
1713324916834,CSE 8A,A50,489366,Staff,21,0,25,4
1713324916834,CSE 8A,A51,489367,Staff,24,0,25,1
1713324917859,CSE 11,A01,489398,Cao; Yingjun,75,0,100,25
1713324918885,CSE 12,A01,489487,Staff,43,0,50,7
1713324919910,CSE 20,A01,489497,Staff,48,0,50,2
1713324920935,CSE 21,A01,489517,Braun; Oliver,42,0,50,8
1713324921960,CSE 101,A01,489524,Braun; Oliver,0,28,50,50
1713324922986,CSE 105,A01,512594,Jones; Miles E,73,0,100,27
1713324922986,CSE 105,B01,512598,Jones; Miles E,53,0,100,47
1713324924012,CSE 140,A01,489538,Staff,42,0,50,8
1713324925036,CSE 141,A01,489550,Eldon; John,69,0,100,31
1713324926063,CSE 141L,A01,489571,Eldon; John,67,0,100,33
1713324927089,CSE 151A,A01,489583,Solares; Edwin A,142,0,200,58
1713324928113,CSE 175,A01,510886,Kumar; Rakesh,30,0,30,0
1713324929142,CSE 190,A00,516828,Dubnov; Shlomo,38,0,49,11
1713324930167,DOC 100D,A00,489667,Pass; Natalye Joann,19,0,25,6
1713324931195,DSC 10,A01,624268,Staff,72,0,75,3
1713324932219,DSC 20,A01,624476,Staff,50,0,50,0
1713324933247,DSC 40A,A01,624608,Staff,39,0,40,1
1713324934277,DSGN 1,A01,489179,Rill; Bryan,34,0,50,16
1713324935305,ECE 17,A01,490489,Sahay; Rajeev,18,0,30,12
1713324936332,ECE 65,A50,490492,Staff,12,0,20,8
1713324936332,ECE 65,A51,490493,Staff,19,0,20,1
1713324937356,ECON 1,A01,489715,Famulari; Melissa,68,0,70,2
1713324938385,ECON 2,A01,489717,Levkoff; Steven B.,68,0,70,2
1713324939409,ECON 3,A01,489948,Staff,70,0,70,0
1713324941462,ECON 5,A01,490103,Staff,27,0,30,3
1713324941462,ECON 5,B01,626281,Dai; Yinlin,45,0,45,0
1713324942490,ECON 100A,A01,490127,Famulari; Melissa,66,0,70,4
1713324943517,ECON 100B,A01,490129,Staff,64,0,70,6
1713324944545,ECON 109,A01,490187,Shishkin; Denis,27,0,35,8
1713324945570,ECON 110A,A01,490190,Levkoff; Steven B.,60,0,70,10
1713324946598,ECON 120A,A01,490245,Dai; Yinlin,62,0,70,8
1713324947624,ECON 120B,A01,490247,Nieto-Barthaburu; Augusto,45,0,70,25
1713324948649,ECON 120C,A01,490253,Sun; Yixiao,30,0,35,5
1713324948649,ECON 120C,B01,490255,Sun; Yixiao,34,0,35,1
1713324949673,ECON 129,A00,490256,Eckert; Fabian Paul,24,0,35,11
1713324950701,ECON 131,A00,490257,Nieto-Barthaburu; Augusto,0,6,35,35
1713324951729,ECON 138,A00,490258,Bharadwaj; Prashant,14,0,35,21
1713324951729,ECON 138,B00,490259,Bharadwaj; Prashant,15,0,35,20
1713324952756,ECON 159,A00,490260,Hendrickson; Gerald M.,0,9,0,0
1713324953781,ECON 178,A01,553995,Zhu; Ying,24,0,35,11
1713324954806,EDS 40,A01,512576,Black; Alison Michelle,20,0,20,0
1713324955834,EDS 107,A01,515848,Staff,30,0,30,0
1713324956858,EDS 110R,A01,490262,Staff,26,0,30,4
1713324957886,EDS 112,A01,490264,Chapman; Thandeka K,40,0,50,10
1713324958915,EDS 113,A00,490266,Staff,26,0,30,4
1713324959938,EDS 118,A00,490267,Warstadt; Melissa Fawn,21,0,30,9
1713324960967,EDS 124BR,A00,490268,Eguchi; Emi,4,0,25,21
1713324960967,EDS 124BR,B00,490269,Eguchi; Emi,24,0,25,1
1713324961997,EDS 126,A01,490271,Jones; Makeba,43,0,50,7
1713324963022,EDS 135,A01,490316,Staff,19,0,20,1
1713324964050,ENVR 142GS,A00,519514,Chang; Edmond Yi-Teh,27,0,28,1
1713324965078,ETHN 103,A00,490504,Staff,26,0,36,10
1713324966108,ETHN 103A,A00,490505,Man; Simeon S,5,0,9,4
1713324967136,ETHN 109,A00,490506,Staff,28,0,30,2
1713324968162,ETHN 118,A00,490507,Staff,35,0,36,1
1713324969189,ETHN 119,A00,490508,Staff,33,0,36,3
1713324970218,ETHN 121R,A00,490518,Choi; Esther Min,24,0,36,12
1713324971245,ETHN 127,A00,490528,Staff,14,0,15,1
1713324972269,ETHN 139,A00,490573,Staff,10,0,10,0
1713324973296,ETHN 150,A00,490575,Staff,15,0,15,0
1713324974325,GLBH 20,A00,491705,Elwardani; Nile Regina,38,0,40,2
1713324975350,GLBH 101,A00,491706,Staff,20,0,20,0
1713324976376,GLBH 111,A01,491708,Burgos; Jose L.,15,0,15,0
1713324977399,GLBH 146,A00,491709,Staff,10,0,20,10
1713324978424,GLBH 148,A00,491710,Olivas Hernandez; Olga Lid,11,0,20,9
1713324979451,GLBH 150,A00,491711,Sloane; Julia Kathryn,19,0,20,1
1713324980478,HIEA 131,A00,491760,Staff,29,0,32,3
1713324981502,HIEA 153,A00,491762,Staff,29,0,30,1
1713324982530,HIEU 124,A00,491811,Staff,26,0,32,6
1713324983555,HIEU 124GS,A00,491812,Markman; Kristina,27,0,28,1
1713324984579,HIEU 147,A00,491813,Staff,30,0,32,2
1713324985605,HIEU 149GS,A00,491816,Caldwell; Michael Alan,28,0,28,0
1713324986633,HILD 2C,A01,491713,Hendrickson; Gerald M.,27,0,30,3
1713324987660,HILD 7B,A01,491715,Kwak; Nancy,0,0,30,30
1713324988688,HILD 10,A01,491717,Staff,11,0,20,9
1713324989712,HILD 30GS,A00,491719,Edington; Claire Ellen,24,0,28,4
1713324990737,HINE 109,A00,491818,Shafir; Nir,27,0,32,5
1713324991765,HINE 128,A00,491821,Shafir; Nir,31,0,32,1
1713324992790,HISC 117,A00,491830,Staff,27,0,32,5
1713324993815,HIUS 103,A00,491834,Man; Simeon S,14,0,23,9
1713324994841,HIUS 108B,A00,491835,Staff,28,0,30,2
1713324995865,HIUS 141,A00,491836,Hendrickson; Gerald M.,29,0,32,3
1713324996896,HIUS 149,A00,491839,Staff,25,0,32,7
1713324997924,HUM 3,A01,512617,Crum; Matthew Stephen,43,0,50,7
1713324997924,HUM 3,A02,512618,Crum; Matthew Stephen,48,0,50,2
1713324998952,HUM 3GS,A00,512663,Markman; Kristina,0,0,0,1
1713324998952,HUM 3GS,B00,512664,Staff,0,0,0,0
1713324999977,HUM 4,A01,512620,West; Geoffrey Scott,28,0,50,22
1713325001003,HUM 4GS,A00,512666,Lyon; Antony J.,0,0,0,4
1713325002033,HUM 4R,A01,512625,Watkins; Eric,49,0,50,1
1713325003116,HUM 5,A01,512649,Zavodny; Tatiana Sophia,25,0,50,25
1713325003116,HUM 5,B01,512661,Zroka; Ryan Edward,48,0,50,2
1713325004140,INTL 190,A00,490577,Segui; Alan S,0,0,0,5
1713325005168,JAPN 20AR,A01,491267,Ross; Kayoko F,8,0,20,12
1713325006195,JAPN 180,A00,491285,Berman; Michael David,33,0,40,7
1713325007225,LATI 50,A01,502536,Kokinis; Troy Andreas,16,0,22,6
1713325007225,LATI 50,A02,502551,Kokinis; Troy Andreas,22,0,22,0
1713325007225,LATI 50,A03,502650,Kokinis; Troy Andreas,22,0,22,0
1713325007225,LATI 50,A04,502909,Kokinis; Troy Andreas,22,0,22,0
1713325008250,LATI 160,A01,502920,Kokinis; Troy Andreas,30,0,30,0
1713325009274,LIFR 1A,A00,490494,Van Moer; Vinciane G,17,0,20,3
1713325010300,LIFR 1AX,A00,490495,Van Moer; Vinciane G,17,0,20,3
1713325011328,LIFR 1B,A00,490496,Van Moer; Vinciane G,18,0,20,2
1713325012358,LIFR 1BX,A00,490497,Van Moer; Vinciane G,18,0,20,2
1713325013384,LIGN 8,A00,505198,McIntosh; Justin Daniel,135,0,150,15
1713325014409,LIGN 9GS,A00,491239,Lott; Margaret S.,18,0,20,2
1713325015436,LIGN 101,A01,505200,McIntosh; Justin Daniel,23,0,30,7
1713325016462,LIGN 120,A01,491244,Staff,23,0,30,7
1713325017489,LIGN 149GS,A00,491245,Lott; Margaret S.,18,0,20,2
1713325018517,LIGN 170,A00,491247,Staff,22,0,30,8
1713325019541,LISP 1D,A00,490498,Munoz Sanchez; Alicia,10,0,14,4
1713325019541,LISP 1D,B00,490499,Munoz Sanchez; Alicia,6,0,14,8
1713325019541,LISP 1D,C00,490500,Munoz Sanchez; Alicia,7,0,14,7
1713325019541,LISP 1D,D00,490501,Munoz Sanchez; Alicia,10,0,14,4
1713325020572,LISP 1DX,A00,490502,Munoz Sanchez; Alicia,15,0,28,13
1713325020572,LISP 1DX,B00,490503,Munoz Sanchez; Alicia,16,0,28,12
1713325022625,LTAM 110,A00,491847,Staff,23,0,25,2
1713325023649,LTCS 119,A00,491848,Staff,11,0,15,4
1713325024674,LTCS 130,A00,491849,Staff,24,0,25,1
1713325026723,LTEA 120C,A00,491852,Staff,32,0,40,8
1713325027749,LTEN 130GS,A00,491853,Lyon; Antony J.,24,0,28,4
1713325028776,LTEN 148,A00,491855,Staff,23,0,25,2
1713325029800,LTEN 159,A00,491856,Staff,21,0,25,4
1713325030827,LTEN 180,A00,491857,Staff,8,0,15,7
1713325032879,LTSP 123GS,A00,505928,Bessett; Ryan Matthew,24,0,28,4
1713325033908,LTSP 174GS,A00,506037,Bessett; Ryan Matthew,24,0,28,4
1713325035962,LTWR 102,A00,491861,Staff,9,0,15,6
1713325036990,LTWR 106,A00,491862,Staff,10,0,15,5
1713325038015,MAE 11,A00,490930,Bahadori; Mohammad Yousef,96,0,100,4
1713325039040,MAE 30A,A00,490931,Qi; Huihui,37,0,40,3
1713325040068,MAE 101A,A00,491036,Sadeghizadeh; Zahra,95,0,100,5
1713325041093,MAE 101C,A00,491037,Seshadri; Kalyanasundaram,68,0,100,32
1713325042119,MAE 113,A00,491040,Seshadri; Kalyanasundaram,66,0,80,14
1713325043144,MAE 131A,A00,491041,Ghazinejad; Maziar,37,0,40,3
1713325044170,MAE 142,A00,491053,Staff,39,0,40,1
1713325045193,MAE 143A,A00,491054,Staff,33,0,50,17
1713325046221,MAE 150,A00,491092,Truong; Phuong Thi Ngoc,23,0,35,12
1713325047247,MATH 3C,A01,494031,Pardo Guerra; Sebastian,30,0,30,0
1713325047247,MATH 3C,A02,494032,Pardo Guerra; Sebastian,29,0,30,1
1713325048274,MATH 10A,A01,494034,Staff,27,0,30,3
1713325048274,MATH 10A,A02,494035,Staff,28,0,30,2
1713325048274,MATH 10A,B01,494037,Staff,27,0,30,3
1713325048274,MATH 10A,B02,494038,Staff,29,0,30,1
1713325049306,MATH 10B,A01,494040,Habib; Yousaf,22,0,30,8
1713325049306,MATH 10B,A02,494041,Habib; Yousaf,28,0,30,2
1713325049306,MATH 10B,A03,494042,Habib; Yousaf,29,0,30,1
1713325049306,MATH 10B,A04,494043,Habib; Yousaf,30,0,30,0
1713325049306,MATH 10B,B01,494045,Habib; Yousaf,26,0,30,4
1713325049306,MATH 10B,B02,494046,Habib; Yousaf,30,0,30,0
1713325049306,MATH 10B,B03,494047,Habib; Yousaf,30,0,30,0
1713325049306,MATH 10B,B04,494048,Habib; Yousaf,30,0,30,0
1713325050331,MATH 18,A01,494050,Kemp; Todd Aahron,25,0,30,5
1713325050331,MATH 18,A02,494051,Kemp; Todd Aahron,29,0,30,1
1713325050331,MATH 18,B01,494054,Kemp; Todd Aahron,27,0,30,3
1713325050331,MATH 18,B02,494055,Kemp; Todd Aahron,29,0,30,1
1713325051356,MATH 20A,A01,494059,Suk; Andrew Hoon,30,0,30,0
1713325052386,MATH 20B,A01,494061,Briones; Jor-el Thomas Caparas,33,0,35,2
1713325052386,MATH 20B,B01,494063,Bach; Quang Tran,34,0,35,1
1713325053417,MATH 20C,A01,494065,Staff,28,0,30,2
1713325053417,MATH 20C,A02,494066,Staff,30,0,30,0
1713325053417,MATH 20C,A03,494067,Staff,30,0,30,0
1713325053417,MATH 20C,A04,494068,Staff,30,0,30,0
1713325053417,MATH 20C,B01,494070,Zhang; Ming,26,0,30,4
1713325053417,MATH 20C,B02,494071,Zhang; Ming,27,0,30,3
1713325053417,MATH 20C,B03,494072,Zhang; Ming,29,0,30,1
1713325053417,MATH 20C,B04,494073,Zhang; Ming,29,0,30,1
1713325054446,MATH 20D,A01,494075,Staff,22,0,30,8
1713325054446,MATH 20D,A02,494076,Staff,30,0,30,0
1713325055471,MATH 20E,A01,494079,Staff,24,0,30,6
1713325055471,MATH 20E,A02,494080,Staff,26,0,30,4
1713325055471,MATH 20E,B01,494082,Staff,25,0,30,5
1713325055471,MATH 20E,B02,494083,Staff,25,0,30,5
1713325056495,MATH 103A,A01,494085,Aliabadi Sr.; Mohsen,14,0,30,16
1713325056495,MATH 103A,A02,494086,Aliabadi Sr.; Mohsen,28,0,30,2
1713325056495,MATH 103A,B01,494088,Aliabadi Sr.; Mohsen,21,0,30,9
1713325056495,MATH 103A,B02,494089,Aliabadi Sr.; Mohsen,28,0,30,2
1713325057521,MATH 109,A01,494091,Staff,30,0,30,0
1713325057521,MATH 109,A02,494092,Staff,29,0,30,1
1713325057521,MATH 109,B01,494094,Staff,27,0,30,3
1713325057521,MATH 109,B02,494095,Staff,29,0,30,1
1713325058551,MATH 142A,A01,494097,Chow; Bennett,15,0,30,15
1713325058551,MATH 142A,A02,494098,Chow; Bennett,24,0,30,6
1713325058551,MATH 142A,B01,494100,Chow; Bennett,19,0,30,11
1713325058551,MATH 142A,B02,494101,Chow; Bennett,29,0,30,1
1713325060601,MATH 168A,A01,516677,Dumitriu; Ioana,15,0,35,20
1713325061628,MATH 170A,A01,516679,Dumitriu; Ioana,19,0,30,11
1713325061628,MATH 170A,A02,516680,Dumitriu; Ioana,28,0,30,2
1713325062657,MATH 193A,A01,494107,Staff,14,0,30,16
1713325062657,MATH 193A,A02,494108,Staff,21,0,30,9
1713325062657,MATH 193A,A03,494109,Staff,29,0,30,1
1713325062657,MATH 193A,A04,494110,Staff,22,0,30,8
1713325065736,MGT 16,A00,491930,McKay; Michael J,92,0,98,6
1713325066763,MGT 18,A00,491992,McKay; Michael J,96,0,98,2
1713325067790,MGT 71,A00,492003,Staff,66,0,98,32
1713325068818,MGT 103,A00,505209,Eberhard; Craig A,81,0,98,17
1713325069846,MGT 131A,A00,505210,Anderson; John Charles,90,0,98,8
1713325071897,MGT 153,A00,492077,Perols; Johan Lars,22,0,90,68
1713325074976,MGT 164,A00,492222,McKay; Mary A,91,0,98,7
1713325076004,MGT 172,A00,492245,Staff,59,0,60,1
1713325076004,MGT 172,B00,505526,Hedges; Kathleen,65,0,98,33
1713325077029,MGT 181,A00,505669,Dunn; Louis Jean,82,0,98,16
1713325078054,MMW 14,A01,494399,Staff,15,0,28,13
1713325078054,MMW 14,A02,494400,Staff,25,0,28,3
1713325078054,MMW 14,A03,494401,Staff,28,0,28,0
1713325078054,MMW 14,A04,494402,Staff,28,0,28,0
1713325078054,MMW 14,B01,494404,Carreras; Maria Victoria,10,0,28,18
1713325078054,MMW 14,B02,494405,Carreras; Maria Victoria,25,0,28,3
1713325078054,MMW 14,B03,494406,Carreras; Maria Victoria,27,0,28,1
1713325078054,MMW 14,B04,494407,Carreras; Maria Victoria,28,0,28,0
1713325079078,MMW 14GS,A00,506250,Chang; Edmond Yi-Teh,0,0,0,0
1713325080104,MMW 121R,A01,494415,Adamiak; Patrick John,12,0,28,16
1713325080104,MMW 121R,A02,494416,Adamiak; Patrick John,24,0,28,4
1713325081128,MUS 1A,A01,494113,Staff,12,0,25,13
1713325081128,MUS 1A,A02,494114,Staff,24,0,25,1
1713325082152,MUS 4,A01,494116,Staff,23,0,25,2
1713325082152,MUS 4,A02,494117,Staff,22,0,25,3
1713325083175,MUS 5R,A01,494236,Dubnov; Shlomo,8,0,25,17
1713325083175,MUS 5R,A02,494237,Dubnov; Shlomo,25,0,25,0
1713325084201,MUS 6,A01,494122,Staff,10,0,25,15
1713325084201,MUS 6,A02,494123,Staff,23,0,25,2
1713325085228,MUS 7,A01,494125,Staff,16,0,25,9
1713325085228,MUS 7,A02,494126,Staff,24,0,25,1
1713325086252,MUS 11,A01,494128,Staff,23,0,25,2
1713325086252,MUS 11,A02,494129,Staff,24,0,25,1
1713325087281,MUS 13,A01,494131,Staff,25,0,25,0
1713325087281,MUS 13,A02,494132,Staff,25,0,25,0
1713325088310,MUS 15,A01,494134,Staff,17,0,25,8
1713325088310,MUS 15,A02,494135,Staff,25,0,25,0
1713325088310,MUS 15,B01,494137,Staff,24,0,25,1
1713325089335,MUS 80,A00,494232,Staff,24,0,25,1
1713325089335,MUS 80,B00,494233,Staff,25,0,25,0
1713325089335,MUS 80,C00,494234,Staff,23,0,25,2
1713325090361,MUS 95C,A00,494141,Staff,70,0,75,5
1713325091384,MUS 114,A00,494142,Staff,40,0,50,10
1713325092409,NANO 15,A01,490636,Drews; Aaron,7,0,7,0
1713325093432,PHIL 1,A00,490578,Grush; Rick Scott,49,0,50,1
1713325094462,PHIL 10,A01,490580,Grush; Rick Scott,33,0,35,2
1713325094462,PHIL 10,A02,490586,Grush; Rick Scott,32,0,35,3
1713325095490,PHIL 27,A01,490591,Staff,22,0,25,3
1713325095490,PHIL 27,A02,490592,Staff,25,0,25,0
1713325095490,PHIL 27,A03,490593,Staff,25,0,25,0
1713325095490,PHIL 27,A04,490598,Staff,25,0,25,0
1713325096515,PHIL 32,A01,490611,Staff,20,0,20,0
1713325096515,PHIL 32,A02,490618,Staff,20,0,20,0
1713325097544,PHIL 90,A00,490624,Staff,40,0,40,0
1713325098570,PHIL 136,A00,490627,Cohen; Jonathan David,37,0,40,3
1713325099595,PHIL 155,A00,490634,Staff,63,0,70,7
1713325100620,PHYS 1A,A00,491610,Staff,245,0,250,5
1713325101647,PHYS 1AL,001,491616,Tsai; Philbert S,27,0,30,3
1713325101647,PHYS 1AL,002,491618,Tsai; Philbert S,30,0,30,0
1713325102672,PHYS 1B,A00,491623,Staff,236,0,250,14
1713325103697,PHYS 1BL,001,491626,Tsai; Philbert S,22,0,30,8
1713325103697,PHYS 1BL,002,491628,Tsai; Philbert S,26,0,30,4
1713325104725,PHYS 1C,A00,491632,Staff,216,0,245,29
1713325105752,PHYS 1CL,001,491635,Tsai; Philbert S,5,0,30,25
1713325105752,PHYS 1CL,002,491643,Tsai; Philbert S,22,0,30,8
1713325106833,PHYS 2AR,A01,491651,Meyertholen; Andrew D.,44,0,50,6
1713325107861,PHYS 2B,A01,491659,Staff,105,0,115,10
1713325108884,PHYS 2BL,A01,491685,Staff,21,0,24,3
1713325108884,PHYS 2BL,A02,491700,Staff,21,0,24,3
1713325109911,PHYS 2C,A01,505161,Staff,103,0,115,12
1713325110936,PHYS 4A,A01,491704,Grinstein; Benjamin,99,0,100,1
1713325111960,POLI 5D,A01,494144,Staff,3,0,5,2
1713325111960,POLI 5D,B01,626283,Dai; Yinlin,5,0,5,0
1713325112987,POLI 12,A00,494145,Staff,43,0,45,2
1713325114012,POLI 13R,A00,494146,Forman; Fonna,45,0,50,5
1713325115040,POLI 27,A01,494148,Staff,54,0,60,6
1713325116068,POLI 30,A00,494149,Staff,49,0,50,1
1713325117092,POLI 100DA,A00,494150,Staff,21,0,25,4
1713325119143,POLI 100I,A00,494152,Staff,27,0,30,3
1713325120172,POLI 104B,A00,494153,Smith; Glenn Chatmas,53,0,55,2
1713325121200,POLI 104F,A00,494154,Staff,28,0,30,2
1713325122224,POLI 104I,A00,494155,Smith; Glenn Chatmas,30,0,30,0
1713325123248,POLI 110C,A00,494156,Ingham; Sean,23,0,25,2
1713325124291,POLI 117R,A00,494157,Forman; Fonna,8,0,20,12
1713325125316,POLI 118,A00,494158,Ingham; Sean,21,0,25,4
1713325126341,POLI 120H,A00,494159,Fisk; David Lee,39,0,45,6
1713325127365,POLI 131CR,A00,494160,Hoston; Germaine,35,0,45,10
1713325128390,POLI 133J,A00,494161,Staff,33,0,35,2
1713325129416,POLI 135,A00,494162,Fisk; David Lee,33,0,35,2
1713325130444,POLI 140A,A00,494164,Staff,20,0,30,10
1713325131472,POLI 142I,A00,494165,Staff,30,0,30,0
1713325132498,POLI 144D,A00,494166,Staff,23,0,25,2
1713325133523,POLI 151,A00,494167,Staff,30,0,30,0
1713325134551,POLI 153,A00,494168,Staff,33,0,35,2
1713325135576,POLI 160AA,A00,494169,Staff,34,0,40,6
1713325136600,POLI 162,A00,494170,Mignozzetti; Umberto,19,0,25,6
1713325137628,POLI 171,A00,494171,Mignozzetti; Umberto,20,0,25,5
1713325138656,PSYC 1,A00,494172,Staff,96,0,100,4
1713325139685,PSYC 2,A00,494173,Moranton; Nirelia Melbina-,35,0,50,15
1713325140710,PSYC 3,A00,494174,Staff,29,0,30,1
1713325141736,PSYC 6,A00,494175,Staff,17,0,20,3
1713325142764,PSYC 60,A01,494177,Staff,38,0,45,7
1713325143788,PSYC 70,A01,505724,Geller; Emma Harlan,42,0,45,3
1713325144816,PSYC 101,A00,494180,Heyman; Gail D.,84,0,100,16
1713325145843,PSYC 105,A00,494181,Geller; Emma Harlan,52,0,90,38
1713325146868,PSYC 106,A00,494182,Dobkins; Karen R.,29,0,45,16
1713325147893,PSYC 108,A00,494183,Adrian; Julia Anna,90,0,100,10
1713325148923,PSYC 114,A01,494185,Winkielman; Piotr,0,2,30,30
1713325149950,PSYC 122,A00,494186,Moranton; Nirelia Melbina-,31,0,50,19
1713325150975,PSYC 124,A00,494187,Chapman; Eddie Nathaniel,71,0,80,9
1713325151999,PSYC 131,A00,494188,Anagnostaras; Stephan,43,0,80,37
1713325153027,PSYC 144,A00,494189,Staff,5,0,50,45
1713325154055,PSYC 154,A00,494190,Lacefield; Katharine I,111,0,180,69
1713325155079,PSYC 162,A00,494191,Wixted; John T,73,0,100,27
1713325156104,PSYC 172,A00,494192,Gorman; Michael R.,36,0,45,9
1713325157128,PSYC 178,A00,494193,Glaser; Dale,34,0,45,11
1713325158151,PSYC 193,A00,505725,Chapman; Eddie Nathaniel,20,0,20,0
1713325159178,RELI 145GS,A00,519817,Rahimi; Babak,18,0,20,2
1713325160207,SE 101A,A01,490862,Chadha; Mayank,23,0,25,2
1713325161232,SE 101C,A01,490924,Krysl; Petr,16,0,20,4
1713325162257,SE 110A,A01,490928,Staff,19,0,20,1
1713325163283,SE 130A,A00,490929,Morrison; Machel Leigh,56,0,70,14
1713325164325,SIO 1,A01,519325,Staff,39,0,40,1
1713325165351,SIO 30,A01,519327,Staff,38,0,40,2
1713325166376,SIO 40,A00,519328,Staff,39,0,40,1
1713325167401,SIO 46GS,A00,519819,Cook; Geoffrey W,17,0,25,8
1713325168426,SIO 109R,A00,494197,Forman; Fonna,0,3,20,20
1713325169448,SIO 121GS,A00,519827,Cook; Geoffrey W,17,0,25,8
1713325170474,SIO 132,A01,519330,Staff,38,0,40,2
1713325171501,SIO 133,A01,519397,Staff,37,0,40,3
1713325172529,SIO 139,A00,519396,Kacev; David,30,0,40,10
1713325173554,SOCI 1,A01,494199,Thorpe; Charles Robert,22,0,30,8
1713325173554,SOCI 1,A02,494200,Thorpe; Charles Robert,30,0,30,0
1713325173554,SOCI 1,A03,494201,Thorpe; Charles Robert,29,0,30,1
1713325173554,SOCI 1,A04,494202,Thorpe; Charles Robert,29,0,30,1
1713325173554,SOCI 1,A05,494203,Thorpe; Charles Robert,29,0,30,1
1713325173554,SOCI 1,A06,494204,Thorpe; Charles Robert,30,0,30,0
1713325173554,SOCI 1,A07,494205,Thorpe; Charles Robert,28,0,30,2
1713325174579,SOCI 60,A01,494207,Staff,34,0,40,6
1713325174579,SOCI 60,A02,494208,Staff,39,0,40,1
1713325175606,SOCI 100,A01,494210,Payne; Christine Anna,25,0,30,5
1713325175606,SOCI 100,A02,494211,Payne; Christine Anna,26,0,30,4
1713325176634,SOCI 109M,A00,494212,Staff,20,0,20,0
1713325177660,SOCI 110,A00,494213,Staff,34,0,40,6
1713325179711,SOCI 118E,A00,494215,Ng; Kwai,37,0,40,3
1713325180739,SOCI 125,A00,494216,Calderon-Zaks; Michael Aar,40,0,45,5
1713325181764,SOCI 126,A01,494218,Jones; Makeba,3,0,5,2
1713325182792,SOCI 131,A00,494219,Thorpe; Charles Robert,26,0,30,4
1713325184846,SOCI 135,A00,494221,Payne; Christine Anna,28,0,50,22
1713325185875,SOCI 136E,A00,626690,Ruiz; Jonathan Joseph,24,0,25,1
1713325186902,SOCI 138GS,A00,494222,Navon; Daniel,24,0,28,4
1713325188951,SOCI 145,A00,494224,Staff,40,0,45,5
1713325189975,SOCI 153,A00,494225,Staff,28,0,30,2
1713325191003,SOCI 160E,A00,494226,Ng; Kwai,29,0,40,11
1713325192030,SOCI 180,A00,494227,Staff,29,0,30,1
1713325193056,SOCI 189GS,A00,494228,Ribas Norris; Janet Vanesa,11,0,11,0
1713325194078,SOCI 190GS,A00,553232,Ribas Norris; Janet Vanesa,11,0,11,0
1713325195108,SOMI 220,A00,627178,Schneid; Stephen David,30,0,30,0
1713325196131,SYN 2,001,490768,Staff,14,0,15,1
1713325196131,SYN 2,002,490769,Staff,15,0,15,0
1713325196131,SYN 2,004,490775,Staff,0,0,0,0
1713325196131,SYN 2,003,490774,Staff,0,0,0,0
1713325196131,SYN 2,005,490776,Staff,0,0,0,0
1713325197156,SYN 2R,001,490779,Staff,11,0,15,4
1713325197156,SYN 2R,002,514635,Staff,14,0,15,1
1713325198185,SYN 100,A01,490783,Staff,12,0,20,8
1713325198185,SYN 100,B01,490787,Staff,9,0,20,11
1713325198185,SYN 100,C01,490789,Staff,11,0,20,9
1713325199210,SYN 150,A00,490817,Staff,14,0,15,1
1713325199210,SYN 150,B00,514610,Staff,15,0,15,0
1713325200234,TDAC 1,A00,492753,Walsh; Kim C.,19,0,20,1
1713325200234,TDAC 1,B00,492754,Harting; Carla Kelso,19,0,20,1
1713325200234,TDAC 1,C00,513995,Salovey; Todd,15,0,20,5
1713325201261,TDAC 101,A00,492766,Harting; Carla Kelso,17,0,20,3
1713325202290,TDAC 102,A00,492768,Basso; Beatrice,19,0,20,1
1713325203316,TDDE 111,A00,492769,Staff,25,0,25,0
1713325204352,TDDE 131,A00,492770,Staff,15,0,15,0
1713325204352,TDDE 131,B00,492771,Staff,15,0,15,0
1713325205381,TDDE 131GS,A00,523716,Guirguis; Mark C,23,0,28,5
1713325206405,TDGE 1,A01,492756,Salovey; Todd,57,0,60,3
1713325207434,TDGE 5,A01,492758,Staff,23,0,25,2
1713325208462,TDGE 10,A00,492759,Fulton; Julia,203,0,220,17
1713325209490,TDGE 11,A00,492760,Castro; Robert Jess,198,0,200,2
1713325211599,TDGE 124,A00,492772,Fulton; Julia,186,0,220,34
1713325212624,TDGE 125,A00,492773,Meyer; Ursula,38,0,50,12
1713325212624,TDGE 125,B00,492774,Staff,49,0,50,1
1713325212624,TDGE 125,C00,523565,Staff,48,0,50,2
1713325213649,TDGE 125GS,A00,523580,Guirguis; Mark C,23,0,28,5
1713325214674,TDGE 127,A00,492775,Havis; Allan,35,0,50,15
1713325215701,TDHT 101,A00,492776,Staff,34,0,35,1
1713325216726,TDMV 1,A00,492762,Caligagan; Maria T.,30,0,30,0
1713325216726,TDMV 1,B00,492763,Arcidiacono; Kristin,26,0,30,4
1713325217751,TDMV 2,A00,492764,Weinberg; Sadie,28,0,30,2
1713325218775,TDMV 3,A00,492765,Mack; Kara Shanai',37,0,40,3
1713325219803,TDMV 138,A00,492777,Mack; Kara Shanai',34,0,40,6
1713325220830,TDMV 140,A00,492778,Lima; Paulo Henrique,40,0,40,0
1713325221855,TDMV 142,A00,492779,Caligagan; Maria T.,33,0,40,7
1713325221855,TDMV 142,B00,492780,Caligagan; Tony,37,0,40,3
1713325222883,TDMV 143,A00,492781,Fyall; Daunte Edward,39,0,40,1
1713325223911,USP 1,A01,492401,Kwak; Nancy,27,0,35,8
1713325224939,USP 2,A01,492453,Hinds; Juli Beth,35,0,35,0
1713325225964,USP 3,A01,492516,Staff,28,0,35,7
1713325226990,USP 4,A00,492522,McTague; Sarah,16,0,25,9
1713325228016,USP 100,A00,492523,Staff,32,0,35,3
1713325229041,USP 101,A00,492524,Staff,13,0,15,2
1713325230067,USP 105,A00,492525,Staff,21,0,25,4
1713325231097,USP 151,A00,492526,Shenkman; Michael Thomas,32,0,35,3
1713325232120,USP 170,A00,492545,Hinds; Juli Beth,33,0,35,2
1713325233145,USP 171GS,A00,492608,Bussell; Mirle Rabinowitz,24,0,28,4
1713325234171,USP 183GS,A00,492613,Peerson; Susan,24,0,28,4
1713325235194,VIS 30,A01,490693,Yoldas; Pinar,19,0,22,3
1713325235194,VIS 30,A02,490694,Yoldas; Pinar,18,0,22,4
1713325236223,VIS 83,A00,490695,Kester; Grant,63,0,75,12
1713325237249,VIS 105D,A00,490696,Staff,21,0,25,4
1713325238274,VIS 124CN,A00,490699,Rose; Jordan M,66,0,75,9
1713325239301,VIS 125GS,A00,511221,Williams; Alena J,21,0,22,1
1713325240326,VIS 128D,A00,490700,Staff,73,0,75,2
1713325241351,VIS 151,A01,490717,Staff,33,0,34,1
1713325241351,VIS 151,A02,490766,Staff,33,0,34,1
1713325242378,VIS 154GS,A00,511972,Williams; Alena J,21,0,22,1
1713325243402,VIS 160A,A00,490767,Stone; Patricia,7,0,10,3
1713325244430,WCWP 10A,A00,490638,Staff,14,0,15,1
1713325244430,WCWP 10A,B00,490640,Staff,15,0,15,0
1713325245458,WCWP 10B,A00,490641,Staff,0,0,0,0
1713325245458,WCWP 10B,B00,490642,Staff,14,0,15,1
1713325245458,WCWP 10B,C00,490644,Staff,13,0,15,2
1713325245458,WCWP 10B,D00,490647,Staff,0,0,0,0
1713325246486,WCWP 100,A00,490655,Staff,0,0,0,0
1713325246486,WCWP 100,B00,490687,Staff,10,0,15,5
1713325248546,ANAR 153,A00,487222,Braswell; Geoffrey E.,54,0,60,6
1713325249572,ANBI 134,A00,487223,Staff,6,0,20,14
1713325250599,ANBI 143GS,A00,487224,Noel; Geoffroy Pierre Jean,18,0,24,6
1713325251626,ANBI 144GS,A00,519548,Noel; Geoffroy Pierre Jean,18,0,24,6
1713325252653,ANSC 101,A00,487225,Staff,18,0,20,2
1713325253678,ANSC 125,A00,487227,Brenner; Suzanne A,39,0,40,1
1713325255728,ANSC 146,A00,487229,Staff,35,0,40,5
1713325256753,ANSC 148,A00,487230,Olivas Hernandez; Olga Lid,39,0,40,1
1713325257777,ANSC 150,A00,504165,Sloane; Julia Kathryn,18,0,20,2
1713325258802,ANSC 180,A00,487232,Staff,14,0,15,1
1713325259830,ANSC 188,A00,627155,Staff,39,0,40,1
1713325260855,ANTH 5,A00,519529,Semendeferi; Ekaterini,15,0,15,0
1713325261882,ANTH 10,A00,487219,Staff,58,0,60,2
1713325262911,ANTH 23,A01,487221,Staff,17,0,20,3
1713325263935,ANTH 102,A00,487233,Wilder; Linnea Lorene,51,0,60,9
1713325264963,ANTH 103,A00,487234,Varma; Saiba,55,0,60,5
1713325265988,ANTH 105,A00,487235,Stewart; Alexander B,55,0,60,5
1713325267013,BENG 100,A01,516685,Taylor Amos; Alyssa C,27,0,30,3
1713325268037,BIBC 102,A01,491316,Flagg; Matthew Paul,17,0,88,71
1713325268037,BIBC 102,A02,491366,Flagg; Matthew Paul,79,0,88,9
1713325269063,BIBC 103,A01,491486,Boumechache; Miyyada,16,0,24,8
1713325269063,BIBC 103,A02,491487,Boumechache; Miyyada,24,0,24,0
1713325270090,BICD 100,A01,516882,Staff,73,0,75,2
1713325270090,BICD 100,A02,516890,Staff,69,0,75,6
1713325271120,BICD 102GS,A00,491488,Lo; Stanley M.,26,0,28,2
1713325272148,BIEB 136GS,A00,516940,Holway; David A. & Shurin; Jonathan,19,0,24,5
1713325273176,BIEB 137GS,A01,517034,Holway; David A. & Shurin; Jonathan,19,0,24,5
1713325274202,BIEB 138GS,A01,491492,Pirino; Giorgia,21,0,28,7
1713325275230,BILD 1,A01,491296,Staff,60,0,63,3
1713325275230,BILD 1,A02,491297,Staff,63,0,63,0
1713325276254,BILD 4,A01,517099,Gonzalez Gamboa; Ivonne,22,0,24,2
1713325276254,BILD 4,A02,517100,Gonzalez Gamboa; Ivonne,24,0,24,0
1713325277281,BILD 60GS,A00,491309,Lo; Stanley M.,26,0,28,2
1713325278313,BIMM 100,A01,517136,Staff,85,0,100,15
1713325279342,BIMM 110,A01,517182,Staff,58,0,100,42
1713325280371,BIMM 120,A01,517228,Pickett; Brooke Elizabeth,29,0,63,34
1713325280371,BIMM 120,A02,517240,Pickett; Brooke Elizabeth,44,0,63,19
1713325281399,BIMM 132GS,A01,491498,Pirino; Giorgia,21,0,28,7
1713325282427,BIMM 143,A01,491589,Bozinovic; Goran,13,0,40,27
1713325283455,BIPN 100,A01,491594,Armour; Jon Christopher,89,0,100,11
1713325284479,BIPN 140,A01,491602,Marino; Marc J,26,0,50,24
1713325286533,CAT 125,A00,515973,Staff,18,0,20,2
1713325287561,CAT 125GS,A00,515974,Rahimi; Babak,17,0,20,3
1713325288586,CAT 125R,A00,515980,Staff,12,0,20,8
1713325288586,CAT 125R,B00,515981,Tosun; Adriana,19,0,20,1
1713325288586,CAT 125R,C00,515987,Hyland; Tina Mae,0,2,20,20
1713325288586,CAT 125R,D00,515988,Bronstein; Phoebe Malan,17,0,20,3
1713325289612,CENG 15,A01,488699,Drews; Aaron,25,0,25,0
1713325290640,CENG 100,A00,505196,Opatkiewicz; Justin Paul,25,0,25,0
1713325291668,CGS 2A,A01,489598,Staff,33,0,35,2
1713325292695,CGS 112,A00,489599,Staff,15,0,15,0
1713325293723,CGS 119,A00,489603,Staff,10,0,10,0
1713325294748,CGS 120,A00,489604,Staff,14,0,15,1
1713325295773,CGS 150,A00,489607,Staff,15,0,15,0
1713325296799,CHEM 6A,A01,488715,Staff,98,0,100,2
1713325297824,CHEM 6B,A01,488719,Piercy; Marc Anthony,99,0,100,1
1713325298849,CHEM 6C,A01,488723,Albizati; Kim F.,93,0,100,7
1713325299877,CHEM 7L,A01,488728,Schurmeier; Kimberly,18,0,24,6
1713325299877,CHEM 7L,A02,488730,Schurmeier; Kimberly,23,0,24,1
1713325299877,CHEM 7L,A03,488734,Schurmeier; Kimberly,20,0,24,4
1713325299877,CHEM 7L,A04,488763,Schurmeier; Kimberly,23,0,24,1
1713325299877,CHEM 7L,B01,488798,Schurmeier; Kimberly,17,0,24,7
1713325299877,CHEM 7L,B02,488801,Schurmeier; Kimberly,23,0,24,1
1713325299877,CHEM 7L,B03,488808,Schurmeier; Kimberly,23,0,24,1
1713325299877,CHEM 7L,B04,488811,Schurmeier; Kimberly,24,0,24,0
1713325300902,CHEM 11,A01,488897,Stallings; Dontarie M,95,0,100,5
1713325301931,CHEM 40A,A01,488913,Albizati; Kim F.,84,0,100,16
1713325302956,CHEM 40B,A01,488920,Weizman; Haim,43,0,50,7
1713325302956,CHEM 40B,A02,488938,Weizman; Haim,45,0,50,5
1713325303984,CHEM 41A,A01,489029,Klosterman; Jeremy K,57,0,60,3
1713325305013,CHEM 41C,A01,500436,Tor; Yitzhak,55,0,60,5
1713325306044,CHEM 43A,A01,500426,Weizman; Haim,0,0,24,24
1713325306044,CHEM 43A,A02,500430,Weizman; Haim,9,0,24,15
1713325306044,CHEM 43A,B01,514041,Klosterman; Jeremy K,16,0,24,8
1713325306044,CHEM 43A,B02,514047,Klosterman; Jeremy K,23,0,24,1
1713325307074,CHEM 108,A01,489140,Jennings; Patricia A.,11,0,24,13
1713325307074,CHEM 108,A02,489142,Jennings; Patricia A.,14,0,24,10
1713325308100,CHEM 114A,A01,489147,Stallings; Dontarie M,72,0,100,28
1713325309124,CHIN 169A,A00,489171,Wang; Xiao,19,0,20,1
1713325311174,COGS 3,A01,518827,Boyle; Mary E. T.,26,0,40,14
1713325312199,COGS 11,A01,489175,Staff,27,0,30,3
1713325313227,COGS 14A,A01,518829,Staff,51,0,60,9
1713325314309,COGS 14B,A01,489177,Hoffman; Drew Ellen,64,0,75,11
1713325315336,COGS 100,A01,489181,Allen; Michael Gordon,63,0,75,12
1713325316364,COGS 101A,A01,489183,Staff,46,0,60,14
1713325317389,COGS 101B,A01,489185,Allen; Michael Gordon,8,0,30,22
1713325318414,COGS 101C,A01,526786,Staff,23,0,30,7
1713325320466,COGS 107A,A01,489189,Boyle; Mary E. T.,18,0,35,17
1713325321491,COGS 107B,A01,627144,Mooshagian; Eric Frederick,60,0,60,0
1713325322518,COGS 118A,A01,489191,Staff,0,42,40,40
1713325324572,COGS 171GS,A01,489194,Pineda; Jaime A,21,0,28,7
1713325325598,COGS 172,A01,489196,Staff,3,0,30,27
1713325326629,COGS 174GS,A01,489264,Pineda; Jaime A,21,0,28,7
1713325327658,COGS 180,A01,627150,Staff,28,0,30,2
1713325328682,COGS 186,A01,489274,Staff,0,1,30,30
1713325329706,COMM 10,A01,489276,Staff,23,0,25,2
1713325329706,COMM 10,A02,489303,Staff,23,0,25,2
1713325330733,COMM 100A,A01,489312,Staff,14,0,25,11
1713325330733,COMM 100A,A02,489313,Staff,24,0,25,1
1713325331760,COMM 106T,A00,512540,Staff,33,0,35,2
1713325332788,COMM 107,A00,489347,Staff,27,0,35,8
1713325333813,COMM 109P,A00,489358,Staff,31,0,35,4
1713325334837,COMM 132,A00,489361,McKenna; Denise,27,0,30,3
1713325335862,COMM 146,A00,489362,Halm; Gavin Patrick,26,0,30,4
1713325336886,COMM 190,A00,489363,Abuelhiga; Soraya Jill,17,0,23,6
1713325337911,CSE 8A,A50,489366,Staff,21,0,25,4
1713325337911,CSE 8A,A51,489367,Staff,24,0,25,1
1713325338936,CSE 11,A01,489398,Cao; Yingjun,75,0,100,25
1713325339965,CSE 12,A01,489487,Staff,43,0,50,7
1713325340989,CSE 20,A01,489497,Staff,48,0,50,2
1713325342013,CSE 21,A01,489517,Braun; Oliver,42,0,50,8
1713325343042,CSE 101,A01,489524,Braun; Oliver,0,28,50,50
1713325344070,CSE 105,A01,512594,Jones; Miles E,73,0,100,27
1713325344070,CSE 105,B01,512598,Jones; Miles E,53,0,100,47
1713325345097,CSE 140,A01,489538,Staff,42,0,50,8
1713325346122,CSE 141,A01,489550,Eldon; John,69,0,100,31
1713325347147,CSE 141L,A01,489571,Eldon; John,67,0,100,33
1713325348175,CSE 151A,A01,489583,Solares; Edwin A,142,0,200,58
1713325349200,CSE 175,A01,510886,Kumar; Rakesh,30,0,30,0
1713325350225,CSE 190,A00,516828,Dubnov; Shlomo,38,0,49,11
1713325351249,DOC 100D,A00,489667,Pass; Natalye Joann,19,0,25,6
1713325352274,DSC 10,A01,624268,Staff,72,0,75,3
1713325353299,DSC 20,A01,624476,Staff,50,0,50,0
1713325354324,DSC 40A,A01,624608,Staff,39,0,40,1
1713325355350,DSGN 1,A01,489179,Rill; Bryan,34,0,50,16
1713325356379,ECE 17,A01,490489,Sahay; Rajeev,18,0,30,12
1713325357407,ECE 65,A50,490492,Staff,12,0,20,8
1713325357407,ECE 65,A51,490493,Staff,19,0,20,1
1713325358436,ECON 1,A01,489715,Famulari; Melissa,68,0,70,2
1713325359460,ECON 2,A01,489717,Levkoff; Steven B.,68,0,70,2
1713325360488,ECON 3,A01,489948,Staff,70,0,70,0
1713325362541,ECON 5,A01,490103,Staff,27,0,30,3
1713325362541,ECON 5,B01,626281,Dai; Yinlin,45,0,45,0
1713325363566,ECON 100A,A01,490127,Famulari; Melissa,66,0,70,4
1713325364590,ECON 100B,A01,490129,Staff,64,0,70,6
1713325365617,ECON 109,A01,490187,Shishkin; Denis,27,0,35,8
1713325366642,ECON 110A,A01,490190,Levkoff; Steven B.,60,0,70,10
1713325367667,ECON 120A,A01,490245,Dai; Yinlin,62,0,70,8
1713325368696,ECON 120B,A01,490247,Nieto-Barthaburu; Augusto,45,0,70,25
1713325369723,ECON 120C,A01,490253,Sun; Yixiao,30,0,35,5
1713325369723,ECON 120C,B01,490255,Sun; Yixiao,34,0,35,1
1713325370748,ECON 129,A00,490256,Eckert; Fabian Paul,24,0,35,11
1713325371773,ECON 131,A00,490257,Nieto-Barthaburu; Augusto,0,6,35,35
1713325372798,ECON 138,A00,490258,Bharadwaj; Prashant,14,0,35,21
1713325372798,ECON 138,B00,490259,Bharadwaj; Prashant,15,0,35,20
1713325373824,ECON 159,A00,490260,Hendrickson; Gerald M.,0,10,0,0
1713325374849,ECON 178,A01,553995,Zhu; Ying,24,0,35,11
1713325375875,EDS 40,A01,512576,Black; Alison Michelle,20,0,20,0
1713325376905,EDS 107,A01,515848,Staff,30,0,30,0
1713325377932,EDS 110R,A01,490262,Staff,26,0,30,4
1713325378957,EDS 112,A01,490264,Chapman; Thandeka K,40,0,50,10
1713325379981,EDS 113,A00,490266,Staff,26,0,30,4
1713325381005,EDS 118,A00,490267,Warstadt; Melissa Fawn,21,0,30,9
1713325382029,EDS 124BR,A00,490268,Eguchi; Emi,4,0,25,21
1713325382029,EDS 124BR,B00,490269,Eguchi; Emi,24,0,25,1
1713325383058,EDS 126,A01,490271,Jones; Makeba,43,0,50,7
1713325384089,EDS 135,A01,490316,Staff,19,0,20,1
1713325385116,ENVR 142GS,A00,519514,Chang; Edmond Yi-Teh,27,0,28,1
1713325386142,ETHN 103,A00,490504,Staff,26,0,36,10
1713325387171,ETHN 103A,A00,490505,Man; Simeon S,5,0,9,4
1713325388199,ETHN 109,A00,490506,Staff,28,0,30,2
1713325389222,ETHN 118,A00,490507,Staff,35,0,36,1
1713325390247,ETHN 119,A00,490508,Staff,33,0,36,3
1713325391276,ETHN 121R,A00,490518,Choi; Esther Min,24,0,36,12
1713325392302,ETHN 127,A00,490528,Staff,14,0,15,1
1713325393332,ETHN 139,A00,490573,Staff,10,0,10,0
1713325394360,ETHN 150,A00,490575,Staff,15,0,15,0
1713325395388,GLBH 20,A00,491705,Elwardani; Nile Regina,38,0,40,2
1713325396413,GLBH 101,A00,491706,Staff,20,0,20,0
1713325397440,GLBH 111,A01,491708,Burgos; Jose L.,15,0,15,0
1713325398468,GLBH 146,A00,491709,Staff,10,0,20,10
1713325399493,GLBH 148,A00,491710,Olivas Hernandez; Olga Lid,11,0,20,9
1713325400519,GLBH 150,A00,491711,Sloane; Julia Kathryn,19,0,20,1
1713325401544,HIEA 131,A00,491760,Staff,28,0,32,4
1713325402571,HIEA 153,A00,491762,Staff,28,0,30,2
1713325403599,HIEU 124,A00,491811,Staff,26,0,32,6
1713325404625,HIEU 124GS,A00,491812,Markman; Kristina,27,0,28,1
1713325405652,HIEU 147,A00,491813,Staff,30,0,32,2
1713325406679,HIEU 149GS,A00,491816,Caldwell; Michael Alan,28,0,28,0
1713325407710,HILD 2C,A01,491713,Hendrickson; Gerald M.,27,0,30,3
1713325408734,HILD 7B,A01,491715,Kwak; Nancy,0,0,30,30
1713325409763,HILD 10,A01,491717,Staff,11,0,20,9
1713325410787,HILD 30GS,A00,491719,Edington; Claire Ellen,24,0,28,4
1713325411812,HINE 109,A00,491818,Shafir; Nir,27,0,32,5
1713325412840,HINE 128,A00,491821,Shafir; Nir,31,0,32,1
1713325413868,HISC 117,A00,491830,Staff,27,0,32,5
1713325414895,HIUS 103,A00,491834,Man; Simeon S,14,0,23,9
1713325415922,HIUS 108B,A00,491835,Staff,28,0,30,2
1713325416950,HIUS 141,A00,491836,Hendrickson; Gerald M.,28,0,32,4
1713325418032,HIUS 149,A00,491839,Staff,24,0,32,8
1713325419064,HUM 3,A01,512617,Crum; Matthew Stephen,43,0,50,7
1713325419064,HUM 3,A02,512618,Crum; Matthew Stephen,48,0,50,2
1713325420089,HUM 3GS,A00,512663,Markman; Kristina,0,0,0,1
1713325420089,HUM 3GS,B00,512664,Staff,0,0,0,0
1713325421118,HUM 4,A01,512620,West; Geoffrey Scott,28,0,50,22
1713325422146,HUM 4GS,A00,512666,Lyon; Antony J.,0,0,0,4
1713325423171,HUM 4R,A01,512625,Watkins; Eric,49,0,50,1
1713325424198,HUM 5,A01,512649,Zavodny; Tatiana Sophia,25,0,50,25
1713325424198,HUM 5,B01,512661,Zroka; Ryan Edward,48,0,50,2
1713325425220,INTL 190,A00,490577,Segui; Alan S,0,0,0,5
1713325426245,JAPN 20AR,A01,491267,Ross; Kayoko F,8,0,20,12
1713325427271,JAPN 180,A00,491285,Berman; Michael David,33,0,40,7
1713325428295,LATI 50,A01,502536,Kokinis; Troy Andreas,16,0,22,6
1713325428295,LATI 50,A02,502551,Kokinis; Troy Andreas,22,0,22,0
1713325428295,LATI 50,A03,502650,Kokinis; Troy Andreas,22,0,22,0
1713325428295,LATI 50,A04,502909,Kokinis; Troy Andreas,22,0,22,0
1713325429320,LATI 160,A01,502920,Kokinis; Troy Andreas,30,0,30,0
1713325430346,LIFR 1A,A00,490494,Van Moer; Vinciane G,17,0,20,3
1713325431372,LIFR 1AX,A00,490495,Van Moer; Vinciane G,17,0,20,3
1713325432396,LIFR 1B,A00,490496,Van Moer; Vinciane G,18,0,20,2
1713325433424,LIFR 1BX,A00,490497,Van Moer; Vinciane G,18,0,20,2
1713325434453,LIGN 8,A00,505198,McIntosh; Justin Daniel,134,0,150,16
1713325435479,LIGN 9GS,A00,491239,Lott; Margaret S.,18,0,20,2
1713325436504,LIGN 101,A01,505200,McIntosh; Justin Daniel,23,0,30,7
1713325437529,LIGN 120,A01,491244,Staff,23,0,30,7
1713325438556,LIGN 149GS,A00,491245,Lott; Margaret S.,18,0,20,2
1713325439585,LIGN 170,A00,491247,Staff,22,0,30,8
1713325440612,LISP 1D,A00,490498,Munoz Sanchez; Alicia,10,0,14,4
1713325440612,LISP 1D,B00,490499,Munoz Sanchez; Alicia,6,0,14,8
1713325440612,LISP 1D,C00,490500,Munoz Sanchez; Alicia,7,0,14,7
1713325440612,LISP 1D,D00,490501,Munoz Sanchez; Alicia,10,0,14,4
1713325441635,LISP 1DX,A00,490502,Munoz Sanchez; Alicia,15,0,28,13
1713325441635,LISP 1DX,B00,490503,Munoz Sanchez; Alicia,16,0,28,12
1713325443692,LTAM 110,A00,491847,Staff,23,0,25,2
1713325444718,LTCS 119,A00,491848,Staff,11,0,15,4
1713325445744,LTCS 130,A00,491849,Staff,24,0,25,1
1713325447799,LTEA 120C,A00,491852,Staff,31,0,40,9
1713325448822,LTEN 130GS,A00,491853,Lyon; Antony J.,24,0,28,4
1713325449848,LTEN 148,A00,491855,Staff,23,0,25,2
1713325450876,LTEN 159,A00,491856,Staff,21,0,25,4
1713325451902,LTEN 180,A00,491857,Staff,8,0,15,7
1713325453953,LTSP 123GS,A00,505928,Bessett; Ryan Matthew,24,0,28,4
1713325454981,LTSP 174GS,A00,506037,Bessett; Ryan Matthew,24,0,28,4
1713325457030,LTWR 102,A00,491861,Staff,9,0,15,6
1713325458055,LTWR 106,A00,491862,Staff,10,0,15,5
1713325459080,MAE 11,A00,490930,Bahadori; Mohammad Yousef,96,0,100,4
1713325460103,MAE 30A,A00,490931,Qi; Huihui,37,0,40,3
1713325461132,MAE 101A,A00,491036,Sadeghizadeh; Zahra,93,0,100,7
1713325462161,MAE 101C,A00,491037,Seshadri; Kalyanasundaram,67,0,100,33
1713325463189,MAE 113,A00,491040,Seshadri; Kalyanasundaram,66,0,80,14
1713325464217,MAE 131A,A00,491041,Ghazinejad; Maziar,37,0,40,3
1713325465240,MAE 142,A00,491053,Staff,39,0,40,1
1713325466267,MAE 143A,A00,491054,Staff,33,0,50,17
1713325467292,MAE 150,A00,491092,Truong; Phuong Thi Ngoc,23,0,35,12
1713325468318,MATH 3C,A01,494031,Pardo Guerra; Sebastian,30,0,30,0
1713325468318,MATH 3C,A02,494032,Pardo Guerra; Sebastian,29,0,30,1
1713325469343,MATH 10A,A01,494034,Staff,27,0,30,3
1713325469343,MATH 10A,A02,494035,Staff,28,0,30,2
1713325469343,MATH 10A,B01,494037,Staff,27,0,30,3
1713325469343,MATH 10A,B02,494038,Staff,29,0,30,1
1713325470366,MATH 10B,A01,494040,Habib; Yousaf,22,0,30,8
1713325470366,MATH 10B,A02,494041,Habib; Yousaf,28,0,30,2
1713325470366,MATH 10B,A03,494042,Habib; Yousaf,29,0,30,1
1713325470366,MATH 10B,A04,494043,Habib; Yousaf,30,0,30,0
1713325470366,MATH 10B,B01,494045,Habib; Yousaf,26,0,30,4
1713325470366,MATH 10B,B02,494046,Habib; Yousaf,30,0,30,0
1713325470366,MATH 10B,B03,494047,Habib; Yousaf,30,0,30,0
1713325470366,MATH 10B,B04,494048,Habib; Yousaf,30,0,30,0
1713325471392,MATH 18,A01,494050,Kemp; Todd Aahron,25,0,30,5
1713325471392,MATH 18,A02,494051,Kemp; Todd Aahron,29,0,30,1
1713325471392,MATH 18,B01,494054,Kemp; Todd Aahron,27,0,30,3
1713325471392,MATH 18,B02,494055,Kemp; Todd Aahron,29,0,30,1
1713325472420,MATH 20A,A01,494059,Suk; Andrew Hoon,30,0,30,0
1713325473447,MATH 20B,A01,494061,Briones; Jor-el Thomas Caparas,33,0,35,2
1713325473447,MATH 20B,B01,494063,Bach; Quang Tran,34,0,35,1
1713325474479,MATH 20C,A01,494065,Staff,28,0,30,2
1713325474479,MATH 20C,A02,494066,Staff,30,0,30,0
1713325474479,MATH 20C,A03,494067,Staff,30,0,30,0
1713325474479,MATH 20C,A04,494068,Staff,30,0,30,0
1713325474479,MATH 20C,B01,494070,Zhang; Ming,26,0,30,4
1713325474479,MATH 20C,B02,494071,Zhang; Ming,27,0,30,3
1713325474479,MATH 20C,B03,494072,Zhang; Ming,29,0,30,1
1713325474479,MATH 20C,B04,494073,Zhang; Ming,29,0,30,1
1713325475505,MATH 20D,A01,494075,Staff,22,0,30,8
1713325475505,MATH 20D,A02,494076,Staff,30,0,30,0
1713325476535,MATH 20E,A01,494079,Staff,24,0,30,6
1713325476535,MATH 20E,A02,494080,Staff,26,0,30,4
1713325476535,MATH 20E,B01,494082,Staff,25,0,30,5
1713325476535,MATH 20E,B02,494083,Staff,25,0,30,5
1713325477562,MATH 103A,A01,494085,Aliabadi Sr.; Mohsen,14,0,30,16
1713325477562,MATH 103A,A02,494086,Aliabadi Sr.; Mohsen,28,0,30,2
1713325477562,MATH 103A,B01,494088,Aliabadi Sr.; Mohsen,21,0,30,9
1713325477562,MATH 103A,B02,494089,Aliabadi Sr.; Mohsen,28,0,30,2
1713325478588,MATH 109,A01,494091,Staff,30,0,30,0
1713325478588,MATH 109,A02,494092,Staff,29,0,30,1
1713325478588,MATH 109,B01,494094,Staff,27,0,30,3
1713325478588,MATH 109,B02,494095,Staff,29,0,30,1
1713325479615,MATH 142A,A01,494097,Chow; Bennett,15,0,30,15
1713325479615,MATH 142A,A02,494098,Chow; Bennett,23,0,30,7
1713325479615,MATH 142A,B01,494100,Chow; Bennett,19,0,30,11
1713325479615,MATH 142A,B02,494101,Chow; Bennett,29,0,30,1
1713325481670,MATH 168A,A01,516677,Dumitriu; Ioana,15,0,35,20
1713325482699,MATH 170A,A01,516679,Dumitriu; Ioana,18,0,30,12
1713325482699,MATH 170A,A02,516680,Dumitriu; Ioana,28,0,30,2
1713325483727,MATH 193A,A01,494107,Staff,14,0,30,16
1713325483727,MATH 193A,A02,494108,Staff,21,0,30,9
1713325483727,MATH 193A,A03,494109,Staff,29,0,30,1
1713325483727,MATH 193A,A04,494110,Staff,22,0,30,8
1713325486805,MGT 16,A00,491930,McKay; Michael J,92,0,98,6
1713325487834,MGT 18,A00,491992,McKay; Michael J,96,0,98,2
1713325488858,MGT 71,A00,492003,Staff,66,0,98,32
1713325489883,MGT 103,A00,505209,Eberhard; Craig A,81,0,98,17
1713325490908,MGT 131A,A00,505210,Anderson; John Charles,90,0,98,8
1713325492961,MGT 153,A00,492077,Perols; Johan Lars,22,0,90,68
1713325496040,MGT 164,A00,492222,McKay; Mary A,91,0,98,7
1713325497065,MGT 172,A00,492245,Staff,59,0,60,1
1713325497065,MGT 172,B00,505526,Hedges; Kathleen,65,0,98,33
1713325498089,MGT 181,A00,505669,Dunn; Louis Jean,82,0,98,16
1713325499115,MMW 14,A01,494399,Staff,15,0,28,13
1713325499115,MMW 14,A02,494400,Staff,25,0,28,3
1713325499115,MMW 14,A03,494401,Staff,28,0,28,0
1713325499115,MMW 14,A04,494402,Staff,28,0,28,0
1713325499115,MMW 14,B01,494404,Carreras; Maria Victoria,9,0,28,19
1713325499115,MMW 14,B02,494405,Carreras; Maria Victoria,25,0,28,3
1713325499115,MMW 14,B03,494406,Carreras; Maria Victoria,27,0,28,1
1713325499115,MMW 14,B04,494407,Carreras; Maria Victoria,28,0,28,0
1713325500140,MMW 14GS,A00,506250,Chang; Edmond Yi-Teh,0,0,0,0
1713325501166,MMW 121R,A01,494415,Adamiak; Patrick John,11,0,28,17
1713325501166,MMW 121R,A02,494416,Adamiak; Patrick John,24,0,28,4
1713325502193,MUS 1A,A01,494113,Staff,12,0,25,13
1713325502193,MUS 1A,A02,494114,Staff,24,0,25,1
1713325503217,MUS 4,A01,494116,Staff,23,0,25,2
1713325503217,MUS 4,A02,494117,Staff,22,0,25,3
1713325504242,MUS 5R,A01,494236,Dubnov; Shlomo,7,0,25,18
1713325504242,MUS 5R,A02,494237,Dubnov; Shlomo,25,0,25,0
1713325505270,MUS 6,A01,494122,Staff,10,0,25,15
1713325505270,MUS 6,A02,494123,Staff,23,0,25,2
1713325506297,MUS 7,A01,494125,Staff,16,0,25,9
1713325506297,MUS 7,A02,494126,Staff,24,0,25,1
1713325507321,MUS 11,A01,494128,Staff,23,0,25,2
1713325507321,MUS 11,A02,494129,Staff,24,0,25,1
1713325508349,MUS 13,A01,494131,Staff,25,0,25,0
1713325508349,MUS 13,A02,494132,Staff,25,0,25,0
1713325509376,MUS 15,A01,494134,Staff,17,0,25,8
1713325509376,MUS 15,A02,494135,Staff,25,0,25,0
1713325509376,MUS 15,B01,494137,Staff,24,0,25,1
1713325510406,MUS 80,A00,494232,Staff,24,0,25,1
1713325510406,MUS 80,B00,494233,Staff,25,0,25,0
1713325510406,MUS 80,C00,494234,Staff,23,0,25,2
1713325511431,MUS 95C,A00,494141,Staff,70,0,75,5
1713325512455,MUS 114,A00,494142,Staff,40,0,50,10
1713325513480,NANO 15,A01,490636,Drews; Aaron,7,0,7,0
1713325514506,PHIL 1,A00,490578,Grush; Rick Scott,49,0,50,1
1713325515533,PHIL 10,A01,490580,Grush; Rick Scott,33,0,35,2
1713325515533,PHIL 10,A02,490586,Grush; Rick Scott,32,0,35,3
1713325516560,PHIL 27,A01,490591,Staff,22,0,25,3
1713325516560,PHIL 27,A02,490592,Staff,25,0,25,0
1713325516560,PHIL 27,A03,490593,Staff,25,0,25,0
1713325516560,PHIL 27,A04,490598,Staff,25,0,25,0
1713325517585,PHIL 32,A01,490611,Staff,20,0,20,0
1713325517585,PHIL 32,A02,490618,Staff,20,0,20,0
1713325518611,PHIL 90,A00,490624,Staff,40,0,40,0
1713325519636,PHIL 136,A00,490627,Cohen; Jonathan David,37,0,40,3
1713325520662,PHIL 155,A00,490634,Staff,62,0,70,8
1713325521743,PHYS 1A,A00,491610,Staff,245,0,250,5
1713325522771,PHYS 1AL,001,491616,Tsai; Philbert S,27,0,30,3
1713325522771,PHYS 1AL,002,491618,Tsai; Philbert S,30,0,30,0
1713325523796,PHYS 1B,A00,491623,Staff,236,0,250,14
1713325524824,PHYS 1BL,001,491626,Tsai; Philbert S,22,0,30,8
1713325524824,PHYS 1BL,002,491628,Tsai; Philbert S,26,0,30,4
1713325525852,PHYS 1C,A00,491632,Staff,216,0,245,29
1713325526877,PHYS 1CL,001,491635,Tsai; Philbert S,5,0,30,25
1713325526877,PHYS 1CL,002,491643,Tsai; Philbert S,22,0,30,8
1713325527903,PHYS 2AR,A01,491651,Meyertholen; Andrew D.,44,0,50,6
1713325528932,PHYS 2B,A01,491659,Staff,105,0,115,10
1713325529959,PHYS 2BL,A01,491685,Staff,21,0,24,3
1713325529959,PHYS 2BL,A02,491700,Staff,21,0,24,3
1713325530984,PHYS 2C,A01,505161,Staff,103,0,115,12
1713325532013,PHYS 4A,A01,491704,Grinstein; Benjamin,99,0,100,1
1713325533040,POLI 5D,A01,494144,Staff,3,0,5,2
1713325533040,POLI 5D,B01,626283,Dai; Yinlin,5,0,5,0
1713325534064,POLI 12,A00,494145,Staff,43,0,45,2
1713325535091,POLI 13R,A00,494146,Forman; Fonna,45,0,50,5
1713325536117,POLI 27,A01,494148,Staff,54,0,60,6
1713325537141,POLI 30,A00,494149,Staff,49,0,50,1
1713325538167,POLI 100DA,A00,494150,Staff,21,0,25,4
1713325540217,POLI 100I,A00,494152,Staff,27,0,30,3
1713325541242,POLI 104B,A00,494153,Smith; Glenn Chatmas,53,0,55,2
1713325542268,POLI 104F,A00,494154,Staff,28,0,30,2
1713325543293,POLI 104I,A00,494155,Smith; Glenn Chatmas,30,0,30,0
1713325544324,POLI 110C,A00,494156,Ingham; Sean,23,0,25,2
1713325545355,POLI 117R,A00,494157,Forman; Fonna,8,0,20,12
1713325546383,POLI 118,A00,494158,Ingham; Sean,21,0,25,4
1713325547407,POLI 120H,A00,494159,Fisk; David Lee,39,0,45,6
1713325548431,POLI 131CR,A00,494160,Hoston; Germaine,35,0,45,10
1713325549456,POLI 133J,A00,494161,Staff,33,0,35,2
1713325550486,POLI 135,A00,494162,Fisk; David Lee,33,0,35,2
1713325551508,POLI 140A,A00,494164,Staff,20,0,30,10
1713325552533,POLI 142I,A00,494165,Staff,30,0,30,0
1713325553559,POLI 144D,A00,494166,Staff,23,0,25,2
1713325554599,POLI 151,A00,494167,Staff,30,0,30,0
1713325555625,POLI 153,A00,494168,Staff,33,0,35,2
1713325556652,POLI 160AA,A00,494169,Staff,34,0,40,6
1713325557676,POLI 162,A00,494170,Mignozzetti; Umberto,19,0,25,6
1713325558700,POLI 171,A00,494171,Mignozzetti; Umberto,20,0,25,5
1713325559724,PSYC 1,A00,494172,Staff,96,0,100,4
1713325560752,PSYC 2,A00,494173,Moranton; Nirelia Melbina-,34,0,50,16
1713325561776,PSYC 3,A00,494174,Staff,29,0,30,1
1713325562801,PSYC 6,A00,494175,Staff,17,0,20,3
1713325563826,PSYC 60,A01,494177,Staff,38,0,45,7
1713325564849,PSYC 70,A01,505724,Geller; Emma Harlan,42,0,45,3
1713325565879,PSYC 101,A00,494180,Heyman; Gail D.,84,0,100,16
1713325566904,PSYC 105,A00,494181,Geller; Emma Harlan,52,0,90,38
1713325567933,PSYC 106,A00,494182,Dobkins; Karen R.,29,0,45,16
1713325568961,PSYC 108,A00,494183,Adrian; Julia Anna,90,0,100,10
1713325569992,PSYC 114,A01,494185,Winkielman; Piotr,0,2,30,30
1713325571018,PSYC 122,A00,494186,Moranton; Nirelia Melbina-,30,0,50,20
1713325572042,PSYC 124,A00,494187,Chapman; Eddie Nathaniel,71,0,80,9
1713325573067,PSYC 131,A00,494188,Anagnostaras; Stephan,43,0,80,37
1713325574092,PSYC 144,A00,494189,Staff,5,0,50,45
1713325575117,PSYC 154,A00,494190,Lacefield; Katharine I,109,0,180,71
1713325576144,PSYC 162,A00,494191,Wixted; John T,71,0,100,29
1713325577172,PSYC 172,A00,494192,Gorman; Michael R.,36,0,45,9
1713325578198,PSYC 178,A00,494193,Glaser; Dale,34,0,45,11
1713325579223,PSYC 193,A00,505725,Chapman; Eddie Nathaniel,20,0,20,0
1713325580247,RELI 145GS,A00,519817,Rahimi; Babak,18,0,20,2
1713325581270,SE 101A,A01,490862,Chadha; Mayank,23,0,25,2
1713325582301,SE 101C,A01,490924,Krysl; Petr,16,0,20,4
1713325583328,SE 110A,A01,490928,Staff,19,0,20,1
1713325584357,SE 130A,A00,490929,Morrison; Machel Leigh,56,0,70,14
1713325585384,SIO 1,A01,519325,Staff,39,0,40,1
1713325586409,SIO 30,A01,519327,Staff,38,0,40,2
1713325587435,SIO 40,A00,519328,Staff,39,0,40,1
1713325588463,SIO 46GS,A00,519819,Cook; Geoffrey W,17,0,25,8
1713325589486,SIO 109R,A00,494197,Forman; Fonna,0,3,20,20
1713325590509,SIO 121GS,A00,519827,Cook; Geoffrey W,17,0,25,8
1713325591533,SIO 132,A01,519330,Staff,38,0,40,2
1713325592558,SIO 133,A01,519397,Staff,37,0,40,3
1713325593583,SIO 139,A00,519396,Kacev; David,30,0,40,10
1713325594616,SOCI 1,A01,494199,Thorpe; Charles Robert,22,0,30,8
1713325594616,SOCI 1,A02,494200,Thorpe; Charles Robert,30,0,30,0
1713325594616,SOCI 1,A03,494201,Thorpe; Charles Robert,29,0,30,1
1713325594616,SOCI 1,A04,494202,Thorpe; Charles Robert,29,0,30,1
1713325594616,SOCI 1,A05,494203,Thorpe; Charles Robert,29,0,30,1
1713325594616,SOCI 1,A06,494204,Thorpe; Charles Robert,30,0,30,0
1713325594616,SOCI 1,A07,494205,Thorpe; Charles Robert,28,0,30,2
1713325595642,SOCI 60,A01,494207,Staff,34,0,40,6
1713325595642,SOCI 60,A02,494208,Staff,39,0,40,1
1713325596667,SOCI 100,A01,494210,Payne; Christine Anna,25,0,30,5
1713325596667,SOCI 100,A02,494211,Payne; Christine Anna,26,0,30,4
1713325597692,SOCI 109M,A00,494212,Staff,20,0,20,0
1713325598716,SOCI 110,A00,494213,Staff,34,0,40,6
1713325600771,SOCI 118E,A00,494215,Ng; Kwai,37,0,40,3
1713325601797,SOCI 125,A00,494216,Calderon-Zaks; Michael Aar,40,0,45,5
1713325602828,SOCI 126,A01,494218,Jones; Makeba,3,0,5,2
1713325603864,SOCI 131,A00,494219,Thorpe; Charles Robert,26,0,30,4
1713325605914,SOCI 135,A00,494221,Payne; Christine Anna,28,0,50,22
1713325606942,SOCI 136E,A00,626690,Ruiz; Jonathan Joseph,24,0,25,1
1713325607967,SOCI 138GS,A00,494222,Navon; Daniel,24,0,28,4
1713325610020,SOCI 145,A00,494224,Staff,40,0,45,5
1713325611045,SOCI 153,A00,494225,Staff,28,0,30,2
1713325612072,SOCI 160E,A00,494226,Ng; Kwai,29,0,40,11
1713325613098,SOCI 180,A00,494227,Staff,29,0,30,1
1713325614125,SOCI 189GS,A00,494228,Ribas Norris; Janet Vanesa,11,0,11,0
1713325615151,SOCI 190GS,A00,553232,Ribas Norris; Janet Vanesa,11,0,11,0
1713325616177,SOMI 220,A00,627178,Schneid; Stephen David,30,0,30,0
1713325617205,SYN 2,001,490768,Staff,14,0,15,1
1713325617205,SYN 2,002,490769,Staff,15,0,15,0
1713325617205,SYN 2,004,490775,Staff,0,0,0,0
1713325617205,SYN 2,003,490774,Staff,0,0,0,0
1713325617205,SYN 2,005,490776,Staff,0,0,0,0
1713325618231,SYN 2R,001,490779,Staff,11,0,15,4
1713325618231,SYN 2R,002,514635,Staff,14,0,15,1
1713325619256,SYN 100,A01,490783,Staff,12,0,20,8
1713325619256,SYN 100,B01,490787,Staff,9,0,20,11
1713325619256,SYN 100,C01,490789,Staff,10,0,20,10
1713325620280,SYN 150,A00,490817,Staff,14,0,15,1
1713325620280,SYN 150,B00,514610,Staff,15,0,15,0
1713325621308,TDAC 1,A00,492753,Walsh; Kim C.,19,0,20,1
1713325621308,TDAC 1,B00,492754,Harting; Carla Kelso,19,0,20,1
1713325621308,TDAC 1,C00,513995,Salovey; Todd,15,0,20,5
1713325622336,TDAC 101,A00,492766,Harting; Carla Kelso,17,0,20,3
1713325623366,TDAC 102,A00,492768,Basso; Beatrice,19,0,20,1
1713325624394,TDDE 111,A00,492769,Staff,25,0,25,0
1713325625474,TDDE 131,A00,492770,Staff,15,0,15,0
1713325625474,TDDE 131,B00,492771,Staff,15,0,15,0
1713325626497,TDDE 131GS,A00,523716,Guirguis; Mark C,23,0,28,5
1713325627522,TDGE 1,A01,492756,Salovey; Todd,57,0,60,3
1713325628546,TDGE 5,A01,492758,Staff,23,0,25,2
1713325629573,TDGE 10,A00,492759,Fulton; Julia,203,0,220,17
1713325630600,TDGE 11,A00,492760,Castro; Robert Jess,198,0,200,2
1713325632652,TDGE 124,A00,492772,Fulton; Julia,185,0,220,35
1713325633680,TDGE 125,A00,492773,Meyer; Ursula,38,0,50,12
1713325633680,TDGE 125,B00,492774,Staff,49,0,50,1
1713325633680,TDGE 125,C00,523565,Staff,48,0,50,2
1713325634704,TDGE 125GS,A00,523580,Guirguis; Mark C,23,0,28,5
1713325635729,TDGE 127,A00,492775,Havis; Allan,35,0,50,15
1713325636754,TDHT 101,A00,492776,Staff,34,0,35,1
1713325637780,TDMV 1,A00,492762,Caligagan; Maria T.,30,0,30,0
1713325637780,TDMV 1,B00,492763,Arcidiacono; Kristin,26,0,30,4
1713325638808,TDMV 2,A00,492764,Weinberg; Sadie,28,0,30,2
1713325639833,TDMV 3,A00,492765,Mack; Kara Shanai',37,0,40,3
1713325640857,TDMV 138,A00,492777,Mack; Kara Shanai',34,0,40,6
1713325641883,TDMV 140,A00,492778,Lima; Paulo Henrique,40,0,40,0
1713325642907,TDMV 142,A00,492779,Caligagan; Maria T.,33,0,40,7
1713325642907,TDMV 142,B00,492780,Caligagan; Tony,37,0,40,3
1713325643934,TDMV 143,A00,492781,Fyall; Daunte Edward,39,0,40,1
1713325644962,USP 1,A01,492401,Kwak; Nancy,27,0,35,8
1713325645987,USP 2,A01,492453,Hinds; Juli Beth,35,0,35,0
1713325647010,USP 3,A01,492516,Staff,28,0,35,7
1713325648039,USP 4,A00,492522,McTague; Sarah,16,0,25,9
1713325649063,USP 100,A00,492523,Staff,32,0,35,3
1713325650091,USP 101,A00,492524,Staff,13,0,15,2
1713325651116,USP 105,A00,492525,Staff,21,0,25,4
1713325652144,USP 151,A00,492526,Shenkman; Michael Thomas,32,0,35,3
1713325653173,USP 170,A00,492545,Hinds; Juli Beth,33,0,35,2
1713325654197,USP 171GS,A00,492608,Bussell; Mirle Rabinowitz,24,0,28,4
1713325655222,USP 183GS,A00,492613,Peerson; Susan,24,0,28,4
1713325656251,VIS 30,A01,490693,Yoldas; Pinar,19,0,22,3
1713325656251,VIS 30,A02,490694,Yoldas; Pinar,18,0,22,4
1713325657277,VIS 83,A00,490695,Kester; Grant,63,0,75,12
1713325658307,VIS 105D,A00,490696,Staff,22,0,25,3
1713325659331,VIS 124CN,A00,490699,Rose; Jordan M,65,0,75,10
1713325660356,VIS 125GS,A00,511221,Williams; Alena J,21,0,22,1
1713325661385,VIS 128D,A00,490700,Staff,73,0,75,2
1713325662409,VIS 151,A01,490717,Staff,33,0,34,1
1713325662409,VIS 151,A02,490766,Staff,33,0,34,1
1713325663438,VIS 154GS,A00,511972,Williams; Alena J,21,0,22,1
1713325664467,VIS 160A,A00,490767,Stone; Patricia,7,0,10,3
1713325665490,WCWP 10A,A00,490638,Staff,14,0,15,1
1713325665490,WCWP 10A,B00,490640,Staff,15,0,15,0
1713325666518,WCWP 10B,A00,490641,Staff,0,0,0,0
1713325666518,WCWP 10B,B00,490642,Staff,14,0,15,1
1713325666518,WCWP 10B,C00,490644,Staff,13,0,15,2
1713325666518,WCWP 10B,D00,490647,Staff,0,0,0,0
1713325667542,WCWP 100,A00,490655,Staff,0,0,0,0
1713325667542,WCWP 100,B00,490687,Staff,10,0,15,5
1713325669609,ANAR 153,A00,487222,Braswell; Geoffrey E.,54,0,60,6
1713325670634,ANBI 134,A00,487223,Staff,6,0,20,14
1713325671657,ANBI 143GS,A00,487224,Noel; Geoffroy Pierre Jean,18,0,24,6
1713325672685,ANBI 144GS,A00,519548,Noel; Geoffroy Pierre Jean,18,0,24,6
1713325673711,ANSC 101,A00,487225,Staff,18,0,20,2
1713325674740,ANSC 125,A00,487227,Brenner; Suzanne A,39,0,40,1
1713325676798,ANSC 146,A00,487229,Staff,35,0,40,5
1713325677826,ANSC 148,A00,487230,Olivas Hernandez; Olga Lid,39,0,40,1
1713325678853,ANSC 150,A00,504165,Sloane; Julia Kathryn,18,0,20,2
1713325679878,ANSC 180,A00,487232,Staff,14,0,15,1
1713325680906,ANSC 188,A00,627155,Staff,39,0,40,1
1713325681931,ANTH 5,A00,519529,Semendeferi; Ekaterini,15,0,15,0
1713325682956,ANTH 10,A00,487219,Staff,58,0,60,2
1713325683984,ANTH 23,A01,487221,Staff,17,0,20,3
1713325685009,ANTH 102,A00,487233,Wilder; Linnea Lorene,51,0,60,9
1713325686034,ANTH 103,A00,487234,Varma; Saiba,55,0,60,5
1713325687058,ANTH 105,A00,487235,Stewart; Alexander B,55,0,60,5
1713325688083,BENG 100,A01,516685,Taylor Amos; Alyssa C,27,0,30,3
1713325689112,BIBC 102,A01,491316,Flagg; Matthew Paul,16,0,88,72
1713325689112,BIBC 102,A02,491366,Flagg; Matthew Paul,78,0,88,10
1713325690137,BIBC 103,A01,491486,Boumechache; Miyyada,16,0,24,8
1713325690137,BIBC 103,A02,491487,Boumechache; Miyyada,24,0,24,0
1713325691161,BICD 100,A01,516882,Staff,73,0,75,2
1713325691161,BICD 100,A02,516890,Staff,69,0,75,6
1713325692186,BICD 102GS,A00,491488,Lo; Stanley M.,26,0,28,2
1713325693215,BIEB 136GS,A00,516940,Holway; David A. & Shurin; Jonathan,18,0,24,6
1713325694240,BIEB 137GS,A01,517034,Holway; David A. & Shurin; Jonathan,18,0,24,6
1713325695264,BIEB 138GS,A01,491492,Pirino; Giorgia,21,0,28,7
1713325696289,BILD 1,A01,491296,Staff,60,0,63,3
1713325696289,BILD 1,A02,491297,Staff,63,0,63,0
1713325697313,BILD 4,A01,517099,Gonzalez Gamboa; Ivonne,22,0,24,2
1713325697313,BILD 4,A02,517100,Gonzalez Gamboa; Ivonne,24,0,24,0
1713325698337,BILD 60GS,A00,491309,Lo; Stanley M.,26,0,28,2
1713325699360,BIMM 100,A01,517136,Staff,85,0,100,15
1713325700385,BIMM 110,A01,517182,Staff,58,0,100,42
1713325701414,BIMM 120,A01,517228,Pickett; Brooke Elizabeth,29,0,63,34
1713325701414,BIMM 120,A02,517240,Pickett; Brooke Elizabeth,44,0,63,19
1713325702441,BIMM 132GS,A01,491498,Pirino; Giorgia,21,0,28,7
1713325703471,BIMM 143,A01,491589,Bozinovic; Goran,13,0,40,27
1713325704498,BIPN 100,A01,491594,Armour; Jon Christopher,89,0,100,11
1713325705523,BIPN 140,A01,491602,Marino; Marc J,26,0,50,24
1713325707575,CAT 125,A00,515973,Staff,18,0,20,2
1713325708600,CAT 125GS,A00,515974,Rahimi; Babak,17,0,20,3
1713325709625,CAT 125R,A00,515980,Staff,12,0,20,8
1713325709625,CAT 125R,B00,515981,Tosun; Adriana,19,0,20,1
1713325709625,CAT 125R,C00,515987,Hyland; Tina Mae,0,2,20,20
1713325709625,CAT 125R,D00,515988,Bronstein; Phoebe Malan,17,0,20,3
1713325710654,CENG 15,A01,488699,Drews; Aaron,25,0,25,0
1713325711683,CENG 100,A00,505196,Opatkiewicz; Justin Paul,25,0,25,0
1713325712710,CGS 2A,A01,489598,Staff,33,0,35,2
1713325713734,CGS 112,A00,489599,Staff,15,0,15,0
1713325714760,CGS 119,A00,489603,Staff,10,0,10,0
1713325715784,CGS 120,A00,489604,Staff,14,0,15,1
1713325716809,CGS 150,A00,489607,Staff,15,0,15,0
1713325717840,CHEM 6A,A01,488715,Staff,98,0,100,2
1713325718870,CHEM 6B,A01,488719,Piercy; Marc Anthony,99,0,100,1
1713325719895,CHEM 6C,A01,488723,Albizati; Kim F.,93,0,100,7
1713325720928,CHEM 7L,A01,488728,Schurmeier; Kimberly,18,0,24,6
1713325720928,CHEM 7L,A02,488730,Schurmeier; Kimberly,23,0,24,1
1713325720928,CHEM 7L,A03,488734,Schurmeier; Kimberly,20,0,24,4
1713325720928,CHEM 7L,A04,488763,Schurmeier; Kimberly,23,0,24,1
1713325720928,CHEM 7L,B01,488798,Schurmeier; Kimberly,17,0,24,7
1713325720928,CHEM 7L,B02,488801,Schurmeier; Kimberly,23,0,24,1
1713325720928,CHEM 7L,B03,488808,Schurmeier; Kimberly,23,0,24,1
1713325720928,CHEM 7L,B04,488811,Schurmeier; Kimberly,24,0,24,0
1713325721955,CHEM 11,A01,488897,Stallings; Dontarie M,95,0,100,5
1713325722978,CHEM 40A,A01,488913,Albizati; Kim F.,84,0,100,16
1713325724003,CHEM 40B,A01,488920,Weizman; Haim,43,0,50,7
1713325724003,CHEM 40B,A02,488938,Weizman; Haim,45,0,50,5
1713325725028,CHEM 41A,A01,489029,Klosterman; Jeremy K,57,0,60,3
1713325726056,CHEM 41C,A01,500436,Tor; Yitzhak,55,0,60,5
1713325727083,CHEM 43A,A01,500426,Weizman; Haim,0,0,24,24
1713325727083,CHEM 43A,A02,500430,Weizman; Haim,9,0,24,15
1713325727083,CHEM 43A,B01,514041,Klosterman; Jeremy K,16,0,24,8
1713325727083,CHEM 43A,B02,514047,Klosterman; Jeremy K,23,0,24,1
1713325728107,CHEM 108,A01,489140,Jennings; Patricia A.,11,0,24,13
1713325728107,CHEM 108,A02,489142,Jennings; Patricia A.,14,0,24,10
1713325729186,CHEM 114A,A01,489147,Stallings; Dontarie M,72,0,100,28
1713325730212,CHIN 169A,A00,489171,Wang; Xiao,19,0,20,1
1713325732265,COGS 3,A01,518827,Boyle; Mary E. T.,26,0,40,14
1713325733292,COGS 11,A01,489175,Staff,27,0,30,3
1713325734321,COGS 14A,A01,518829,Staff,51,0,60,9
1713325735345,COGS 14B,A01,489177,Hoffman; Drew Ellen,64,0,75,11
1713325736371,COGS 100,A01,489181,Allen; Michael Gordon,63,0,75,12
1713325737394,COGS 101A,A01,489183,Staff,46,0,60,14
1713325738425,COGS 101B,A01,489185,Allen; Michael Gordon,8,0,30,22
1713325739455,COGS 101C,A01,526786,Staff,23,0,30,7
1713325741508,COGS 107A,A01,489189,Boyle; Mary E. T.,18,0,35,17
1713325742538,COGS 107B,A01,627144,Mooshagian; Eric Frederick,60,0,60,0
1713325743567,COGS 118A,A01,489191,Staff,0,42,40,40
1713325745619,COGS 171GS,A01,489194,Pineda; Jaime A,20,0,28,8
1713325746645,COGS 172,A01,489196,Staff,3,0,30,27
1713325747670,COGS 174GS,A01,489264,Pineda; Jaime A,20,0,28,8
1713325748697,COGS 180,A01,627150,Staff,28,0,30,2
1713325749724,COGS 186,A01,489274,Staff,0,1,30,30
1713325750752,COMM 10,A01,489276,Staff,23,0,25,2
1713325750752,COMM 10,A02,489303,Staff,23,0,25,2
1713325751779,COMM 100A,A01,489312,Staff,14,0,25,11
1713325751779,COMM 100A,A02,489313,Staff,24,0,25,1
1713325752804,COMM 106T,A00,512540,Staff,33,0,35,2
1713325753832,COMM 107,A00,489347,Staff,27,0,35,8
1713325754858,COMM 109P,A00,489358,Staff,31,0,35,4
1713325755884,COMM 132,A00,489361,McKenna; Denise,27,0,30,3
1713325756908,COMM 146,A00,489362,Halm; Gavin Patrick,26,0,30,4
1713325757937,COMM 190,A00,489363,Abuelhiga; Soraya Jill,17,0,23,6
1713325758963,CSE 8A,A50,489366,Staff,21,0,25,4
1713325758963,CSE 8A,A51,489367,Staff,24,0,25,1
1713325759988,CSE 11,A01,489398,Cao; Yingjun,75,0,100,25
1713325761020,CSE 12,A01,489487,Staff,43,0,50,7
1713325762047,CSE 20,A01,489497,Staff,48,0,50,2
1713325763071,CSE 21,A01,489517,Braun; Oliver,42,0,50,8
1713325764096,CSE 101,A01,489524,Braun; Oliver,0,28,50,50
1713325765134,CSE 105,A01,512594,Jones; Miles E,73,0,100,27
1713325765134,CSE 105,B01,512598,Jones; Miles E,53,0,100,47
1713325766158,CSE 140,A01,489538,Staff,42,0,50,8
1713325767183,CSE 141,A01,489550,Eldon; John,68,0,100,32
1713325768212,CSE 141L,A01,489571,Eldon; John,66,0,100,34
1713325769240,CSE 151A,A01,489583,Solares; Edwin A,142,0,200,58
1713325770266,CSE 175,A01,510886,Kumar; Rakesh,30,0,30,0
1713325771291,CSE 190,A00,516828,Dubnov; Shlomo,38,0,49,11
1713325772318,DOC 100D,A00,489667,Pass; Natalye Joann,19,0,25,6
1713325773345,DSC 10,A01,624268,Staff,72,0,75,3
1713325774373,DSC 20,A01,624476,Staff,50,0,50,0
1713325775402,DSC 40A,A01,624608,Staff,39,0,40,1
1713325776427,DSGN 1,A01,489179,Rill; Bryan,34,0,50,16
1713325777455,ECE 17,A01,490489,Sahay; Rajeev,18,0,30,12
1713325778481,ECE 65,A50,490492,Staff,12,0,20,8
1713325778481,ECE 65,A51,490493,Staff,18,0,20,2
1713325779510,ECON 1,A01,489715,Famulari; Melissa,68,0,70,2
1713325780535,ECON 2,A01,489717,Levkoff; Steven B.,68,0,70,2
1713325781560,ECON 3,A01,489948,Staff,70,0,70,0
1713325783616,ECON 5,A01,490103,Staff,27,0,30,3
1713325783616,ECON 5,B01,626281,Dai; Yinlin,45,0,45,0
1713325784640,ECON 100A,A01,490127,Famulari; Melissa,66,0,70,4
1713325785665,ECON 100B,A01,490129,Staff,64,0,70,6
1713325786692,ECON 109,A01,490187,Shishkin; Denis,27,0,35,8
1713325787718,ECON 110A,A01,490190,Levkoff; Steven B.,60,0,70,10
1713325788743,ECON 120A,A01,490245,Dai; Yinlin,62,0,70,8
1713325789768,ECON 120B,A01,490247,Nieto-Barthaburu; Augusto,45,0,70,25
1713325790800,ECON 120C,A01,490253,Sun; Yixiao,30,0,35,5
1713325790800,ECON 120C,B01,490255,Sun; Yixiao,34,0,35,1
1713325791827,ECON 129,A00,490256,Eckert; Fabian Paul,23,0,35,12
1713325792852,ECON 131,A00,490257,Nieto-Barthaburu; Augusto,0,6,35,35
1713325793881,ECON 138,A00,490258,Bharadwaj; Prashant,14,0,35,21
1713325793881,ECON 138,B00,490259,Bharadwaj; Prashant,15,0,35,20
1713325794906,ECON 159,A00,490260,Hendrickson; Gerald M.,0,10,0,0
1713325795931,ECON 178,A01,553995,Zhu; Ying,24,0,35,11
1713325796956,EDS 40,A01,512576,Black; Alison Michelle,20,0,20,0
1713325797981,EDS 107,A01,515848,Staff,30,0,30,0
1713325799004,EDS 110R,A01,490262,Staff,26,0,30,4
1713325800029,EDS 112,A01,490264,Chapman; Thandeka K,40,0,50,10
1713325801054,EDS 113,A00,490266,Staff,26,0,30,4
1713325802081,EDS 118,A00,490267,Warstadt; Melissa Fawn,21,0,30,9
1713325803106,EDS 124BR,A00,490268,Eguchi; Emi,4,0,25,21
1713325803106,EDS 124BR,B00,490269,Eguchi; Emi,24,0,25,1
1713325804136,EDS 126,A01,490271,Jones; Makeba,43,0,50,7
1713325805168,EDS 135,A01,490316,Staff,19,0,20,1
1713325806192,ENVR 142GS,A00,519514,Chang; Edmond Yi-Teh,27,0,28,1
1713325807217,ETHN 103,A00,490504,Staff,26,0,36,10
1713325808245,ETHN 103A,A00,490505,Man; Simeon S,5,0,9,4
1713325809269,ETHN 109,A00,490506,Staff,28,0,30,2
1713325810298,ETHN 118,A00,490507,Staff,35,0,36,1
1713325811326,ETHN 119,A00,490508,Staff,33,0,36,3
1713325812349,ETHN 121R,A00,490518,Choi; Esther Min,24,0,36,12
1713325813373,ETHN 127,A00,490528,Staff,14,0,15,1
1713325814401,ETHN 139,A00,490573,Staff,10,0,10,0
1713325815426,ETHN 150,A00,490575,Staff,15,0,15,0
1713325816450,GLBH 20,A00,491705,Elwardani; Nile Regina,38,0,40,2
1713325817476,GLBH 101,A00,491706,Staff,20,0,20,0
1713325818500,GLBH 111,A01,491708,Burgos; Jose L.,15,0,15,0
1713325819526,GLBH 146,A00,491709,Staff,10,0,20,10
1713325820551,GLBH 148,A00,491710,Olivas Hernandez; Olga Lid,11,0,20,9
1713325821576,GLBH 150,A00,491711,Sloane; Julia Kathryn,19,0,20,1
1713325822600,HIEA 131,A00,491760,Staff,28,0,32,4
1713325823628,HIEA 153,A00,491762,Staff,28,0,30,2
1713325824654,HIEU 124,A00,491811,Staff,26,0,32,6
1713325825679,HIEU 124GS,A00,491812,Markman; Kristina,27,0,28,1
1713325826704,HIEU 147,A00,491813,Staff,30,0,32,2
1713325827729,HIEU 149GS,A00,491816,Caldwell; Michael Alan,28,0,28,0
1713325828773,HILD 2C,A01,491713,Hendrickson; Gerald M.,27,0,30,3
1713325829798,HILD 7B,A01,491715,Kwak; Nancy,0,0,30,30
1713325830822,HILD 10,A01,491717,Staff,11,0,20,9
1713325831847,HILD 30GS,A00,491719,Edington; Claire Ellen,24,0,28,4
1713325832925,HINE 109,A00,491818,Shafir; Nir,27,0,32,5
1713325833950,HINE 128,A00,491821,Shafir; Nir,31,0,32,1
1713325834974,HISC 117,A00,491830,Staff,27,0,32,5
1713325836003,HIUS 103,A00,491834,Man; Simeon S,14,0,23,9
1713325837027,HIUS 108B,A00,491835,Staff,28,0,30,2
1713325838052,HIUS 141,A00,491836,Hendrickson; Gerald M.,28,0,32,4
1713325839077,HIUS 149,A00,491839,Staff,24,0,32,8
1713325840102,HUM 3,A01,512617,Crum; Matthew Stephen,43,0,50,7
1713325840102,HUM 3,A02,512618,Crum; Matthew Stephen,48,0,50,2
1713325841130,HUM 3GS,A00,512663,Markman; Kristina,0,0,0,1
1713325841130,HUM 3GS,B00,512664,Staff,0,0,0,0
1713325842153,HUM 4,A01,512620,West; Geoffrey Scott,28,0,50,22
1713325843182,HUM 4GS,A00,512666,Lyon; Antony J.,0,0,0,4
1713325844207,HUM 4R,A01,512625,Watkins; Eric,49,0,50,1
1713325845231,HUM 5,A01,512649,Zavodny; Tatiana Sophia,24,0,50,26
1713325845231,HUM 5,B01,512661,Zroka; Ryan Edward,48,0,50,2
1713325846257,INTL 190,A00,490577,Segui; Alan S,0,0,0,5
1713325847283,JAPN 20AR,A01,491267,Ross; Kayoko F,8,0,20,12
1713325848307,JAPN 180,A00,491285,Berman; Michael David,33,0,40,7
1713325849338,LATI 50,A01,502536,Kokinis; Troy Andreas,16,0,22,6
1713325849338,LATI 50,A02,502551,Kokinis; Troy Andreas,22,0,22,0
1713325849338,LATI 50,A03,502650,Kokinis; Troy Andreas,22,0,22,0
1713325849338,LATI 50,A04,502909,Kokinis; Troy Andreas,22,0,22,0
1713325850366,LATI 160,A01,502920,Kokinis; Troy Andreas,30,0,30,0
1713325851394,LIFR 1A,A00,490494,Van Moer; Vinciane G,17,0,20,3
1713325852422,LIFR 1AX,A00,490495,Van Moer; Vinciane G,17,0,20,3
1713325853451,LIFR 1B,A00,490496,Van Moer; Vinciane G,18,0,20,2
1713325854476,LIFR 1BX,A00,490497,Van Moer; Vinciane G,18,0,20,2
1713325855506,LIGN 8,A00,505198,McIntosh; Justin Daniel,134,0,150,16
1713325856530,LIGN 9GS,A00,491239,Lott; Margaret S.,18,0,20,2
1713325857554,LIGN 101,A01,505200,McIntosh; Justin Daniel,23,0,30,7
1713325858582,LIGN 120,A01,491244,Staff,23,0,30,7
1713325859607,LIGN 149GS,A00,491245,Lott; Margaret S.,18,0,20,2
1713325860632,LIGN 170,A00,491247,Staff,22,0,30,8
1713325861661,LISP 1D,A00,490498,Munoz Sanchez; Alicia,9,0,14,5
1713325861661,LISP 1D,B00,490499,Munoz Sanchez; Alicia,6,0,14,8
1713325861661,LISP 1D,C00,490500,Munoz Sanchez; Alicia,7,0,14,7
1713325861661,LISP 1D,D00,490501,Munoz Sanchez; Alicia,10,0,14,4
1713325862691,LISP 1DX,A00,490502,Munoz Sanchez; Alicia,14,0,28,14
1713325862691,LISP 1DX,B00,490503,Munoz Sanchez; Alicia,16,0,28,12
1713325864741,LTAM 110,A00,491847,Staff,23,0,25,2
1713325865772,LTCS 119,A00,491848,Staff,11,0,15,4
1713325866800,LTCS 130,A00,491849,Staff,24,0,25,1
1713325868850,LTEA 120C,A00,491852,Staff,31,0,40,9
1713325869875,LTEN 130GS,A00,491853,Lyon; Antony J.,24,0,28,4
1713325870903,LTEN 148,A00,491855,Staff,23,0,25,2
1713325871929,LTEN 159,A00,491856,Staff,21,0,25,4
1713325872957,LTEN 180,A00,491857,Staff,8,0,15,7
1713325875007,LTSP 123GS,A00,505928,Bessett; Ryan Matthew,24,0,28,4
1713325876035,LTSP 174GS,A00,506037,Bessett; Ryan Matthew,24,0,28,4
1713325878087,LTWR 102,A00,491861,Staff,9,0,15,6
1713325879115,LTWR 106,A00,491862,Staff,10,0,15,5
1713325880139,MAE 11,A00,490930,Bahadori; Mohammad Yousef,96,0,100,4
1713325881170,MAE 30A,A00,490931,Qi; Huihui,37,0,40,3
1713325882195,MAE 101A,A00,491036,Sadeghizadeh; Zahra,93,0,100,7
1713325883219,MAE 101C,A00,491037,Seshadri; Kalyanasundaram,67,0,100,33
1713325884244,MAE 113,A00,491040,Seshadri; Kalyanasundaram,66,0,80,14
1713325885271,MAE 131A,A00,491041,Ghazinejad; Maziar,37,0,40,3
1713325886296,MAE 142,A00,491053,Staff,39,0,40,1
1713325887321,MAE 143A,A00,491054,Staff,33,0,50,17
1713325888350,MAE 150,A00,491092,Truong; Phuong Thi Ngoc,23,0,35,12
1713325889373,MATH 3C,A01,494031,Pardo Guerra; Sebastian,30,0,30,0
1713325889373,MATH 3C,A02,494032,Pardo Guerra; Sebastian,29,0,30,1
1713325890400,MATH 10A,A01,494034,Staff,27,0,30,3
1713325890400,MATH 10A,A02,494035,Staff,28,0,30,2
1713325890400,MATH 10A,B01,494037,Staff,27,0,30,3
1713325890400,MATH 10A,B02,494038,Staff,29,0,30,1
1713325891427,MATH 10B,A01,494040,Habib; Yousaf,22,0,30,8
1713325891427,MATH 10B,A02,494041,Habib; Yousaf,28,0,30,2
1713325891427,MATH 10B,A03,494042,Habib; Yousaf,29,0,30,1
1713325891427,MATH 10B,A04,494043,Habib; Yousaf,30,0,30,0
1713325891427,MATH 10B,B01,494045,Habib; Yousaf,25,0,30,5
1713325891427,MATH 10B,B02,494046,Habib; Yousaf,30,0,30,0
1713325891427,MATH 10B,B03,494047,Habib; Yousaf,30,0,30,0
1713325891427,MATH 10B,B04,494048,Habib; Yousaf,30,0,30,0
1713325892454,MATH 18,A01,494050,Kemp; Todd Aahron,25,0,30,5
1713325892454,MATH 18,A02,494051,Kemp; Todd Aahron,29,0,30,1
1713325892454,MATH 18,B01,494054,Kemp; Todd Aahron,26,0,30,4
1713325892454,MATH 18,B02,494055,Kemp; Todd Aahron,29,0,30,1
1713325893599,MATH 20A,A01,494059,Suk; Andrew Hoon,30,0,30,0
1713325894623,MATH 20B,A01,494061,Briones; Jor-el Thomas Caparas,33,0,35,2
1713325894623,MATH 20B,B01,494063,Bach; Quang Tran,34,0,35,1
1713325895651,MATH 20C,A01,494065,Staff,28,0,30,2
1713325895651,MATH 20C,A02,494066,Staff,30,0,30,0
1713325895651,MATH 20C,A03,494067,Staff,30,0,30,0
1713325895651,MATH 20C,A04,494068,Staff,30,0,30,0
1713325895651,MATH 20C,B01,494070,Zhang; Ming,25,0,30,5
1713325895651,MATH 20C,B02,494071,Zhang; Ming,27,0,30,3
1713325895651,MATH 20C,B03,494072,Zhang; Ming,29,0,30,1
1713325895651,MATH 20C,B04,494073,Zhang; Ming,29,0,30,1
1713325896681,MATH 20D,A01,494075,Staff,22,0,30,8
1713325896681,MATH 20D,A02,494076,Staff,29,0,30,1
1713325897710,MATH 20E,A01,494079,Staff,24,0,30,6
1713325897710,MATH 20E,A02,494080,Staff,26,0,30,4
1713325897710,MATH 20E,B01,494082,Staff,25,0,30,5
1713325897710,MATH 20E,B02,494083,Staff,25,0,30,5
1713325898735,MATH 103A,A01,494085,Aliabadi Sr.; Mohsen,14,0,30,16
1713325898735,MATH 103A,A02,494086,Aliabadi Sr.; Mohsen,28,0,30,2
1713325898735,MATH 103A,B01,494088,Aliabadi Sr.; Mohsen,20,0,30,10
1713325898735,MATH 103A,B02,494089,Aliabadi Sr.; Mohsen,28,0,30,2
1713325899763,MATH 109,A01,494091,Staff,30,0,30,0
1713325899763,MATH 109,A02,494092,Staff,29,0,30,1
1713325899763,MATH 109,B01,494094,Staff,27,0,30,3
1713325899763,MATH 109,B02,494095,Staff,29,0,30,1
1713325900790,MATH 142A,A01,494097,Chow; Bennett,15,0,30,15
1713325900790,MATH 142A,A02,494098,Chow; Bennett,23,0,30,7
1713325900790,MATH 142A,B01,494100,Chow; Bennett,19,0,30,11
1713325900790,MATH 142A,B02,494101,Chow; Bennett,29,0,30,1
1713325902841,MATH 168A,A01,516677,Dumitriu; Ioana,15,0,35,20
1713325903871,MATH 170A,A01,516679,Dumitriu; Ioana,18,0,30,12
1713325903871,MATH 170A,A02,516680,Dumitriu; Ioana,28,0,30,2
1713325904900,MATH 193A,A01,494107,Staff,14,0,30,16
1713325904900,MATH 193A,A02,494108,Staff,21,0,30,9
1713325904900,MATH 193A,A03,494109,Staff,29,0,30,1
1713325904900,MATH 193A,A04,494110,Staff,22,0,30,8
1713325907983,MGT 16,A00,491930,McKay; Michael J,92,0,98,6
1713325909013,MGT 18,A00,491992,McKay; Michael J,96,0,98,2
1713325910038,MGT 71,A00,492003,Staff,66,0,98,32
1713325911066,MGT 103,A00,505209,Eberhard; Craig A,81,0,98,17
1713325912095,MGT 131A,A00,505210,Anderson; John Charles,89,0,98,9
1713325914146,MGT 153,A00,492077,Perols; Johan Lars,21,0,90,69
1713325917227,MGT 164,A00,492222,McKay; Mary A,91,0,98,7
1713325918252,MGT 172,A00,492245,Staff,59,0,60,1
1713325918252,MGT 172,B00,505526,Hedges; Kathleen,65,0,98,33
1713325919281,MGT 181,A00,505669,Dunn; Louis Jean,82,0,98,16
1713325920306,MMW 14,A01,494399,Staff,15,0,28,13
1713325920306,MMW 14,A02,494400,Staff,25,0,28,3
1713325920306,MMW 14,A03,494401,Staff,28,0,28,0
1713325920306,MMW 14,A04,494402,Staff,28,0,28,0
1713325920306,MMW 14,B01,494404,Carreras; Maria Victoria,8,0,28,20
1713325920306,MMW 14,B02,494405,Carreras; Maria Victoria,25,0,28,3
1713325920306,MMW 14,B03,494406,Carreras; Maria Victoria,27,0,28,1
1713325920306,MMW 14,B04,494407,Carreras; Maria Victoria,28,0,28,0
1713325921331,MMW 14GS,A00,506250,Chang; Edmond Yi-Teh,0,0,0,0
1713325922361,MMW 121R,A01,494415,Adamiak; Patrick John,11,0,28,17
1713325922361,MMW 121R,A02,494416,Adamiak; Patrick John,24,0,28,4
1713325923384,MUS 1A,A01,494113,Staff,12,0,25,13
1713325923384,MUS 1A,A02,494114,Staff,24,0,25,1
1713325924409,MUS 4,A01,494116,Staff,23,0,25,2
1713325924409,MUS 4,A02,494117,Staff,22,0,25,3
1713325925434,MUS 5R,A01,494236,Dubnov; Shlomo,7,0,25,18
1713325925434,MUS 5R,A02,494237,Dubnov; Shlomo,25,0,25,0
1713325926461,MUS 6,A01,494122,Staff,10,0,25,15
1713325926461,MUS 6,A02,494123,Staff,23,0,25,2
1713325927486,MUS 7,A01,494125,Staff,16,0,25,9
1713325927486,MUS 7,A02,494126,Staff,24,0,25,1
1713325928511,MUS 11,A01,494128,Staff,23,0,25,2
1713325928511,MUS 11,A02,494129,Staff,24,0,25,1
1713325929535,MUS 13,A01,494131,Staff,25,0,25,0
1713325929535,MUS 13,A02,494132,Staff,25,0,25,0
1713325930561,MUS 15,A01,494134,Staff,17,0,25,8
1713325930561,MUS 15,A02,494135,Staff,25,0,25,0
1713325930561,MUS 15,B01,494137,Staff,24,0,25,1
1713325931585,MUS 80,A00,494232,Staff,24,0,25,1
1713325931585,MUS 80,B00,494233,Staff,25,0,25,0
1713325931585,MUS 80,C00,494234,Staff,23,0,25,2
1713325932611,MUS 95C,A00,494141,Staff,70,0,75,5
1713325933641,MUS 114,A00,494142,Staff,40,0,50,10
1713325934670,NANO 15,A01,490636,Drews; Aaron,7,0,7,0
1713325935697,PHIL 1,A00,490578,Grush; Rick Scott,49,0,50,1
1713325936777,PHIL 10,A01,490580,Grush; Rick Scott,33,0,35,2
1713325936777,PHIL 10,A02,490586,Grush; Rick Scott,32,0,35,3
1713325937806,PHIL 27,A01,490591,Staff,22,0,25,3
1713325937806,PHIL 27,A02,490592,Staff,25,0,25,0
1713325937806,PHIL 27,A03,490593,Staff,25,0,25,0
1713325937806,PHIL 27,A04,490598,Staff,25,0,25,0
1713325938834,PHIL 32,A01,490611,Staff,20,0,20,0
1713325938834,PHIL 32,A02,490618,Staff,20,0,20,0
1713325939858,PHIL 90,A00,490624,Staff,40,0,40,0
1713325940882,PHIL 136,A00,490627,Cohen; Jonathan David,37,0,40,3
1713325941914,PHIL 155,A00,490634,Staff,62,0,70,8
1713325942940,PHYS 1A,A00,491610,Staff,245,0,250,5
1713325943965,PHYS 1AL,001,491616,Tsai; Philbert S,27,0,30,3
1713325943965,PHYS 1AL,002,491618,Tsai; Philbert S,30,0,30,0
1713325944989,PHYS 1B,A00,491623,Staff,236,0,250,14
1713325946015,PHYS 1BL,001,491626,Tsai; Philbert S,22,0,30,8
1713325946015,PHYS 1BL,002,491628,Tsai; Philbert S,26,0,30,4
1713325947042,PHYS 1C,A00,491632,Staff,215,0,245,30
1713325948071,PHYS 1CL,001,491635,Tsai; Philbert S,4,0,30,26
1713325948071,PHYS 1CL,002,491643,Tsai; Philbert S,22,0,30,8
1713325949095,PHYS 2AR,A01,491651,Meyertholen; Andrew D.,44,0,50,6
1713325950121,PHYS 2B,A01,491659,Staff,105,0,115,10
1713325951147,PHYS 2BL,A01,491685,Staff,21,0,24,3
1713325951147,PHYS 2BL,A02,491700,Staff,21,0,24,3
1713325952171,PHYS 2C,A01,505161,Staff,102,0,115,13
1713325953197,PHYS 4A,A01,491704,Grinstein; Benjamin,99,0,100,1
1713325954223,POLI 5D,A01,494144,Staff,3,0,5,2
1713325954223,POLI 5D,B01,626283,Dai; Yinlin,5,0,5,0
1713325955247,POLI 12,A00,494145,Staff,43,0,45,2
1713325956271,POLI 13R,A00,494146,Forman; Fonna,45,0,50,5
1713325957296,POLI 27,A01,494148,Staff,54,0,60,6
1713325958321,POLI 30,A00,494149,Staff,49,0,50,1
1713325959348,POLI 100DA,A00,494150,Staff,21,0,25,4
1713325961400,POLI 100I,A00,494152,Staff,27,0,30,3
1713325962427,POLI 104B,A00,494153,Smith; Glenn Chatmas,53,0,55,2
1713325963452,POLI 104F,A00,494154,Staff,28,0,30,2
1713325964479,POLI 104I,A00,494155,Smith; Glenn Chatmas,29,0,30,1
1713325965504,POLI 110C,A00,494156,Ingham; Sean,23,0,25,2
1713325966530,POLI 117R,A00,494157,Forman; Fonna,8,0,20,12
1713325967558,POLI 118,A00,494158,Ingham; Sean,21,0,25,4
1713325968587,POLI 120H,A00,494159,Fisk; David Lee,39,0,45,6
1713325969612,POLI 131CR,A00,494160,Hoston; Germaine,35,0,45,10
1713325970636,POLI 133J,A00,494161,Staff,33,0,35,2
1713325971661,POLI 135,A00,494162,Fisk; David Lee,33,0,35,2
1713325972686,POLI 140A,A00,494164,Staff,20,0,30,10
1713325973714,POLI 142I,A00,494165,Staff,30,0,30,0
1713325974741,POLI 144D,A00,494166,Staff,23,0,25,2
1713325975766,POLI 151,A00,494167,Staff,30,0,30,0
1713325976790,POLI 153,A00,494168,Staff,33,0,35,2
1713325977815,POLI 160AA,A00,494169,Staff,34,0,40,6
1713325978840,POLI 162,A00,494170,Mignozzetti; Umberto,19,0,25,6
1713325979864,POLI 171,A00,494171,Mignozzetti; Umberto,20,0,25,5
1713325980892,PSYC 1,A00,494172,Staff,96,0,100,4
1713325981921,PSYC 2,A00,494173,Moranton; Nirelia Melbina-,34,0,50,16
1713325982945,PSYC 3,A00,494174,Staff,29,0,30,1
1713325983974,PSYC 6,A00,494175,Staff,17,0,20,3
1713325985003,PSYC 60,A01,494177,Staff,38,0,45,7
1713325986028,PSYC 70,A01,505724,Geller; Emma Harlan,42,0,45,3
1713325987055,PSYC 101,A00,494180,Heyman; Gail D.,84,0,100,16
1713325988081,PSYC 105,A00,494181,Geller; Emma Harlan,52,0,90,38
1713325989106,PSYC 106,A00,494182,Dobkins; Karen R.,29,0,45,16
1713325990131,PSYC 108,A00,494183,Adrian; Julia Anna,90,0,100,10
1713325991159,PSYC 114,A01,494185,Winkielman; Piotr,0,2,30,30
1713325992182,PSYC 122,A00,494186,Moranton; Nirelia Melbina-,30,0,50,20
1713325993207,PSYC 124,A00,494187,Chapman; Eddie Nathaniel,71,0,80,9
1713325994234,PSYC 131,A00,494188,Anagnostaras; Stephan,43,0,80,37
1713325995259,PSYC 144,A00,494189,Staff,5,0,50,45
1713325996284,PSYC 154,A00,494190,Lacefield; Katharine I,108,0,180,72
1713325997310,PSYC 162,A00,494191,Wixted; John T,71,0,100,29
1713325998339,PSYC 172,A00,494192,Gorman; Michael R.,36,0,45,9
1713325999364,PSYC 178,A00,494193,Glaser; Dale,34,0,45,11
1713326000391,PSYC 193,A00,505725,Chapman; Eddie Nathaniel,20,0,20,0
1713326001419,RELI 145GS,A00,519817,Rahimi; Babak,18,0,20,2
1713326002443,SE 101A,A01,490862,Chadha; Mayank,23,0,25,2
1713326003469,SE 101C,A01,490924,Krysl; Petr,16,0,20,4
1713326004493,SE 110A,A01,490928,Staff,19,0,20,1
1713326005521,SE 130A,A00,490929,Morrison; Machel Leigh,56,0,70,14
1713326006546,SIO 1,A01,519325,Staff,39,0,40,1
1713326007572,SIO 30,A01,519327,Staff,38,0,40,2
1713326008597,SIO 40,A00,519328,Staff,39,0,40,1
1713326009621,SIO 46GS,A00,519819,Cook; Geoffrey W,17,0,25,8
1713326010650,SIO 109R,A00,494197,Forman; Fonna,0,3,20,20
1713326011675,SIO 121GS,A00,519827,Cook; Geoffrey W,17,0,25,8
1713326012699,SIO 132,A01,519330,Staff,38,0,40,2
1713326013726,SIO 133,A01,519397,Staff,37,0,40,3
1713326014754,SIO 139,A00,519396,Kacev; David,30,0,40,10
1713326015779,SOCI 1,A01,494199,Thorpe; Charles Robert,21,0,30,9
1713326015779,SOCI 1,A02,494200,Thorpe; Charles Robert,30,0,30,0
1713326015779,SOCI 1,A03,494201,Thorpe; Charles Robert,29,0,30,1
1713326015779,SOCI 1,A04,494202,Thorpe; Charles Robert,29,0,30,1
1713326015779,SOCI 1,A05,494203,Thorpe; Charles Robert,29,0,30,1
1713326015779,SOCI 1,A06,494204,Thorpe; Charles Robert,30,0,30,0
1713326015779,SOCI 1,A07,494205,Thorpe; Charles Robert,28,0,30,2
1713326016804,SOCI 60,A01,494207,Staff,34,0,40,6
1713326016804,SOCI 60,A02,494208,Staff,39,0,40,1
1713326017828,SOCI 100,A01,494210,Payne; Christine Anna,25,0,30,5
1713326017828,SOCI 100,A02,494211,Payne; Christine Anna,26,0,30,4
1713326018855,SOCI 109M,A00,494212,Staff,20,0,20,0
1713326019882,SOCI 110,A00,494213,Staff,34,0,40,6
1713326021934,SOCI 118E,A00,494215,Ng; Kwai,37,0,40,3
1713326022963,SOCI 125,A00,494216,Calderon-Zaks; Michael Aar,40,0,45,5
1713326023989,SOCI 126,A01,494218,Jones; Makeba,3,0,5,2
1713326025017,SOCI 131,A00,494219,Thorpe; Charles Robert,26,0,30,4
1713326027072,SOCI 135,A00,494221,Payne; Christine Anna,28,0,50,22
1713326028098,SOCI 136E,A00,626690,Ruiz; Jonathan Joseph,24,0,25,1
1713326029123,SOCI 138GS,A00,494222,Navon; Daniel,24,0,28,4
1713326031176,SOCI 145,A00,494224,Staff,40,0,45,5
1713326032202,SOCI 153,A00,494225,Staff,28,0,30,2
1713326033227,SOCI 160E,A00,494226,Ng; Kwai,29,0,40,11
1713326034251,SOCI 180,A00,494227,Staff,29,0,30,1
1713326035277,SOCI 189GS,A00,494228,Ribas Norris; Janet Vanesa,11,0,11,0
1713326036304,SOCI 190GS,A00,553232,Ribas Norris; Janet Vanesa,11,0,11,0
1713326037333,SOMI 220,A00,627178,Schneid; Stephen David,30,0,30,0
1713326038361,SYN 2,001,490768,Staff,14,0,15,1
1713326038361,SYN 2,002,490769,Staff,15,0,15,0
1713326038361,SYN 2,004,490775,Staff,0,0,0,0
1713326038361,SYN 2,003,490774,Staff,0,0,0,0
1713326038361,SYN 2,005,490776,Staff,0,0,0,0
1713326039388,SYN 2R,001,490779,Staff,11,0,15,4
1713326039388,SYN 2R,002,514635,Staff,14,0,15,1
1713326040469,SYN 100,A01,490783,Staff,11,0,20,9
1713326040469,SYN 100,B01,490787,Staff,8,0,20,12
1713326040469,SYN 100,C01,490789,Staff,10,0,20,10
1713326041495,SYN 150,A00,490817,Staff,14,0,15,1
1713326041495,SYN 150,B00,514610,Staff,15,0,15,0
1713326042520,TDAC 1,A00,492753,Walsh; Kim C.,19,0,20,1
1713326042520,TDAC 1,B00,492754,Harting; Carla Kelso,19,0,20,1
1713326042520,TDAC 1,C00,513995,Salovey; Todd,15,0,20,5
1713326043547,TDAC 101,A00,492766,Harting; Carla Kelso,17,0,20,3
1713326044571,TDAC 102,A00,492768,Basso; Beatrice,19,0,20,1
1713326045596,TDDE 111,A00,492769,Staff,25,0,25,0
1713326046621,TDDE 131,A00,492770,Staff,15,0,15,0
1713326046621,TDDE 131,B00,492771,Staff,15,0,15,0
1713326047646,TDDE 131GS,A00,523716,Guirguis; Mark C,23,0,28,5
1713326048672,TDGE 1,A01,492756,Salovey; Todd,56,0,60,4
1713326049696,TDGE 5,A01,492758,Staff,23,0,25,2
1713326050721,TDGE 10,A00,492759,Fulton; Julia,203,0,220,17
1713326051746,TDGE 11,A00,492760,Castro; Robert Jess,198,0,200,2
1713326053798,TDGE 124,A00,492772,Fulton; Julia,185,0,220,35
1713326054827,TDGE 125,A00,492773,Meyer; Ursula,38,0,50,12
1713326054827,TDGE 125,B00,492774,Staff,49,0,50,1
1713326054827,TDGE 125,C00,523565,Staff,48,0,50,2
1713326055855,TDGE 125GS,A00,523580,Guirguis; Mark C,23,0,28,5
1713326056880,TDGE 127,A00,492775,Havis; Allan,34,0,50,16
1713326057909,TDHT 101,A00,492776,Staff,34,0,35,1
1713326058937,TDMV 1,A00,492762,Caligagan; Maria T.,30,0,30,0
1713326058937,TDMV 1,B00,492763,Arcidiacono; Kristin,26,0,30,4
1713326059967,TDMV 2,A00,492764,Weinberg; Sadie,28,0,30,2
1713326060991,TDMV 3,A00,492765,Mack; Kara Shanai',37,0,40,3
1713326062015,TDMV 138,A00,492777,Mack; Kara Shanai',34,0,40,6
1713326063045,TDMV 140,A00,492778,Lima; Paulo Henrique,40,0,40,0
1713326064070,TDMV 142,A00,492779,Caligagan; Maria T.,33,0,40,7
1713326064070,TDMV 142,B00,492780,Caligagan; Tony,37,0,40,3
1713326065095,TDMV 143,A00,492781,Fyall; Daunte Edward,39,0,40,1
1713326066120,USP 1,A01,492401,Kwak; Nancy,27,0,35,8
1713326067145,USP 2,A01,492453,Hinds; Juli Beth,35,0,35,0
1713326068170,USP 3,A01,492516,Staff,28,0,35,7
1713326069195,USP 4,A00,492522,McTague; Sarah,16,0,25,9
1713326070222,USP 100,A00,492523,Staff,32,0,35,3
1713326071247,USP 101,A00,492524,Staff,13,0,15,2
1713326072273,USP 105,A00,492525,Staff,21,0,25,4
1713326073297,USP 151,A00,492526,Shenkman; Michael Thomas,32,0,35,3
1713326074323,USP 170,A00,492545,Hinds; Juli Beth,33,0,35,2
1713326075349,USP 171GS,A00,492608,Bussell; Mirle Rabinowitz,24,0,28,4
1713326076375,USP 183GS,A00,492613,Peerson; Susan,24,0,28,4
1713326077400,VIS 30,A01,490693,Yoldas; Pinar,19,0,22,3
1713326077400,VIS 30,A02,490694,Yoldas; Pinar,18,0,22,4
1713326078426,VIS 83,A00,490695,Kester; Grant,63,0,75,12
1713326079453,VIS 105D,A00,490696,Staff,22,0,25,3
1713326080476,VIS 124CN,A00,490699,Rose; Jordan M,65,0,75,10
1713326081502,VIS 125GS,A00,511221,Williams; Alena J,21,0,22,1
1713326082527,VIS 128D,A00,490700,Staff,73,0,75,2
1713326083555,VIS 151,A01,490717,Staff,33,0,34,1
1713326083555,VIS 151,A02,490766,Staff,33,0,34,1
1713326084585,VIS 154GS,A00,511972,Williams; Alena J,21,0,22,1
1713326085612,VIS 160A,A00,490767,Stone; Patricia,7,0,10,3
1713326086638,WCWP 10A,A00,490638,Staff,14,0,15,1
1713326086638,WCWP 10A,B00,490640,Staff,15,0,15,0
1713326087665,WCWP 10B,A00,490641,Staff,0,0,0,0
1713326087665,WCWP 10B,B00,490642,Staff,14,0,15,1
1713326087665,WCWP 10B,C00,490644,Staff,13,0,15,2
1713326087665,WCWP 10B,D00,490647,Staff,0,0,0,0
1713326088690,WCWP 100,A00,490655,Staff,0,0,0,0
1713326088690,WCWP 100,B00,490687,Staff,10,0,15,5
1713326090796,ANAR 153,A00,487222,Braswell; Geoffrey E.,54,0,60,6
1713326091825,ANBI 134,A00,487223,Staff,6,0,20,14
1713326092853,ANBI 143GS,A00,487224,Noel; Geoffroy Pierre Jean,18,0,24,6
1713326093880,ANBI 144GS,A00,519548,Noel; Geoffroy Pierre Jean,18,0,24,6
1713326094912,ANSC 101,A00,487225,Staff,18,0,20,2
1713326095935,ANSC 125,A00,487227,Brenner; Suzanne A,39,0,40,1
1713326097993,ANSC 146,A00,487229,Staff,35,0,40,5
1713326099017,ANSC 148,A00,487230,Olivas Hernandez; Olga Lid,39,0,40,1
1713326100041,ANSC 150,A00,504165,Sloane; Julia Kathryn,18,0,20,2
1713326101065,ANSC 180,A00,487232,Staff,14,0,15,1
1713326102091,ANSC 188,A00,627155,Staff,39,0,40,1
1713326103120,ANTH 5,A00,519529,Semendeferi; Ekaterini,15,0,15,0
1713326104147,ANTH 10,A00,487219,Staff,58,0,60,2
1713326105178,ANTH 23,A01,487221,Staff,17,0,20,3
1713326106201,ANTH 102,A00,487233,Wilder; Linnea Lorene,51,0,60,9
1713326107231,ANTH 103,A00,487234,Varma; Saiba,55,0,60,5
1713326108255,ANTH 105,A00,487235,Stewart; Alexander B,55,0,60,5
1713326109278,BENG 100,A01,516685,Taylor Amos; Alyssa C,27,0,30,3
1713326110306,BIBC 102,A01,491316,Flagg; Matthew Paul,14,0,88,74
1713326110306,BIBC 102,A02,491366,Flagg; Matthew Paul,78,0,88,10
1713326111335,BIBC 103,A01,491486,Boumechache; Miyyada,16,0,24,8
1713326111335,BIBC 103,A02,491487,Boumechache; Miyyada,24,0,24,0
1713326112363,BICD 100,A01,516882,Staff,73,0,75,2
1713326112363,BICD 100,A02,516890,Staff,69,0,75,6
1713326113391,BICD 102GS,A00,491488,Lo; Stanley M.,26,0,28,2
1713326114416,BIEB 136GS,A00,516940,Holway; David A. & Shurin; Jonathan,18,0,24,6
1713326115443,BIEB 137GS,A01,517034,Holway; David A. & Shurin; Jonathan,18,0,24,6
1713326116468,BIEB 138GS,A01,491492,Pirino; Giorgia,21,0,28,7
1713326117493,BILD 1,A01,491296,Staff,60,0,63,3
1713326117493,BILD 1,A02,491297,Staff,63,0,63,0
1713326118518,BILD 4,A01,517099,Gonzalez Gamboa; Ivonne,22,0,24,2
1713326118518,BILD 4,A02,517100,Gonzalez Gamboa; Ivonne,24,0,24,0
1713326119544,BILD 60GS,A00,491309,Lo; Stanley M.,26,0,28,2
1713326120567,BIMM 100,A01,517136,Staff,85,0,100,15
1713326121592,BIMM 110,A01,517182,Staff,58,0,100,42
1713326122622,BIMM 120,A01,517228,Pickett; Brooke Elizabeth,29,0,63,34
1713326122622,BIMM 120,A02,517240,Pickett; Brooke Elizabeth,44,0,63,19
1713326123650,BIMM 132GS,A01,491498,Pirino; Giorgia,21,0,28,7
1713326124682,BIMM 143,A01,491589,Bozinovic; Goran,13,0,40,27
1713326125706,BIPN 100,A01,491594,Armour; Jon Christopher,88,0,100,12
1713326126731,BIPN 140,A01,491602,Marino; Marc J,26,0,50,24
1713326128784,CAT 125,A00,515973,Staff,18,0,20,2
1713326129807,CAT 125GS,A00,515974,Rahimi; Babak,17,0,20,3
1713326130836,CAT 125R,A00,515980,Staff,12,0,20,8
1713326130836,CAT 125R,B00,515981,Tosun; Adriana,19,0,20,1
1713326130836,CAT 125R,C00,515987,Hyland; Tina Mae,0,2,20,20
1713326130836,CAT 125R,D00,515988,Bronstein; Phoebe Malan,17,0,20,3
1713326131863,CENG 15,A01,488699,Drews; Aaron,25,0,25,0
1713326132890,CENG 100,A00,505196,Opatkiewicz; Justin Paul,25,0,25,0
1713326133919,CGS 2A,A01,489598,Staff,33,0,35,2
1713326134949,CGS 112,A00,489599,Staff,15,0,15,0
1713326135972,CGS 119,A00,489603,Staff,10,0,10,0
1713326137000,CGS 120,A00,489604,Staff,14,0,15,1
1713326138026,CGS 150,A00,489607,Staff,15,0,15,0
1713326139055,CHEM 6A,A01,488715,Staff,98,0,100,2
1713326140083,CHEM 6B,A01,488719,Piercy; Marc Anthony,99,0,100,1
1713326141109,CHEM 6C,A01,488723,Albizati; Kim F.,93,0,100,7
1713326142135,CHEM 7L,A01,488728,Schurmeier; Kimberly,18,0,24,6
1713326142135,CHEM 7L,A02,488730,Schurmeier; Kimberly,23,0,24,1
1713326142135,CHEM 7L,A03,488734,Schurmeier; Kimberly,20,0,24,4
1713326142135,CHEM 7L,A04,488763,Schurmeier; Kimberly,23,0,24,1
1713326142135,CHEM 7L,B01,488798,Schurmeier; Kimberly,17,0,24,7
1713326142135,CHEM 7L,B02,488801,Schurmeier; Kimberly,23,0,24,1
1713326142135,CHEM 7L,B03,488808,Schurmeier; Kimberly,23,0,24,1
1713326142135,CHEM 7L,B04,488811,Schurmeier; Kimberly,24,0,24,0
1713326143163,CHEM 11,A01,488897,Stallings; Dontarie M,95,0,100,5
1713326144244,CHEM 40A,A01,488913,Albizati; Kim F.,84,0,100,16
1713326145274,CHEM 40B,A01,488920,Weizman; Haim,43,0,50,7
1713326145274,CHEM 40B,A02,488938,Weizman; Haim,45,0,50,5
1713326146299,CHEM 41A,A01,489029,Klosterman; Jeremy K,57,0,60,3
1713326147324,CHEM 41C,A01,500436,Tor; Yitzhak,55,0,60,5
1713326148349,CHEM 43A,A01,500426,Weizman; Haim,0,0,24,24
1713326148349,CHEM 43A,A02,500430,Weizman; Haim,9,0,24,15
1713326148349,CHEM 43A,B01,514041,Klosterman; Jeremy K,16,0,24,8
1713326148349,CHEM 43A,B02,514047,Klosterman; Jeremy K,23,0,24,1
1713326149379,CHEM 108,A01,489140,Jennings; Patricia A.,11,0,24,13
1713326149379,CHEM 108,A02,489142,Jennings; Patricia A.,14,0,24,10
1713326150408,CHEM 114A,A01,489147,Stallings; Dontarie M,70,0,100,30
1713326151433,CHIN 169A,A00,489171,Wang; Xiao,19,0,20,1
1713326153488,COGS 3,A01,518827,Boyle; Mary E. T.,26,0,40,14
1713326154515,COGS 11,A01,489175,Staff,27,0,30,3
1713326155539,COGS 14A,A01,518829,Staff,51,0,60,9
1713326156563,COGS 14B,A01,489177,Hoffman; Drew Ellen,64,0,75,11
1713326157591,COGS 100,A01,489181,Allen; Michael Gordon,63,0,75,12
1713326158617,COGS 101A,A01,489183,Staff,46,0,60,14
1713326159642,COGS 101B,A01,489185,Allen; Michael Gordon,8,0,30,22
1713326160667,COGS 101C,A01,526786,Staff,23,0,30,7
1713326162723,COGS 107A,A01,489189,Boyle; Mary E. T.,18,0,35,17
1713326163748,COGS 107B,A01,627144,Mooshagian; Eric Frederick,60,0,60,0
1713326164776,COGS 118A,A01,489191,Staff,0,44,40,40
1713326166829,COGS 171GS,A01,489194,Pineda; Jaime A,20,0,28,8
1713326167855,COGS 172,A01,489196,Staff,3,0,30,27
1713326168882,COGS 174GS,A01,489264,Pineda; Jaime A,20,0,28,8
1713326169908,COGS 180,A01,627150,Staff,28,0,30,2
1713326170933,COGS 186,A01,489274,Staff,0,1,30,30
1713326171961,COMM 10,A01,489276,Staff,23,0,25,2
1713326171961,COMM 10,A02,489303,Staff,23,0,25,2
1713326172988,COMM 100A,A01,489312,Staff,14,0,25,11
1713326172988,COMM 100A,A02,489313,Staff,24,0,25,1
1713326174012,COMM 106T,A00,512540,Staff,33,0,35,2
1713326175037,COMM 107,A00,489347,Staff,27,0,35,8
1713326176063,COMM 109P,A00,489358,Staff,31,0,35,4
1713326177088,COMM 132,A00,489361,McKenna; Denise,27,0,30,3
1713326178115,COMM 146,A00,489362,Halm; Gavin Patrick,26,0,30,4
1713326179139,COMM 190,A00,489363,Abuelhiga; Soraya Jill,17,0,23,6
1713326180165,CSE 8A,A50,489366,Staff,21,0,25,4
1713326180165,CSE 8A,A51,489367,Staff,24,0,25,1
1713326181190,CSE 11,A01,489398,Cao; Yingjun,75,0,100,25
1713326182217,CSE 12,A01,489487,Staff,43,0,50,7
1713326183243,CSE 20,A01,489497,Staff,48,0,50,2
1713326184268,CSE 21,A01,489517,Braun; Oliver,42,0,50,8
1713326185295,CSE 101,A01,489524,Braun; Oliver,0,28,50,50
1713326186325,CSE 105,A01,512594,Jones; Miles E,73,0,100,27
1713326186325,CSE 105,B01,512598,Jones; Miles E,52,0,100,48
1713326187360,CSE 140,A01,489538,Staff,41,0,50,9
1713326188388,CSE 141,A01,489550,Eldon; John,68,0,100,32
1713326189414,CSE 141L,A01,489571,Eldon; John,66,0,100,34
1713326190442,CSE 151A,A01,489583,Solares; Edwin A,141,0,200,59
1713326191470,CSE 175,A01,510886,Kumar; Rakesh,30,0,30,0
1713326192498,CSE 190,A00,516828,Dubnov; Shlomo,38,0,49,11
1713326193522,DOC 100D,A00,489667,Pass; Natalye Joann,19,0,25,6
1713326194549,DSC 10,A01,624268,Staff,72,0,75,3
1713326195577,DSC 20,A01,624476,Staff,50,0,50,0
1713326196602,DSC 40A,A01,624608,Staff,39,0,40,1
1713326197628,DSGN 1,A01,489179,Rill; Bryan,33,0,50,17
1713326198654,ECE 17,A01,490489,Sahay; Rajeev,18,0,30,12
1713326199680,ECE 65,A50,490492,Staff,12,0,20,8
1713326199680,ECE 65,A51,490493,Staff,18,0,20,2
1713326200704,ECON 1,A01,489715,Famulari; Melissa,68,0,70,2
1713326201731,ECON 2,A01,489717,Levkoff; Steven B.,68,0,70,2
1713326202756,ECON 3,A01,489948,Staff,70,0,70,0
1713326204810,ECON 5,A01,490103,Staff,27,0,30,3
1713326204810,ECON 5,B01,626281,Dai; Yinlin,45,0,45,0
1713326205835,ECON 100A,A01,490127,Famulari; Melissa,65,0,70,5
1713326206860,ECON 100B,A01,490129,Staff,64,0,70,6
1713326207885,ECON 109,A01,490187,Shishkin; Denis,27,0,35,8
1713326208912,ECON 110A,A01,490190,Levkoff; Steven B.,60,0,70,10
1713326209941,ECON 120A,A01,490245,Dai; Yinlin,61,0,70,9
1713326210970,ECON 120B,A01,490247,Nieto-Barthaburu; Augusto,43,0,70,27
1713326211995,ECON 120C,A01,490253,Sun; Yixiao,30,0,35,5
1713326211995,ECON 120C,B01,490255,Sun; Yixiao,34,0,35,1
1713326213019,ECON 129,A00,490256,Eckert; Fabian Paul,23,0,35,12
1713326214048,ECON 131,A00,490257,Nieto-Barthaburu; Augusto,0,6,35,35
1713326215073,ECON 138,A00,490258,Bharadwaj; Prashant,13,0,35,22
1713326215073,ECON 138,B00,490259,Bharadwaj; Prashant,15,0,35,20
1713326216097,ECON 159,A00,490260,Hendrickson; Gerald M.,0,10,0,0
1713326217121,ECON 178,A01,553995,Zhu; Ying,24,0,35,11
1713326218150,EDS 40,A01,512576,Black; Alison Michelle,20,0,20,0
1713326219176,EDS 107,A01,515848,Staff,30,0,30,0
1713326220201,EDS 110R,A01,490262,Staff,26,0,30,4
1713326221230,EDS 112,A01,490264,Chapman; Thandeka K,40,0,50,10
1713326222254,EDS 113,A00,490266,Staff,26,0,30,4
1713326223278,EDS 118,A00,490267,Warstadt; Melissa Fawn,21,0,30,9
1713326224304,EDS 124BR,A00,490268,Eguchi; Emi,4,0,25,21
1713326224304,EDS 124BR,B00,490269,Eguchi; Emi,23,0,25,2
1713326225329,EDS 126,A01,490271,Jones; Makeba,43,0,50,7
1713326226358,EDS 135,A01,490316,Staff,19,0,20,1
1713326227383,ENVR 142GS,A00,519514,Chang; Edmond Yi-Teh,27,0,28,1
1713326228413,ETHN 103,A00,490504,Staff,26,0,36,10
1713326229441,ETHN 103A,A00,490505,Man; Simeon S,4,0,9,5
1713326230467,ETHN 109,A00,490506,Staff,28,0,30,2
1713326231492,ETHN 118,A00,490507,Staff,35,0,36,1
1713326232516,ETHN 119,A00,490508,Staff,33,0,36,3
1713326233545,ETHN 121R,A00,490518,Choi; Esther Min,23,0,36,13
1713326234569,ETHN 127,A00,490528,Staff,14,0,15,1
1713326235593,ETHN 139,A00,490573,Staff,10,0,10,0
1713326236621,ETHN 150,A00,490575,Staff,15,0,15,0
1713326237646,GLBH 20,A00,491705,Elwardani; Nile Regina,38,0,40,2
1713326238673,GLBH 101,A00,491706,Staff,20,0,20,0
1713326239699,GLBH 111,A01,491708,Burgos; Jose L.,15,0,15,0
1713326240727,GLBH 146,A00,491709,Staff,9,0,20,11
1713326241752,GLBH 148,A00,491710,Olivas Hernandez; Olga Lid,11,0,20,9
1713326242780,GLBH 150,A00,491711,Sloane; Julia Kathryn,19,0,20,1
1713326243805,HIEA 131,A00,491760,Staff,28,0,32,4
1713326244829,HIEA 153,A00,491762,Staff,28,0,30,2
1713326245853,HIEU 124,A00,491811,Staff,26,0,32,6
1713326246879,HIEU 124GS,A00,491812,Markman; Kristina,27,0,28,1
1713326247958,HIEU 147,A00,491813,Staff,30,0,32,2
1713326248986,HIEU 149GS,A00,491816,Caldwell; Michael Alan,28,0,28,0
1713326250014,HILD 2C,A01,491713,Hendrickson; Gerald M.,26,0,30,4
1713326251039,HILD 7B,A01,491715,Kwak; Nancy,0,0,30,30
1713326252063,HILD 10,A01,491717,Staff,11,0,20,9
1713326253089,HILD 30GS,A00,491719,Edington; Claire Ellen,24,0,28,4
1713326254116,HINE 109,A00,491818,Shafir; Nir,27,0,32,5
1713326255141,HINE 128,A00,491821,Shafir; Nir,31,0,32,1
1713326256165,HISC 117,A00,491830,Staff,27,0,32,5
1713326257191,HIUS 103,A00,491834,Man; Simeon S,14,0,23,9
1713326258219,HIUS 108B,A00,491835,Staff,28,0,30,2
1713326259241,HIUS 141,A00,491836,Hendrickson; Gerald M.,28,0,32,4
1713326260266,HIUS 149,A00,491839,Staff,24,0,32,8
1713326261295,HUM 3,A01,512617,Crum; Matthew Stephen,43,0,50,7
1713326261295,HUM 3,A02,512618,Crum; Matthew Stephen,48,0,50,2
1713326262321,HUM 3GS,A00,512663,Markman; Kristina,0,0,0,1
1713326262321,HUM 3GS,B00,512664,Staff,0,0,0,0
1713326263346,HUM 4,A01,512620,West; Geoffrey Scott,28,0,50,22
1713326264371,HUM 4GS,A00,512666,Lyon; Antony J.,0,0,0,4
1713326265396,HUM 4R,A01,512625,Watkins; Eric,49,0,50,1
1713326266421,HUM 5,A01,512649,Zavodny; Tatiana Sophia,24,0,50,26
1713326266421,HUM 5,B01,512661,Zroka; Ryan Edward,48,0,50,2
1713326267446,INTL 190,A00,490577,Segui; Alan S,0,0,0,5
1713326268469,JAPN 20AR,A01,491267,Ross; Kayoko F,8,0,20,12
1713326269496,JAPN 180,A00,491285,Berman; Michael David,33,0,40,7
1713326270522,LATI 50,A01,502536,Kokinis; Troy Andreas,16,0,22,6
1713326270522,LATI 50,A02,502551,Kokinis; Troy Andreas,22,0,22,0
1713326270522,LATI 50,A03,502650,Kokinis; Troy Andreas,22,0,22,0
1713326270522,LATI 50,A04,502909,Kokinis; Troy Andreas,21,0,22,1
1713326271547,LATI 160,A01,502920,Kokinis; Troy Andreas,30,0,30,0
1713326272569,LIFR 1A,A00,490494,Van Moer; Vinciane G,17,0,20,3
1713326273598,LIFR 1AX,A00,490495,Van Moer; Vinciane G,17,0,20,3
1713326274623,LIFR 1B,A00,490496,Van Moer; Vinciane G,18,0,20,2
1713326275650,LIFR 1BX,A00,490497,Van Moer; Vinciane G,18,0,20,2
1713326276680,LIGN 8,A00,505198,McIntosh; Justin Daniel,134,0,150,16
1713326277705,LIGN 9GS,A00,491239,Lott; Margaret S.,18,0,20,2
1713326278733,LIGN 101,A01,505200,McIntosh; Justin Daniel,23,0,30,7
1713326279757,LIGN 120,A01,491244,Staff,23,0,30,7
1713326280786,LIGN 149GS,A00,491245,Lott; Margaret S.,18,0,20,2
1713326281811,LIGN 170,A00,491247,Staff,22,0,30,8
1713326282835,LISP 1D,A00,490498,Munoz Sanchez; Alicia,9,0,14,5
1713326282835,LISP 1D,B00,490499,Munoz Sanchez; Alicia,6,0,14,8
1713326282835,LISP 1D,C00,490500,Munoz Sanchez; Alicia,7,0,14,7
1713326282835,LISP 1D,D00,490501,Munoz Sanchez; Alicia,10,0,14,4
1713326283863,LISP 1DX,A00,490502,Munoz Sanchez; Alicia,14,0,28,14
1713326283863,LISP 1DX,B00,490503,Munoz Sanchez; Alicia,16,0,28,12
1713326285917,LTAM 110,A00,491847,Staff,23,0,25,2
1713326286945,LTCS 119,A00,491848,Staff,11,0,15,4
1713326287970,LTCS 130,A00,491849,Staff,24,0,25,1
1713326290021,LTEA 120C,A00,491852,Staff,32,0,40,8
1713326291049,LTEN 130GS,A00,491853,Lyon; Antony J.,24,0,28,4
1713326292076,LTEN 148,A00,491855,Staff,23,0,25,2
1713326293100,LTEN 159,A00,491856,Staff,21,0,25,4
1713326294131,LTEN 180,A00,491857,Staff,8,0,15,7
1713326296185,LTSP 123GS,A00,505928,Bessett; Ryan Matthew,24,0,28,4
1713326297211,LTSP 174GS,A00,506037,Bessett; Ryan Matthew,24,0,28,4
1713326299267,LTWR 102,A00,491861,Staff,9,0,15,6
1713326300297,LTWR 106,A00,491862,Staff,8,0,15,7
1713326301322,MAE 11,A00,490930,Bahadori; Mohammad Yousef,95,0,100,5
1713326302348,MAE 30A,A00,490931,Qi; Huihui,37,0,40,3
1713326303376,MAE 101A,A00,491036,Sadeghizadeh; Zahra,92,0,100,8
1713326304403,MAE 101C,A00,491037,Seshadri; Kalyanasundaram,67,0,100,33
1713326305427,MAE 113,A00,491040,Seshadri; Kalyanasundaram,66,0,80,14
1713326306453,MAE 131A,A00,491041,Ghazinejad; Maziar,37,0,40,3
1713326307477,MAE 142,A00,491053,Staff,39,0,40,1
1713326308503,MAE 143A,A00,491054,Staff,33,0,50,17
1713326309528,MAE 150,A00,491092,Truong; Phuong Thi Ngoc,23,0,35,12
1713326310553,MATH 3C,A01,494031,Pardo Guerra; Sebastian,30,0,30,0
1713326310553,MATH 3C,A02,494032,Pardo Guerra; Sebastian,29,0,30,1
1713326311577,MATH 10A,A01,494034,Staff,27,0,30,3
1713326311577,MATH 10A,A02,494035,Staff,28,0,30,2
1713326311577,MATH 10A,B01,494037,Staff,27,0,30,3
1713326311577,MATH 10A,B02,494038,Staff,29,0,30,1
1713326312610,MATH 10B,A01,494040,Habib; Yousaf,22,0,30,8
1713326312610,MATH 10B,A02,494041,Habib; Yousaf,28,0,30,2
1713326312610,MATH 10B,A03,494042,Habib; Yousaf,29,0,30,1
1713326312610,MATH 10B,A04,494043,Habib; Yousaf,30,0,30,0
1713326312610,MATH 10B,B01,494045,Habib; Yousaf,25,0,30,5
1713326312610,MATH 10B,B02,494046,Habib; Yousaf,30,0,30,0
1713326312610,MATH 10B,B03,494047,Habib; Yousaf,30,0,30,0
1713326312610,MATH 10B,B04,494048,Habib; Yousaf,30,0,30,0
1713326313637,MATH 18,A01,494050,Kemp; Todd Aahron,25,0,30,5
1713326313637,MATH 18,A02,494051,Kemp; Todd Aahron,29,0,30,1
1713326313637,MATH 18,B01,494054,Kemp; Todd Aahron,26,0,30,4
1713326313637,MATH 18,B02,494055,Kemp; Todd Aahron,29,0,30,1
1713326314663,MATH 20A,A01,494059,Suk; Andrew Hoon,30,0,30,0
1713326315691,MATH 20B,A01,494061,Briones; Jor-el Thomas Caparas,33,0,35,2
1713326315691,MATH 20B,B01,494063,Bach; Quang Tran,34,0,35,1
1713326316722,MATH 20C,A01,494065,Staff,28,0,30,2
1713326316722,MATH 20C,A02,494066,Staff,30,0,30,0
1713326316722,MATH 20C,A03,494067,Staff,30,0,30,0
1713326316722,MATH 20C,A04,494068,Staff,30,0,30,0
1713326316722,MATH 20C,B01,494070,Zhang; Ming,25,0,30,5
1713326316722,MATH 20C,B02,494071,Zhang; Ming,27,0,30,3
1713326316722,MATH 20C,B03,494072,Zhang; Ming,29,0,30,1
1713326316722,MATH 20C,B04,494073,Zhang; Ming,29,0,30,1
1713326317746,MATH 20D,A01,494075,Staff,22,0,30,8
1713326317746,MATH 20D,A02,494076,Staff,29,0,30,1
1713326318775,MATH 20E,A01,494079,Staff,24,0,30,6
1713326318775,MATH 20E,A02,494080,Staff,26,0,30,4
1713326318775,MATH 20E,B01,494082,Staff,25,0,30,5
1713326318775,MATH 20E,B02,494083,Staff,25,0,30,5
1713326319798,MATH 103A,A01,494085,Aliabadi Sr.; Mohsen,14,0,30,16
1713326319798,MATH 103A,A02,494086,Aliabadi Sr.; Mohsen,28,0,30,2
1713326319798,MATH 103A,B01,494088,Aliabadi Sr.; Mohsen,21,0,30,9
1713326319798,MATH 103A,B02,494089,Aliabadi Sr.; Mohsen,28,0,30,2
1713326320824,MATH 109,A01,494091,Staff,30,0,30,0
1713326320824,MATH 109,A02,494092,Staff,29,0,30,1
1713326320824,MATH 109,B01,494094,Staff,27,0,30,3
1713326320824,MATH 109,B02,494095,Staff,29,0,30,1
1713326321848,MATH 142A,A01,494097,Chow; Bennett,15,0,30,15
1713326321848,MATH 142A,A02,494098,Chow; Bennett,23,0,30,7
1713326321848,MATH 142A,B01,494100,Chow; Bennett,19,0,30,11
1713326321848,MATH 142A,B02,494101,Chow; Bennett,29,0,30,1
1713326323899,MATH 168A,A01,516677,Dumitriu; Ioana,15,0,35,20
1713326324927,MATH 170A,A01,516679,Dumitriu; Ioana,18,0,30,12
1713326324927,MATH 170A,A02,516680,Dumitriu; Ioana,28,0,30,2
1713326325955,MATH 193A,A01,494107,Staff,14,0,30,16
1713326325955,MATH 193A,A02,494108,Staff,21,0,30,9
1713326325955,MATH 193A,A03,494109,Staff,29,0,30,1
1713326325955,MATH 193A,A04,494110,Staff,22,0,30,8
1713326329030,MGT 16,A00,491930,McKay; Michael J,92,0,98,6
1713326330053,MGT 18,A00,491992,McKay; Michael J,96,0,98,2
1713326331079,MGT 71,A00,492003,Staff,66,0,98,32
1713326332104,MGT 103,A00,505209,Eberhard; Craig A,81,0,98,17
1713326333132,MGT 131A,A00,505210,Anderson; John Charles,89,0,98,9
1713326335179,MGT 153,A00,492077,Perols; Johan Lars,20,0,90,70
1713326338255,MGT 164,A00,492222,McKay; Mary A,91,0,98,7
1713326339280,MGT 172,A00,492245,Staff,59,0,60,1
1713326339280,MGT 172,B00,505526,Hedges; Kathleen,65,0,98,33
1713326340303,MGT 181,A00,505669,Dunn; Louis Jean,82,0,98,16
1713326341331,MMW 14,A01,494399,Staff,15,0,28,13
1713326341331,MMW 14,A02,494400,Staff,25,0,28,3
1713326341331,MMW 14,A03,494401,Staff,28,0,28,0
1713326341331,MMW 14,A04,494402,Staff,28,0,28,0
1713326341331,MMW 14,B01,494404,Carreras; Maria Victoria,8,0,28,20
1713326341331,MMW 14,B02,494405,Carreras; Maria Victoria,25,0,28,3
1713326341331,MMW 14,B03,494406,Carreras; Maria Victoria,27,0,28,1
1713326341331,MMW 14,B04,494407,Carreras; Maria Victoria,28,0,28,0
1713326342358,MMW 14GS,A00,506250,Chang; Edmond Yi-Teh,0,0,0,0
1713326343381,MMW 121R,A01,494415,Adamiak; Patrick John,11,0,28,17
1713326343381,MMW 121R,A02,494416,Adamiak; Patrick John,24,0,28,4
1713326344405,MUS 1A,A01,494113,Staff,12,0,25,13
1713326344405,MUS 1A,A02,494114,Staff,24,0,25,1
1713326345433,MUS 4,A01,494116,Staff,23,0,25,2
1713326345433,MUS 4,A02,494117,Staff,22,0,25,3
1713326346457,MUS 5R,A01,494236,Dubnov; Shlomo,6,0,25,19
1713326346457,MUS 5R,A02,494237,Dubnov; Shlomo,25,0,25,0
1713326347482,MUS 6,A01,494122,Staff,10,0,25,15
1713326347482,MUS 6,A02,494123,Staff,23,0,25,2
1713326348507,MUS 7,A01,494125,Staff,16,0,25,9
1713326348507,MUS 7,A02,494126,Staff,24,0,25,1
1713326349532,MUS 11,A01,494128,Staff,23,0,25,2
1713326349532,MUS 11,A02,494129,Staff,24,0,25,1
1713326350561,MUS 13,A01,494131,Staff,25,0,25,0
1713326350561,MUS 13,A02,494132,Staff,25,0,25,0
1713326351639,MUS 15,A01,494134,Staff,17,0,25,8
1713326351639,MUS 15,A02,494135,Staff,25,0,25,0
1713326351639,MUS 15,B01,494137,Staff,24,0,25,1
1713326352664,MUS 80,A00,494232,Staff,24,0,25,1
1713326352664,MUS 80,B00,494233,Staff,25,0,25,0
1713326352664,MUS 80,C00,494234,Staff,23,0,25,2
1713326353689,MUS 95C,A00,494141,Staff,70,0,75,5
1713326354714,MUS 114,A00,494142,Staff,40,0,50,10
1713326355738,NANO 15,A01,490636,Drews; Aaron,7,0,7,0
1713326356763,PHIL 1,A00,490578,Grush; Rick Scott,49,0,50,1
1713326357788,PHIL 10,A01,490580,Grush; Rick Scott,33,0,35,2
1713326357788,PHIL 10,A02,490586,Grush; Rick Scott,32,0,35,3
1713326358817,PHIL 27,A01,490591,Staff,22,0,25,3
1713326358817,PHIL 27,A02,490592,Staff,25,0,25,0
1713326358817,PHIL 27,A03,490593,Staff,25,0,25,0
1713326358817,PHIL 27,A04,490598,Staff,25,0,25,0
1713326359845,PHIL 32,A01,490611,Staff,20,0,20,0
1713326359845,PHIL 32,A02,490618,Staff,20,0,20,0
1713326360873,PHIL 90,A00,490624,Staff,40,0,40,0
1713326361901,PHIL 136,A00,490627,Cohen; Jonathan David,37,0,40,3
1713326362926,PHIL 155,A00,490634,Staff,62,0,70,8
1713326363956,PHYS 1A,A00,491610,Staff,245,0,250,5
1713326364999,PHYS 1AL,001,491616,Tsai; Philbert S,27,0,30,3
1713326364999,PHYS 1AL,002,491618,Tsai; Philbert S,30,0,30,0
1713326366024,PHYS 1B,A00,491623,Staff,236,0,250,14
1713326367050,PHYS 1BL,001,491626,Tsai; Philbert S,22,0,30,8
1713326367050,PHYS 1BL,002,491628,Tsai; Philbert S,26,0,30,4
1713326368075,PHYS 1C,A00,491632,Staff,215,0,245,30
1713326369099,PHYS 1CL,001,491635,Tsai; Philbert S,4,0,30,26
1713326369099,PHYS 1CL,002,491643,Tsai; Philbert S,22,0,30,8
1713326370125,PHYS 2AR,A01,491651,Meyertholen; Andrew D.,44,0,50,6
1713326371149,PHYS 2B,A01,491659,Staff,105,0,115,10
1713326372174,PHYS 2BL,A01,491685,Staff,21,0,24,3
1713326372174,PHYS 2BL,A02,491700,Staff,21,0,24,3
1713326373198,PHYS 2C,A01,505161,Staff,102,0,115,13
1713326374225,PHYS 4A,A01,491704,Grinstein; Benjamin,99,0,100,1
1713326375256,POLI 5D,A01,494144,Staff,3,0,5,2
1713326375256,POLI 5D,B01,626283,Dai; Yinlin,5,0,5,0
1713326376284,POLI 12,A00,494145,Staff,43,0,45,2
1713326377313,POLI 13R,A00,494146,Forman; Fonna,45,0,50,5
1713326378339,POLI 27,A01,494148,Staff,54,0,60,6
1713326379363,POLI 30,A00,494149,Staff,49,0,50,1
1713326380388,POLI 100DA,A00,494150,Staff,21,0,25,4
1713326382437,POLI 100I,A00,494152,Staff,27,0,30,3
1713326383466,POLI 104B,A00,494153,Smith; Glenn Chatmas,53,0,55,2
1713326384491,POLI 104F,A00,494154,Staff,28,0,30,2
1713326385518,POLI 104I,A00,494155,Smith; Glenn Chatmas,29,0,30,1
1713326386542,POLI 110C,A00,494156,Ingham; Sean,23,0,25,2
1713326387570,POLI 117R,A00,494157,Forman; Fonna,8,0,20,12
1713326388594,POLI 118,A00,494158,Ingham; Sean,21,0,25,4
1713326389619,POLI 120H,A00,494159,Fisk; David Lee,39,0,45,6
1713326390643,POLI 131CR,A00,494160,Hoston; Germaine,35,0,45,10
1713326391670,POLI 133J,A00,494161,Staff,33,0,35,2
1713326392696,POLI 135,A00,494162,Fisk; David Lee,33,0,35,2
1713326393722,POLI 140A,A00,494164,Staff,20,0,30,10
1713326394748,POLI 142I,A00,494165,Staff,30,0,30,0
1713326395775,POLI 144D,A00,494166,Staff,23,0,25,2
1713326396801,POLI 151,A00,494167,Staff,30,0,30,0
1713326397827,POLI 153,A00,494168,Staff,33,0,35,2
1713326398854,POLI 160AA,A00,494169,Staff,34,0,40,6
1713326399881,POLI 162,A00,494170,Mignozzetti; Umberto,19,0,25,6
1713326400910,POLI 171,A00,494171,Mignozzetti; Umberto,20,0,25,5
1713326401937,PSYC 1,A00,494172,Staff,96,0,100,4
1713326402962,PSYC 2,A00,494173,Moranton; Nirelia Melbina-,34,0,50,16
1713326403991,PSYC 3,A00,494174,Staff,29,0,30,1
1713326405018,PSYC 6,A00,494175,Staff,17,0,20,3
1713326406047,PSYC 60,A01,494177,Staff,38,0,45,7
1713326407078,PSYC 70,A01,505724,Geller; Emma Harlan,42,0,45,3
1713326408104,PSYC 101,A00,494180,Heyman; Gail D.,84,0,100,16
1713326409130,PSYC 105,A00,494181,Geller; Emma Harlan,51,0,90,39
1713326410156,PSYC 106,A00,494182,Dobkins; Karen R.,28,0,45,17
1713326411188,PSYC 108,A00,494183,Adrian; Julia Anna,90,0,100,10
1713326412215,PSYC 114,A01,494185,Winkielman; Piotr,0,2,30,30
1713326413241,PSYC 122,A00,494186,Moranton; Nirelia Melbina-,30,0,50,20
1713326414265,PSYC 124,A00,494187,Chapman; Eddie Nathaniel,71,0,80,9
1713326415288,PSYC 131,A00,494188,Anagnostaras; Stephan,42,0,80,38
1713326416313,PSYC 144,A00,494189,Staff,5,0,50,45
1713326417339,PSYC 154,A00,494190,Lacefield; Katharine I,107,0,180,73
1713326418365,PSYC 162,A00,494191,Wixted; John T,71,0,100,29
1713326419398,PSYC 172,A00,494192,Gorman; Michael R.,36,0,45,9
1713326420423,PSYC 178,A00,494193,Glaser; Dale,34,0,45,11
1713326421451,PSYC 193,A00,505725,Chapman; Eddie Nathaniel,20,0,20,0
1713326422480,RELI 145GS,A00,519817,Rahimi; Babak,18,0,20,2
1713326423506,SE 101A,A01,490862,Chadha; Mayank,23,0,25,2
1713326424533,SE 101C,A01,490924,Krysl; Petr,16,0,20,4
1713326425561,SE 110A,A01,490928,Staff,19,0,20,1
1713326426586,SE 130A,A00,490929,Morrison; Machel Leigh,56,0,70,14
1713326427617,SIO 1,A01,519325,Staff,39,0,40,1
1713326428643,SIO 30,A01,519327,Staff,38,0,40,2
1713326429671,SIO 40,A00,519328,Staff,39,0,40,1
1713326430696,SIO 46GS,A00,519819,Cook; Geoffrey W,17,0,25,8
1713326431724,SIO 109R,A00,494197,Forman; Fonna,0,3,20,20
1713326432749,SIO 121GS,A00,519827,Cook; Geoffrey W,17,0,25,8
1713326433775,SIO 132,A01,519330,Staff,38,0,40,2
1713326434799,SIO 133,A01,519397,Staff,37,0,40,3
1713326435825,SIO 139,A00,519396,Kacev; David,30,0,40,10
1713326436851,SOCI 1,A01,494199,Thorpe; Charles Robert,21,0,30,9
1713326436851,SOCI 1,A02,494200,Thorpe; Charles Robert,30,0,30,0
1713326436851,SOCI 1,A03,494201,Thorpe; Charles Robert,29,0,30,1
1713326436851,SOCI 1,A04,494202,Thorpe; Charles Robert,29,0,30,1
1713326436851,SOCI 1,A05,494203,Thorpe; Charles Robert,29,0,30,1
1713326436851,SOCI 1,A06,494204,Thorpe; Charles Robert,30,0,30,0
1713326436851,SOCI 1,A07,494205,Thorpe; Charles Robert,28,0,30,2
1713326437880,SOCI 60,A01,494207,Staff,34,0,40,6
1713326437880,SOCI 60,A02,494208,Staff,39,0,40,1
1713326438908,SOCI 100,A01,494210,Payne; Christine Anna,25,0,30,5
1713326438908,SOCI 100,A02,494211,Payne; Christine Anna,26,0,30,4
1713326439935,SOCI 109M,A00,494212,Staff,20,0,20,0
1713326440959,SOCI 110,A00,494213,Staff,34,0,40,6
1713326443008,SOCI 118E,A00,494215,Ng; Kwai,37,0,40,3
1713326444035,SOCI 125,A00,494216,Calderon-Zaks; Michael Aar,40,0,45,5
1713326445061,SOCI 126,A01,494218,Jones; Makeba,3,0,5,2
1713326446086,SOCI 131,A00,494219,Thorpe; Charles Robert,26,0,30,4
1713326448136,SOCI 135,A00,494221,Payne; Christine Anna,28,0,50,22
1713326449160,SOCI 136E,A00,626690,Ruiz; Jonathan Joseph,24,0,25,1
1713326450188,SOCI 138GS,A00,494222,Navon; Daniel,24,0,28,4
1713326452240,SOCI 145,A00,494224,Staff,40,0,45,5
1713326453266,SOCI 153,A00,494225,Staff,28,0,30,2
1713326454292,SOCI 160E,A00,494226,Ng; Kwai,29,0,40,11
1713326455373,SOCI 180,A00,494227,Staff,29,0,30,1
1713326456398,SOCI 189GS,A00,494228,Ribas Norris; Janet Vanesa,11,0,11,0
1713326457425,SOCI 190GS,A00,553232,Ribas Norris; Janet Vanesa,11,0,11,0
1713326458449,SOMI 220,A00,627178,Schneid; Stephen David,30,0,30,0
1713326459474,SYN 2,001,490768,Staff,14,0,15,1
1713326459474,SYN 2,002,490769,Staff,15,0,15,0
1713326459474,SYN 2,004,490775,Staff,0,0,0,0
1713326459474,SYN 2,003,490774,Staff,0,0,0,0
1713326459474,SYN 2,005,490776,Staff,0,0,0,0
1713326460498,SYN 2R,001,490779,Staff,11,0,15,4
1713326460498,SYN 2R,002,514635,Staff,14,0,15,1
1713326461524,SYN 100,A01,490783,Staff,10,0,20,10
1713326461524,SYN 100,B01,490787,Staff,9,0,20,11
1713326461524,SYN 100,C01,490789,Staff,10,0,20,10
1713326462550,SYN 150,A00,490817,Staff,14,0,15,1
1713326462550,SYN 150,B00,514610,Staff,15,0,15,0
1713326463574,TDAC 1,A00,492753,Walsh; Kim C.,19,0,20,1
1713326463574,TDAC 1,B00,492754,Harting; Carla Kelso,19,0,20,1
1713326463574,TDAC 1,C00,513995,Salovey; Todd,15,0,20,5
1713326464603,TDAC 101,A00,492766,Harting; Carla Kelso,17,0,20,3
1713326465628,TDAC 102,A00,492768,Basso; Beatrice,19,0,20,1
1713326466655,TDDE 111,A00,492769,Staff,25,0,25,0
1713326467680,TDDE 131,A00,492770,Staff,15,0,15,0
1713326467680,TDDE 131,B00,492771,Staff,15,0,15,0
1713326468707,TDDE 131GS,A00,523716,Guirguis; Mark C,23,0,28,5
1713326469735,TDGE 1,A01,492756,Salovey; Todd,56,0,60,4
1713326470759,TDGE 5,A01,492758,Staff,23,0,25,2
1713326471783,TDGE 10,A00,492759,Fulton; Julia,203,0,220,17
1713326472806,TDGE 11,A00,492760,Castro; Robert Jess,198,0,200,2
1713326474861,TDGE 124,A00,492772,Fulton; Julia,185,0,220,35
1713326475889,TDGE 125,A00,492773,Meyer; Ursula,38,0,50,12
1713326475889,TDGE 125,B00,492774,Staff,49,0,50,1
1713326475889,TDGE 125,C00,523565,Staff,48,0,50,2
1713326476915,TDGE 125GS,A00,523580,Guirguis; Mark C,23,0,28,5
1713326477944,TDGE 127,A00,492775,Havis; Allan,34,0,50,16
1713326478987,TDHT 101,A00,492776,Staff,34,0,35,1
1713326480015,TDMV 1,A00,492762,Caligagan; Maria T.,30,0,30,0
1713326480015,TDMV 1,B00,492763,Arcidiacono; Kristin,26,0,30,4
1713326481039,TDMV 2,A00,492764,Weinberg; Sadie,28,0,30,2
1713326482066,TDMV 3,A00,492765,Mack; Kara Shanai',37,0,40,3
1713326483090,TDMV 138,A00,492777,Mack; Kara Shanai',34,0,40,6
1713326484116,TDMV 140,A00,492778,Lima; Paulo Henrique,40,0,40,0
1713326485142,TDMV 142,A00,492779,Caligagan; Maria T.,33,0,40,7
1713326485142,TDMV 142,B00,492780,Caligagan; Tony,37,0,40,3
1713326486166,TDMV 143,A00,492781,Fyall; Daunte Edward,39,0,40,1
1713326487190,USP 1,A01,492401,Kwak; Nancy,27,0,35,8
1713326488214,USP 2,A01,492453,Hinds; Juli Beth,35,0,35,0
1713326489238,USP 3,A01,492516,Staff,28,0,35,7
1713326490265,USP 4,A00,492522,McTague; Sarah,16,0,25,9
1713326491290,USP 100,A00,492523,Staff,32,0,35,3
1713326492315,USP 101,A00,492524,Staff,13,0,15,2
1713326493341,USP 105,A00,492525,Staff,21,0,25,4
1713326494365,USP 151,A00,492526,Shenkman; Michael Thomas,32,0,35,3
1713326495390,USP 170,A00,492545,Hinds; Juli Beth,33,0,35,2
1713326496413,USP 171GS,A00,492608,Bussell; Mirle Rabinowitz,24,0,28,4
1713326497444,USP 183GS,A00,492613,Peerson; Susan,24,0,28,4
1713326498474,VIS 30,A01,490693,Yoldas; Pinar,19,0,22,3
1713326498474,VIS 30,A02,490694,Yoldas; Pinar,18,0,22,4
1713326499501,VIS 83,A00,490695,Kester; Grant,63,0,75,12
1713326500530,VIS 105D,A00,490696,Staff,22,0,25,3
1713326501560,VIS 124CN,A00,490699,Rose; Jordan M,65,0,75,10
1713326502586,VIS 125GS,A00,511221,Williams; Alena J,21,0,22,1
1713326503614,VIS 128D,A00,490700,Staff,73,0,75,2
1713326504642,VIS 151,A01,490717,Staff,33,0,34,1
1713326504642,VIS 151,A02,490766,Staff,33,0,34,1
1713326505667,VIS 154GS,A00,511972,Williams; Alena J,21,0,22,1
1713326506691,VIS 160A,A00,490767,Stone; Patricia,7,0,10,3
1713326507717,WCWP 10A,A00,490638,Staff,14,0,15,1
1713326507717,WCWP 10A,B00,490640,Staff,15,0,15,0
1713326508744,WCWP 10B,A00,490641,Staff,0,0,0,0
1713326508744,WCWP 10B,B00,490642,Staff,14,0,15,1
1713326508744,WCWP 10B,C00,490644,Staff,13,0,15,2
1713326508744,WCWP 10B,D00,490647,Staff,0,0,0,0
1713326509769,WCWP 100,A00,490655,Staff,0,0,0,0
1713326509769,WCWP 100,B00,490687,Staff,10,0,15,5
1713326511874,ANAR 153,A00,487222,Braswell; Geoffrey E.,54,0,60,6
1713326512902,ANBI 134,A00,487223,Staff,6,0,20,14
1713326513925,ANBI 143GS,A00,487224,Noel; Geoffroy Pierre Jean,18,0,24,6
1713326514951,ANBI 144GS,A00,519548,Noel; Geoffroy Pierre Jean,18,0,24,6
1713326515974,ANSC 101,A00,487225,Staff,18,0,20,2
1713326517000,ANSC 125,A00,487227,Brenner; Suzanne A,39,0,40,1
1713326519051,ANSC 146,A00,487229,Staff,35,0,40,5
1713326520075,ANSC 148,A00,487230,Olivas Hernandez; Olga Lid,39,0,40,1
1713326521100,ANSC 150,A00,504165,Sloane; Julia Kathryn,18,0,20,2
1713326522126,ANSC 180,A00,487232,Staff,14,0,15,1
1713326523151,ANSC 188,A00,627155,Staff,39,0,40,1
1713326524180,ANTH 5,A00,519529,Semendeferi; Ekaterini,15,0,15,0
1713326525208,ANTH 10,A00,487219,Staff,58,0,60,2
1713326526233,ANTH 23,A01,487221,Staff,17,0,20,3
1713326527258,ANTH 102,A00,487233,Wilder; Linnea Lorene,51,0,60,9
1713326528283,ANTH 103,A00,487234,Varma; Saiba,55,0,60,5
1713326529311,ANTH 105,A00,487235,Stewart; Alexander B,55,0,60,5
1713326530339,BENG 100,A01,516685,Taylor Amos; Alyssa C,27,0,30,3
1713326531473,BIBC 102,A01,491316,Flagg; Matthew Paul,14,0,88,74
1713326531473,BIBC 102,A02,491366,Flagg; Matthew Paul,78,0,88,10
1713326532498,BIBC 103,A01,491486,Boumechache; Miyyada,16,0,24,8
1713326532498,BIBC 103,A02,491487,Boumechache; Miyyada,24,0,24,0
1713326533522,BICD 100,A01,516882,Staff,73,0,75,2
1713326533522,BICD 100,A02,516890,Staff,69,0,75,6
1713326534544,BICD 102GS,A00,491488,Lo; Stanley M.,26,0,28,2
1713326535573,BIEB 136GS,A00,516940,Holway; David A. & Shurin; Jonathan,18,0,24,6
1713326536598,BIEB 137GS,A01,517034,Holway; David A. & Shurin; Jonathan,18,0,24,6
1713326537625,BIEB 138GS,A01,491492,Pirino; Giorgia,21,0,28,7
1713326538655,BILD 1,A01,491296,Staff,60,0,63,3
1713326538655,BILD 1,A02,491297,Staff,63,0,63,0
1713326539680,BILD 4,A01,517099,Gonzalez Gamboa; Ivonne,22,0,24,2
1713326539680,BILD 4,A02,517100,Gonzalez Gamboa; Ivonne,24,0,24,0
1713326540708,BILD 60GS,A00,491309,Lo; Stanley M.,26,0,28,2
1713326541735,BIMM 100,A01,517136,Staff,85,0,100,15
1713326542764,BIMM 110,A01,517182,Staff,57,0,100,43
1713326543792,BIMM 120,A01,517228,Pickett; Brooke Elizabeth,29,0,63,34
1713326543792,BIMM 120,A02,517240,Pickett; Brooke Elizabeth,44,0,63,19
1713326544817,BIMM 132GS,A01,491498,Pirino; Giorgia,21,0,28,7
1713326545841,BIMM 143,A01,491589,Bozinovic; Goran,13,0,40,27
1713326546869,BIPN 100,A01,491594,Armour; Jon Christopher,85,0,100,15
1713326547894,BIPN 140,A01,491602,Marino; Marc J,26,0,50,24
1713326549945,CAT 125,A00,515973,Staff,18,0,20,2
1713326550970,CAT 125GS,A00,515974,Rahimi; Babak,17,0,20,3
1713326552000,CAT 125R,A00,515980,Staff,12,0,20,8
1713326552000,CAT 125R,B00,515981,Tosun; Adriana,19,0,20,1
1713326552000,CAT 125R,C00,515987,Hyland; Tina Mae,0,2,20,20
1713326552000,CAT 125R,D00,515988,Bronstein; Phoebe Malan,17,0,20,3
1713326553024,CENG 15,A01,488699,Drews; Aaron,25,0,25,0
1713326554051,CENG 100,A00,505196,Opatkiewicz; Justin Paul,25,0,25,0
1713326555079,CGS 2A,A01,489598,Staff,33,0,35,2
1713326556106,CGS 112,A00,489599,Staff,15,0,15,0
1713326557134,CGS 119,A00,489603,Staff,10,0,10,0
1713326558160,CGS 120,A00,489604,Staff,14,0,15,1
1713326559237,CGS 150,A00,489607,Staff,15,0,15,0
1713326560265,CHEM 6A,A01,488715,Staff,98,0,100,2
1713326561295,CHEM 6B,A01,488719,Piercy; Marc Anthony,99,0,100,1
1713326562325,CHEM 6C,A01,488723,Albizati; Kim F.,93,0,100,7
1713326563350,CHEM 7L,A01,488728,Schurmeier; Kimberly,18,0,24,6
1713326563350,CHEM 7L,A02,488730,Schurmeier; Kimberly,23,0,24,1
1713326563350,CHEM 7L,A03,488734,Schurmeier; Kimberly,20,0,24,4
1713326563350,CHEM 7L,A04,488763,Schurmeier; Kimberly,23,0,24,1
1713326563350,CHEM 7L,B01,488798,Schurmeier; Kimberly,17,0,24,7
1713326563350,CHEM 7L,B02,488801,Schurmeier; Kimberly,22,0,24,2
1713326563350,CHEM 7L,B03,488808,Schurmeier; Kimberly,23,0,24,1
1713326563350,CHEM 7L,B04,488811,Schurmeier; Kimberly,24,0,24,0
1713326564380,CHEM 11,A01,488897,Stallings; Dontarie M,95,0,100,5
1713326565405,CHEM 40A,A01,488913,Albizati; Kim F.,84,0,100,16
1713326566435,CHEM 40B,A01,488920,Weizman; Haim,43,0,50,7
1713326566435,CHEM 40B,A02,488938,Weizman; Haim,45,0,50,5
1713326567459,CHEM 41A,A01,489029,Klosterman; Jeremy K,57,0,60,3
1713326568488,CHEM 41C,A01,500436,Tor; Yitzhak,55,0,60,5
1713326569520,CHEM 43A,A01,500426,Weizman; Haim,0,0,24,24
1713326569520,CHEM 43A,A02,500430,Weizman; Haim,9,0,24,15
1713326569520,CHEM 43A,B01,514041,Klosterman; Jeremy K,16,0,24,8
1713326569520,CHEM 43A,B02,514047,Klosterman; Jeremy K,23,0,24,1
1713326570549,CHEM 108,A01,489140,Jennings; Patricia A.,10,0,24,14
1713326570549,CHEM 108,A02,489142,Jennings; Patricia A.,14,0,24,10
1713326571574,CHEM 114A,A01,489147,Stallings; Dontarie M,69,0,100,31
1713326572601,CHIN 169A,A00,489171,Wang; Xiao,19,0,20,1
1713326574651,COGS 3,A01,518827,Boyle; Mary E. T.,26,0,40,14
1713326575677,COGS 11,A01,489175,Staff,27,0,30,3
1713326576704,COGS 14A,A01,518829,Staff,51,0,60,9
1713326577733,COGS 14B,A01,489177,Hoffman; Drew Ellen,64,0,75,11
1713326578761,COGS 100,A01,489181,Allen; Michael Gordon,63,0,75,12
1713326579790,COGS 101A,A01,489183,Staff,46,0,60,14
1713326580818,COGS 101B,A01,489185,Allen; Michael Gordon,8,0,30,22
1713326581843,COGS 101C,A01,526786,Staff,23,0,30,7
1713326583894,COGS 107A,A01,489189,Boyle; Mary E. T.,18,0,35,17
1713326584921,COGS 107B,A01,627144,Mooshagian; Eric Frederick,60,0,60,0
1713326585946,COGS 118A,A01,489191,Staff,0,44,40,40
1713326587999,COGS 171GS,A01,489194,Pineda; Jaime A,20,0,28,8
1713326589023,COGS 172,A01,489196,Staff,3,0,30,27
1713326590048,COGS 174GS,A01,489264,Pineda; Jaime A,20,0,28,8
1713326591072,COGS 180,A01,627150,Staff,28,0,30,2
1713326592098,COGS 186,A01,489274,Staff,0,1,30,30
1713326593123,COMM 10,A01,489276,Staff,23,0,25,2
1713326593123,COMM 10,A02,489303,Staff,23,0,25,2
1713326594147,COMM 100A,A01,489312,Staff,14,0,25,11
1713326594147,COMM 100A,A02,489313,Staff,24,0,25,1
1713326595174,COMM 106T,A00,512540,Staff,33,0,35,2
1713326596200,COMM 107,A00,489347,Staff,27,0,35,8
1713326597225,COMM 109P,A00,489358,Staff,31,0,35,4
1713326598252,COMM 132,A00,489361,McKenna; Denise,27,0,30,3
1713326599274,COMM 146,A00,489362,Halm; Gavin Patrick,26,0,30,4
1713326600298,COMM 190,A00,489363,Abuelhiga; Soraya Jill,17,0,23,6
1713326601326,CSE 8A,A50,489366,Staff,21,0,25,4
1713326601326,CSE 8A,A51,489367,Staff,24,0,25,1
1713326602351,CSE 11,A01,489398,Cao; Yingjun,74,0,100,26
1713326603375,CSE 12,A01,489487,Staff,43,0,50,7
1713326604403,CSE 20,A01,489497,Staff,48,0,50,2
1713326605430,CSE 21,A01,489517,Braun; Oliver,42,0,50,8
1713326606455,CSE 101,A01,489524,Braun; Oliver,0,28,50,50
1713326607480,CSE 105,A01,512594,Jones; Miles E,73,0,100,27
1713326607480,CSE 105,B01,512598,Jones; Miles E,52,0,100,48
1713326608505,CSE 140,A01,489538,Staff,41,0,50,9
1713326609530,CSE 141,A01,489550,Eldon; John,68,0,100,32
1713326610555,CSE 141L,A01,489571,Eldon; John,66,0,100,34
1713326611581,CSE 151A,A01,489583,Solares; Edwin A,141,0,200,59
1713326612606,CSE 175,A01,510886,Kumar; Rakesh,30,0,30,0
1713326613631,CSE 190,A00,516828,Dubnov; Shlomo,38,0,49,11
1713326614656,DOC 100D,A00,489667,Pass; Natalye Joann,19,0,25,6
1713326615681,DSC 10,A01,624268,Staff,72,0,75,3
1713326616709,DSC 20,A01,624476,Staff,50,0,50,0
1713326617733,DSC 40A,A01,624608,Staff,39,0,40,1
1713326618758,DSGN 1,A01,489179,Rill; Bryan,33,0,50,17
1713326619782,ECE 17,A01,490489,Sahay; Rajeev,18,0,30,12
1713326620810,ECE 65,A50,490492,Staff,12,0,20,8
1713326620810,ECE 65,A51,490493,Staff,18,0,20,2
1713326621837,ECON 1,A01,489715,Famulari; Melissa,68,0,70,2
1713326622862,ECON 2,A01,489717,Levkoff; Steven B.,68,0,70,2
1713326623891,ECON 3,A01,489948,Staff,70,0,70,0
1713326625943,ECON 5,A01,490103,Staff,27,0,30,3
1713326625943,ECON 5,B01,626281,Dai; Yinlin,45,0,45,0
1713326626975,ECON 100A,A01,490127,Famulari; Melissa,65,0,70,5
1713326628001,ECON 100B,A01,490129,Staff,64,0,70,6
1713326629028,ECON 109,A01,490187,Shishkin; Denis,27,0,35,8
1713326630055,ECON 110A,A01,490190,Levkoff; Steven B.,60,0,70,10
1713326631085,ECON 120A,A01,490245,Dai; Yinlin,61,0,70,9
1713326632110,ECON 120B,A01,490247,Nieto-Barthaburu; Augusto,42,0,70,28
1713326633139,ECON 120C,A01,490253,Sun; Yixiao,30,0,35,5
1713326633139,ECON 120C,B01,490255,Sun; Yixiao,34,0,35,1
1713326634166,ECON 129,A00,490256,Eckert; Fabian Paul,23,0,35,12
1713326635194,ECON 131,A00,490257,Nieto-Barthaburu; Augusto,0,6,35,35
1713326636220,ECON 138,A00,490258,Bharadwaj; Prashant,13,0,35,22
1713326636220,ECON 138,B00,490259,Bharadwaj; Prashant,15,0,35,20
1713326637247,ECON 159,A00,490260,Hendrickson; Gerald M.,0,9,0,0
1713326638277,ECON 178,A01,553995,Zhu; Ying,24,0,35,11
1713326639305,EDS 40,A01,512576,Black; Alison Michelle,20,0,20,0
1713326640330,EDS 107,A01,515848,Staff,30,0,30,0
1713326641359,EDS 110R,A01,490262,Staff,26,0,30,4
1713326642384,EDS 112,A01,490264,Chapman; Thandeka K,40,0,50,10
1713326643409,EDS 113,A00,490266,Staff,26,0,30,4
1713326644438,EDS 118,A00,490267,Warstadt; Melissa Fawn,21,0,30,9
1713326645466,EDS 124BR,A00,490268,Eguchi; Emi,4,0,25,21
1713326645466,EDS 124BR,B00,490269,Eguchi; Emi,23,0,25,2
1713326646494,EDS 126,A01,490271,Jones; Makeba,43,0,50,7
1713326647517,EDS 135,A01,490316,Staff,19,0,20,1
1713326648542,ENVR 142GS,A00,519514,Chang; Edmond Yi-Teh,27,0,28,1
1713326649567,ETHN 103,A00,490504,Staff,26,0,36,10
1713326650595,ETHN 103A,A00,490505,Man; Simeon S,4,0,9,5
1713326651622,ETHN 109,A00,490506,Staff,28,0,30,2
1713326652646,ETHN 118,A00,490507,Staff,35,0,36,1
1713326653673,ETHN 119,A00,490508,Staff,33,0,36,3
1713326654701,ETHN 121R,A00,490518,Choi; Esther Min,23,0,36,13
1713326655725,ETHN 127,A00,490528,Staff,14,0,15,1
1713326656749,ETHN 139,A00,490573,Staff,10,0,10,0
1713326657774,ETHN 150,A00,490575,Staff,15,0,15,0
1713326658803,GLBH 20,A00,491705,Elwardani; Nile Regina,38,0,40,2
1713326659831,GLBH 101,A00,491706,Staff,20,0,20,0
1713326660855,GLBH 111,A01,491708,Burgos; Jose L.,15,0,15,0
1713326661880,GLBH 146,A00,491709,Staff,9,0,20,11
1713326662959,GLBH 148,A00,491710,Olivas Hernandez; Olga Lid,11,0,20,9
1713326663984,GLBH 150,A00,491711,Sloane; Julia Kathryn,19,0,20,1
1713326665011,HIEA 131,A00,491760,Staff,28,0,32,4
1713326666035,HIEA 153,A00,491762,Staff,28,0,30,2
1713326667061,HIEU 124,A00,491811,Staff,26,0,32,6
1713326668225,HIEU 124GS,A00,491812,Markman; Kristina,27,0,28,1
1713326669251,HIEU 147,A00,491813,Staff,30,0,32,2
1713326670279,HIEU 149GS,A00,491816,Caldwell; Michael Alan,28,0,28,0
1713326671304,HILD 2C,A01,491713,Hendrickson; Gerald M.,26,0,30,4
1713326672332,HILD 7B,A01,491715,Kwak; Nancy,0,0,30,30
1713326673358,HILD 10,A01,491717,Staff,11,0,20,9
1713326674382,HILD 30GS,A00,491719,Edington; Claire Ellen,24,0,28,4
1713326675410,HINE 109,A00,491818,Shafir; Nir,27,0,32,5
1713326676435,HINE 128,A00,491821,Shafir; Nir,31,0,32,1
1713326677461,HISC 117,A00,491830,Staff,27,0,32,5
1713326678488,HIUS 103,A00,491834,Man; Simeon S,14,0,23,9
1713326679512,HIUS 108B,A00,491835,Staff,28,0,30,2
1713326680536,HIUS 141,A00,491836,Hendrickson; Gerald M.,28,0,32,4
1713326681564,HIUS 149,A00,491839,Staff,24,0,32,8
1713326682590,HUM 3,A01,512617,Crum; Matthew Stephen,43,0,50,7
1713326682590,HUM 3,A02,512618,Crum; Matthew Stephen,48,0,50,2
1713326683615,HUM 3GS,A00,512663,Markman; Kristina,0,0,0,1
1713326683615,HUM 3GS,B00,512664,Staff,0,0,0,0
1713326684643,HUM 4,A01,512620,West; Geoffrey Scott,28,0,50,22
1713326685671,HUM 4GS,A00,512666,Lyon; Antony J.,0,0,0,4
1713326686697,HUM 4R,A01,512625,Watkins; Eric,49,0,50,1
1713326687724,HUM 5,A01,512649,Zavodny; Tatiana Sophia,24,0,50,26
1713326687724,HUM 5,B01,512661,Zroka; Ryan Edward,48,0,50,2
1713326688749,INTL 190,A00,490577,Segui; Alan S,0,0,0,5
1713326689778,JAPN 20AR,A01,491267,Ross; Kayoko F,8,0,20,12
1713326690804,JAPN 180,A00,491285,Berman; Michael David,33,0,40,7
1713326691833,LATI 50,A01,502536,Kokinis; Troy Andreas,16,0,22,6
1713326691833,LATI 50,A02,502551,Kokinis; Troy Andreas,22,0,22,0
1713326691833,LATI 50,A03,502650,Kokinis; Troy Andreas,22,0,22,0
1713326691833,LATI 50,A04,502909,Kokinis; Troy Andreas,21,0,22,1
1713326692862,LATI 160,A01,502920,Kokinis; Troy Andreas,30,0,30,0
1713326693899,LIFR 1A,A00,490494,Van Moer; Vinciane G,17,0,20,3
1713326694924,LIFR 1AX,A00,490495,Van Moer; Vinciane G,17,0,20,3
1713326695949,LIFR 1B,A00,490496,Van Moer; Vinciane G,18,0,20,2
1713326696973,LIFR 1BX,A00,490497,Van Moer; Vinciane G,18,0,20,2
1713326697999,LIGN 8,A00,505198,McIntosh; Justin Daniel,134,0,150,16
1713326699024,LIGN 9GS,A00,491239,Lott; Margaret S.,18,0,20,2
1713326700047,LIGN 101,A01,505200,McIntosh; Justin Daniel,23,0,30,7
1713326701072,LIGN 120,A01,491244,Staff,23,0,30,7
1713326702103,LIGN 149GS,A00,491245,Lott; Margaret S.,18,0,20,2
1713326703130,LIGN 170,A00,491247,Staff,22,0,30,8
1713326704158,LISP 1D,A00,490498,Munoz Sanchez; Alicia,9,0,14,5
1713326704158,LISP 1D,B00,490499,Munoz Sanchez; Alicia,6,0,14,8
1713326704158,LISP 1D,C00,490500,Munoz Sanchez; Alicia,7,0,14,7
1713326704158,LISP 1D,D00,490501,Munoz Sanchez; Alicia,10,0,14,4
1713326705190,LISP 1DX,A00,490502,Munoz Sanchez; Alicia,14,0,28,14
1713326705190,LISP 1DX,B00,490503,Munoz Sanchez; Alicia,16,0,28,12
1713326707239,LTAM 110,A00,491847,Staff,23,0,25,2
1713326708265,LTCS 119,A00,491848,Staff,11,0,15,4
1713326709291,LTCS 130,A00,491849,Staff,24,0,25,1
1713326711345,LTEA 120C,A00,491852,Staff,32,0,40,8
1713326712373,LTEN 130GS,A00,491853,Lyon; Antony J.,24,0,28,4
1713326713398,LTEN 148,A00,491855,Staff,23,0,25,2
1713326714423,LTEN 159,A00,491856,Staff,21,0,25,4
1713326715450,LTEN 180,A00,491857,Staff,8,0,15,7
1713326717503,LTSP 123GS,A00,505928,Bessett; Ryan Matthew,24,0,28,4
1713326718527,LTSP 174GS,A00,506037,Bessett; Ryan Matthew,24,0,28,4
1713326720575,LTWR 102,A00,491861,Staff,9,0,15,6
1713326721604,LTWR 106,A00,491862,Staff,8,0,15,7
1713326722629,MAE 11,A00,490930,Bahadori; Mohammad Yousef,95,0,100,5
1713326723657,MAE 30A,A00,490931,Qi; Huihui,37,0,40,3
1713326724686,MAE 101A,A00,491036,Sadeghizadeh; Zahra,92,0,100,8
1713326725713,MAE 101C,A00,491037,Seshadri; Kalyanasundaram,67,0,100,33
1713326726739,MAE 113,A00,491040,Seshadri; Kalyanasundaram,66,0,80,14
1713326727767,MAE 131A,A00,491041,Ghazinejad; Maziar,37,0,40,3
1713326728797,MAE 142,A00,491053,Staff,39,0,40,1
1713326729822,MAE 143A,A00,491054,Staff,33,0,50,17
1713326730847,MAE 150,A00,491092,Truong; Phuong Thi Ngoc,23,0,35,12
1713326731875,MATH 3C,A01,494031,Pardo Guerra; Sebastian,30,0,30,0
1713326731875,MATH 3C,A02,494032,Pardo Guerra; Sebastian,29,0,30,1
1713326732905,MATH 10A,A01,494034,Staff,27,0,30,3
1713326732905,MATH 10A,A02,494035,Staff,28,0,30,2
1713326732905,MATH 10A,B01,494037,Staff,27,0,30,3
1713326732905,MATH 10A,B02,494038,Staff,29,0,30,1
1713326733935,MATH 10B,A01,494040,Habib; Yousaf,22,0,30,8
1713326733935,MATH 10B,A02,494041,Habib; Yousaf,28,0,30,2
1713326733935,MATH 10B,A03,494042,Habib; Yousaf,29,0,30,1
1713326733935,MATH 10B,A04,494043,Habib; Yousaf,30,0,30,0
1713326733935,MATH 10B,B01,494045,Habib; Yousaf,25,0,30,5
1713326733935,MATH 10B,B02,494046,Habib; Yousaf,30,0,30,0
1713326733935,MATH 10B,B03,494047,Habib; Yousaf,30,0,30,0
1713326733935,MATH 10B,B04,494048,Habib; Yousaf,30,0,30,0
1713326734962,MATH 18,A01,494050,Kemp; Todd Aahron,25,0,30,5
1713326734962,MATH 18,A02,494051,Kemp; Todd Aahron,29,0,30,1
1713326734962,MATH 18,B01,494054,Kemp; Todd Aahron,26,0,30,4
1713326734962,MATH 18,B02,494055,Kemp; Todd Aahron,29,0,30,1
1713326735989,MATH 20A,A01,494059,Suk; Andrew Hoon,30,0,30,0
1713326737013,MATH 20B,A01,494061,Briones; Jor-el Thomas Caparas,33,0,35,2
1713326737013,MATH 20B,B01,494063,Bach; Quang Tran,34,0,35,1
1713326738046,MATH 20C,A01,494065,Staff,28,0,30,2
1713326738046,MATH 20C,A02,494066,Staff,30,0,30,0
1713326738046,MATH 20C,A03,494067,Staff,30,0,30,0
1713326738046,MATH 20C,A04,494068,Staff,30,0,30,0
1713326738046,MATH 20C,B01,494070,Zhang; Ming,25,0,30,5
1713326738046,MATH 20C,B02,494071,Zhang; Ming,27,0,30,3
1713326738046,MATH 20C,B03,494072,Zhang; Ming,29,0,30,1
1713326738046,MATH 20C,B04,494073,Zhang; Ming,29,0,30,1
1713326739069,MATH 20D,A01,494075,Staff,22,0,30,8
1713326739069,MATH 20D,A02,494076,Staff,29,0,30,1
1713326740095,MATH 20E,A01,494079,Staff,24,0,30,6
1713326740095,MATH 20E,A02,494080,Staff,26,0,30,4
1713326740095,MATH 20E,B01,494082,Staff,25,0,30,5
1713326740095,MATH 20E,B02,494083,Staff,25,0,30,5
1713326741124,MATH 103A,A01,494085,Aliabadi Sr.; Mohsen,14,0,30,16
1713326741124,MATH 103A,A02,494086,Aliabadi Sr.; Mohsen,28,0,30,2
1713326741124,MATH 103A,B01,494088,Aliabadi Sr.; Mohsen,21,0,30,9
1713326741124,MATH 103A,B02,494089,Aliabadi Sr.; Mohsen,27,0,30,3
1713326742150,MATH 109,A01,494091,Staff,30,0,30,0
1713326742150,MATH 109,A02,494092,Staff,29,0,30,1
1713326742150,MATH 109,B01,494094,Staff,27,0,30,3
1713326742150,MATH 109,B02,494095,Staff,29,0,30,1
1713326743181,MATH 142A,A01,494097,Chow; Bennett,15,0,30,15
1713326743181,MATH 142A,A02,494098,Chow; Bennett,23,0,30,7
1713326743181,MATH 142A,B01,494100,Chow; Bennett,19,0,30,11
1713326743181,MATH 142A,B02,494101,Chow; Bennett,29,0,30,1
1713326745237,MATH 168A,A01,516677,Dumitriu; Ioana,15,0,35,20
1713326746263,MATH 170A,A01,516679,Dumitriu; Ioana,18,0,30,12
1713326746263,MATH 170A,A02,516680,Dumitriu; Ioana,28,0,30,2
1713326747292,MATH 193A,A01,494107,Staff,14,0,30,16
1713326747292,MATH 193A,A02,494108,Staff,21,0,30,9
1713326747292,MATH 193A,A03,494109,Staff,29,0,30,1
1713326747292,MATH 193A,A04,494110,Staff,22,0,30,8
1713326750371,MGT 16,A00,491930,McKay; Michael J,92,0,98,6
1713326751396,MGT 18,A00,491992,McKay; Michael J,96,0,98,2
1713326752421,MGT 71,A00,492003,Staff,66,0,98,32
1713326753449,MGT 103,A00,505209,Eberhard; Craig A,81,0,98,17
1713326754473,MGT 131A,A00,505210,Anderson; John Charles,89,0,98,9
1713326756526,MGT 153,A00,492077,Perols; Johan Lars,19,0,90,71
1713326759603,MGT 164,A00,492222,McKay; Mary A,91,0,98,7
1713326760631,MGT 172,A00,492245,Staff,59,0,60,1
1713326760631,MGT 172,B00,505526,Hedges; Kathleen,65,0,98,33
1713326761656,MGT 181,A00,505669,Dunn; Louis Jean,82,0,98,16
1713326762680,MMW 14,A01,494399,Staff,15,0,28,13
1713326762680,MMW 14,A02,494400,Staff,25,0,28,3
1713326762680,MMW 14,A03,494401,Staff,28,0,28,0
1713326762680,MMW 14,A04,494402,Staff,28,0,28,0
1713326762680,MMW 14,B01,494404,Carreras; Maria Victoria,8,0,28,20
1713326762680,MMW 14,B02,494405,Carreras; Maria Victoria,25,0,28,3
1713326762680,MMW 14,B03,494406,Carreras; Maria Victoria,27,0,28,1
1713326762680,MMW 14,B04,494407,Carreras; Maria Victoria,28,0,28,0
1713326763706,MMW 14GS,A00,506250,Chang; Edmond Yi-Teh,0,0,0,0
1713326764733,MMW 121R,A01,494415,Adamiak; Patrick John,11,0,28,17
1713326764733,MMW 121R,A02,494416,Adamiak; Patrick John,24,0,28,4
1713326765761,MUS 1A,A01,494113,Staff,12,0,25,13
1713326765761,MUS 1A,A02,494114,Staff,24,0,25,1
1713326766845,MUS 4,A01,494116,Staff,23,0,25,2
1713326766845,MUS 4,A02,494117,Staff,22,0,25,3
1713326767874,MUS 5R,A01,494236,Dubnov; Shlomo,6,0,25,19
1713326767874,MUS 5R,A02,494237,Dubnov; Shlomo,25,0,25,0
1713326768899,MUS 6,A01,494122,Staff,10,0,25,15
1713326768899,MUS 6,A02,494123,Staff,23,0,25,2
1713326769924,MUS 7,A01,494125,Staff,16,0,25,9
1713326769924,MUS 7,A02,494126,Staff,24,0,25,1
1713326770952,MUS 11,A01,494128,Staff,23,0,25,2
1713326770952,MUS 11,A02,494129,Staff,24,0,25,1
1713326771976,MUS 13,A01,494131,Staff,25,0,25,0
1713326771976,MUS 13,A02,494132,Staff,25,0,25,0
1713326773003,MUS 15,A01,494134,Staff,17,0,25,8
1713326773003,MUS 15,A02,494135,Staff,25,0,25,0
1713326773003,MUS 15,B01,494137,Staff,24,0,25,1
1713326774033,MUS 80,A00,494232,Staff,24,0,25,1
1713326774033,MUS 80,B00,494233,Staff,25,0,25,0
1713326774033,MUS 80,C00,494234,Staff,23,0,25,2
1713326775058,MUS 95C,A00,494141,Staff,70,0,75,5
1713326776083,MUS 114,A00,494142,Staff,40,0,50,10
1713326777112,NANO 15,A01,490636,Drews; Aaron,7,0,7,0
1713326778139,PHIL 1,A00,490578,Grush; Rick Scott,49,0,50,1
1713326779166,PHIL 10,A01,490580,Grush; Rick Scott,33,0,35,2
1713326779166,PHIL 10,A02,490586,Grush; Rick Scott,32,0,35,3
1713326780193,PHIL 27,A01,490591,Staff,22,0,25,3
1713326780193,PHIL 27,A02,490592,Staff,25,0,25,0
1713326780193,PHIL 27,A03,490593,Staff,25,0,25,0
1713326780193,PHIL 27,A04,490598,Staff,25,0,25,0
1713326781220,PHIL 32,A01,490611,Staff,20,0,20,0
1713326781220,PHIL 32,A02,490618,Staff,20,0,20,0
1713326782249,PHIL 90,A00,490624,Staff,40,0,40,0
1713326783275,PHIL 136,A00,490627,Cohen; Jonathan David,37,0,40,3
1713326784300,PHIL 155,A00,490634,Staff,62,0,70,8
1713326785326,PHYS 1A,A00,491610,Staff,245,0,250,5
1713326786351,PHYS 1AL,001,491616,Tsai; Philbert S,27,0,30,3
1713326786351,PHYS 1AL,002,491618,Tsai; Philbert S,30,0,30,0
1713326787376,PHYS 1B,A00,491623,Staff,236,0,250,14
1713326788401,PHYS 1BL,001,491626,Tsai; Philbert S,22,0,30,8
1713326788401,PHYS 1BL,002,491628,Tsai; Philbert S,26,0,30,4
1713326789427,PHYS 1C,A00,491632,Staff,215,0,245,30
1713326790453,PHYS 1CL,001,491635,Tsai; Philbert S,4,0,30,26
1713326790453,PHYS 1CL,002,491643,Tsai; Philbert S,22,0,30,8
1713326791483,PHYS 2AR,A01,491651,Meyertholen; Andrew D.,44,0,50,6
1713326792512,PHYS 2B,A01,491659,Staff,105,0,115,10
1713326793537,PHYS 2BL,A01,491685,Staff,21,0,24,3
1713326793537,PHYS 2BL,A02,491700,Staff,21,0,24,3
1713326794562,PHYS 2C,A01,505161,Staff,102,0,115,13
1713326795588,PHYS 4A,A01,491704,Grinstein; Benjamin,99,0,100,1
1713326796618,POLI 5D,A01,494144,Staff,3,0,5,2
1713326796618,POLI 5D,B01,626283,Dai; Yinlin,5,0,5,0
1713326797642,POLI 12,A00,494145,Staff,43,0,45,2
1713326798671,POLI 13R,A00,494146,Forman; Fonna,45,0,50,5
1713326799699,POLI 27,A01,494148,Staff,54,0,60,6
1713326800723,POLI 30,A00,494149,Staff,49,0,50,1
1713326801746,POLI 100DA,A00,494150,Staff,21,0,25,4
1713326803802,POLI 100I,A00,494152,Staff,27,0,30,3
1713326804829,POLI 104B,A00,494153,Smith; Glenn Chatmas,53,0,55,2
1713326805855,POLI 104F,A00,494154,Staff,28,0,30,2
1713326806881,POLI 104I,A00,494155,Smith; Glenn Chatmas,29,0,30,1
1713326807907,POLI 110C,A00,494156,Ingham; Sean,23,0,25,2
1713326808931,POLI 117R,A00,494157,Forman; Fonna,8,0,20,12
1713326809955,POLI 118,A00,494158,Ingham; Sean,21,0,25,4
1713326810985,POLI 120H,A00,494159,Fisk; David Lee,39,0,45,6
1713326812008,POLI 131CR,A00,494160,Hoston; Germaine,35,0,45,10
1713326813033,POLI 133J,A00,494161,Staff,33,0,35,2
1713326814060,POLI 135,A00,494162,Fisk; David Lee,33,0,35,2
1713326815086,POLI 140A,A00,494164,Staff,20,0,30,10
1713326816114,POLI 142I,A00,494165,Staff,30,0,30,0
1713326817138,POLI 144D,A00,494166,Staff,23,0,25,2
1713326818163,POLI 151,A00,494167,Staff,30,0,30,0
1713326819203,POLI 153,A00,494168,Staff,33,0,35,2
1713326820228,POLI 160AA,A00,494169,Staff,34,0,40,6
1713326821251,POLI 162,A00,494170,Mignozzetti; Umberto,19,0,25,6
1713326822277,POLI 171,A00,494171,Mignozzetti; Umberto,20,0,25,5
1713326823303,PSYC 1,A00,494172,Staff,96,0,100,4
1713326824328,PSYC 2,A00,494173,Moranton; Nirelia Melbina-,34,0,50,16
1713326825354,PSYC 3,A00,494174,Staff,29,0,30,1
1713326826378,PSYC 6,A00,494175,Staff,17,0,20,3
1713326827403,PSYC 60,A01,494177,Staff,38,0,45,7
1713326828427,PSYC 70,A01,505724,Geller; Emma Harlan,42,0,45,3
1713326829452,PSYC 101,A00,494180,Heyman; Gail D.,84,0,100,16
1713326830477,PSYC 105,A00,494181,Geller; Emma Harlan,51,0,90,39
1713326831505,PSYC 106,A00,494182,Dobkins; Karen R.,28,0,45,17
1713326832533,PSYC 108,A00,494183,Adrian; Julia Anna,89,0,100,11
1713326833558,PSYC 114,A01,494185,Winkielman; Piotr,0,2,30,30
1713326834582,PSYC 122,A00,494186,Moranton; Nirelia Melbina-,29,0,50,21
1713326835611,PSYC 124,A00,494187,Chapman; Eddie Nathaniel,71,0,80,9
1713326836635,PSYC 131,A00,494188,Anagnostaras; Stephan,42,0,80,38
1713326837659,PSYC 144,A00,494189,Staff,5,0,50,45
1713326838687,PSYC 154,A00,494190,Lacefield; Katharine I,107,0,180,73
1713326839713,PSYC 162,A00,494191,Wixted; John T,71,0,100,29
1713326840737,PSYC 172,A00,494192,Gorman; Michael R.,36,0,45,9
1713326841767,PSYC 178,A00,494193,Glaser; Dale,34,0,45,11
1713326842795,PSYC 193,A00,505725,Chapman; Eddie Nathaniel,20,0,20,0
1713326843823,RELI 145GS,A00,519817,Rahimi; Babak,18,0,20,2
1713326844849,SE 101A,A01,490862,Chadha; Mayank,23,0,25,2
1713326845873,SE 101C,A01,490924,Krysl; Petr,15,0,20,5
1713326846898,SE 110A,A01,490928,Staff,19,0,20,1
1713326847927,SE 130A,A00,490929,Morrison; Machel Leigh,55,0,70,15
1713326848955,SIO 1,A01,519325,Staff,39,0,40,1
1713326849983,SIO 30,A01,519327,Staff,38,0,40,2
1713326851012,SIO 40,A00,519328,Staff,39,0,40,1
1713326852038,SIO 46GS,A00,519819,Cook; Geoffrey W,17,0,25,8
1713326853062,SIO 109R,A00,494197,Forman; Fonna,0,3,20,20
1713326854086,SIO 121GS,A00,519827,Cook; Geoffrey W,17,0,25,8
1713326855111,SIO 132,A01,519330,Staff,38,0,40,2
1713326856137,SIO 133,A01,519397,Staff,37,0,40,3
1713326857164,SIO 139,A00,519396,Kacev; David,29,0,40,11
1713326858192,SOCI 1,A01,494199,Thorpe; Charles Robert,21,0,30,9
1713326858192,SOCI 1,A02,494200,Thorpe; Charles Robert,30,0,30,0
1713326858192,SOCI 1,A03,494201,Thorpe; Charles Robert,29,0,30,1
1713326858192,SOCI 1,A04,494202,Thorpe; Charles Robert,29,0,30,1
1713326858192,SOCI 1,A05,494203,Thorpe; Charles Robert,29,0,30,1
1713326858192,SOCI 1,A06,494204,Thorpe; Charles Robert,30,0,30,0
1713326858192,SOCI 1,A07,494205,Thorpe; Charles Robert,28,0,30,2
1713326859216,SOCI 60,A01,494207,Staff,34,0,40,6
1713326859216,SOCI 60,A02,494208,Staff,39,0,40,1
1713326860241,SOCI 100,A01,494210,Payne; Christine Anna,25,0,30,5
1713326860241,SOCI 100,A02,494211,Payne; Christine Anna,26,0,30,4
1713326861265,SOCI 109M,A00,494212,Staff,20,0,20,0
1713326862290,SOCI 110,A00,494213,Staff,34,0,40,6
1713326864342,SOCI 118E,A00,494215,Ng; Kwai,37,0,40,3
1713326865372,SOCI 125,A00,494216,Calderon-Zaks; Michael Aar,40,0,45,5
1713326866397,SOCI 126,A01,494218,Jones; Makeba,3,0,5,2
1713326867419,SOCI 131,A00,494219,Thorpe; Charles Robert,26,0,30,4
1713326869471,SOCI 135,A00,494221,Payne; Christine Anna,28,0,50,22
1713326870552,SOCI 136E,A00,626690,Ruiz; Jonathan Joseph,24,0,25,1
1713326871578,SOCI 138GS,A00,494222,Navon; Daniel,24,0,28,4
1713326873630,SOCI 145,A00,494224,Staff,40,0,45,5
1713326874658,SOCI 153,A00,494225,Staff,28,0,30,2
1713326875682,SOCI 160E,A00,494226,Ng; Kwai,29,0,40,11
1713326876707,SOCI 180,A00,494227,Staff,29,0,30,1
1713326877732,SOCI 189GS,A00,494228,Ribas Norris; Janet Vanesa,11,0,11,0
1713326878760,SOCI 190GS,A00,553232,Ribas Norris; Janet Vanesa,11,0,11,0
1713326879785,SOMI 220,A00,627178,Schneid; Stephen David,30,0,30,0
1713326880813,SYN 2,001,490768,Staff,14,0,15,1
1713326880813,SYN 2,002,490769,Staff,14,0,15,1
1713326880813,SYN 2,004,490775,Staff,0,0,0,0
1713326880813,SYN 2,003,490774,Staff,0,0,0,0
1713326880813,SYN 2,005,490776,Staff,0,0,0,0
1713326881841,SYN 2R,001,490779,Staff,11,0,15,4
1713326881841,SYN 2R,002,514635,Staff,14,0,15,1
1713326882871,SYN 100,A01,490783,Staff,10,0,20,10
1713326882871,SYN 100,B01,490787,Staff,9,0,20,11
1713326882871,SYN 100,C01,490789,Staff,10,0,20,10
1713326883899,SYN 150,A00,490817,Staff,14,0,15,1
1713326883899,SYN 150,B00,514610,Staff,15,0,15,0
1713326884932,TDAC 1,A00,492753,Walsh; Kim C.,19,0,20,1
1713326884932,TDAC 1,B00,492754,Harting; Carla Kelso,19,0,20,1
1713326884932,TDAC 1,C00,513995,Salovey; Todd,15,0,20,5
1713326885957,TDAC 101,A00,492766,Harting; Carla Kelso,17,0,20,3
1713326886983,TDAC 102,A00,492768,Basso; Beatrice,19,0,20,1
1713326888008,TDDE 111,A00,492769,Staff,25,0,25,0
1713326889037,TDDE 131,A00,492770,Staff,15,0,15,0
1713326889037,TDDE 131,B00,492771,Staff,15,0,15,0
1713326890060,TDDE 131GS,A00,523716,Guirguis; Mark C,23,0,28,5
1713326891085,TDGE 1,A01,492756,Salovey; Todd,56,0,60,4
1713326892111,TDGE 5,A01,492758,Staff,23,0,25,2
1713326893136,TDGE 10,A00,492759,Fulton; Julia,203,0,220,17
1713326894161,TDGE 11,A00,492760,Castro; Robert Jess,198,0,200,2
1713326896209,TDGE 124,A00,492772,Fulton; Julia,185,0,220,35
1713326897239,TDGE 125,A00,492773,Meyer; Ursula,38,0,50,12
1713326897239,TDGE 125,B00,492774,Staff,49,0,50,1
1713326897239,TDGE 125,C00,523565,Staff,48,0,50,2
1713326898265,TDGE 125GS,A00,523580,Guirguis; Mark C,23,0,28,5
1713326899289,TDGE 127,A00,492775,Havis; Allan,34,0,50,16
1713326900316,TDHT 101,A00,492776,Staff,34,0,35,1
1713326901341,TDMV 1,A00,492762,Caligagan; Maria T.,30,0,30,0
1713326901341,TDMV 1,B00,492763,Arcidiacono; Kristin,26,0,30,4
1713326902365,TDMV 2,A00,492764,Weinberg; Sadie,28,0,30,2
1713326903392,TDMV 3,A00,492765,Mack; Kara Shanai',37,0,40,3
1713326904418,TDMV 138,A00,492777,Mack; Kara Shanai',34,0,40,6
1713326905442,TDMV 140,A00,492778,Lima; Paulo Henrique,40,0,40,0
1713326906469,TDMV 142,A00,492779,Caligagan; Maria T.,33,0,40,7
1713326906469,TDMV 142,B00,492780,Caligagan; Tony,37,0,40,3
1713326907493,TDMV 143,A00,492781,Fyall; Daunte Edward,39,0,40,1
1713326908518,USP 1,A01,492401,Kwak; Nancy,27,0,35,8
1713326909547,USP 2,A01,492453,Hinds; Juli Beth,35,0,35,0
1713326910573,USP 3,A01,492516,Staff,28,0,35,7
1713326911602,USP 4,A00,492522,McTague; Sarah,16,0,25,9
1713326912626,USP 100,A00,492523,Staff,32,0,35,3
1713326913651,USP 101,A00,492524,Staff,13,0,15,2
1713326914679,USP 105,A00,492525,Staff,21,0,25,4
1713326915703,USP 151,A00,492526,Shenkman; Michael Thomas,32,0,35,3
1713326916729,USP 170,A00,492545,Hinds; Juli Beth,33,0,35,2
1713326917754,USP 171GS,A00,492608,Bussell; Mirle Rabinowitz,24,0,28,4
1713326918778,USP 183GS,A00,492613,Peerson; Susan,24,0,28,4
1713326919807,VIS 30,A01,490693,Yoldas; Pinar,19,0,22,3
1713326919807,VIS 30,A02,490694,Yoldas; Pinar,18,0,22,4
1713326920836,VIS 83,A00,490695,Kester; Grant,63,0,75,12
1713326921861,VIS 105D,A00,490696,Staff,22,0,25,3
1713326922886,VIS 124CN,A00,490699,Rose; Jordan M,65,0,75,10
1713326923911,VIS 125GS,A00,511221,Williams; Alena J,21,0,22,1
1713326924939,VIS 128D,A00,490700,Staff,73,0,75,2
1713326925963,VIS 151,A01,490717,Staff,33,0,34,1
1713326925963,VIS 151,A02,490766,Staff,33,0,34,1
1713326926992,VIS 154GS,A00,511972,Williams; Alena J,21,0,22,1
1713326928019,VIS 160A,A00,490767,Stone; Patricia,7,0,10,3
1713326929049,WCWP 10A,A00,490638,Staff,14,0,15,1
1713326929049,WCWP 10A,B00,490640,Staff,15,0,15,0
1713326930076,WCWP 10B,A00,490641,Staff,0,0,0,0
1713326930076,WCWP 10B,B00,490642,Staff,14,0,15,1
1713326930076,WCWP 10B,C00,490644,Staff,13,0,15,2
1713326930076,WCWP 10B,D00,490647,Staff,0,0,0,0
1713326931103,WCWP 100,A00,490655,Staff,0,0,0,0
1713326931103,WCWP 100,B00,490687,Staff,10,0,15,5
1713326933209,ANAR 153,A00,487222,Braswell; Geoffrey E.,54,0,60,6
1713326934235,ANBI 134,A00,487223,Staff,6,0,20,14
1713326935258,ANBI 143GS,A00,487224,Noel; Geoffroy Pierre Jean,18,0,24,6
1713326936286,ANBI 144GS,A00,519548,Noel; Geoffroy Pierre Jean,18,0,24,6
1713326937310,ANSC 101,A00,487225,Staff,18,0,20,2
1713326938336,ANSC 125,A00,487227,Brenner; Suzanne A,39,0,40,1
1713326940385,ANSC 146,A00,487229,Staff,35,0,40,5
1713326941415,ANSC 148,A00,487230,Olivas Hernandez; Olga Lid,39,0,40,1
1713326942439,ANSC 150,A00,504165,Sloane; Julia Kathryn,18,0,20,2
1713326943462,ANSC 180,A00,487232,Staff,14,0,15,1
1713326944486,ANSC 188,A00,627155,Staff,39,0,40,1
1713326945516,ANTH 5,A00,519529,Semendeferi; Ekaterini,15,0,15,0
1713326946541,ANTH 10,A00,487219,Staff,58,0,60,2
1713326947565,ANTH 23,A01,487221,Staff,17,0,20,3
1713326948594,ANTH 102,A00,487233,Wilder; Linnea Lorene,51,0,60,9
1713326949618,ANTH 103,A00,487234,Varma; Saiba,55,0,60,5
1713326950644,ANTH 105,A00,487235,Stewart; Alexander B,55,0,60,5
1713326951669,BENG 100,A01,516685,Taylor Amos; Alyssa C,27,0,30,3
1713326952695,BIBC 102,A01,491316,Flagg; Matthew Paul,14,0,88,74
1713326952695,BIBC 102,A02,491366,Flagg; Matthew Paul,78,0,88,10
1713326953724,BIBC 103,A01,491486,Boumechache; Miyyada,16,0,24,8
1713326953724,BIBC 103,A02,491487,Boumechache; Miyyada,24,0,24,0
1713326954749,BICD 100,A01,516882,Staff,73,0,75,2
1713326954749,BICD 100,A02,516890,Staff,69,0,75,6
1713326955775,BICD 102GS,A00,491488,Lo; Stanley M.,26,0,28,2
1713326956799,BIEB 136GS,A00,516940,Holway; David A. & Shurin; Jonathan,18,0,24,6
1713326957828,BIEB 137GS,A01,517034,Holway; David A. & Shurin; Jonathan,18,0,24,6
1713326958852,BIEB 138GS,A01,491492,Pirino; Giorgia,21,0,28,7
1713326959878,BILD 1,A01,491296,Staff,60,0,63,3
1713326959878,BILD 1,A02,491297,Staff,63,0,63,0
1713326960903,BILD 4,A01,517099,Gonzalez Gamboa; Ivonne,22,0,24,2
1713326960903,BILD 4,A02,517100,Gonzalez Gamboa; Ivonne,24,0,24,0
1713326961927,BILD 60GS,A00,491309,Lo; Stanley M.,26,0,28,2
1713326962956,BIMM 100,A01,517136,Staff,85,0,100,15
1713326963979,BIMM 110,A01,517182,Staff,56,0,100,44
1713326965004,BIMM 120,A01,517228,Pickett; Brooke Elizabeth,29,0,63,34
1713326965004,BIMM 120,A02,517240,Pickett; Brooke Elizabeth,44,0,63,19
1713326966032,BIMM 132GS,A01,491498,Pirino; Giorgia,21,0,28,7
1713326967061,BIMM 143,A01,491589,Bozinovic; Goran,13,0,40,27
1713326968085,BIPN 100,A01,491594,Armour; Jon Christopher,85,0,100,15
1713326969111,BIPN 140,A01,491602,Marino; Marc J,26,0,50,24
1713326971161,CAT 125,A00,515973,Staff,18,0,20,2
1713326972187,CAT 125GS,A00,515974,Rahimi; Babak,17,0,20,3
1713326973211,CAT 125R,A00,515980,Staff,12,0,20,8
1713326973211,CAT 125R,B00,515981,Tosun; Adriana,19,0,20,1
1713326973211,CAT 125R,C00,515987,Hyland; Tina Mae,0,2,20,20
1713326973211,CAT 125R,D00,515988,Bronstein; Phoebe Malan,17,0,20,3
1713326974314,CENG 15,A01,488699,Drews; Aaron,25,0,25,0
1713326975339,CENG 100,A00,505196,Opatkiewicz; Justin Paul,25,0,25,0
1713326976368,CGS 2A,A01,489598,Staff,33,0,35,2
1713326977395,CGS 112,A00,489599,Staff,15,0,15,0
1713326978421,CGS 119,A00,489603,Staff,10,0,10,0
1713326979445,CGS 120,A00,489604,Staff,14,0,15,1
1713326980471,CGS 150,A00,489607,Staff,15,0,15,0
1713326981494,CHEM 6A,A01,488715,Staff,98,0,100,2
1713326982516,CHEM 6B,A01,488719,Piercy; Marc Anthony,99,0,100,1
1713326983542,CHEM 6C,A01,488723,Albizati; Kim F.,93,0,100,7
1713326984573,CHEM 7L,A01,488728,Schurmeier; Kimberly,18,0,24,6
1713326984573,CHEM 7L,A02,488730,Schurmeier; Kimberly,23,0,24,1
1713326984573,CHEM 7L,A03,488734,Schurmeier; Kimberly,20,0,24,4
1713326984573,CHEM 7L,A04,488763,Schurmeier; Kimberly,23,0,24,1
1713326984573,CHEM 7L,B01,488798,Schurmeier; Kimberly,17,0,24,7
1713326984573,CHEM 7L,B02,488801,Schurmeier; Kimberly,22,0,24,2
1713326984573,CHEM 7L,B03,488808,Schurmeier; Kimberly,23,0,24,1
1713326984573,CHEM 7L,B04,488811,Schurmeier; Kimberly,24,0,24,0
1713326985598,CHEM 11,A01,488897,Stallings; Dontarie M,95,0,100,5
1713326986623,CHEM 40A,A01,488913,Albizati; Kim F.,84,0,100,16
1713326987649,CHEM 40B,A01,488920,Weizman; Haim,43,0,50,7
1713326987649,CHEM 40B,A02,488938,Weizman; Haim,45,0,50,5
1713326988674,CHEM 41A,A01,489029,Klosterman; Jeremy K,57,0,60,3
1713326989699,CHEM 41C,A01,500436,Tor; Yitzhak,55,0,60,5
1713326990726,CHEM 43A,A01,500426,Weizman; Haim,0,0,24,24
1713326990726,CHEM 43A,A02,500430,Weizman; Haim,8,0,24,16
1713326990726,CHEM 43A,B01,514041,Klosterman; Jeremy K,16,0,24,8
1713326990726,CHEM 43A,B02,514047,Klosterman; Jeremy K,23,0,24,1
1713326991749,CHEM 108,A01,489140,Jennings; Patricia A.,9,0,24,15
1713326991749,CHEM 108,A02,489142,Jennings; Patricia A.,14,0,24,10
1713326992773,CHEM 114A,A01,489147,Stallings; Dontarie M,68,0,100,32
1713326993798,CHIN 169A,A00,489171,Wang; Xiao,19,0,20,1
1713326995851,COGS 3,A01,518827,Boyle; Mary E. T.,26,0,40,14
1713326996877,COGS 11,A01,489175,Staff,27,0,30,3
1713326997902,COGS 14A,A01,518829,Staff,51,0,60,9
1713326998927,COGS 14B,A01,489177,Hoffman; Drew Ellen,63,0,75,12
1713326999952,COGS 100,A01,489181,Allen; Michael Gordon,63,0,75,12
1713327000981,COGS 101A,A01,489183,Staff,46,0,60,14
1713327002009,COGS 101B,A01,489185,Allen; Michael Gordon,8,0,30,22
1713327003038,COGS 101C,A01,526786,Staff,23,0,30,7
1713327005087,COGS 107A,A01,489189,Boyle; Mary E. T.,18,0,35,17
1713327006113,COGS 107B,A01,627144,Mooshagian; Eric Frederick,60,0,60,0
1713327007141,COGS 118A,A01,489191,Staff,0,44,40,40
1713327009192,COGS 171GS,A01,489194,Pineda; Jaime A,20,0,28,8
1713327010220,COGS 172,A01,489196,Staff,3,0,30,27
1713327011248,COGS 174GS,A01,489264,Pineda; Jaime A,20,0,28,8
1713327012272,COGS 180,A01,627150,Staff,28,0,30,2
1713327013297,COGS 186,A01,489274,Staff,0,1,30,30
1713327014325,COMM 10,A01,489276,Staff,23,0,25,2
1713327014325,COMM 10,A02,489303,Staff,23,0,25,2
1713327015351,COMM 100A,A01,489312,Staff,14,0,25,11
1713327015351,COMM 100A,A02,489313,Staff,24,0,25,1
1713327016377,COMM 106T,A00,512540,Staff,33,0,35,2
1713327017401,COMM 107,A00,489347,Staff,27,0,35,8
1713327018427,COMM 109P,A00,489358,Staff,31,0,35,4
1713327019456,COMM 132,A00,489361,McKenna; Denise,27,0,30,3
1713327020483,COMM 146,A00,489362,Halm; Gavin Patrick,26,0,30,4
1713327021508,COMM 190,A00,489363,Abuelhiga; Soraya Jill,17,0,23,6
1713327022533,CSE 8A,A50,489366,Staff,21,0,25,4
1713327022533,CSE 8A,A51,489367,Staff,24,0,25,1
1713327023557,CSE 11,A01,489398,Cao; Yingjun,74,0,100,26
1713327024585,CSE 12,A01,489487,Staff,43,0,50,7
1713327025608,CSE 20,A01,489497,Staff,48,0,50,2
1713327026637,CSE 21,A01,489517,Braun; Oliver,42,0,50,8
1713327027665,CSE 101,A01,489524,Braun; Oliver,0,28,50,50
1713327028689,CSE 105,A01,512594,Jones; Miles E,72,0,100,28
1713327028689,CSE 105,B01,512598,Jones; Miles E,52,0,100,48
1713327029712,CSE 140,A01,489538,Staff,41,0,50,9
1713327030741,CSE 141,A01,489550,Eldon; John,68,0,100,32
1713327031773,CSE 141L,A01,489571,Eldon; John,66,0,100,34
1713327032797,CSE 151A,A01,489583,Solares; Edwin A,141,0,200,59
1713327033824,CSE 175,A01,510886,Kumar; Rakesh,30,0,30,0
1713327034853,CSE 190,A00,516828,Dubnov; Shlomo,38,0,49,11
1713327035879,DOC 100D,A00,489667,Pass; Natalye Joann,19,0,25,6
1713327036902,DSC 10,A01,624268,Staff,72,0,75,3
1713327037927,DSC 20,A01,624476,Staff,50,0,50,0
1713327038955,DSC 40A,A01,624608,Staff,39,0,40,1
1713327039981,DSGN 1,A01,489179,Rill; Bryan,33,0,50,17
1713327041010,ECE 17,A01,490489,Sahay; Rajeev,18,0,30,12
1713327042039,ECE 65,A50,490492,Staff,12,0,20,8
1713327042039,ECE 65,A51,490493,Staff,18,0,20,2
1713327043063,ECON 1,A01,489715,Famulari; Melissa,68,0,70,2
1713327044089,ECON 2,A01,489717,Levkoff; Steven B.,68,0,70,2
1713327045113,ECON 3,A01,489948,Staff,70,0,70,0
1713327047169,ECON 5,A01,490103,Staff,27,0,30,3
1713327047169,ECON 5,B01,626281,Dai; Yinlin,45,0,45,0
1713327048197,ECON 100A,A01,490127,Famulari; Melissa,65,0,70,5
1713327049224,ECON 100B,A01,490129,Staff,64,0,70,6
1713327050252,ECON 109,A01,490187,Shishkin; Denis,27,0,35,8
1713327051277,ECON 110A,A01,490190,Levkoff; Steven B.,60,0,70,10
1713327052301,ECON 120A,A01,490245,Dai; Yinlin,61,0,70,9
1713327053325,ECON 120B,A01,490247,Nieto-Barthaburu; Augusto,42,0,70,28
1713327054355,ECON 120C,A01,490253,Sun; Yixiao,30,0,35,5
1713327054355,ECON 120C,B01,490255,Sun; Yixiao,34,0,35,1
1713327055413,ECON 129,A00,490256,Eckert; Fabian Paul,23,0,35,12
1713327056438,ECON 131,A00,490257,Nieto-Barthaburu; Augusto,0,6,35,35
1713327057464,ECON 138,A00,490258,Bharadwaj; Prashant,13,0,35,22
1713327057464,ECON 138,B00,490259,Bharadwaj; Prashant,15,0,35,20
1713327058494,ECON 159,A00,490260,Hendrickson; Gerald M.,0,9,0,0
1713327059522,ECON 178,A01,553995,Zhu; Ying,24,0,35,11
1713327060546,EDS 40,A01,512576,Black; Alison Michelle,20,0,20,0
1713327061570,EDS 107,A01,515848,Staff,30,0,30,0
1713327062598,EDS 110R,A01,490262,Staff,26,0,30,4
1713327063624,EDS 112,A01,490264,Chapman; Thandeka K,40,0,50,10
1713327064654,EDS 113,A00,490266,Staff,26,0,30,4
1713327065681,EDS 118,A00,490267,Warstadt; Melissa Fawn,21,0,30,9
1713327066705,EDS 124BR,A00,490268,Eguchi; Emi,4,0,25,21
1713327066705,EDS 124BR,B00,490269,Eguchi; Emi,23,0,25,2
1713327067733,EDS 126,A01,490271,Jones; Makeba,43,0,50,7
1713327068761,EDS 135,A01,490316,Staff,19,0,20,1
1713327069787,ENVR 142GS,A00,519514,Chang; Edmond Yi-Teh,27,0,28,1
1713327070811,ETHN 103,A00,490504,Staff,25,0,36,11
1713327071835,ETHN 103A,A00,490505,Man; Simeon S,4,0,9,5
1713327072860,ETHN 109,A00,490506,Staff,28,0,30,2
1713327073900,ETHN 118,A00,490507,Staff,35,0,36,1
1713327074925,ETHN 119,A00,490508,Staff,33,0,36,3
1713327075951,ETHN 121R,A00,490518,Choi; Esther Min,21,0,36,15
1713327076980,ETHN 127,A00,490528,Staff,14,0,15,1
1713327078058,ETHN 139,A00,490573,Staff,10,0,10,0
1713327079087,ETHN 150,A00,490575,Staff,15,0,15,0
1713327080115,GLBH 20,A00,491705,Elwardani; Nile Regina,38,0,40,2
1713327081144,GLBH 101,A00,491706,Staff,20,0,20,0
1713327082169,GLBH 111,A01,491708,Burgos; Jose L.,15,0,15,0
1713327083194,GLBH 146,A00,491709,Staff,9,0,20,11
1713327084223,GLBH 148,A00,491710,Olivas Hernandez; Olga Lid,11,0,20,9
1713327085250,GLBH 150,A00,491711,Sloane; Julia Kathryn,19,0,20,1
1713327086276,HIEA 131,A00,491760,Staff,28,0,32,4
1713327087303,HIEA 153,A00,491762,Staff,28,0,30,2
1713327088331,HIEU 124,A00,491811,Staff,26,0,32,6
1713327089357,HIEU 124GS,A00,491812,Markman; Kristina,27,0,28,1
1713327090381,HIEU 147,A00,491813,Staff,30,0,32,2
1713327091408,HIEU 149GS,A00,491816,Caldwell; Michael Alan,28,0,28,0
1713327092439,HILD 2C,A01,491713,Hendrickson; Gerald M.,26,0,30,4
1713327093463,HILD 7B,A01,491715,Kwak; Nancy,0,1,30,30
1713327094493,HILD 10,A01,491717,Staff,11,0,20,9
1713327095520,HILD 30GS,A00,491719,Edington; Claire Ellen,24,0,28,4
1713327096545,HINE 109,A00,491818,Shafir; Nir,27,0,32,5
1713327097571,HINE 128,A00,491821,Shafir; Nir,31,0,32,1
1713327098595,HISC 117,A00,491830,Staff,27,0,32,5
1713327099624,HIUS 103,A00,491834,Man; Simeon S,14,0,23,9
1713327100650,HIUS 108B,A00,491835,Staff,28,0,30,2
1713327101677,HIUS 141,A00,491836,Hendrickson; Gerald M.,28,0,32,4
1713327102706,HIUS 149,A00,491839,Staff,24,0,32,8
1713327103734,HUM 3,A01,512617,Crum; Matthew Stephen,43,0,50,7
1713327103734,HUM 3,A02,512618,Crum; Matthew Stephen,48,0,50,2
1713327104758,HUM 3GS,A00,512663,Markman; Kristina,0,0,0,1
1713327104758,HUM 3GS,B00,512664,Staff,0,0,0,0
1713327105782,HUM 4,A01,512620,West; Geoffrey Scott,27,0,50,23
1713327106807,HUM 4GS,A00,512666,Lyon; Antony J.,0,0,0,4
1713327107836,HUM 4R,A01,512625,Watkins; Eric,49,0,50,1
1713327108861,HUM 5,A01,512649,Zavodny; Tatiana Sophia,23,0,50,27
1713327108861,HUM 5,B01,512661,Zroka; Ryan Edward,48,0,50,2
1713327109887,INTL 190,A00,490577,Segui; Alan S,0,0,0,5
1713327110918,JAPN 20AR,A01,491267,Ross; Kayoko F,8,0,20,12
1713327111942,JAPN 180,A00,491285,Berman; Michael David,33,0,40,7
1713327112966,LATI 50,A01,502536,Kokinis; Troy Andreas,16,0,22,6
1713327112966,LATI 50,A02,502551,Kokinis; Troy Andreas,22,0,22,0
1713327112966,LATI 50,A03,502650,Kokinis; Troy Andreas,22,0,22,0
1713327112966,LATI 50,A04,502909,Kokinis; Troy Andreas,21,0,22,1
1713327113991,LATI 160,A01,502920,Kokinis; Troy Andreas,30,0,30,0
1713327115014,LIFR 1A,A00,490494,Van Moer; Vinciane G,17,0,20,3
1713327116038,LIFR 1AX,A00,490495,Van Moer; Vinciane G,17,0,20,3
1713327117063,LIFR 1B,A00,490496,Van Moer; Vinciane G,18,0,20,2
1713327118089,LIFR 1BX,A00,490497,Van Moer; Vinciane G,18,0,20,2
1713327119116,LIGN 8,A00,505198,McIntosh; Justin Daniel,134,0,150,16
1713327120141,LIGN 9GS,A00,491239,Lott; Margaret S.,18,0,20,2
1713327121168,LIGN 101,A01,505200,McIntosh; Justin Daniel,22,0,30,8
1713327122192,LIGN 120,A01,491244,Staff,23,0,30,7
1713327123220,LIGN 149GS,A00,491245,Lott; Margaret S.,18,0,20,2
1713327124249,LIGN 170,A00,491247,Staff,22,0,30,8
1713327125273,LISP 1D,A00,490498,Munoz Sanchez; Alicia,9,0,14,5
1713327125273,LISP 1D,B00,490499,Munoz Sanchez; Alicia,6,0,14,8
1713327125273,LISP 1D,C00,490500,Munoz Sanchez; Alicia,7,0,14,7
1713327125273,LISP 1D,D00,490501,Munoz Sanchez; Alicia,10,0,14,4
1713327126297,LISP 1DX,A00,490502,Munoz Sanchez; Alicia,14,0,28,14
1713327126297,LISP 1DX,B00,490503,Munoz Sanchez; Alicia,16,0,28,12
1713327128348,LTAM 110,A00,491847,Staff,23,0,25,2
1713327129372,LTCS 119,A00,491848,Staff,11,0,15,4
1713327130399,LTCS 130,A00,491849,Staff,24,0,25,1
1713327132452,LTEA 120C,A00,491852,Staff,32,0,40,8
1713327133476,LTEN 130GS,A00,491853,Lyon; Antony J.,24,0,28,4
1713327134504,LTEN 148,A00,491855,Staff,23,0,25,2
1713327135528,LTEN 159,A00,491856,Staff,21,0,25,4
1713327136552,LTEN 180,A00,491857,Staff,8,0,15,7
1713327138606,LTSP 123GS,A00,505928,Bessett; Ryan Matthew,24,0,28,4
1713327139632,LTSP 174GS,A00,506037,Bessett; Ryan Matthew,24,0,28,4
1713327141684,LTWR 102,A00,491861,Staff,9,0,15,6
1713327142711,LTWR 106,A00,491862,Staff,8,0,15,7
1713327143736,MAE 11,A00,490930,Bahadori; Mohammad Yousef,95,0,100,5
1713327144762,MAE 30A,A00,490931,Qi; Huihui,37,0,40,3
1713327145787,MAE 101A,A00,491036,Sadeghizadeh; Zahra,92,0,100,8
1713327146810,MAE 101C,A00,491037,Seshadri; Kalyanasundaram,67,0,100,33
1713327147835,MAE 113,A00,491040,Seshadri; Kalyanasundaram,66,0,80,14
1713327148863,MAE 131A,A00,491041,Ghazinejad; Maziar,37,0,40,3
1713327149893,MAE 142,A00,491053,Staff,39,0,40,1
1713327150918,MAE 143A,A00,491054,Staff,33,0,50,17
1713327151941,MAE 150,A00,491092,Truong; Phuong Thi Ngoc,23,0,35,12
1713327152967,MATH 3C,A01,494031,Pardo Guerra; Sebastian,30,0,30,0
1713327152967,MATH 3C,A02,494032,Pardo Guerra; Sebastian,29,0,30,1
1713327153991,MATH 10A,A01,494034,Staff,27,0,30,3
1713327153991,MATH 10A,A02,494035,Staff,28,0,30,2
1713327153991,MATH 10A,B01,494037,Staff,27,0,30,3
1713327153991,MATH 10A,B02,494038,Staff,29,0,30,1
1713327155022,MATH 10B,A01,494040,Habib; Yousaf,22,0,30,8
1713327155022,MATH 10B,A02,494041,Habib; Yousaf,28,0,30,2
1713327155022,MATH 10B,A03,494042,Habib; Yousaf,29,0,30,1
1713327155022,MATH 10B,A04,494043,Habib; Yousaf,30,0,30,0
1713327155022,MATH 10B,B01,494045,Habib; Yousaf,25,0,30,5
1713327155022,MATH 10B,B02,494046,Habib; Yousaf,30,0,30,0
1713327155022,MATH 10B,B03,494047,Habib; Yousaf,30,0,30,0
1713327155022,MATH 10B,B04,494048,Habib; Yousaf,30,0,30,0
1713327156047,MATH 18,A01,494050,Kemp; Todd Aahron,25,0,30,5
1713327156047,MATH 18,A02,494051,Kemp; Todd Aahron,29,0,30,1
1713327156047,MATH 18,B01,494054,Kemp; Todd Aahron,26,0,30,4
1713327156047,MATH 18,B02,494055,Kemp; Todd Aahron,29,0,30,1
1713327157077,MATH 20A,A01,494059,Suk; Andrew Hoon,30,0,30,0
1713327158108,MATH 20B,A01,494061,Briones; Jor-el Thomas Caparas,33,0,35,2
1713327158108,MATH 20B,B01,494063,Bach; Quang Tran,34,0,35,1
1713327159139,MATH 20C,A01,494065,Staff,28,0,30,2
1713327159139,MATH 20C,A02,494066,Staff,30,0,30,0
1713327159139,MATH 20C,A03,494067,Staff,30,0,30,0
1713327159139,MATH 20C,A04,494068,Staff,30,0,30,0
1713327159139,MATH 20C,B01,494070,Zhang; Ming,25,0,30,5
1713327159139,MATH 20C,B02,494071,Zhang; Ming,27,0,30,3
1713327159139,MATH 20C,B03,494072,Zhang; Ming,29,0,30,1
1713327159139,MATH 20C,B04,494073,Zhang; Ming,29,0,30,1
1713327160164,MATH 20D,A01,494075,Staff,22,0,30,8
1713327160164,MATH 20D,A02,494076,Staff,29,0,30,1
1713327161192,MATH 20E,A01,494079,Staff,24,0,30,6
1713327161192,MATH 20E,A02,494080,Staff,26,0,30,4
1713327161192,MATH 20E,B01,494082,Staff,25,0,30,5
1713327161192,MATH 20E,B02,494083,Staff,25,0,30,5
1713327162221,MATH 103A,A01,494085,Aliabadi Sr.; Mohsen,14,0,30,16
1713327162221,MATH 103A,A02,494086,Aliabadi Sr.; Mohsen,28,0,30,2
1713327162221,MATH 103A,B01,494088,Aliabadi Sr.; Mohsen,21,0,30,9
1713327162221,MATH 103A,B02,494089,Aliabadi Sr.; Mohsen,27,0,30,3
1713327163252,MATH 109,A01,494091,Staff,30,0,30,0
1713327163252,MATH 109,A02,494092,Staff,29,0,30,1
1713327163252,MATH 109,B01,494094,Staff,27,0,30,3
1713327163252,MATH 109,B02,494095,Staff,29,0,30,1
1713327164279,MATH 142A,A01,494097,Chow; Bennett,15,0,30,15
1713327164279,MATH 142A,A02,494098,Chow; Bennett,23,0,30,7
1713327164279,MATH 142A,B01,494100,Chow; Bennett,19,0,30,11
1713327164279,MATH 142A,B02,494101,Chow; Bennett,29,0,30,1
1713327166333,MATH 168A,A01,516677,Dumitriu; Ioana,16,0,35,19
1713327167359,MATH 170A,A01,516679,Dumitriu; Ioana,18,0,30,12
1713327167359,MATH 170A,A02,516680,Dumitriu; Ioana,28,0,30,2
1713327168383,MATH 193A,A01,494107,Staff,14,0,30,16
1713327168383,MATH 193A,A02,494108,Staff,20,0,30,10
1713327168383,MATH 193A,A03,494109,Staff,29,0,30,1
1713327168383,MATH 193A,A04,494110,Staff,22,0,30,8
1713327171458,MGT 16,A00,491930,McKay; Michael J,92,0,98,6
1713327172481,MGT 18,A00,491992,McKay; Michael J,96,0,98,2
1713327173505,MGT 71,A00,492003,Staff,66,0,98,32
1713327174529,MGT 103,A00,505209,Eberhard; Craig A,81,0,98,17
1713327175557,MGT 131A,A00,505210,Anderson; John Charles,89,0,98,9
1713327177611,MGT 153,A00,492077,Perols; Johan Lars,19,0,90,71
1713327180694,MGT 164,A00,492222,McKay; Mary A,91,0,98,7
1713327181775,MGT 172,A00,492245,Staff,59,0,60,1
1713327181775,MGT 172,B00,505526,Hedges; Kathleen,65,0,98,33
1713327182801,MGT 181,A00,505669,Dunn; Louis Jean,82,0,98,16
1713327183827,MMW 14,A01,494399,Staff,15,0,28,13
1713327183827,MMW 14,A02,494400,Staff,25,0,28,3
1713327183827,MMW 14,A03,494401,Staff,28,0,28,0
1713327183827,MMW 14,A04,494402,Staff,28,0,28,0
1713327183827,MMW 14,B01,494404,Carreras; Maria Victoria,8,0,28,20
1713327183827,MMW 14,B02,494405,Carreras; Maria Victoria,25,0,28,3
1713327183827,MMW 14,B03,494406,Carreras; Maria Victoria,27,0,28,1
1713327183827,MMW 14,B04,494407,Carreras; Maria Victoria,28,0,28,0
1713327184853,MMW 14GS,A00,506250,Chang; Edmond Yi-Teh,0,0,0,0
1713327185877,MMW 121R,A01,494415,Adamiak; Patrick John,11,0,28,17
1713327185877,MMW 121R,A02,494416,Adamiak; Patrick John,24,0,28,4
1713327186902,MUS 1A,A01,494113,Staff,12,0,25,13
1713327186902,MUS 1A,A02,494114,Staff,24,0,25,1
1713327187930,MUS 4,A01,494116,Staff,23,0,25,2
1713327187930,MUS 4,A02,494117,Staff,22,0,25,3
1713327188963,MUS 5R,A01,494236,Dubnov; Shlomo,6,0,25,19
1713327188963,MUS 5R,A02,494237,Dubnov; Shlomo,25,0,25,0
1713327189988,MUS 6,A01,494122,Staff,10,0,25,15
1713327189988,MUS 6,A02,494123,Staff,23,0,25,2
1713327191014,MUS 7,A01,494125,Staff,16,0,25,9
1713327191014,MUS 7,A02,494126,Staff,24,0,25,1
1713327192042,MUS 11,A01,494128,Staff,23,0,25,2
1713327192042,MUS 11,A02,494129,Staff,24,0,25,1
1713327193066,MUS 13,A01,494131,Staff,25,0,25,0
1713327193066,MUS 13,A02,494132,Staff,25,0,25,0
1713327194093,MUS 15,A01,494134,Staff,17,0,25,8
1713327194093,MUS 15,A02,494135,Staff,25,0,25,0
1713327194093,MUS 15,B01,494137,Staff,24,0,25,1
1713327195124,MUS 80,A00,494232,Staff,24,0,25,1
1713327195124,MUS 80,B00,494233,Staff,25,0,25,0
1713327195124,MUS 80,C00,494234,Staff,23,0,25,2
1713327196154,MUS 95C,A00,494141,Staff,70,0,75,5
1713327197179,MUS 114,A00,494142,Staff,40,0,50,10
1713327198202,NANO 15,A01,490636,Drews; Aaron,7,0,7,0
1713327199230,PHIL 1,A00,490578,Grush; Rick Scott,49,0,50,1
1713327200259,PHIL 10,A01,490580,Grush; Rick Scott,33,0,35,2
1713327200259,PHIL 10,A02,490586,Grush; Rick Scott,32,0,35,3
1713327201283,PHIL 27,A01,490591,Staff,22,0,25,3
1713327201283,PHIL 27,A02,490592,Staff,25,0,25,0
1713327201283,PHIL 27,A03,490593,Staff,25,0,25,0
1713327201283,PHIL 27,A04,490598,Staff,25,0,25,0
1713327202308,PHIL 32,A01,490611,Staff,20,0,20,0
1713327202308,PHIL 32,A02,490618,Staff,20,0,20,0
1713327203333,PHIL 90,A00,490624,Staff,40,0,40,0
1713327204362,PHIL 136,A00,490627,Cohen; Jonathan David,37,0,40,3
1713327205386,PHIL 155,A00,490634,Staff,62,0,70,8
1713327206420,PHYS 1A,A00,491610,Staff,245,0,250,5
1713327207446,PHYS 1AL,001,491616,Tsai; Philbert S,27,0,30,3
1713327207446,PHYS 1AL,002,491618,Tsai; Philbert S,30,0,30,0
1713327208472,PHYS 1B,A00,491623,Staff,236,0,250,14
1713327209501,PHYS 1BL,001,491626,Tsai; Philbert S,22,0,30,8
1713327209501,PHYS 1BL,002,491628,Tsai; Philbert S,26,0,30,4
1713327210525,PHYS 1C,A00,491632,Staff,214,0,245,31
1713327211554,PHYS 1CL,001,491635,Tsai; Philbert S,3,0,30,27
1713327211554,PHYS 1CL,002,491643,Tsai; Philbert S,22,0,30,8
1713327212579,PHYS 2AR,A01,491651,Meyertholen; Andrew D.,44,0,50,6
1713327213605,PHYS 2B,A01,491659,Staff,105,0,115,10
1713327214630,PHYS 2BL,A01,491685,Staff,21,0,24,3
1713327214630,PHYS 2BL,A02,491700,Staff,21,0,24,3
1713327215656,PHYS 2C,A01,505161,Staff,102,0,115,13
1713327216681,PHYS 4A,A01,491704,Grinstein; Benjamin,99,0,100,1
1713327217707,POLI 5D,A01,494144,Staff,3,0,5,2
1713327217707,POLI 5D,B01,626283,Dai; Yinlin,5,0,5,0
1713327218734,POLI 12,A00,494145,Staff,43,0,45,2
1713327219758,POLI 13R,A00,494146,Forman; Fonna,45,0,50,5
1713327220786,POLI 27,A01,494148,Staff,54,0,60,6
1713327221812,POLI 30,A00,494149,Staff,49,0,50,1
1713327222840,POLI 100DA,A00,494150,Staff,21,0,25,4
1713327224892,POLI 100I,A00,494152,Staff,27,0,30,3
1713327225921,POLI 104B,A00,494153,Smith; Glenn Chatmas,53,0,55,2
1713327226946,POLI 104F,A00,494154,Staff,28,0,30,2
1713327227975,POLI 104I,A00,494155,Smith; Glenn Chatmas,29,0,30,1
1713327229003,POLI 110C,A00,494156,Ingham; Sean,23,0,25,2
1713327230031,POLI 117R,A00,494157,Forman; Fonna,8,0,20,12
1713327231058,POLI 118,A00,494158,Ingham; Sean,21,0,25,4
1713327232085,POLI 120H,A00,494159,Fisk; David Lee,39,0,45,6
1713327233113,POLI 131CR,A00,494160,Hoston; Germaine,35,0,45,10
1713327234139,POLI 133J,A00,494161,Staff,33,0,35,2
1713327235168,POLI 135,A00,494162,Fisk; David Lee,33,0,35,2
1713327236196,POLI 140A,A00,494164,Staff,20,0,30,10
1713327237221,POLI 142I,A00,494165,Staff,30,0,30,0
1713327238247,POLI 144D,A00,494166,Staff,23,0,25,2
1713327239273,POLI 151,A00,494167,Staff,30,0,30,0
1713327240297,POLI 153,A00,494168,Staff,33,0,35,2
1713327241323,POLI 160AA,A00,494169,Staff,34,0,40,6
1713327242349,POLI 162,A00,494170,Mignozzetti; Umberto,19,0,25,6
1713327243374,POLI 171,A00,494171,Mignozzetti; Umberto,20,0,25,5
1713327244397,PSYC 1,A00,494172,Staff,96,0,100,4
1713327245425,PSYC 2,A00,494173,Moranton; Nirelia Melbina-,34,0,50,16
1713327246450,PSYC 3,A00,494174,Staff,29,0,30,1
1713327247475,PSYC 6,A00,494175,Staff,17,0,20,3
1713327248501,PSYC 60,A01,494177,Staff,38,0,45,7
1713327249524,PSYC 70,A01,505724,Geller; Emma Harlan,42,0,45,3
1713327250549,PSYC 101,A00,494180,Heyman; Gail D.,84,0,100,16
1713327251577,PSYC 105,A00,494181,Geller; Emma Harlan,51,0,90,39
1713327252602,PSYC 106,A00,494182,Dobkins; Karen R.,28,0,45,17
1713327253628,PSYC 108,A00,494183,Adrian; Julia Anna,89,0,100,11
1713327254657,PSYC 114,A01,494185,Winkielman; Piotr,0,2,30,30
1713327255686,PSYC 122,A00,494186,Moranton; Nirelia Melbina-,29,0,50,21
1713327256714,PSYC 124,A00,494187,Chapman; Eddie Nathaniel,71,0,80,9
1713327257741,PSYC 131,A00,494188,Anagnostaras; Stephan,42,0,80,38
1713327258766,PSYC 144,A00,494189,Staff,5,0,50,45
1713327259796,PSYC 154,A00,494190,Lacefield; Katharine I,107,0,180,73
1713327260825,PSYC 162,A00,494191,Wixted; John T,71,0,100,29
1713327261850,PSYC 172,A00,494192,Gorman; Michael R.,36,0,45,9
1713327262880,PSYC 178,A00,494193,Glaser; Dale,34,0,45,11
1713327263904,PSYC 193,A00,505725,Chapman; Eddie Nathaniel,20,0,20,0
1713327264929,RELI 145GS,A00,519817,Rahimi; Babak,18,0,20,2
1713327265951,SE 101A,A01,490862,Chadha; Mayank,23,0,25,2
1713327266978,SE 101C,A01,490924,Krysl; Petr,15,0,20,5
1713327268006,SE 110A,A01,490928,Staff,19,0,20,1
1713327269033,SE 130A,A00,490929,Morrison; Machel Leigh,55,0,70,15
1713327270064,SIO 1,A01,519325,Staff,39,0,40,1
1713327271089,SIO 30,A01,519327,Staff,38,0,40,2
1713327272114,SIO 40,A00,519328,Staff,39,0,40,1
1713327273186,SIO 46GS,A00,519819,Cook; Geoffrey W,17,0,25,8
1713327274212,SIO 109R,A00,494197,Forman; Fonna,0,3,20,20
1713327275236,SIO 121GS,A00,519827,Cook; Geoffrey W,17,0,25,8
1713327276260,SIO 132,A01,519330,Staff,38,0,40,2
1713327277286,SIO 133,A01,519397,Staff,37,0,40,3
1713327278311,SIO 139,A00,519396,Kacev; David,29,0,40,11
1713327279340,SOCI 1,A01,494199,Thorpe; Charles Robert,21,0,30,9
1713327279340,SOCI 1,A02,494200,Thorpe; Charles Robert,30,0,30,0
1713327279340,SOCI 1,A03,494201,Thorpe; Charles Robert,29,0,30,1
1713327279340,SOCI 1,A04,494202,Thorpe; Charles Robert,29,0,30,1
1713327279340,SOCI 1,A05,494203,Thorpe; Charles Robert,29,0,30,1
1713327279340,SOCI 1,A06,494204,Thorpe; Charles Robert,30,0,30,0
1713327279340,SOCI 1,A07,494205,Thorpe; Charles Robert,28,0,30,2
1713327280371,SOCI 60,A01,494207,Staff,34,0,40,6
1713327280371,SOCI 60,A02,494208,Staff,39,0,40,1
1713327281400,SOCI 100,A01,494210,Payne; Christine Anna,25,0,30,5
1713327281400,SOCI 100,A02,494211,Payne; Christine Anna,26,0,30,4
1713327282424,SOCI 109M,A00,494212,Staff,20,0,20,0
1713327283448,SOCI 110,A00,494213,Staff,34,0,40,6
1713327285550,SOCI 118E,A00,494215,Ng; Kwai,37,0,40,3
1713327286579,SOCI 125,A00,494216,Calderon-Zaks; Michael Aar,40,0,45,5
1713327287609,SOCI 126,A01,494218,Jones; Makeba,3,0,5,2
1713327288633,SOCI 131,A00,494219,Thorpe; Charles Robert,26,0,30,4
1713327290683,SOCI 135,A00,494221,Payne; Christine Anna,28,0,50,22
1713327291709,SOCI 136E,A00,626690,Ruiz; Jonathan Joseph,24,0,25,1
1713327292731,SOCI 138GS,A00,494222,Navon; Daniel,24,0,28,4
1713327294785,SOCI 145,A00,494224,Staff,40,0,45,5
1713327295811,SOCI 153,A00,494225,Staff,28,0,30,2
1713327296836,SOCI 160E,A00,494226,Ng; Kwai,29,0,40,11
1713327297859,SOCI 180,A00,494227,Staff,29,0,30,1
1713327298884,SOCI 189GS,A00,494228,Ribas Norris; Janet Vanesa,11,0,11,0
1713327299908,SOCI 190GS,A00,553232,Ribas Norris; Janet Vanesa,11,0,11,0
1713327300936,SOMI 220,A00,627178,Schneid; Stephen David,30,0,30,0
1713327301963,SYN 2,001,490768,Staff,14,0,15,1
1713327301963,SYN 2,002,490769,Staff,14,0,15,1
1713327301963,SYN 2,004,490775,Staff,0,0,0,0
1713327301963,SYN 2,003,490774,Staff,0,0,0,0
1713327301963,SYN 2,005,490776,Staff,0,0,0,0
1713327302989,SYN 2R,001,490779,Staff,11,0,15,4
1713327302989,SYN 2R,002,514635,Staff,14,0,15,1
1713327304013,SYN 100,A01,490783,Staff,10,0,20,10
1713327304013,SYN 100,B01,490787,Staff,9,0,20,11
1713327304013,SYN 100,C01,490789,Staff,10,0,20,10
1713327305041,SYN 150,A00,490817,Staff,14,0,15,1
1713327305041,SYN 150,B00,514610,Staff,15,0,15,0
1713327306070,TDAC 1,A00,492753,Walsh; Kim C.,19,0,20,1
1713327306070,TDAC 1,B00,492754,Harting; Carla Kelso,19,0,20,1
1713327306070,TDAC 1,C00,513995,Salovey; Todd,15,0,20,5
1713327307097,TDAC 101,A00,492766,Harting; Carla Kelso,17,0,20,3
1713327308128,TDAC 102,A00,492768,Basso; Beatrice,19,0,20,1
1713327309153,TDDE 111,A00,492769,Staff,25,0,25,0
1713327310182,TDDE 131,A00,492770,Staff,15,0,15,0
1713327310182,TDDE 131,B00,492771,Staff,15,0,15,0
1713327311206,TDDE 131GS,A00,523716,Guirguis; Mark C,23,0,28,5
1713327312230,TDGE 1,A01,492756,Salovey; Todd,56,0,60,4
1713327313257,TDGE 5,A01,492758,Staff,23,0,25,2
1713327314285,TDGE 10,A00,492759,Fulton; Julia,203,0,220,17
1713327315313,TDGE 11,A00,492760,Castro; Robert Jess,198,0,200,2
1713327317366,TDGE 124,A00,492772,Fulton; Julia,185,0,220,35
1713327318394,TDGE 125,A00,492773,Meyer; Ursula,38,0,50,12
1713327318394,TDGE 125,B00,492774,Staff,49,0,50,1
1713327318394,TDGE 125,C00,523565,Staff,48,0,50,2
1713327319421,TDGE 125GS,A00,523580,Guirguis; Mark C,23,0,28,5
1713327320444,TDGE 127,A00,492775,Havis; Allan,34,0,50,16
1713327321471,TDHT 101,A00,492776,Staff,34,0,35,1
1713327322495,TDMV 1,A00,492762,Caligagan; Maria T.,30,0,30,0
1713327322495,TDMV 1,B00,492763,Arcidiacono; Kristin,26,0,30,4
1713327323519,TDMV 2,A00,492764,Weinberg; Sadie,28,0,30,2
1713327324543,TDMV 3,A00,492765,Mack; Kara Shanai',37,0,40,3
1713327325567,TDMV 138,A00,492777,Mack; Kara Shanai',34,0,40,6
1713327326595,TDMV 140,A00,492778,Lima; Paulo Henrique,40,0,40,0
1713327327622,TDMV 142,A00,492779,Caligagan; Maria T.,33,0,40,7
1713327327622,TDMV 142,B00,492780,Caligagan; Tony,37,0,40,3
1713327328650,TDMV 143,A00,492781,Fyall; Daunte Edward,39,0,40,1
1713327329674,USP 1,A01,492401,Kwak; Nancy,27,0,35,8
1713327330699,USP 2,A01,492453,Hinds; Juli Beth,35,0,35,0
1713327331727,USP 3,A01,492516,Staff,28,0,35,7
1713327332752,USP 4,A00,492522,McTague; Sarah,16,0,25,9
1713327333780,USP 100,A00,492523,Staff,32,0,35,3
1713327334805,USP 101,A00,492524,Staff,13,0,15,2
1713327335829,USP 105,A00,492525,Staff,21,0,25,4
1713327336853,USP 151,A00,492526,Shenkman; Michael Thomas,32,0,35,3
1713327337880,USP 170,A00,492545,Hinds; Juli Beth,33,0,35,2
1713327338906,USP 171GS,A00,492608,Bussell; Mirle Rabinowitz,24,0,28,4
1713327339934,USP 183GS,A00,492613,Peerson; Susan,24,0,28,4
1713327340961,VIS 30,A01,490693,Yoldas; Pinar,19,0,22,3
1713327340961,VIS 30,A02,490694,Yoldas; Pinar,18,0,22,4
1713327341984,VIS 83,A00,490695,Kester; Grant,63,0,75,12
1713327343009,VIS 105D,A00,490696,Staff,22,0,25,3
1713327344035,VIS 124CN,A00,490699,Rose; Jordan M,65,0,75,10
1713327345062,VIS 125GS,A00,511221,Williams; Alena J,21,0,22,1
1713327346086,VIS 128D,A00,490700,Staff,73,0,75,2
1713327347110,VIS 151,A01,490717,Staff,33,0,34,1
1713327347110,VIS 151,A02,490766,Staff,33,0,34,1
1713327348136,VIS 154GS,A00,511972,Williams; Alena J,21,0,22,1
1713327349165,VIS 160A,A00,490767,Stone; Patricia,7,0,10,3
1713327350190,WCWP 10A,A00,490638,Staff,14,0,15,1
1713327350190,WCWP 10A,B00,490640,Staff,15,0,15,0
1713327351215,WCWP 10B,A00,490641,Staff,0,0,0,0
1713327351215,WCWP 10B,B00,490642,Staff,14,0,15,1
1713327351215,WCWP 10B,C00,490644,Staff,13,0,15,2
1713327351215,WCWP 10B,D00,490647,Staff,0,0,0,0
1713327352238,WCWP 100,A00,490655,Staff,0,0,0,0
1713327352238,WCWP 100,B00,490687,Staff,10,0,15,5
1713327354308,ANAR 153,A00,487222,Braswell; Geoffrey E.,54,0,60,6
1713327355332,ANBI 134,A00,487223,Staff,6,0,20,14
1713327356358,ANBI 143GS,A00,487224,Noel; Geoffroy Pierre Jean,18,0,24,6
1713327357381,ANBI 144GS,A00,519548,Noel; Geoffroy Pierre Jean,18,0,24,6
1713327358404,ANSC 101,A00,487225,Staff,18,0,20,2
1713327359429,ANSC 125,A00,487227,Brenner; Suzanne A,39,0,40,1
1713327361478,ANSC 146,A00,487229,Staff,35,0,40,5
1713327362503,ANSC 148,A00,487230,Olivas Hernandez; Olga Lid,39,0,40,1
1713327363526,ANSC 150,A00,504165,Sloane; Julia Kathryn,18,0,20,2
1713327364551,ANSC 180,A00,487232,Staff,14,0,15,1
1713327365578,ANSC 188,A00,627155,Staff,39,0,40,1
1713327366607,ANTH 5,A00,519529,Semendeferi; Ekaterini,15,0,15,0
1713327367632,ANTH 10,A00,487219,Staff,58,0,60,2
1713327368660,ANTH 23,A01,487221,Staff,17,0,20,3
1713327369685,ANTH 102,A00,487233,Wilder; Linnea Lorene,51,0,60,9
1713327370709,ANTH 103,A00,487234,Varma; Saiba,55,0,60,5
1713327371735,ANTH 105,A00,487235,Stewart; Alexander B,55,0,60,5
1713327372760,BENG 100,A01,516685,Taylor Amos; Alyssa C,27,0,30,3
1713327373786,BIBC 102,A01,491316,Flagg; Matthew Paul,14,0,88,74
1713327373786,BIBC 102,A02,491366,Flagg; Matthew Paul,78,0,88,10
1713327374817,BIBC 103,A01,491486,Boumechache; Miyyada,16,0,24,8
1713327374817,BIBC 103,A02,491487,Boumechache; Miyyada,24,0,24,0
1713327375847,BICD 100,A01,516882,Staff,73,0,75,2
1713327375847,BICD 100,A02,516890,Staff,69,0,75,6
1713327376873,BICD 102GS,A00,491488,Lo; Stanley M.,26,0,28,2
1713327377897,BIEB 136GS,A00,516940,Holway; David A. & Shurin; Jonathan,18,0,24,6
1713327378923,BIEB 137GS,A01,517034,Holway; David A. & Shurin; Jonathan,18,0,24,6
1713327379952,BIEB 138GS,A01,491492,Pirino; Giorgia,21,0,28,7
1713327380977,BILD 1,A01,491296,Staff,60,0,63,3
1713327380977,BILD 1,A02,491297,Staff,63,0,63,0
1713327382000,BILD 4,A01,517099,Gonzalez Gamboa; Ivonne,22,0,24,2
1713327382000,BILD 4,A02,517100,Gonzalez Gamboa; Ivonne,24,0,24,0
1713327383028,BILD 60GS,A00,491309,Lo; Stanley M.,26,0,28,2
1713327384056,BIMM 100,A01,517136,Staff,85,0,100,15
1713327385081,BIMM 110,A01,517182,Staff,56,0,100,44
1713327386110,BIMM 120,A01,517228,Pickett; Brooke Elizabeth,29,0,63,34
1713327386110,BIMM 120,A02,517240,Pickett; Brooke Elizabeth,44,0,63,19
1713327387136,BIMM 132GS,A01,491498,Pirino; Giorgia,21,0,28,7
1713327388164,BIMM 143,A01,491589,Bozinovic; Goran,13,0,40,27
1713327389244,BIPN 100,A01,491594,Armour; Jon Christopher,85,0,100,15
1713327390267,BIPN 140,A01,491602,Marino; Marc J,26,0,50,24
1713327392320,CAT 125,A00,515973,Staff,18,0,20,2
1713327393347,CAT 125GS,A00,515974,Rahimi; Babak,17,0,20,3
1713327394372,CAT 125R,A00,515980,Staff,12,0,20,8
1713327394372,CAT 125R,B00,515981,Tosun; Adriana,19,0,20,1
1713327394372,CAT 125R,C00,515987,Hyland; Tina Mae,0,2,20,20
1713327394372,CAT 125R,D00,515988,Bronstein; Phoebe Malan,17,0,20,3
1713327395401,CENG 15,A01,488699,Drews; Aaron,25,0,25,0
1713327396429,CENG 100,A00,505196,Opatkiewicz; Justin Paul,25,0,25,0
1713327397453,CGS 2A,A01,489598,Staff,33,0,35,2
1713327398477,CGS 112,A00,489599,Staff,15,0,15,0
1713327399501,CGS 119,A00,489603,Staff,10,0,10,0
1713327400529,CGS 120,A00,489604,Staff,14,0,15,1
1713327401557,CGS 150,A00,489607,Staff,15,0,15,0
1713327402587,CHEM 6A,A01,488715,Staff,98,0,100,2
1713327403616,CHEM 6B,A01,488719,Piercy; Marc Anthony,99,0,100,1
1713327404645,CHEM 6C,A01,488723,Albizati; Kim F.,93,0,100,7
1713327405672,CHEM 7L,A01,488728,Schurmeier; Kimberly,18,0,24,6
1713327405672,CHEM 7L,A02,488730,Schurmeier; Kimberly,23,0,24,1
1713327405672,CHEM 7L,A03,488734,Schurmeier; Kimberly,20,0,24,4
1713327405672,CHEM 7L,A04,488763,Schurmeier; Kimberly,23,0,24,1
1713327405672,CHEM 7L,B01,488798,Schurmeier; Kimberly,17,0,24,7
1713327405672,CHEM 7L,B02,488801,Schurmeier; Kimberly,22,0,24,2
1713327405672,CHEM 7L,B03,488808,Schurmeier; Kimberly,23,0,24,1
1713327405672,CHEM 7L,B04,488811,Schurmeier; Kimberly,24,0,24,0
1713327406706,CHEM 11,A01,488897,Stallings; Dontarie M,95,0,100,5
1713327407732,CHEM 40A,A01,488913,Albizati; Kim F.,84,0,100,16
1713327408757,CHEM 40B,A01,488920,Weizman; Haim,43,0,50,7
1713327408757,CHEM 40B,A02,488938,Weizman; Haim,45,0,50,5
1713327409783,CHEM 41A,A01,489029,Klosterman; Jeremy K,57,0,60,3
1713327410810,CHEM 41C,A01,500436,Tor; Yitzhak,55,0,60,5
1713327411842,CHEM 43A,A01,500426,Weizman; Haim,0,0,24,24
1713327411842,CHEM 43A,A02,500430,Weizman; Haim,8,0,24,16
1713327411842,CHEM 43A,B01,514041,Klosterman; Jeremy K,16,0,24,8
1713327411842,CHEM 43A,B02,514047,Klosterman; Jeremy K,23,0,24,1
1713327412866,CHEM 108,A01,489140,Jennings; Patricia A.,9,0,24,15
1713327412866,CHEM 108,A02,489142,Jennings; Patricia A.,14,0,24,10
1713327413892,CHEM 114A,A01,489147,Stallings; Dontarie M,68,0,100,32
1713327414919,CHIN 169A,A00,489171,Wang; Xiao,19,0,20,1
1713327416971,COGS 3,A01,518827,Boyle; Mary E. T.,26,0,40,14
1713327417995,COGS 11,A01,489175,Staff,27,0,30,3
1713327419026,COGS 14A,A01,518829,Staff,51,0,60,9
1713327420051,COGS 14B,A01,489177,Hoffman; Drew Ellen,63,0,75,12
1713327421081,COGS 100,A01,489181,Allen; Michael Gordon,63,0,75,12
1713327422108,COGS 101A,A01,489183,Staff,46,0,60,14
1713327423135,COGS 101B,A01,489185,Allen; Michael Gordon,8,0,30,22
1713327424165,COGS 101C,A01,526786,Staff,23,0,30,7
1713327426216,COGS 107A,A01,489189,Boyle; Mary E. T.,18,0,35,17
1713327427245,COGS 107B,A01,627144,Mooshagian; Eric Frederick,60,0,60,0
1713327428273,COGS 118A,A01,489191,Staff,0,44,40,40
1713327430330,COGS 171GS,A01,489194,Pineda; Jaime A,20,0,28,8
1713327431356,COGS 172,A01,489196,Staff,3,0,30,27
1713327432383,COGS 174GS,A01,489264,Pineda; Jaime A,20,0,28,8
1713327433407,COGS 180,A01,627150,Staff,28,0,30,2
1713327434433,COGS 186,A01,489274,Staff,0,1,30,30
1713327435458,COMM 10,A01,489276,Staff,23,0,25,2
1713327435458,COMM 10,A02,489303,Staff,23,0,25,2
1713327436482,COMM 100A,A01,489312,Staff,14,0,25,11
1713327436482,COMM 100A,A02,489313,Staff,24,0,25,1
1713327437509,COMM 106T,A00,512540,Staff,33,0,35,2
1713327438536,COMM 107,A00,489347,Staff,27,0,35,8
1713327439564,COMM 109P,A00,489358,Staff,31,0,35,4
1713327440589,COMM 132,A00,489361,McKenna; Denise,27,0,30,3
1713327441613,COMM 146,A00,489362,Halm; Gavin Patrick,26,0,30,4
1713327442637,COMM 190,A00,489363,Abuelhiga; Soraya Jill,17,0,23,6
1713327443662,CSE 8A,A50,489366,Staff,21,0,25,4
1713327443662,CSE 8A,A51,489367,Staff,24,0,25,1
1713327444688,CSE 11,A01,489398,Cao; Yingjun,74,0,100,26
1713327445716,CSE 12,A01,489487,Staff,43,0,50,7
1713327446745,CSE 20,A01,489497,Staff,48,0,50,2
1713327447770,CSE 21,A01,489517,Braun; Oliver,42,0,50,8
1713327448795,CSE 101,A01,489524,Braun; Oliver,0,28,50,50
1713327449820,CSE 105,A01,512594,Jones; Miles E,72,0,100,28
1713327449820,CSE 105,B01,512598,Jones; Miles E,52,0,100,48
1713327450844,CSE 140,A01,489538,Staff,41,0,50,9
1713327451873,CSE 141,A01,489550,Eldon; John,68,0,100,32
1713327452898,CSE 141L,A01,489571,Eldon; John,66,0,100,34
1713327453926,CSE 151A,A01,489583,Solares; Edwin A,141,0,200,59
1713327454952,CSE 175,A01,510886,Kumar; Rakesh,30,0,30,0
1713327455980,CSE 190,A00,516828,Dubnov; Shlomo,38,0,49,11
1713327457004,DOC 100D,A00,489667,Pass; Natalye Joann,19,0,25,6
1713327458030,DSC 10,A01,624268,Staff,72,0,75,3
1713327459055,DSC 20,A01,624476,Staff,50,0,50,0
1713327460079,DSC 40A,A01,624608,Staff,39,0,40,1
1713327461107,DSGN 1,A01,489179,Rill; Bryan,33,0,50,17
1713327462133,ECE 17,A01,490489,Sahay; Rajeev,18,0,30,12
1713327463158,ECE 65,A50,490492,Staff,12,0,20,8
1713327463158,ECE 65,A51,490493,Staff,18,0,20,2
1713327464183,ECON 1,A01,489715,Famulari; Melissa,68,0,70,2
1713327465208,ECON 2,A01,489717,Levkoff; Steven B.,68,0,70,2
1713327466236,ECON 3,A01,489948,Staff,70,0,70,0
1713327468291,ECON 5,A01,490103,Staff,27,0,30,3
1713327468291,ECON 5,B01,626281,Dai; Yinlin,45,0,45,0
1713327469318,ECON 100A,A01,490127,Famulari; Melissa,65,0,70,5
1713327470343,ECON 100B,A01,490129,Staff,64,0,70,6
1713327471369,ECON 109,A01,490187,Shishkin; Denis,27,0,35,8
1713327472398,ECON 110A,A01,490190,Levkoff; Steven B.,60,0,70,10
1713327473423,ECON 120A,A01,490245,Dai; Yinlin,61,0,70,9
1713327474446,ECON 120B,A01,490247,Nieto-Barthaburu; Augusto,42,0,70,28
1713327475472,ECON 120C,A01,490253,Sun; Yixiao,30,0,35,5
1713327475472,ECON 120C,B01,490255,Sun; Yixiao,34,0,35,1
1713327476496,ECON 129,A00,490256,Eckert; Fabian Paul,23,0,35,12
1713327477522,ECON 131,A00,490257,Nieto-Barthaburu; Augusto,0,6,35,35
1713327478547,ECON 138,A00,490258,Bharadwaj; Prashant,13,0,35,22
1713327478547,ECON 138,B00,490259,Bharadwaj; Prashant,15,0,35,20
1713327479570,ECON 159,A00,490260,Hendrickson; Gerald M.,0,9,0,0
1713327480599,ECON 178,A01,553995,Zhu; Ying,24,0,35,11
1713327481621,EDS 40,A01,512576,Black; Alison Michelle,20,0,20,0
1713327482649,EDS 107,A01,515848,Staff,30,0,30,0
1713327483677,EDS 110R,A01,490262,Staff,26,0,30,4
1713327484703,EDS 112,A01,490264,Chapman; Thandeka K,40,0,50,10
1713327485729,EDS 113,A00,490266,Staff,26,0,30,4
1713327486757,EDS 118,A00,490267,Warstadt; Melissa Fawn,20,0,30,10
1713327487780,EDS 124BR,A00,490268,Eguchi; Emi,4,0,25,21
1713327487780,EDS 124BR,B00,490269,Eguchi; Emi,23,0,25,2
1713327488807,EDS 126,A01,490271,Jones; Makeba,43,0,50,7
1713327489831,EDS 135,A01,490316,Staff,19,0,20,1
1713327490855,ENVR 142GS,A00,519514,Chang; Edmond Yi-Teh,27,0,28,1
1713327491879,ETHN 103,A00,490504,Staff,25,0,36,11
1713327492959,ETHN 103A,A00,490505,Man; Simeon S,4,0,9,5
1713327493983,ETHN 109,A00,490506,Staff,28,0,30,2
1713327495009,ETHN 118,A00,490507,Staff,35,0,36,1
1713327496037,ETHN 119,A00,490508,Staff,33,0,36,3
1713327497065,ETHN 121R,A00,490518,Choi; Esther Min,21,0,36,15
1713327498092,ETHN 127,A00,490528,Staff,14,0,15,1
1713327499118,ETHN 139,A00,490573,Staff,10,0,10,0
1713327500146,ETHN 150,A00,490575,Staff,15,0,15,0
1713327501173,GLBH 20,A00,491705,Elwardani; Nile Regina,38,0,40,2
1713327502204,GLBH 101,A00,491706,Staff,20,0,20,0
1713327503227,GLBH 111,A01,491708,Burgos; Jose L.,15,0,15,0
1713327504257,GLBH 146,A00,491709,Staff,9,0,20,11
1713327505282,GLBH 148,A00,491710,Olivas Hernandez; Olga Lid,11,0,20,9
1713327506306,GLBH 150,A00,491711,Sloane; Julia Kathryn,19,0,20,1
1713327507330,HIEA 131,A00,491760,Staff,28,0,32,4
1713327508357,HIEA 153,A00,491762,Staff,28,0,30,2
1713327509382,HIEU 124,A00,491811,Staff,26,0,32,6
1713327510405,HIEU 124GS,A00,491812,Markman; Kristina,27,0,28,1
1713327511430,HIEU 147,A00,491813,Staff,30,0,32,2
1713327512456,HIEU 149GS,A00,491816,Caldwell; Michael Alan,28,0,28,0
1713327513480,HILD 2C,A01,491713,Hendrickson; Gerald M.,26,0,30,4
1713327514507,HILD 7B,A01,491715,Kwak; Nancy,0,1,30,30
1713327515533,HILD 10,A01,491717,Staff,11,0,20,9
1713327516560,HILD 30GS,A00,491719,Edington; Claire Ellen,24,0,28,4
1713327517587,HINE 109,A00,491818,Shafir; Nir,27,0,32,5
1713327518610,HINE 128,A00,491821,Shafir; Nir,31,0,32,1
1713327519634,HISC 117,A00,491830,Staff,27,0,32,5
1713327520659,HIUS 103,A00,491834,Man; Simeon S,14,0,23,9
1713327521684,HIUS 108B,A00,491835,Staff,28,0,30,2
1713327522709,HIUS 141,A00,491836,Hendrickson; Gerald M.,28,0,32,4
1713327523732,HIUS 149,A00,491839,Staff,24,0,32,8
1713327524757,HUM 3,A01,512617,Crum; Matthew Stephen,43,0,50,7
1713327524757,HUM 3,A02,512618,Crum; Matthew Stephen,48,0,50,2
1713327525785,HUM 3GS,A00,512663,Markman; Kristina,0,0,0,1
1713327525785,HUM 3GS,B00,512664,Staff,0,0,0,0
1713327526810,HUM 4,A01,512620,West; Geoffrey Scott,26,0,50,24
1713327527837,HUM 4GS,A00,512666,Lyon; Antony J.,0,0,0,4
1713327528861,HUM 4R,A01,512625,Watkins; Eric,49,0,50,1
1713327529887,HUM 5,A01,512649,Zavodny; Tatiana Sophia,23,0,50,27
1713327529887,HUM 5,B01,512661,Zroka; Ryan Edward,48,0,50,2
1713327530912,INTL 190,A00,490577,Segui; Alan S,0,0,0,5
1713327531941,JAPN 20AR,A01,491267,Ross; Kayoko F,8,0,20,12
1713327532965,JAPN 180,A00,491285,Berman; Michael David,33,0,40,7
1713327533995,LATI 50,A01,502536,Kokinis; Troy Andreas,16,0,22,6
1713327533995,LATI 50,A02,502551,Kokinis; Troy Andreas,22,0,22,0
1713327533995,LATI 50,A03,502650,Kokinis; Troy Andreas,22,0,22,0
1713327533995,LATI 50,A04,502909,Kokinis; Troy Andreas,21,0,22,1
1713327535018,LATI 160,A01,502920,Kokinis; Troy Andreas,30,0,30,0
1713327536043,LIFR 1A,A00,490494,Van Moer; Vinciane G,17,0,20,3
1713327537069,LIFR 1AX,A00,490495,Van Moer; Vinciane G,17,0,20,3
1713327538096,LIFR 1B,A00,490496,Van Moer; Vinciane G,18,0,20,2
1713327539124,LIFR 1BX,A00,490497,Van Moer; Vinciane G,18,0,20,2
1713327540153,LIGN 8,A00,505198,McIntosh; Justin Daniel,134,0,150,16
1713327541178,LIGN 9GS,A00,491239,Lott; Margaret S.,18,0,20,2
1713327542202,LIGN 101,A01,505200,McIntosh; Justin Daniel,22,0,30,8
1713327543226,LIGN 120,A01,491244,Staff,23,0,30,7
1713327544249,LIGN 149GS,A00,491245,Lott; Margaret S.,18,0,20,2
1713327545275,LIGN 170,A00,491247,Staff,22,0,30,8
1713327546301,LISP 1D,A00,490498,Munoz Sanchez; Alicia,9,0,14,5
1713327546301,LISP 1D,B00,490499,Munoz Sanchez; Alicia,6,0,14,8
1713327546301,LISP 1D,C00,490500,Munoz Sanchez; Alicia,7,0,14,7
1713327546301,LISP 1D,D00,490501,Munoz Sanchez; Alicia,10,0,14,4
1713327547326,LISP 1DX,A00,490502,Munoz Sanchez; Alicia,14,0,28,14
1713327547326,LISP 1DX,B00,490503,Munoz Sanchez; Alicia,16,0,28,12
1713327549376,LTAM 110,A00,491847,Staff,22,0,25,3
1713327550400,LTCS 119,A00,491848,Staff,11,0,15,4
1713327551423,LTCS 130,A00,491849,Staff,24,0,25,1
1713327553479,LTEA 120C,A00,491852,Staff,32,0,40,8
1713327554505,LTEN 130GS,A00,491853,Lyon; Antony J.,24,0,28,4
1713327555530,LTEN 148,A00,491855,Staff,23,0,25,2
1713327556631,LTEN 159,A00,491856,Staff,20,0,25,5
1713327557654,LTEN 180,A00,491857,Staff,8,0,15,7
1713327559705,LTSP 123GS,A00,505928,Bessett; Ryan Matthew,24,0,28,4
1713327560730,LTSP 174GS,A00,506037,Bessett; Ryan Matthew,24,0,28,4
1713327562791,LTWR 102,A00,491861,Staff,9,0,15,6
1713327563818,LTWR 106,A00,491862,Staff,8,0,15,7
1713327564843,MAE 11,A00,490930,Bahadori; Mohammad Yousef,95,0,100,5
1713327565869,MAE 30A,A00,490931,Qi; Huihui,37,0,40,3
1713327566897,MAE 101A,A00,491036,Sadeghizadeh; Zahra,92,0,100,8
1713327567925,MAE 101C,A00,491037,Seshadri; Kalyanasundaram,67,0,100,33
1713327568949,MAE 113,A00,491040,Seshadri; Kalyanasundaram,66,0,80,14
1713327569974,MAE 131A,A00,491041,Ghazinejad; Maziar,37,0,40,3
1713327571005,MAE 142,A00,491053,Staff,39,0,40,1
1713327572030,MAE 143A,A00,491054,Staff,33,0,50,17
1713327573058,MAE 150,A00,491092,Truong; Phuong Thi Ngoc,23,0,35,12
1713327574084,MATH 3C,A01,494031,Pardo Guerra; Sebastian,30,0,30,0
1713327574084,MATH 3C,A02,494032,Pardo Guerra; Sebastian,29,0,30,1
1713327575112,MATH 10A,A01,494034,Staff,27,0,30,3
1713327575112,MATH 10A,A02,494035,Staff,28,0,30,2
1713327575112,MATH 10A,B01,494037,Staff,27,0,30,3
1713327575112,MATH 10A,B02,494038,Staff,29,0,30,1
1713327576144,MATH 10B,A01,494040,Habib; Yousaf,22,0,30,8
1713327576144,MATH 10B,A02,494041,Habib; Yousaf,28,0,30,2
1713327576144,MATH 10B,A03,494042,Habib; Yousaf,29,0,30,1
1713327576144,MATH 10B,A04,494043,Habib; Yousaf,30,0,30,0
1713327576144,MATH 10B,B01,494045,Habib; Yousaf,25,0,30,5
1713327576144,MATH 10B,B02,494046,Habib; Yousaf,30,0,30,0
1713327576144,MATH 10B,B03,494047,Habib; Yousaf,30,0,30,0
1713327576144,MATH 10B,B04,494048,Habib; Yousaf,30,0,30,0
1713327577170,MATH 18,A01,494050,Kemp; Todd Aahron,25,0,30,5
1713327577170,MATH 18,A02,494051,Kemp; Todd Aahron,29,0,30,1
1713327577170,MATH 18,B01,494054,Kemp; Todd Aahron,26,0,30,4
1713327577170,MATH 18,B02,494055,Kemp; Todd Aahron,29,0,30,1
1713327578195,MATH 20A,A01,494059,Suk; Andrew Hoon,30,0,30,0
1713327579220,MATH 20B,A01,494061,Briones; Jor-el Thomas Caparas,33,0,35,2
1713327579220,MATH 20B,B01,494063,Bach; Quang Tran,34,0,35,1
1713327580250,MATH 20C,A01,494065,Staff,28,0,30,2
1713327580250,MATH 20C,A02,494066,Staff,30,0,30,0
1713327580250,MATH 20C,A03,494067,Staff,30,0,30,0
1713327580250,MATH 20C,A04,494068,Staff,30,0,30,0
1713327580250,MATH 20C,B01,494070,Zhang; Ming,25,0,30,5
1713327580250,MATH 20C,B02,494071,Zhang; Ming,27,0,30,3
1713327580250,MATH 20C,B03,494072,Zhang; Ming,29,0,30,1
1713327580250,MATH 20C,B04,494073,Zhang; Ming,29,0,30,1
1713327581275,MATH 20D,A01,494075,Staff,22,0,30,8
1713327581275,MATH 20D,A02,494076,Staff,29,0,30,1
1713327582299,MATH 20E,A01,494079,Staff,24,0,30,6
1713327582299,MATH 20E,A02,494080,Staff,26,0,30,4
1713327582299,MATH 20E,B01,494082,Staff,25,0,30,5
1713327582299,MATH 20E,B02,494083,Staff,25,0,30,5
1713327583330,MATH 103A,A01,494085,Aliabadi Sr.; Mohsen,14,0,30,16
1713327583330,MATH 103A,A02,494086,Aliabadi Sr.; Mohsen,28,0,30,2
1713327583330,MATH 103A,B01,494088,Aliabadi Sr.; Mohsen,21,0,30,9
1713327583330,MATH 103A,B02,494089,Aliabadi Sr.; Mohsen,27,0,30,3
1713327584356,MATH 109,A01,494091,Staff,30,0,30,0
1713327584356,MATH 109,A02,494092,Staff,29,0,30,1
1713327584356,MATH 109,B01,494094,Staff,27,0,30,3
1713327584356,MATH 109,B02,494095,Staff,29,0,30,1
1713327585382,MATH 142A,A01,494097,Chow; Bennett,15,0,30,15
1713327585382,MATH 142A,A02,494098,Chow; Bennett,23,0,30,7
1713327585382,MATH 142A,B01,494100,Chow; Bennett,19,0,30,11
1713327585382,MATH 142A,B02,494101,Chow; Bennett,29,0,30,1
1713327587433,MATH 168A,A01,516677,Dumitriu; Ioana,16,0,35,19
1713327588461,MATH 170A,A01,516679,Dumitriu; Ioana,18,0,30,12
1713327588461,MATH 170A,A02,516680,Dumitriu; Ioana,28,0,30,2
1713327589490,MATH 193A,A01,494107,Staff,14,0,30,16
1713327589490,MATH 193A,A02,494108,Staff,20,0,30,10
1713327589490,MATH 193A,A03,494109,Staff,29,0,30,1
1713327589490,MATH 193A,A04,494110,Staff,22,0,30,8
1713327592567,MGT 16,A00,491930,McKay; Michael J,92,0,98,6
1713327593592,MGT 18,A00,491992,McKay; Michael J,96,0,98,2
1713327594622,MGT 71,A00,492003,Staff,66,0,98,32
1713327595647,MGT 103,A00,505209,Eberhard; Craig A,81,0,98,17
1713327596730,MGT 131A,A00,505210,Anderson; John Charles,89,0,98,9
1713327598788,MGT 153,A00,492077,Perols; Johan Lars,19,0,90,71
1713327601863,MGT 164,A00,492222,McKay; Mary A,91,0,98,7
1713327602890,MGT 172,A00,492245,Staff,59,0,60,1
1713327602890,MGT 172,B00,505526,Hedges; Kathleen,65,0,98,33
1713327603915,MGT 181,A00,505669,Dunn; Louis Jean,82,0,98,16
1713327604949,MMW 14,A01,494399,Staff,15,0,28,13
1713327604949,MMW 14,A02,494400,Staff,25,0,28,3
1713327604949,MMW 14,A03,494401,Staff,28,0,28,0
1713327604949,MMW 14,A04,494402,Staff,28,0,28,0
1713327604949,MMW 14,B01,494404,Carreras; Maria Victoria,8,0,28,20
1713327604949,MMW 14,B02,494405,Carreras; Maria Victoria,25,0,28,3
1713327604949,MMW 14,B03,494406,Carreras; Maria Victoria,27,0,28,1
1713327604949,MMW 14,B04,494407,Carreras; Maria Victoria,28,0,28,0
1713327605975,MMW 14GS,A00,506250,Chang; Edmond Yi-Teh,0,0,0,0
1713327607003,MMW 121R,A01,494415,Adamiak; Patrick John,11,0,28,17
1713327607003,MMW 121R,A02,494416,Adamiak; Patrick John,24,0,28,4
1713327608030,MUS 1A,A01,494113,Staff,12,0,25,13
1713327608030,MUS 1A,A02,494114,Staff,24,0,25,1
1713327609056,MUS 4,A01,494116,Staff,23,0,25,2
1713327609056,MUS 4,A02,494117,Staff,22,0,25,3
1713327610083,MUS 5R,A01,494236,Dubnov; Shlomo,6,0,25,19
1713327610083,MUS 5R,A02,494237,Dubnov; Shlomo,25,0,25,0
1713327611112,MUS 6,A01,494122,Staff,10,0,25,15
1713327611112,MUS 6,A02,494123,Staff,23,0,25,2
1713327612137,MUS 7,A01,494125,Staff,16,0,25,9
1713327612137,MUS 7,A02,494126,Staff,24,0,25,1
1713327613161,MUS 11,A01,494128,Staff,23,0,25,2
1713327613161,MUS 11,A02,494129,Staff,24,0,25,1
1713327614189,MUS 13,A01,494131,Staff,25,0,25,0
1713327614189,MUS 13,A02,494132,Staff,25,0,25,0
1713327615215,MUS 15,A01,494134,Staff,17,0,25,8
1713327615215,MUS 15,A02,494135,Staff,25,0,25,0
1713327615215,MUS 15,B01,494137,Staff,24,0,25,1
1713327616240,MUS 80,A00,494232,Staff,24,0,25,1
1713327616240,MUS 80,B00,494233,Staff,25,0,25,0
1713327616240,MUS 80,C00,494234,Staff,23,0,25,2
1713327617264,MUS 95C,A00,494141,Staff,70,0,75,5
1713327618291,MUS 114,A00,494142,Staff,40,0,50,10
1713327619318,NANO 15,A01,490636,Drews; Aaron,7,0,7,0
1713327620349,PHIL 1,A00,490578,Grush; Rick Scott,49,0,50,1
1713327621374,PHIL 10,A01,490580,Grush; Rick Scott,33,0,35,2
1713327621374,PHIL 10,A02,490586,Grush; Rick Scott,32,0,35,3
1713327622399,PHIL 27,A01,490591,Staff,22,0,25,3
1713327622399,PHIL 27,A02,490592,Staff,25,0,25,0
1713327622399,PHIL 27,A03,490593,Staff,25,0,25,0
1713327622399,PHIL 27,A04,490598,Staff,25,0,25,0
1713327623425,PHIL 32,A01,490611,Staff,20,0,20,0
1713327623425,PHIL 32,A02,490618,Staff,20,0,20,0
1713327624449,PHIL 90,A00,490624,Staff,40,0,40,0
1713327625479,PHIL 136,A00,490627,Cohen; Jonathan David,37,0,40,3
1713327626504,PHIL 155,A00,490634,Staff,62,0,70,8
1713327627533,PHYS 1A,A00,491610,Staff,245,0,250,5
1713327628558,PHYS 1AL,001,491616,Tsai; Philbert S,27,0,30,3
1713327628558,PHYS 1AL,002,491618,Tsai; Philbert S,30,0,30,0
1713327629586,PHYS 1B,A00,491623,Staff,236,0,250,14
1713327630739,PHYS 1BL,001,491626,Tsai; Philbert S,22,0,30,8
1713327630739,PHYS 1BL,002,491628,Tsai; Philbert S,26,0,30,4
1713327631766,PHYS 1C,A00,491632,Staff,214,0,245,31
1713327632790,PHYS 1CL,001,491635,Tsai; Philbert S,3,0,30,27
1713327632790,PHYS 1CL,002,491643,Tsai; Philbert S,22,0,30,8
1713327633821,PHYS 2AR,A01,491651,Meyertholen; Andrew D.,44,0,50,6
1713327634846,PHYS 2B,A01,491659,Staff,105,0,115,10
1713327635870,PHYS 2BL,A01,491685,Staff,21,0,24,3
1713327635870,PHYS 2BL,A02,491700,Staff,21,0,24,3
1713327636895,PHYS 2C,A01,505161,Staff,102,0,115,13
1713327637927,PHYS 4A,A01,491704,Grinstein; Benjamin,99,0,100,1
1713327638953,POLI 5D,A01,494144,Staff,3,0,5,2
1713327638953,POLI 5D,B01,626283,Dai; Yinlin,5,0,5,0
1713327639979,POLI 12,A00,494145,Staff,43,0,45,2
1713327641008,POLI 13R,A00,494146,Forman; Fonna,45,0,50,5
1713327642036,POLI 27,A01,494148,Staff,54,0,60,6
1713327643061,POLI 30,A00,494149,Staff,49,0,50,1
1713327644086,POLI 100DA,A00,494150,Staff,21,0,25,4
1713327646139,POLI 100I,A00,494152,Staff,27,0,30,3
1713327647247,POLI 104B,A00,494153,Smith; Glenn Chatmas,53,0,55,2
1713327648272,POLI 104F,A00,494154,Staff,28,0,30,2
1713327649296,POLI 104I,A00,494155,Smith; Glenn Chatmas,29,0,30,1
1713327650326,POLI 110C,A00,494156,Ingham; Sean,23,0,25,2
1713327651355,POLI 117R,A00,494157,Forman; Fonna,8,0,20,12
1713327652385,POLI 118,A00,494158,Ingham; Sean,21,0,25,4
1713327653412,POLI 120H,A00,494159,Fisk; David Lee,39,0,45,6
1713327654437,POLI 131CR,A00,494160,Hoston; Germaine,35,0,45,10
1713327655463,POLI 133J,A00,494161,Staff,33,0,35,2
1713327656492,POLI 135,A00,494162,Fisk; David Lee,33,0,35,2
1713327657517,POLI 140A,A00,494164,Staff,20,0,30,10
1713327658542,POLI 142I,A00,494165,Staff,30,0,30,0
1713327659568,POLI 144D,A00,494166,Staff,23,0,25,2
1713327660594,POLI 151,A00,494167,Staff,30,0,30,0
1713327661620,POLI 153,A00,494168,Staff,33,0,35,2
1713327662646,POLI 160AA,A00,494169,Staff,34,0,40,6
1713327663701,POLI 162,A00,494170,Mignozzetti; Umberto,19,0,25,6
1713327664725,POLI 171,A00,494171,Mignozzetti; Umberto,20,0,25,5
1713327665764,PSYC 1,A00,494172,Staff,96,0,100,4
1713327666793,PSYC 2,A00,494173,Moranton; Nirelia Melbina-,34,0,50,16
1713327667819,PSYC 3,A00,494174,Staff,29,0,30,1
1713327668847,PSYC 6,A00,494175,Staff,17,0,20,3
1713327669875,PSYC 60,A01,494177,Staff,38,0,45,7
1713327670907,PSYC 70,A01,505724,Geller; Emma Harlan,42,0,45,3
1713327671937,PSYC 101,A00,494180,Heyman; Gail D.,84,0,100,16
1713327672963,PSYC 105,A00,494181,Geller; Emma Harlan,51,0,90,39
1713327673989,PSYC 106,A00,494182,Dobkins; Karen R.,28,0,45,17
1713327675018,PSYC 108,A00,494183,Adrian; Julia Anna,89,0,100,11
1713327676049,PSYC 114,A01,494185,Winkielman; Piotr,0,2,30,30
1713327677077,PSYC 122,A00,494186,Moranton; Nirelia Melbina-,29,0,50,21
1713327678102,PSYC 124,A00,494187,Chapman; Eddie Nathaniel,71,0,80,9
1713327679131,PSYC 131,A00,494188,Anagnostaras; Stephan,42,0,80,38
1713327680159,PSYC 144,A00,494189,Staff,5,0,50,45
1713327681187,PSYC 154,A00,494190,Lacefield; Katharine I,107,0,180,73
1713327682216,PSYC 162,A00,494191,Wixted; John T,71,0,100,29
1713327683243,PSYC 172,A00,494192,Gorman; Michael R.,36,0,45,9
1713327684278,PSYC 178,A00,494193,Glaser; Dale,34,0,45,11
1713327685303,PSYC 193,A00,505725,Chapman; Eddie Nathaniel,20,0,20,0
1713327686329,RELI 145GS,A00,519817,Rahimi; Babak,18,0,20,2
1713327687355,SE 101A,A01,490862,Chadha; Mayank,23,0,25,2
1713327688381,SE 101C,A01,490924,Krysl; Petr,15,0,20,5
1713327689406,SE 110A,A01,490928,Staff,19,0,20,1
1713327690449,SE 130A,A00,490929,Morrison; Machel Leigh,55,0,70,15
1713327691475,SIO 1,A01,519325,Staff,39,0,40,1
1713327692501,SIO 30,A01,519327,Staff,38,0,40,2
1713327693528,SIO 40,A00,519328,Staff,39,0,40,1
1713327694553,SIO 46GS,A00,519819,Cook; Geoffrey W,17,0,25,8
1713327695576,SIO 109R,A00,494197,Forman; Fonna,0,3,20,20
1713327696602,SIO 121GS,A00,519827,Cook; Geoffrey W,17,0,25,8
1713327697630,SIO 132,A01,519330,Staff,38,0,40,2
1713327698655,SIO 133,A01,519397,Staff,37,0,40,3
1713327699682,SIO 139,A00,519396,Kacev; David,29,0,40,11
1713327700763,SOCI 1,A01,494199,Thorpe; Charles Robert,21,0,30,9
1713327700763,SOCI 1,A02,494200,Thorpe; Charles Robert,30,0,30,0
1713327700763,SOCI 1,A03,494201,Thorpe; Charles Robert,29,0,30,1
1713327700763,SOCI 1,A04,494202,Thorpe; Charles Robert,29,0,30,1
1713327700763,SOCI 1,A05,494203,Thorpe; Charles Robert,29,0,30,1
1713327700763,SOCI 1,A06,494204,Thorpe; Charles Robert,30,0,30,0
1713327700763,SOCI 1,A07,494205,Thorpe; Charles Robert,28,0,30,2
1713327701789,SOCI 60,A01,494207,Staff,34,0,40,6
1713327701789,SOCI 60,A02,494208,Staff,39,0,40,1
1713327702820,SOCI 100,A01,494210,Payne; Christine Anna,25,0,30,5
1713327702820,SOCI 100,A02,494211,Payne; Christine Anna,26,0,30,4
1713327703844,SOCI 109M,A00,494212,Staff,20,0,20,0
1713327704871,SOCI 110,A00,494213,Staff,34,0,40,6
1713327706922,SOCI 118E,A00,494215,Ng; Kwai,37,0,40,3
1713327707950,SOCI 125,A00,494216,Calderon-Zaks; Michael Aar,40,0,45,5
1713327708981,SOCI 126,A01,494218,Jones; Makeba,3,0,5,2
1713327710009,SOCI 131,A00,494219,Thorpe; Charles Robert,26,0,30,4
1713327712061,SOCI 135,A00,494221,Payne; Christine Anna,28,0,50,22
1713327713087,SOCI 136E,A00,626690,Ruiz; Jonathan Joseph,24,0,25,1
1713327714112,SOCI 138GS,A00,494222,Navon; Daniel,24,0,28,4
1713327716165,SOCI 145,A00,494224,Staff,40,0,45,5
1713327717190,SOCI 153,A00,494225,Staff,28,0,30,2
1713327718216,SOCI 160E,A00,494226,Ng; Kwai,29,0,40,11
1713327719242,SOCI 180,A00,494227,Staff,29,0,30,1
1713327720270,SOCI 189GS,A00,494228,Ribas Norris; Janet Vanesa,11,0,11,0
1713327721297,SOCI 190GS,A00,553232,Ribas Norris; Janet Vanesa,11,0,11,0
1713327722327,SOMI 220,A00,627178,Schneid; Stephen David,30,0,30,0
1713327723355,SYN 2,001,490768,Staff,14,0,15,1
1713327723355,SYN 2,002,490769,Staff,14,0,15,1
1713327723355,SYN 2,004,490775,Staff,0,0,0,0
1713327723355,SYN 2,003,490774,Staff,0,0,0,0
1713327723355,SYN 2,005,490776,Staff,0,0,0,0
1713327724381,SYN 2R,001,490779,Staff,11,0,15,4
1713327724381,SYN 2R,002,514635,Staff,14,0,15,1
1713327725412,SYN 100,A01,490783,Staff,11,0,20,9
1713327725412,SYN 100,B01,490787,Staff,9,0,20,11
1713327725412,SYN 100,C01,490789,Staff,10,0,20,10
1713327726437,SYN 150,A00,490817,Staff,14,0,15,1
1713327726437,SYN 150,B00,514610,Staff,15,0,15,0
1713327727465,TDAC 1,A00,492753,Walsh; Kim C.,19,0,20,1
1713327727465,TDAC 1,B00,492754,Harting; Carla Kelso,19,0,20,1
1713327727465,TDAC 1,C00,513995,Salovey; Todd,15,0,20,5
1713327728491,TDAC 101,A00,492766,Harting; Carla Kelso,17,0,20,3
1713327729521,TDAC 102,A00,492768,Basso; Beatrice,19,0,20,1
1713327730549,TDDE 111,A00,492769,Staff,25,0,25,0
1713327731578,TDDE 131,A00,492770,Staff,15,0,15,0
1713327731578,TDDE 131,B00,492771,Staff,15,0,15,0
1713327732607,TDDE 131GS,A00,523716,Guirguis; Mark C,23,0,28,5
1713327733633,TDGE 1,A01,492756,Salovey; Todd,56,0,60,4
1713327734662,TDGE 5,A01,492758,Staff,23,0,25,2
1713327735688,TDGE 10,A00,492759,Fulton; Julia,203,0,220,17
1713327736717,TDGE 11,A00,492760,Castro; Robert Jess,198,0,200,2
1713327738772,TDGE 124,A00,492772,Fulton; Julia,185,0,220,35
1713327739798,TDGE 125,A00,492773,Meyer; Ursula,38,0,50,12
1713327739798,TDGE 125,B00,492774,Staff,49,0,50,1
1713327739798,TDGE 125,C00,523565,Staff,48,0,50,2
1713327740824,TDGE 125GS,A00,523580,Guirguis; Mark C,23,0,28,5
1713327741850,TDGE 127,A00,492775,Havis; Allan,34,0,50,16
1713327742877,TDHT 101,A00,492776,Staff,34,0,35,1
1713327743907,TDMV 1,A00,492762,Caligagan; Maria T.,30,0,30,0
1713327743907,TDMV 1,B00,492763,Arcidiacono; Kristin,26,0,30,4
1713327744938,TDMV 2,A00,492764,Weinberg; Sadie,28,0,30,2
1713327745965,TDMV 3,A00,492765,Mack; Kara Shanai',37,0,40,3
1713327746994,TDMV 138,A00,492777,Mack; Kara Shanai',34,0,40,6
1713327748019,TDMV 140,A00,492778,Lima; Paulo Henrique,40,0,40,0
1713327749052,TDMV 142,A00,492779,Caligagan; Maria T.,33,0,40,7
1713327749052,TDMV 142,B00,492780,Caligagan; Tony,37,0,40,3
1713327750077,TDMV 143,A00,492781,Fyall; Daunte Edward,39,0,40,1
1713327751103,USP 1,A01,492401,Kwak; Nancy,27,0,35,8
1713327752135,USP 2,A01,492453,Hinds; Juli Beth,35,0,35,0
1713327753158,USP 3,A01,492516,Staff,28,0,35,7
1713327754185,USP 4,A00,492522,McTague; Sarah,16,0,25,9
1713327755210,USP 100,A00,492523,Staff,32,0,35,3
1713327756234,USP 101,A00,492524,Staff,13,0,15,2
1713327757264,USP 105,A00,492525,Staff,21,0,25,4
1713327758289,USP 151,A00,492526,Shenkman; Michael Thomas,32,0,35,3
1713327759316,USP 170,A00,492545,Hinds; Juli Beth,33,0,35,2
1713327760345,USP 171GS,A00,492608,Bussell; Mirle Rabinowitz,24,0,28,4
1713327761370,USP 183GS,A00,492613,Peerson; Susan,24,0,28,4
1713327762396,VIS 30,A01,490693,Yoldas; Pinar,19,0,22,3
1713327762396,VIS 30,A02,490694,Yoldas; Pinar,18,0,22,4
1713327763421,VIS 83,A00,490695,Kester; Grant,63,0,75,12
1713327764449,VIS 105D,A00,490696,Staff,22,0,25,3
1713327765476,VIS 124CN,A00,490699,Rose; Jordan M,65,0,75,10
1713327766502,VIS 125GS,A00,511221,Williams; Alena J,21,0,22,1
1713327767526,VIS 128D,A00,490700,Staff,73,0,75,2
1713327768556,VIS 151,A01,490717,Staff,33,0,34,1
1713327768556,VIS 151,A02,490766,Staff,33,0,34,1
1713327769585,VIS 154GS,A00,511972,Williams; Alena J,21,0,22,1
1713327770611,VIS 160A,A00,490767,Stone; Patricia,7,0,10,3
1713327771640,WCWP 10A,A00,490638,Staff,14,0,15,1
1713327771640,WCWP 10A,B00,490640,Staff,15,0,15,0
1713327772669,WCWP 10B,A00,490641,Staff,0,0,0,0
1713327772669,WCWP 10B,B00,490642,Staff,14,0,15,1
1713327772669,WCWP 10B,C00,490644,Staff,13,0,15,2
1713327772669,WCWP 10B,D00,490647,Staff,0,0,0,0
1713327773696,WCWP 100,A00,490655,Staff,0,0,0,0
1713327773696,WCWP 100,B00,490687,Staff,10,0,15,5
1713327775783,ANAR 153,A00,487222,Braswell; Geoffrey E.,54,0,60,6
1713327776810,ANBI 134,A00,487223,Staff,6,0,20,14
1713327777836,ANBI 143GS,A00,487224,Noel; Geoffroy Pierre Jean,18,0,24,6
1713327778860,ANBI 144GS,A00,519548,Noel; Geoffroy Pierre Jean,18,0,24,6
1713327779886,ANSC 101,A00,487225,Staff,18,0,20,2
1713327780912,ANSC 125,A00,487227,Brenner; Suzanne A,39,0,40,1
1713327782966,ANSC 146,A00,487229,Staff,35,0,40,5
1713327783993,ANSC 148,A00,487230,Olivas Hernandez; Olga Lid,39,0,40,1
1713327785025,ANSC 150,A00,504165,Sloane; Julia Kathryn,18,0,20,2
1713327786050,ANSC 180,A00,487232,Staff,14,0,15,1
1713327787075,ANSC 188,A00,627155,Staff,39,0,40,1
1713327788105,ANTH 5,A00,519529,Semendeferi; Ekaterini,15,0,15,0
1713327789132,ANTH 10,A00,487219,Staff,58,0,60,2
1713327790157,ANTH 23,A01,487221,Staff,17,0,20,3
1713327791187,ANTH 102,A00,487233,Wilder; Linnea Lorene,51,0,60,9
1713327792215,ANTH 103,A00,487234,Varma; Saiba,55,0,60,5
1713327793241,ANTH 105,A00,487235,Stewart; Alexander B,54,0,60,6
1713327794267,BENG 100,A01,516685,Taylor Amos; Alyssa C,27,0,30,3
1713327795293,BIBC 102,A01,491316,Flagg; Matthew Paul,14,0,88,74
1713327795293,BIBC 102,A02,491366,Flagg; Matthew Paul,78,0,88,10
1713327796323,BIBC 103,A01,491486,Boumechache; Miyyada,16,0,24,8
1713327796323,BIBC 103,A02,491487,Boumechache; Miyyada,24,0,24,0
1713327797347,BICD 100,A01,516882,Staff,73,0,75,2
1713327797347,BICD 100,A02,516890,Staff,69,0,75,6
1713327798373,BICD 102GS,A00,491488,Lo; Stanley M.,26,0,28,2
1713327799401,BIEB 136GS,A00,516940,Holway; David A. & Shurin; Jonathan,18,0,24,6
1713327800425,BIEB 137GS,A01,517034,Holway; David A. & Shurin; Jonathan,18,0,24,6
1713327801452,BIEB 138GS,A01,491492,Pirino; Giorgia,21,0,28,7
1713327802481,BILD 1,A01,491296,Staff,60,0,63,3
1713327802481,BILD 1,A02,491297,Staff,63,0,63,0
1713327803507,BILD 4,A01,517099,Gonzalez Gamboa; Ivonne,22,0,24,2
1713327803507,BILD 4,A02,517100,Gonzalez Gamboa; Ivonne,24,0,24,0
1713327804587,BILD 60GS,A00,491309,Lo; Stanley M.,26,0,28,2
1713327805615,BIMM 100,A01,517136,Staff,85,0,100,15
1713327806641,BIMM 110,A01,517182,Staff,55,0,100,45
1713327807667,BIMM 120,A01,517228,Pickett; Brooke Elizabeth,29,0,63,34
1713327807667,BIMM 120,A02,517240,Pickett; Brooke Elizabeth,44,0,63,19
1713327808696,BIMM 132GS,A01,491498,Pirino; Giorgia,21,0,28,7
1713327809728,BIMM 143,A01,491589,Bozinovic; Goran,13,0,40,27
1713327810754,BIPN 100,A01,491594,Armour; Jon Christopher,85,0,100,15
1713327811784,BIPN 140,A01,491602,Marino; Marc J,26,0,50,24
1713327813836,CAT 125,A00,515973,Staff,18,0,20,2
1713327814862,CAT 125GS,A00,515974,Rahimi; Babak,17,0,20,3
1713327815896,CAT 125R,A00,515980,Staff,12,0,20,8
1713327815896,CAT 125R,B00,515981,Tosun; Adriana,19,0,20,1
1713327815896,CAT 125R,C00,515987,Hyland; Tina Mae,0,2,20,20
1713327815896,CAT 125R,D00,515988,Bronstein; Phoebe Malan,16,0,20,4
1713327816926,CENG 15,A01,488699,Drews; Aaron,25,0,25,0
1713327817951,CENG 100,A00,505196,Opatkiewicz; Justin Paul,25,0,25,0
1713327818977,CGS 2A,A01,489598,Staff,33,0,35,2
1713327820006,CGS 112,A00,489599,Staff,15,0,15,0
1713327821031,CGS 119,A00,489603,Staff,10,0,10,0
1713327822060,CGS 120,A00,489604,Staff,14,0,15,1
1713327823087,CGS 150,A00,489607,Staff,15,0,15,0
1713327824113,CHEM 6A,A01,488715,Staff,98,0,100,2
1713327825139,CHEM 6B,A01,488719,Piercy; Marc Anthony,99,0,100,1
1713327826163,CHEM 6C,A01,488723,Albizati; Kim F.,93,0,100,7
1713327827191,CHEM 7L,A01,488728,Schurmeier; Kimberly,18,0,24,6
1713327827191,CHEM 7L,A02,488730,Schurmeier; Kimberly,23,0,24,1
1713327827191,CHEM 7L,A03,488734,Schurmeier; Kimberly,20,0,24,4
1713327827191,CHEM 7L,A04,488763,Schurmeier; Kimberly,23,0,24,1
1713327827191,CHEM 7L,B01,488798,Schurmeier; Kimberly,17,0,24,7
1713327827191,CHEM 7L,B02,488801,Schurmeier; Kimberly,22,0,24,2
1713327827191,CHEM 7L,B03,488808,Schurmeier; Kimberly,23,0,24,1
1713327827191,CHEM 7L,B04,488811,Schurmeier; Kimberly,24,0,24,0
1713327828218,CHEM 11,A01,488897,Stallings; Dontarie M,95,0,100,5
1713327829244,CHEM 40A,A01,488913,Albizati; Kim F.,84,0,100,16
1713327830273,CHEM 40B,A01,488920,Weizman; Haim,43,0,50,7
1713327830273,CHEM 40B,A02,488938,Weizman; Haim,45,0,50,5
1713327831304,CHEM 41A,A01,489029,Klosterman; Jeremy K,57,0,60,3
1713327832329,CHEM 41C,A01,500436,Tor; Yitzhak,55,0,60,5
1713327833357,CHEM 43A,A01,500426,Weizman; Haim,0,0,24,24
1713327833357,CHEM 43A,A02,500430,Weizman; Haim,8,0,24,16
1713327833357,CHEM 43A,B01,514041,Klosterman; Jeremy K,16,0,24,8
1713327833357,CHEM 43A,B02,514047,Klosterman; Jeremy K,23,0,24,1
1713327834383,CHEM 108,A01,489140,Jennings; Patricia A.,9,0,24,15
1713327834383,CHEM 108,A02,489142,Jennings; Patricia A.,14,0,24,10
1713327835412,CHEM 114A,A01,489147,Stallings; Dontarie M,68,0,100,32
1713327836440,CHIN 169A,A00,489171,Wang; Xiao,19,0,20,1
1713327838490,COGS 3,A01,518827,Boyle; Mary E. T.,26,0,40,14
1713327839514,COGS 11,A01,489175,Staff,27,0,30,3
1713327840538,COGS 14A,A01,518829,Staff,51,0,60,9
1713327841568,COGS 14B,A01,489177,Hoffman; Drew Ellen,63,0,75,12
1713327842592,COGS 100,A01,489181,Allen; Michael Gordon,63,0,75,12
1713327843617,COGS 101A,A01,489183,Staff,46,0,60,14
1713327844641,COGS 101B,A01,489185,Allen; Michael Gordon,8,0,30,22
1713327845744,COGS 101C,A01,526786,Staff,23,0,30,7
1713327847795,COGS 107A,A01,489189,Boyle; Mary E. T.,18,0,35,17
1713327848822,COGS 107B,A01,627144,Mooshagian; Eric Frederick,60,0,60,0
1713327849851,COGS 118A,A01,489191,Staff,0,44,40,40
1713327851904,COGS 171GS,A01,489194,Pineda; Jaime A,20,0,28,8
1713327852932,COGS 172,A01,489196,Staff,3,0,30,27
1713327853961,COGS 174GS,A01,489264,Pineda; Jaime A,20,0,28,8
1713327854991,COGS 180,A01,627150,Staff,28,0,30,2
1713327856020,COGS 186,A01,489274,Staff,0,1,30,30
1713327857045,COMM 10,A01,489276,Staff,23,0,25,2
1713327857045,COMM 10,A02,489303,Staff,23,0,25,2
1713327858070,COMM 100A,A01,489312,Staff,14,0,25,11
1713327858070,COMM 100A,A02,489313,Staff,24,0,25,1
1713327859097,COMM 106T,A00,512540,Staff,33,0,35,2
1713327860126,COMM 107,A00,489347,Staff,27,0,35,8
1713327861150,COMM 109P,A00,489358,Staff,31,0,35,4
1713327862179,COMM 132,A00,489361,McKenna; Denise,27,0,30,3
1713327863204,COMM 146,A00,489362,Halm; Gavin Patrick,26,0,30,4
1713327864229,COMM 190,A00,489363,Abuelhiga; Soraya Jill,17,0,23,6
1713327865262,CSE 8A,A50,489366,Staff,21,0,25,4
1713327865262,CSE 8A,A51,489367,Staff,24,0,25,1
1713327866287,CSE 11,A01,489398,Cao; Yingjun,74,0,100,26
1713327867315,CSE 12,A01,489487,Staff,43,0,50,7
1713327868345,CSE 20,A01,489497,Staff,48,0,50,2
1713327869369,CSE 21,A01,489517,Braun; Oliver,42,0,50,8
1713327870397,CSE 101,A01,489524,Braun; Oliver,0,29,50,50
1713327871424,CSE 105,A01,512594,Jones; Miles E,72,0,100,28
1713327871424,CSE 105,B01,512598,Jones; Miles E,52,0,100,48
1713327872451,CSE 140,A01,489538,Staff,41,0,50,9
1713327873477,CSE 141,A01,489550,Eldon; John,68,0,100,32
1713327874503,CSE 141L,A01,489571,Eldon; John,66,0,100,34
1713327875529,CSE 151A,A01,489583,Solares; Edwin A,141,0,200,59
1713327876554,CSE 175,A01,510886,Kumar; Rakesh,30,0,30,0
1713327877584,CSE 190,A00,516828,Dubnov; Shlomo,38,0,49,11
1713327878611,DOC 100D,A00,489667,Pass; Natalye Joann,19,0,25,6
1713327879636,DSC 10,A01,624268,Staff,72,0,75,3
1713327880663,DSC 20,A01,624476,Staff,50,0,50,0
1713327881688,DSC 40A,A01,624608,Staff,39,0,40,1
1713327882714,DSGN 1,A01,489179,Rill; Bryan,33,0,50,17
1713327883739,ECE 17,A01,490489,Sahay; Rajeev,18,0,30,12
1713327884767,ECE 65,A50,490492,Staff,12,0,20,8
1713327884767,ECE 65,A51,490493,Staff,18,0,20,2
1713327885794,ECON 1,A01,489715,Famulari; Melissa,68,0,70,2
1713327886822,ECON 2,A01,489717,Levkoff; Steven B.,68,0,70,2
1713327887852,ECON 3,A01,489948,Staff,70,0,70,0
1713327889907,ECON 5,A01,490103,Staff,27,0,30,3
1713327889907,ECON 5,B01,626281,Dai; Yinlin,45,0,45,0
1713327890932,ECON 100A,A01,490127,Famulari; Melissa,65,0,70,5
1713327891960,ECON 100B,A01,490129,Staff,64,0,70,6
1713327892988,ECON 109,A01,490187,Shishkin; Denis,27,0,35,8
1713327894012,ECON 110A,A01,490190,Levkoff; Steven B.,60,0,70,10
1713327895038,ECON 120A,A01,490245,Dai; Yinlin,61,0,70,9
1713327896067,ECON 120B,A01,490247,Nieto-Barthaburu; Augusto,42,0,70,28
1713327897100,ECON 120C,A01,490253,Sun; Yixiao,30,0,35,5
1713327897100,ECON 120C,B01,490255,Sun; Yixiao,34,0,35,1
1713327898128,ECON 129,A00,490256,Eckert; Fabian Paul,23,0,35,12
1713327899155,ECON 131,A00,490257,Nieto-Barthaburu; Augusto,0,6,35,35
1713327900184,ECON 138,A00,490258,Bharadwaj; Prashant,13,0,35,22
1713327900184,ECON 138,B00,490259,Bharadwaj; Prashant,15,0,35,20
1713327901209,ECON 159,A00,490260,Hendrickson; Gerald M.,0,9,0,0
1713327902235,ECON 178,A01,553995,Zhu; Ying,24,0,35,11
1713327903262,EDS 40,A01,512576,Black; Alison Michelle,20,0,20,0
1713327904289,EDS 107,A01,515848,Staff,30,0,30,0
1713327905318,EDS 110R,A01,490262,Staff,26,0,30,4
1713327906348,EDS 112,A01,490264,Chapman; Thandeka K,40,0,50,10
1713327907373,EDS 113,A00,490266,Staff,26,0,30,4
1713327908453,EDS 118,A00,490267,Warstadt; Melissa Fawn,20,0,30,10
1713327909477,EDS 124BR,A00,490268,Eguchi; Emi,4,0,25,21
1713327909477,EDS 124BR,B00,490269,Eguchi; Emi,23,0,25,2
1713327910502,EDS 126,A01,490271,Jones; Makeba,43,0,50,7
1713327911530,EDS 135,A01,490316,Staff,19,0,20,1
1713327912556,ENVR 142GS,A00,519514,Chang; Edmond Yi-Teh,27,0,28,1
1713327913585,ETHN 103,A00,490504,Staff,25,0,36,11
1713327914610,ETHN 103A,A00,490505,Man; Simeon S,4,0,9,5
1713327915636,ETHN 109,A00,490506,Staff,28,0,30,2
1713327916664,ETHN 118,A00,490507,Staff,35,0,36,1
1713327917690,ETHN 119,A00,490508,Staff,33,0,36,3
1713327918717,ETHN 121R,A00,490518,Choi; Esther Min,21,0,36,15
1713327919986,ETHN 127,A00,490528,Staff,14,0,15,1
1713327921011,ETHN 139,A00,490573,Staff,10,0,10,0
1713327922035,ETHN 150,A00,490575,Staff,15,0,15,0
1713327923066,GLBH 20,A00,491705,Elwardani; Nile Regina,38,0,40,2
1713327924096,GLBH 101,A00,491706,Staff,20,0,20,0
1713327925125,GLBH 111,A01,491708,Burgos; Jose L.,15,0,15,0
1713327926152,GLBH 146,A00,491709,Staff,9,0,20,11
1713327927181,GLBH 148,A00,491710,Olivas Hernandez; Olga Lid,11,0,20,9
1713327928209,GLBH 150,A00,491711,Sloane; Julia Kathryn,19,0,20,1
1713327929237,HIEA 131,A00,491760,Staff,28,0,32,4
1713327930263,HIEA 153,A00,491762,Staff,28,0,30,2
1713327931290,HIEU 124,A00,491811,Staff,26,0,32,6
1713327932317,HIEU 124GS,A00,491812,Markman; Kristina,27,0,28,1
1713327933345,HIEU 147,A00,491813,Staff,30,0,32,2
1713327934370,HIEU 149GS,A00,491816,Caldwell; Michael Alan,28,0,28,0
1713327935394,HILD 2C,A01,491713,Hendrickson; Gerald M.,26,0,30,4
1713327936419,HILD 7B,A01,491715,Kwak; Nancy,0,1,30,30
1713327937444,HILD 10,A01,491717,Staff,11,0,20,9
1713327938467,HILD 30GS,A00,491719,Edington; Claire Ellen,24,0,28,4
1713327939491,HINE 109,A00,491818,Shafir; Nir,27,0,32,5
1713327940516,HINE 128,A00,491821,Shafir; Nir,31,0,32,1
1713327941545,HISC 117,A00,491830,Staff,27,0,32,5
1713327942572,HIUS 103,A00,491834,Man; Simeon S,14,0,23,9
1713327943595,HIUS 108B,A00,491835,Staff,28,0,30,2
1713327944622,HIUS 141,A00,491836,Hendrickson; Gerald M.,28,0,32,4
1713327945647,HIUS 149,A00,491839,Staff,24,0,32,8
1713327946675,HUM 3,A01,512617,Crum; Matthew Stephen,43,0,50,7
1713327946675,HUM 3,A02,512618,Crum; Matthew Stephen,48,0,50,2
1713327947702,HUM 3GS,A00,512663,Markman; Kristina,0,0,0,1
1713327947702,HUM 3GS,B00,512664,Staff,0,0,0,0
1713327948727,HUM 4,A01,512620,West; Geoffrey Scott,26,0,50,24
1713327949755,HUM 4GS,A00,512666,Lyon; Antony J.,0,0,0,4
1713327950781,HUM 4R,A01,512625,Watkins; Eric,49,0,50,1
1713327951807,HUM 5,A01,512649,Zavodny; Tatiana Sophia,23,0,50,27
1713327951807,HUM 5,B01,512661,Zroka; Ryan Edward,48,0,50,2
1713327952832,INTL 190,A00,490577,Segui; Alan S,0,0,0,5
1713327953867,JAPN 20AR,A01,491267,Ross; Kayoko F,8,0,20,12
1713327954895,JAPN 180,A00,491285,Berman; Michael David,33,0,40,7
1713327955928,LATI 50,A01,502536,Kokinis; Troy Andreas,16,0,22,6
1713327955928,LATI 50,A02,502551,Kokinis; Troy Andreas,22,0,22,0
1713327955928,LATI 50,A03,502650,Kokinis; Troy Andreas,22,0,22,0
1713327955928,LATI 50,A04,502909,Kokinis; Troy Andreas,21,0,22,1
1713327956958,LATI 160,A01,502920,Kokinis; Troy Andreas,30,0,30,0
1713327957984,LIFR 1A,A00,490494,Van Moer; Vinciane G,17,0,20,3
1713327959013,LIFR 1AX,A00,490495,Van Moer; Vinciane G,17,0,20,3
1713327960038,LIFR 1B,A00,490496,Van Moer; Vinciane G,18,0,20,2
1713327961063,LIFR 1BX,A00,490497,Van Moer; Vinciane G,18,0,20,2
1713327962090,LIGN 8,A00,505198,McIntosh; Justin Daniel,134,0,150,16
1713327963118,LIGN 9GS,A00,491239,Lott; Margaret S.,18,0,20,2
1713327964142,LIGN 101,A01,505200,McIntosh; Justin Daniel,22,0,30,8
1713327965170,LIGN 120,A01,491244,Staff,23,0,30,7
1713327966195,LIGN 149GS,A00,491245,Lott; Margaret S.,18,0,20,2
1713327967225,LIGN 170,A00,491247,Staff,22,0,30,8
1713327968250,LISP 1D,A00,490498,Munoz Sanchez; Alicia,9,0,14,5
1713327968250,LISP 1D,B00,490499,Munoz Sanchez; Alicia,6,0,14,8
1713327968250,LISP 1D,C00,490500,Munoz Sanchez; Alicia,7,0,14,7
1713327968250,LISP 1D,D00,490501,Munoz Sanchez; Alicia,10,0,14,4
1713327969277,LISP 1DX,A00,490502,Munoz Sanchez; Alicia,14,0,28,14
1713327969277,LISP 1DX,B00,490503,Munoz Sanchez; Alicia,16,0,28,12
1713327971328,LTAM 110,A00,491847,Staff,22,0,25,3
1713327972353,LTCS 119,A00,491848,Staff,11,0,15,4
1713327973378,LTCS 130,A00,491849,Staff,24,0,25,1
1713327975429,LTEA 120C,A00,491852,Staff,32,0,40,8
1713327976456,LTEN 130GS,A00,491853,Lyon; Antony J.,24,0,28,4
1713327977484,LTEN 148,A00,491855,Staff,23,0,25,2
1713327978513,LTEN 159,A00,491856,Staff,20,0,25,5
1713327979541,LTEN 180,A00,491857,Staff,8,0,15,7
1713327981601,LTSP 123GS,A00,505928,Bessett; Ryan Matthew,24,0,28,4
1713327982626,LTSP 174GS,A00,506037,Bessett; Ryan Matthew,24,0,28,4
1713327984681,LTWR 102,A00,491861,Staff,9,0,15,6
1713327985704,LTWR 106,A00,491862,Staff,8,0,15,7
1713327986734,MAE 11,A00,490930,Bahadori; Mohammad Yousef,95,0,100,5
1713327987760,MAE 30A,A00,490931,Qi; Huihui,37,0,40,3
1713327988785,MAE 101A,A00,491036,Sadeghizadeh; Zahra,92,0,100,8
1713327989811,MAE 101C,A00,491037,Seshadri; Kalyanasundaram,67,0,100,33
1713327990834,MAE 113,A00,491040,Seshadri; Kalyanasundaram,66,0,80,14
1713327991864,MAE 131A,A00,491041,Ghazinejad; Maziar,37,0,40,3
1713327992893,MAE 142,A00,491053,Staff,39,0,40,1
1713327993918,MAE 143A,A00,491054,Staff,33,0,50,17
1713327994944,MAE 150,A00,491092,Truong; Phuong Thi Ngoc,23,0,35,12
1713327995994,MATH 3C,A01,494031,Pardo Guerra; Sebastian,30,0,30,0
1713327995994,MATH 3C,A02,494032,Pardo Guerra; Sebastian,29,0,30,1
1713327997020,MATH 10A,A01,494034,Staff,27,0,30,3
1713327997020,MATH 10A,A02,494035,Staff,28,0,30,2
1713327997020,MATH 10A,B01,494037,Staff,27,0,30,3
1713327997020,MATH 10A,B02,494038,Staff,29,0,30,1
1713327998049,MATH 10B,A01,494040,Habib; Yousaf,22,0,30,8
1713327998049,MATH 10B,A02,494041,Habib; Yousaf,28,0,30,2
1713327998049,MATH 10B,A03,494042,Habib; Yousaf,29,0,30,1
1713327998049,MATH 10B,A04,494043,Habib; Yousaf,30,0,30,0
1713327998049,MATH 10B,B01,494045,Habib; Yousaf,25,0,30,5
1713327998049,MATH 10B,B02,494046,Habib; Yousaf,30,0,30,0
1713327998049,MATH 10B,B03,494047,Habib; Yousaf,30,0,30,0
1713327998049,MATH 10B,B04,494048,Habib; Yousaf,30,0,30,0
1713327999085,MATH 18,A01,494050,Kemp; Todd Aahron,25,0,30,5
1713327999085,MATH 18,A02,494051,Kemp; Todd Aahron,29,0,30,1
1713327999085,MATH 18,B01,494054,Kemp; Todd Aahron,26,0,30,4
1713327999085,MATH 18,B02,494055,Kemp; Todd Aahron,29,0,30,1
1713328000114,MATH 20A,A01,494059,Suk; Andrew Hoon,30,0,30,0
1713328001144,MATH 20B,A01,494061,Briones; Jor-el Thomas Caparas,33,0,35,2
1713328001144,MATH 20B,B01,494063,Bach; Quang Tran,34,0,35,1
1713328002339,MATH 20C,A01,494065,Staff,28,0,30,2
1713328002339,MATH 20C,A02,494066,Staff,30,0,30,0
1713328002339,MATH 20C,A03,494067,Staff,30,0,30,0
1713328002339,MATH 20C,A04,494068,Staff,30,0,30,0
1713328002339,MATH 20C,B01,494070,Zhang; Ming,25,0,30,5
1713328002339,MATH 20C,B02,494071,Zhang; Ming,27,0,30,3
1713328002339,MATH 20C,B03,494072,Zhang; Ming,29,0,30,1
1713328002339,MATH 20C,B04,494073,Zhang; Ming,29,0,30,1
1713328003365,MATH 20D,A01,494075,Staff,22,0,30,8
1713328003365,MATH 20D,A02,494076,Staff,29,0,30,1
1713328004394,MATH 20E,A01,494079,Staff,24,0,30,6
1713328004394,MATH 20E,A02,494080,Staff,26,0,30,4
1713328004394,MATH 20E,B01,494082,Staff,25,0,30,5
1713328004394,MATH 20E,B02,494083,Staff,25,0,30,5
1713328005418,MATH 103A,A01,494085,Aliabadi Sr.; Mohsen,14,0,30,16
1713328005418,MATH 103A,A02,494086,Aliabadi Sr.; Mohsen,28,0,30,2
1713328005418,MATH 103A,B01,494088,Aliabadi Sr.; Mohsen,21,0,30,9
1713328005418,MATH 103A,B02,494089,Aliabadi Sr.; Mohsen,27,0,30,3
1713328006444,MATH 109,A01,494091,Staff,30,0,30,0
1713328006444,MATH 109,A02,494092,Staff,29,0,30,1
1713328006444,MATH 109,B01,494094,Staff,27,0,30,3
1713328006444,MATH 109,B02,494095,Staff,29,0,30,1
1713328007472,MATH 142A,A01,494097,Chow; Bennett,15,0,30,15
1713328007472,MATH 142A,A02,494098,Chow; Bennett,23,0,30,7
1713328007472,MATH 142A,B01,494100,Chow; Bennett,19,0,30,11
1713328007472,MATH 142A,B02,494101,Chow; Bennett,29,0,30,1
1713328009523,MATH 168A,A01,516677,Dumitriu; Ioana,16,0,35,19
1713328010548,MATH 170A,A01,516679,Dumitriu; Ioana,18,0,30,12
1713328010548,MATH 170A,A02,516680,Dumitriu; Ioana,28,0,30,2
1713328011647,MATH 193A,A01,494107,Staff,14,0,30,16
1713328011647,MATH 193A,A02,494108,Staff,20,0,30,10
1713328011647,MATH 193A,A03,494109,Staff,29,0,30,1
1713328011647,MATH 193A,A04,494110,Staff,22,0,30,8
1713328014778,MGT 16,A00,491930,McKay; Michael J,92,0,98,6
1713328015805,MGT 18,A00,491992,McKay; Michael J,96,0,98,2
1713328016832,MGT 71,A00,492003,Staff,66,0,98,32
1713328017862,MGT 103,A00,505209,Eberhard; Craig A,81,0,98,17
1713328018887,MGT 131A,A00,505210,Anderson; John Charles,89,0,98,9
1713328020941,MGT 153,A00,492077,Perols; Johan Lars,19,0,90,71
1713328024015,MGT 164,A00,492222,McKay; Mary A,91,0,98,7
1713328025038,MGT 172,A00,492245,Staff,59,0,60,1
1713328025038,MGT 172,B00,505526,Hedges; Kathleen,65,0,98,33
1713328026066,MGT 181,A00,505669,Dunn; Louis Jean,82,0,98,16
1713328027094,MMW 14,A01,494399,Staff,15,0,28,13
1713328027094,MMW 14,A02,494400,Staff,25,0,28,3
1713328027094,MMW 14,A03,494401,Staff,28,0,28,0
1713328027094,MMW 14,A04,494402,Staff,28,0,28,0
1713328027094,MMW 14,B01,494404,Carreras; Maria Victoria,8,0,28,20
1713328027094,MMW 14,B02,494405,Carreras; Maria Victoria,25,0,28,3
1713328027094,MMW 14,B03,494406,Carreras; Maria Victoria,27,0,28,1
1713328027094,MMW 14,B04,494407,Carreras; Maria Victoria,28,0,28,0
1713328028123,MMW 14GS,A00,506250,Chang; Edmond Yi-Teh,0,0,0,0
1713328029151,MMW 121R,A01,494415,Adamiak; Patrick John,11,0,28,17
1713328029151,MMW 121R,A02,494416,Adamiak; Patrick John,24,0,28,4
1713328030179,MUS 1A,A01,494113,Staff,12,0,25,13
1713328030179,MUS 1A,A02,494114,Staff,24,0,25,1
1713328031210,MUS 4,A01,494116,Staff,23,0,25,2
1713328031210,MUS 4,A02,494117,Staff,22,0,25,3
1713328032235,MUS 5R,A01,494236,Dubnov; Shlomo,6,0,25,19
1713328032235,MUS 5R,A02,494237,Dubnov; Shlomo,25,0,25,0
1713328033260,MUS 6,A01,494122,Staff,10,0,25,15
1713328033260,MUS 6,A02,494123,Staff,23,0,25,2
1713328034285,MUS 7,A01,494125,Staff,16,0,25,9
1713328034285,MUS 7,A02,494126,Staff,24,0,25,1
1713328035310,MUS 11,A01,494128,Staff,23,0,25,2
1713328035310,MUS 11,A02,494129,Staff,24,0,25,1
1713328036337,MUS 13,A01,494131,Staff,25,0,25,0
1713328036337,MUS 13,A02,494132,Staff,25,0,25,0
1713328037367,MUS 15,A01,494134,Staff,17,0,25,8
1713328037367,MUS 15,A02,494135,Staff,25,0,25,0
1713328037367,MUS 15,B01,494137,Staff,24,0,25,1
1713328038394,MUS 80,A00,494232,Staff,24,0,25,1
1713328038394,MUS 80,B00,494233,Staff,25,0,25,0
1713328038394,MUS 80,C00,494234,Staff,23,0,25,2
1713328039418,MUS 95C,A00,494141,Staff,70,0,75,5
1713328040446,MUS 114,A00,494142,Staff,40,0,50,10
1713328041475,NANO 15,A01,490636,Drews; Aaron,7,0,7,0
1713328042501,PHIL 1,A00,490578,Grush; Rick Scott,49,0,50,1
1713328043526,PHIL 10,A01,490580,Grush; Rick Scott,33,0,35,2
1713328043526,PHIL 10,A02,490586,Grush; Rick Scott,32,0,35,3
1713328044552,PHIL 27,A01,490591,Staff,22,0,25,3
1713328044552,PHIL 27,A02,490592,Staff,25,0,25,0
1713328044552,PHIL 27,A03,490593,Staff,25,0,25,0
1713328044552,PHIL 27,A04,490598,Staff,25,0,25,0
1713328045582,PHIL 32,A01,490611,Staff,20,0,20,0
1713328045582,PHIL 32,A02,490618,Staff,20,0,20,0
1713328046607,PHIL 90,A00,490624,Staff,40,0,40,0
1713328047634,PHIL 136,A00,490627,Cohen; Jonathan David,37,0,40,3
1713328048659,PHIL 155,A00,490634,Staff,62,0,70,8
1713328049690,PHYS 1A,A00,491610,Staff,245,0,250,5
1713328050715,PHYS 1AL,001,491616,Tsai; Philbert S,27,0,30,3
1713328050715,PHYS 1AL,002,491618,Tsai; Philbert S,30,0,30,0
1713328051740,PHYS 1B,A00,491623,Staff,236,0,250,14
1713328052766,PHYS 1BL,001,491626,Tsai; Philbert S,22,0,30,8
1713328052766,PHYS 1BL,002,491628,Tsai; Philbert S,26,0,30,4
1713328053791,PHYS 1C,A00,491632,Staff,214,0,245,31
1713328054819,PHYS 1CL,001,491635,Tsai; Philbert S,2,0,30,28
1713328054819,PHYS 1CL,002,491643,Tsai; Philbert S,22,0,30,8
1713328055846,PHYS 2AR,A01,491651,Meyertholen; Andrew D.,44,0,50,6
1713328056875,PHYS 2B,A01,491659,Staff,105,0,115,10
1713328057904,PHYS 2BL,A01,491685,Staff,21,0,24,3
1713328057904,PHYS 2BL,A02,491700,Staff,21,0,24,3
1713328058933,PHYS 2C,A01,505161,Staff,102,0,115,13
1713328059965,PHYS 4A,A01,491704,Grinstein; Benjamin,99,0,100,1
1713328060997,POLI 5D,A01,494144,Staff,3,0,5,2
1713328060997,POLI 5D,B01,626283,Dai; Yinlin,5,0,5,0
1713328062020,POLI 12,A00,494145,Staff,43,0,45,2
1713328063046,POLI 13R,A00,494146,Forman; Fonna,45,0,50,5
1713328064078,POLI 27,A01,494148,Staff,54,0,60,6
1713328065103,POLI 30,A00,494149,Staff,49,0,50,1
1713328066130,POLI 100DA,A00,494150,Staff,21,0,25,4
1713328068181,POLI 100I,A00,494152,Staff,27,0,30,3
1713328069213,POLI 104B,A00,494153,Smith; Glenn Chatmas,53,0,55,2
1713328070238,POLI 104F,A00,494154,Staff,28,0,30,2
1713328071267,POLI 104I,A00,494155,Smith; Glenn Chatmas,29,0,30,1
1713328072295,POLI 110C,A00,494156,Ingham; Sean,23,0,25,2
1713328073324,POLI 117R,A00,494157,Forman; Fonna,8,0,20,12
1713328074350,POLI 118,A00,494158,Ingham; Sean,21,0,25,4
1713328075376,POLI 120H,A00,494159,Fisk; David Lee,39,0,45,6
1713328076404,POLI 131CR,A00,494160,Hoston; Germaine,35,0,45,10
1713328077435,POLI 133J,A00,494161,Staff,33,0,35,2
1713328078460,POLI 135,A00,494162,Fisk; David Lee,33,0,35,2
1713328079486,POLI 140A,A00,494164,Staff,20,0,30,10
1713328080512,POLI 142I,A00,494165,Staff,30,0,30,0
1713328081538,POLI 144D,A00,494166,Staff,23,0,25,2
1713328082563,POLI 151,A00,494167,Staff,30,0,30,0
1713328083587,POLI 153,A00,494168,Staff,33,0,35,2
1713328084614,POLI 160AA,A00,494169,Staff,34,0,40,6
1713328085639,POLI 162,A00,494170,Mignozzetti; Umberto,19,0,25,6
1713328086664,POLI 171,A00,494171,Mignozzetti; Umberto,20,0,25,5
1713328087694,PSYC 1,A00,494172,Staff,96,0,100,4
1713328088722,PSYC 2,A00,494173,Moranton; Nirelia Melbina-,34,0,50,16
1713328089750,PSYC 3,A00,494174,Staff,29,0,30,1
1713328090775,PSYC 6,A00,494175,Staff,17,0,20,3
1713328091804,PSYC 60,A01,494177,Staff,38,0,45,7
1713328092829,PSYC 70,A01,505724,Geller; Emma Harlan,42,0,45,3
1713328093870,PSYC 101,A00,494180,Heyman; Gail D.,84,0,100,16
1713328094897,PSYC 105,A00,494181,Geller; Emma Harlan,51,0,90,39
1713328095924,PSYC 106,A00,494182,Dobkins; Karen R.,28,0,45,17
1713328096950,PSYC 108,A00,494183,Adrian; Julia Anna,89,0,100,11
1713328097980,PSYC 114,A01,494185,Winkielman; Piotr,0,2,30,30
1713328099009,PSYC 122,A00,494186,Moranton; Nirelia Melbina-,29,0,50,21
1713328100040,PSYC 124,A00,494187,Chapman; Eddie Nathaniel,71,0,80,9
1713328101069,PSYC 131,A00,494188,Anagnostaras; Stephan,42,0,80,38
1713328102137,PSYC 144,A00,494189,Staff,5,0,50,45
1713328103162,PSYC 154,A00,494190,Lacefield; Katharine I,107,0,180,73
1713328104192,PSYC 162,A00,494191,Wixted; John T,71,0,100,29
1713328105217,PSYC 172,A00,494192,Gorman; Michael R.,36,0,45,9
1713328106242,PSYC 178,A00,494193,Glaser; Dale,34,0,45,11
1713328107270,PSYC 193,A00,505725,Chapman; Eddie Nathaniel,20,0,20,0
1713328108301,RELI 145GS,A00,519817,Rahimi; Babak,18,0,20,2
1713328109332,SE 101A,A01,490862,Chadha; Mayank,23,0,25,2
1713328110356,SE 101C,A01,490924,Krysl; Petr,15,0,20,5
1713328111388,SE 110A,A01,490928,Staff,19,0,20,1
1713328112416,SE 130A,A00,490929,Morrison; Machel Leigh,55,0,70,15
1713328113446,SIO 1,A01,519325,Staff,39,0,40,1
1713328114473,SIO 30,A01,519327,Staff,38,0,40,2
1713328115498,SIO 40,A00,519328,Staff,39,0,40,1
1713328116580,SIO 46GS,A00,519819,Cook; Geoffrey W,17,0,25,8
1713328117604,SIO 109R,A00,494197,Forman; Fonna,0,3,20,20
1713328118629,SIO 121GS,A00,519827,Cook; Geoffrey W,17,0,25,8
1713328119654,SIO 132,A01,519330,Staff,38,0,40,2
1713328120680,SIO 133,A01,519397,Staff,37,0,40,3
1713328121705,SIO 139,A00,519396,Kacev; David,29,0,40,11
1713328122731,SOCI 1,A01,494199,Thorpe; Charles Robert,21,0,30,9
1713328122731,SOCI 1,A02,494200,Thorpe; Charles Robert,30,0,30,0
1713328122731,SOCI 1,A03,494201,Thorpe; Charles Robert,29,0,30,1
1713328122731,SOCI 1,A04,494202,Thorpe; Charles Robert,29,0,30,1
1713328122731,SOCI 1,A05,494203,Thorpe; Charles Robert,29,0,30,1
1713328122731,SOCI 1,A06,494204,Thorpe; Charles Robert,30,0,30,0
1713328122731,SOCI 1,A07,494205,Thorpe; Charles Robert,28,0,30,2
1713328123760,SOCI 60,A01,494207,Staff,34,0,40,6
1713328123760,SOCI 60,A02,494208,Staff,39,0,40,1
1713328124786,SOCI 100,A01,494210,Payne; Christine Anna,25,0,30,5
1713328124786,SOCI 100,A02,494211,Payne; Christine Anna,26,0,30,4
1713328125812,SOCI 109M,A00,494212,Staff,20,0,20,0
1713328126841,SOCI 110,A00,494213,Staff,34,0,40,6
1713328128895,SOCI 118E,A00,494215,Ng; Kwai,37,0,40,3
1713328129924,SOCI 125,A00,494216,Calderon-Zaks; Michael Aar,40,0,45,5
1713328130954,SOCI 126,A01,494218,Jones; Makeba,3,0,5,2
1713328131981,SOCI 131,A00,494219,Thorpe; Charles Robert,26,0,30,4
1713328134034,SOCI 135,A00,494221,Payne; Christine Anna,28,0,50,22
1713328135064,SOCI 136E,A00,626690,Ruiz; Jonathan Joseph,24,0,25,1
1713328136088,SOCI 138GS,A00,494222,Navon; Daniel,24,0,28,4
1713328138138,SOCI 145,A00,494224,Staff,40,0,45,5
1713328139164,SOCI 153,A00,494225,Staff,28,0,30,2
1713328140192,SOCI 160E,A00,494226,Ng; Kwai,29,0,40,11
1713328141217,SOCI 180,A00,494227,Staff,29,0,30,1
1713328142243,SOCI 189GS,A00,494228,Ribas Norris; Janet Vanesa,11,0,11,0
1713328143268,SOCI 190GS,A00,553232,Ribas Norris; Janet Vanesa,11,0,11,0
1713328144295,SOMI 220,A00,627178,Schneid; Stephen David,30,0,30,0
1713328145321,SYN 2,001,490768,Staff,13,0,15,2
1713328145321,SYN 2,002,490769,Staff,14,0,15,1
1713328145321,SYN 2,004,490775,Staff,0,0,0,0
1713328145321,SYN 2,003,490774,Staff,0,0,0,0
1713328145321,SYN 2,005,490776,Staff,0,0,0,0
1713328146347,SYN 2R,001,490779,Staff,11,0,15,4
1713328146347,SYN 2R,002,514635,Staff,14,0,15,1
1713328147373,SYN 100,A01,490783,Staff,10,0,20,10
1713328147373,SYN 100,B01,490787,Staff,9,0,20,11
1713328147373,SYN 100,C01,490789,Staff,10,0,20,10
1713328148398,SYN 150,A00,490817,Staff,14,0,15,1
1713328148398,SYN 150,B00,514610,Staff,15,0,15,0
1713328149425,TDAC 1,A00,492753,Walsh; Kim C.,19,0,20,1
1713328149425,TDAC 1,B00,492754,Harting; Carla Kelso,19,0,20,1
1713328149425,TDAC 1,C00,513995,Salovey; Todd,15,0,20,5
1713328150455,TDAC 101,A00,492766,Harting; Carla Kelso,17,0,20,3
1713328151481,TDAC 102,A00,492768,Basso; Beatrice,19,0,20,1
1713328152505,TDDE 111,A00,492769,Staff,25,0,25,0
1713328153534,TDDE 131,A00,492770,Staff,15,0,15,0
1713328153534,TDDE 131,B00,492771,Staff,15,0,15,0
1713328154558,TDDE 131GS,A00,523716,Guirguis; Mark C,23,0,28,5
1713328155586,TDGE 1,A01,492756,Salovey; Todd,56,0,60,4
1713328156611,TDGE 5,A01,492758,Staff,23,0,25,2
1713328157638,TDGE 10,A00,492759,Fulton; Julia,203,0,220,17
1713328158669,TDGE 11,A00,492760,Castro; Robert Jess,198,0,200,2
1713328160721,TDGE 124,A00,492772,Fulton; Julia,185,0,220,35
1713328161748,TDGE 125,A00,492773,Meyer; Ursula,38,0,50,12
1713328161748,TDGE 125,B00,492774,Staff,49,0,50,1
1713328161748,TDGE 125,C00,523565,Staff,48,0,50,2
1713328162774,TDGE 125GS,A00,523580,Guirguis; Mark C,23,0,28,5
1713328163799,TDGE 127,A00,492775,Havis; Allan,34,0,50,16
1713328164825,TDHT 101,A00,492776,Staff,34,0,35,1
1713328165852,TDMV 1,A00,492762,Caligagan; Maria T.,30,0,30,0
1713328165852,TDMV 1,B00,492763,Arcidiacono; Kristin,26,0,30,4
1713328166883,TDMV 2,A00,492764,Weinberg; Sadie,28,0,30,2
1713328167909,TDMV 3,A00,492765,Mack; Kara Shanai',37,0,40,3
1713328168939,TDMV 138,A00,492777,Mack; Kara Shanai',34,0,40,6
1713328170008,TDMV 140,A00,492778,Lima; Paulo Henrique,40,0,40,0
1713328171033,TDMV 142,A00,492779,Caligagan; Maria T.,33,0,40,7
1713328171033,TDMV 142,B00,492780,Caligagan; Tony,37,0,40,3
1713328172062,TDMV 143,A00,492781,Fyall; Daunte Edward,39,0,40,1
1713328173089,USP 1,A01,492401,Kwak; Nancy,27,0,35,8
1713328174118,USP 2,A01,492453,Hinds; Juli Beth,35,0,35,0
1713328175144,USP 3,A01,492516,Staff,28,0,35,7
1713328176170,USP 4,A00,492522,McTague; Sarah,16,0,25,9
1713328177194,USP 100,A00,492523,Staff,32,0,35,3
1713328178220,USP 101,A00,492524,Staff,13,0,15,2
1713328179248,USP 105,A00,492525,Staff,21,0,25,4
1713328180272,USP 151,A00,492526,Shenkman; Michael Thomas,32,0,35,3
1713328181296,USP 170,A00,492545,Hinds; Juli Beth,33,0,35,2
1713328182325,USP 171GS,A00,492608,Bussell; Mirle Rabinowitz,24,0,28,4
1713328183353,USP 183GS,A00,492613,Peerson; Susan,24,0,28,4
1713328184384,VIS 30,A01,490693,Yoldas; Pinar,19,0,22,3
1713328184384,VIS 30,A02,490694,Yoldas; Pinar,18,0,22,4
1713328185410,VIS 83,A00,490695,Kester; Grant,63,0,75,12
1713328186436,VIS 105D,A00,490696,Staff,22,0,25,3
1713328187466,VIS 124CN,A00,490699,Rose; Jordan M,65,0,75,10
1713328188491,VIS 125GS,A00,511221,Williams; Alena J,21,0,22,1
1713328189516,VIS 128D,A00,490700,Staff,73,0,75,2
1713328190545,VIS 151,A01,490717,Staff,33,0,34,1
1713328190545,VIS 151,A02,490766,Staff,33,0,34,1
1713328191570,VIS 154GS,A00,511972,Williams; Alena J,21,0,22,1
1713328192595,VIS 160A,A00,490767,Stone; Patricia,7,0,10,3
1713328193626,WCWP 10A,A00,490638,Staff,14,0,15,1
1713328193626,WCWP 10A,B00,490640,Staff,15,0,15,0
1713328194653,WCWP 10B,A00,490641,Staff,0,0,0,0
1713328194653,WCWP 10B,B00,490642,Staff,14,0,15,1
1713328194653,WCWP 10B,C00,490644,Staff,13,0,15,2
1713328194653,WCWP 10B,D00,490647,Staff,0,0,0,0
1713328195681,WCWP 100,A00,490655,Staff,0,0,0,0
1713328195681,WCWP 100,B00,490687,Staff,10,0,15,5
1713328197814,ANAR 153,A00,487222,Braswell; Geoffrey E.,54,0,60,6
1713328198840,ANBI 134,A00,487223,Staff,6,0,20,14
1713328199870,ANBI 143GS,A00,487224,Noel; Geoffroy Pierre Jean,18,0,24,6
1713328200897,ANBI 144GS,A00,519548,Noel; Geoffroy Pierre Jean,18,0,24,6
1713328201922,ANSC 101,A00,487225,Staff,18,0,20,2
1713328202948,ANSC 125,A00,487227,Brenner; Suzanne A,39,0,40,1
1713328204999,ANSC 146,A00,487229,Staff,35,0,40,5
1713328206025,ANSC 148,A00,487230,Olivas Hernandez; Olga Lid,39,0,40,1
1713328207051,ANSC 150,A00,504165,Sloane; Julia Kathryn,18,0,20,2
1713328208081,ANSC 180,A00,487232,Staff,14,0,15,1
1713328209107,ANSC 188,A00,627155,Staff,39,0,40,1
1713328210137,ANTH 5,A00,519529,Semendeferi; Ekaterini,15,0,15,0
1713328211162,ANTH 10,A00,487219,Staff,58,0,60,2
1713328212190,ANTH 23,A01,487221,Staff,17,0,20,3
1713328213215,ANTH 102,A00,487233,Wilder; Linnea Lorene,51,0,60,9
1713328214241,ANTH 103,A00,487234,Varma; Saiba,55,0,60,5
1713328215266,ANTH 105,A00,487235,Stewart; Alexander B,54,0,60,6
1713328216293,BENG 100,A01,516685,Taylor Amos; Alyssa C,27,0,30,3
1713328217324,BIBC 102,A01,491316,Flagg; Matthew Paul,14,0,88,74
1713328217324,BIBC 102,A02,491366,Flagg; Matthew Paul,78,0,88,10
1713328218350,BIBC 103,A01,491486,Boumechache; Miyyada,16,0,24,8
1713328218350,BIBC 103,A02,491487,Boumechache; Miyyada,24,0,24,0
1713328219381,BICD 100,A01,516882,Staff,73,0,75,2
1713328219381,BICD 100,A02,516890,Staff,69,0,75,6
1713328220461,BICD 102GS,A00,491488,Lo; Stanley M.,26,0,28,2
1713328221486,BIEB 136GS,A00,516940,Holway; David A. & Shurin; Jonathan,18,0,24,6
1713328222510,BIEB 137GS,A01,517034,Holway; David A. & Shurin; Jonathan,18,0,24,6
1713328223535,BIEB 138GS,A01,491492,Pirino; Giorgia,21,0,28,7
1713328224566,BILD 1,A01,491296,Staff,60,0,63,3
1713328224566,BILD 1,A02,491297,Staff,63,0,63,0
1713328225592,BILD 4,A01,517099,Gonzalez Gamboa; Ivonne,22,0,24,2
1713328225592,BILD 4,A02,517100,Gonzalez Gamboa; Ivonne,24,0,24,0
1713328226622,BILD 60GS,A00,491309,Lo; Stanley M.,26,0,28,2
1713328227652,BIMM 100,A01,517136,Staff,84,0,100,16
1713328228676,BIMM 110,A01,517182,Staff,55,0,100,45
1713328229700,BIMM 120,A01,517228,Pickett; Brooke Elizabeth,29,0,63,34
1713328229700,BIMM 120,A02,517240,Pickett; Brooke Elizabeth,44,0,63,19
1713328230727,BIMM 132GS,A01,491498,Pirino; Giorgia,21,0,28,7
1713328231754,BIMM 143,A01,491589,Bozinovic; Goran,13,0,40,27
1713328232780,BIPN 100,A01,491594,Armour; Jon Christopher,85,0,100,15
1713328233809,BIPN 140,A01,491602,Marino; Marc J,26,0,50,24
1713328235862,CAT 125,A00,515973,Staff,18,0,20,2
1713328236890,CAT 125GS,A00,515974,Rahimi; Babak,17,0,20,3
1713328237916,CAT 125R,A00,515980,Staff,12,0,20,8
1713328237916,CAT 125R,B00,515981,Tosun; Adriana,19,0,20,1
1713328237916,CAT 125R,C00,515987,Hyland; Tina Mae,0,2,20,20
1713328237916,CAT 125R,D00,515988,Bronstein; Phoebe Malan,16,0,20,4
1713328238949,CENG 15,A01,488699,Drews; Aaron,25,0,25,0
1713328239972,CENG 100,A00,505196,Opatkiewicz; Justin Paul,25,0,25,0
1713328241000,CGS 2A,A01,489598,Staff,33,0,35,2
1713328242027,CGS 112,A00,489599,Staff,15,0,15,0
1713328243050,CGS 119,A00,489603,Staff,10,0,10,0
1713328244081,CGS 120,A00,489604,Staff,14,0,15,1
1713328245106,CGS 150,A00,489607,Staff,15,0,15,0
1713328246135,CHEM 6A,A01,488715,Staff,98,0,100,2
1713328247161,CHEM 6B,A01,488719,Piercy; Marc Anthony,99,0,100,1
1713328248186,CHEM 6C,A01,488723,Albizati; Kim F.,93,0,100,7
1713328249214,CHEM 7L,A01,488728,Schurmeier; Kimberly,18,0,24,6
1713328249214,CHEM 7L,A02,488730,Schurmeier; Kimberly,23,0,24,1
1713328249214,CHEM 7L,A03,488734,Schurmeier; Kimberly,20,0,24,4
1713328249214,CHEM 7L,A04,488763,Schurmeier; Kimberly,23,0,24,1
1713328249214,CHEM 7L,B01,488798,Schurmeier; Kimberly,17,0,24,7
1713328249214,CHEM 7L,B02,488801,Schurmeier; Kimberly,22,0,24,2
1713328249214,CHEM 7L,B03,488808,Schurmeier; Kimberly,23,0,24,1
1713328249214,CHEM 7L,B04,488811,Schurmeier; Kimberly,24,0,24,0
1713328250239,CHEM 11,A01,488897,Stallings; Dontarie M,95,0,100,5
1713328251266,CHEM 40A,A01,488913,Albizati; Kim F.,84,0,100,16
1713328252292,CHEM 40B,A01,488920,Weizman; Haim,43,0,50,7
1713328252292,CHEM 40B,A02,488938,Weizman; Haim,45,0,50,5
1713328253319,CHEM 41A,A01,489029,Klosterman; Jeremy K,57,0,60,3
1713328254344,CHEM 41C,A01,500436,Tor; Yitzhak,55,0,60,5
1713328255371,CHEM 43A,A01,500426,Weizman; Haim,0,0,24,24
1713328255371,CHEM 43A,A02,500430,Weizman; Haim,8,0,24,16
1713328255371,CHEM 43A,B01,514041,Klosterman; Jeremy K,16,0,24,8
1713328255371,CHEM 43A,B02,514047,Klosterman; Jeremy K,23,0,24,1
1713328256398,CHEM 108,A01,489140,Jennings; Patricia A.,9,0,24,15
1713328256398,CHEM 108,A02,489142,Jennings; Patricia A.,14,0,24,10
1713328257424,CHEM 114A,A01,489147,Stallings; Dontarie M,68,0,100,32
1713328258455,CHIN 169A,A00,489171,Wang; Xiao,19,0,20,1
1713328260511,COGS 3,A01,518827,Boyle; Mary E. T.,26,0,40,14
1713328261537,COGS 11,A01,489175,Staff,27,0,30,3
1713328262563,COGS 14A,A01,518829,Staff,51,0,60,9
1713328263591,COGS 14B,A01,489177,Hoffman; Drew Ellen,63,0,75,12
1713328264617,COGS 100,A01,489181,Allen; Michael Gordon,63,0,75,12
1713328265644,COGS 101A,A01,489183,Staff,46,0,60,14
1713328266672,COGS 101B,A01,489185,Allen; Michael Gordon,8,0,30,22
1713328267705,COGS 101C,A01,526786,Staff,23,0,30,7
1713328269755,COGS 107A,A01,489189,Boyle; Mary E. T.,18,0,35,17
1713328270782,COGS 107B,A01,627144,Mooshagian; Eric Frederick,60,0,60,0
1713328271805,COGS 118A,A01,489191,Staff,0,44,40,40
1713328273859,COGS 171GS,A01,489194,Pineda; Jaime A,20,0,28,8
1713328274886,COGS 172,A01,489196,Staff,3,0,30,27
1713328275913,COGS 174GS,A01,489264,Pineda; Jaime A,20,0,28,8
1713328276940,COGS 180,A01,627150,Staff,28,0,30,2
1713328277966,COGS 186,A01,489274,Staff,0,1,30,30
1713328278990,COMM 10,A01,489276,Staff,23,0,25,2
1713328278990,COMM 10,A02,489303,Staff,23,0,25,2
1713328280021,COMM 100A,A01,489312,Staff,14,0,25,11
1713328280021,COMM 100A,A02,489313,Staff,24,0,25,1
1713328281050,COMM 106T,A00,512540,Staff,33,0,35,2
1713328282073,COMM 107,A00,489347,Staff,27,0,35,8
1713328283102,COMM 109P,A00,489358,Staff,31,0,35,4
1713328284129,COMM 132,A00,489361,McKenna; Denise,27,0,30,3
1713328285154,COMM 146,A00,489362,Halm; Gavin Patrick,26,0,30,4
1713328286179,COMM 190,A00,489363,Abuelhiga; Soraya Jill,17,0,23,6
1713328287214,CSE 8A,A50,489366,Staff,21,0,25,4
1713328287214,CSE 8A,A51,489367,Staff,24,0,25,1
1713328288238,CSE 11,A01,489398,Cao; Yingjun,74,0,100,26
1713328289270,CSE 12,A01,489487,Staff,43,0,50,7
1713328290299,CSE 20,A01,489497,Staff,48,0,50,2
1713328291326,CSE 21,A01,489517,Braun; Oliver,42,0,50,8
1713328292355,CSE 101,A01,489524,Braun; Oliver,0,29,50,50
1713328293381,CSE 105,A01,512594,Jones; Miles E,72,0,100,28
1713328293381,CSE 105,B01,512598,Jones; Miles E,52,0,100,48
1713328294414,CSE 140,A01,489538,Staff,41,0,50,9
1713328295442,CSE 141,A01,489550,Eldon; John,68,0,100,32
1713328296471,CSE 141L,A01,489571,Eldon; John,66,0,100,34
1713328297497,CSE 151A,A01,489583,Solares; Edwin A,141,0,200,59
1713328298523,CSE 175,A01,510886,Kumar; Rakesh,30,0,30,0
1713328299548,CSE 190,A00,516828,Dubnov; Shlomo,38,0,49,11
1713328300574,DOC 100D,A00,489667,Pass; Natalye Joann,19,0,25,6
1713328301607,DSC 10,A01,624268,Staff,72,0,75,3
1713328302635,DSC 20,A01,624476,Staff,50,0,50,0
1713328303661,DSC 40A,A01,624608,Staff,39,0,40,1
1713328304688,DSGN 1,A01,489179,Rill; Bryan,33,0,50,17
1713328305714,ECE 17,A01,490489,Sahay; Rajeev,18,0,30,12
1713328306738,ECE 65,A50,490492,Staff,12,0,20,8
1713328306738,ECE 65,A51,490493,Staff,18,0,20,2
1713328307765,ECON 1,A01,489715,Famulari; Melissa,68,0,70,2
1713328308791,ECON 2,A01,489717,Levkoff; Steven B.,68,0,70,2
1713328309818,ECON 3,A01,489948,Staff,70,0,70,0
1713328311873,ECON 5,A01,490103,Staff,27,0,30,3
1713328311873,ECON 5,B01,626281,Dai; Yinlin,45,0,45,0
1713328312898,ECON 100A,A01,490127,Famulari; Melissa,65,0,70,5
1713328313923,ECON 100B,A01,490129,Staff,64,0,70,6
1713328314952,ECON 109,A01,490187,Shishkin; Denis,27,0,35,8
1713328315979,ECON 110A,A01,490190,Levkoff; Steven B.,60,0,70,10
1713328317005,ECON 120A,A01,490245,Dai; Yinlin,61,0,70,9
1713328318038,ECON 120B,A01,490247,Nieto-Barthaburu; Augusto,42,0,70,28
1713328319071,ECON 120C,A01,490253,Sun; Yixiao,30,0,35,5
1713328319071,ECON 120C,B01,490255,Sun; Yixiao,34,0,35,1
1713328320097,ECON 129,A00,490256,Eckert; Fabian Paul,23,0,35,12
1713328321122,ECON 131,A00,490257,Nieto-Barthaburu; Augusto,0,6,35,35
1713328322154,ECON 138,A00,490258,Bharadwaj; Prashant,13,0,35,22
1713328322154,ECON 138,B00,490259,Bharadwaj; Prashant,15,0,35,20
1713328323185,ECON 159,A00,490260,Hendrickson; Gerald M.,0,9,0,0
1713328324274,ECON 178,A01,553995,Zhu; Ying,24,0,35,11
1713328325302,EDS 40,A01,512576,Black; Alison Michelle,20,0,20,0
1713328326329,EDS 107,A01,515848,Staff,30,0,30,0
1713328327355,EDS 110R,A01,490262,Staff,26,0,30,4
1713328328385,EDS 112,A01,490264,Chapman; Thandeka K,40,0,50,10
1713328329412,EDS 113,A00,490266,Staff,26,0,30,4
1713328330437,EDS 118,A00,490267,Warstadt; Melissa Fawn,20,0,30,10
1713328331462,EDS 124BR,A00,490268,Eguchi; Emi,4,0,25,21
1713328331462,EDS 124BR,B00,490269,Eguchi; Emi,23,0,25,2
1713328332485,EDS 126,A01,490271,Jones; Makeba,43,0,50,7
1713328333510,EDS 135,A01,490316,Staff,19,0,20,1
1713328334540,ENVR 142GS,A00,519514,Chang; Edmond Yi-Teh,27,0,28,1
1713328335569,ETHN 103,A00,490504,Staff,25,0,36,11
1713328336598,ETHN 103A,A00,490505,Man; Simeon S,4,0,9,5
1713328337627,ETHN 109,A00,490506,Staff,28,0,30,2
1713328338654,ETHN 118,A00,490507,Staff,35,0,36,1
1713328339680,ETHN 119,A00,490508,Staff,33,0,36,3
1713328340706,ETHN 121R,A00,490518,Choi; Esther Min,21,0,36,15
1713328341734,ETHN 127,A00,490528,Staff,14,0,15,1
1713328342762,ETHN 139,A00,490573,Staff,10,0,10,0
1713328343792,ETHN 150,A00,490575,Staff,15,0,15,0
1713328344822,GLBH 20,A00,491705,Elwardani; Nile Regina,38,0,40,2
1713328345849,GLBH 101,A00,491706,Staff,20,0,20,0
1713328346873,GLBH 111,A01,491708,Burgos; Jose L.,15,0,15,0
1713328347898,GLBH 146,A00,491709,Staff,9,0,20,11
1713328348924,GLBH 148,A00,491710,Olivas Hernandez; Olga Lid,11,0,20,9
1713328349955,GLBH 150,A00,491711,Sloane; Julia Kathryn,19,0,20,1
1713328350985,HIEA 131,A00,491760,Staff,28,0,32,4
1713328352011,HIEA 153,A00,491762,Staff,28,0,30,2
1713328353037,HIEU 124,A00,491811,Staff,26,0,32,6
1713328354067,HIEU 124GS,A00,491812,Markman; Kristina,27,0,28,1
1713328355096,HIEU 147,A00,491813,Staff,30,0,32,2
1713328356124,HIEU 149GS,A00,491816,Caldwell; Michael Alan,28,0,28,0
1713328357150,HILD 2C,A01,491713,Hendrickson; Gerald M.,26,0,30,4
1713328358180,HILD 7B,A01,491715,Kwak; Nancy,0,2,30,30
1713328359204,HILD 10,A01,491717,Staff,11,0,20,9
1713328360230,HILD 30GS,A00,491719,Edington; Claire Ellen,24,0,28,4
1713328361255,HINE 109,A00,491818,Shafir; Nir,27,0,32,5
1713328362279,HINE 128,A00,491821,Shafir; Nir,31,0,32,1
1713328363307,HISC 117,A00,491830,Staff,27,0,32,5
1713328364338,HIUS 103,A00,491834,Man; Simeon S,14,0,23,9
1713328365364,HIUS 108B,A00,491835,Staff,28,0,30,2
1713328366394,HIUS 141,A00,491836,Hendrickson; Gerald M.,28,0,32,4
1713328367420,HIUS 149,A00,491839,Staff,24,0,32,8
1713328368450,HUM 3,A01,512617,Crum; Matthew Stephen,43,0,50,7
1713328368450,HUM 3,A02,512618,Crum; Matthew Stephen,48,0,50,2
1713328369474,HUM 3GS,A00,512663,Markman; Kristina,0,0,0,1
1713328369474,HUM 3GS,B00,512664,Staff,0,0,0,0
1713328370503,HUM 4,A01,512620,West; Geoffrey Scott,26,0,50,24
1713328371532,HUM 4GS,A00,512666,Lyon; Antony J.,0,0,0,4
1713328372563,HUM 4R,A01,512625,Watkins; Eric,49,0,50,1
1713328373589,HUM 5,A01,512649,Zavodny; Tatiana Sophia,23,0,50,27
1713328373589,HUM 5,B01,512661,Zroka; Ryan Edward,48,0,50,2
1713328374615,INTL 190,A00,490577,Segui; Alan S,0,0,0,5
1713328375640,JAPN 20AR,A01,491267,Ross; Kayoko F,8,0,20,12
1713328376670,JAPN 180,A00,491285,Berman; Michael David,33,0,40,7
1713328377696,LATI 50,A01,502536,Kokinis; Troy Andreas,16,0,22,6
1713328377696,LATI 50,A02,502551,Kokinis; Troy Andreas,22,0,22,0
1713328377696,LATI 50,A03,502650,Kokinis; Troy Andreas,22,0,22,0
1713328377696,LATI 50,A04,502909,Kokinis; Troy Andreas,21,0,22,1
1713328378723,LATI 160,A01,502920,Kokinis; Troy Andreas,30,0,30,0
1713328379750,LIFR 1A,A00,490494,Van Moer; Vinciane G,17,0,20,3
1713328380774,LIFR 1AX,A00,490495,Van Moer; Vinciane G,17,0,20,3
1713328381801,LIFR 1B,A00,490496,Van Moer; Vinciane G,18,0,20,2
1713328382829,LIFR 1BX,A00,490497,Van Moer; Vinciane G,18,0,20,2
1713328383965,LIGN 8,A00,505198,McIntosh; Justin Daniel,134,0,150,16
1713328384991,LIGN 9GS,A00,491239,Lott; Margaret S.,18,0,20,2
1713328386016,LIGN 101,A01,505200,McIntosh; Justin Daniel,22,0,30,8
1713328387043,LIGN 120,A01,491244,Staff,23,0,30,7
1713328388076,LIGN 149GS,A00,491245,Lott; Margaret S.,18,0,20,2
1713328389101,LIGN 170,A00,491247,Staff,22,0,30,8
1713328390125,LISP 1D,A00,490498,Munoz Sanchez; Alicia,9,0,14,5
1713328390125,LISP 1D,B00,490499,Munoz Sanchez; Alicia,6,0,14,8
1713328390125,LISP 1D,C00,490500,Munoz Sanchez; Alicia,7,0,14,7
1713328390125,LISP 1D,D00,490501,Munoz Sanchez; Alicia,10,0,14,4
1713328391150,LISP 1DX,A00,490502,Munoz Sanchez; Alicia,14,0,28,14
1713328391150,LISP 1DX,B00,490503,Munoz Sanchez; Alicia,16,0,28,12
1713328393206,LTAM 110,A00,491847,Staff,22,0,25,3
1713328394230,LTCS 119,A00,491848,Staff,11,0,15,4
1713328395255,LTCS 130,A00,491849,Staff,24,0,25,1
1713328397311,LTEA 120C,A00,491852,Staff,32,0,40,8
1713328398336,LTEN 130GS,A00,491853,Lyon; Antony J.,24,0,28,4
1713328399361,LTEN 148,A00,491855,Staff,23,0,25,2
1713328400387,LTEN 159,A00,491856,Staff,20,0,25,5
1713328401413,LTEN 180,A00,491857,Staff,8,0,15,7
1713328403465,LTSP 123GS,A00,505928,Bessett; Ryan Matthew,24,0,28,4
1713328404490,LTSP 174GS,A00,506037,Bessett; Ryan Matthew,24,0,28,4
1713328406540,LTWR 102,A00,491861,Staff,9,0,15,6
1713328407566,LTWR 106,A00,491862,Staff,8,0,15,7
1713328408592,MAE 11,A00,490930,Bahadori; Mohammad Yousef,95,0,100,5
1713328409621,MAE 30A,A00,490931,Qi; Huihui,37,0,40,3
1713328410647,MAE 101A,A00,491036,Sadeghizadeh; Zahra,92,0,100,8
1713328411674,MAE 101C,A00,491037,Seshadri; Kalyanasundaram,67,0,100,33
1713328412698,MAE 113,A00,491040,Seshadri; Kalyanasundaram,66,0,80,14
1713328413725,MAE 131A,A00,491041,Ghazinejad; Maziar,37,0,40,3
1713328414750,MAE 142,A00,491053,Staff,39,0,40,1
1713328415776,MAE 143A,A00,491054,Staff,33,0,50,17
1713328416802,MAE 150,A00,491092,Truong; Phuong Thi Ngoc,23,0,35,12
1713328417826,MATH 3C,A01,494031,Pardo Guerra; Sebastian,30,0,30,0
1713328417826,MATH 3C,A02,494032,Pardo Guerra; Sebastian,29,0,30,1
1713328418852,MATH 10A,A01,494034,Staff,27,0,30,3
1713328418852,MATH 10A,A02,494035,Staff,28,0,30,2
1713328418852,MATH 10A,B01,494037,Staff,27,0,30,3
1713328418852,MATH 10A,B02,494038,Staff,29,0,30,1
1713328419879,MATH 10B,A01,494040,Habib; Yousaf,22,0,30,8
1713328419879,MATH 10B,A02,494041,Habib; Yousaf,28,0,30,2
1713328419879,MATH 10B,A03,494042,Habib; Yousaf,29,0,30,1
1713328419879,MATH 10B,A04,494043,Habib; Yousaf,30,0,30,0
1713328419879,MATH 10B,B01,494045,Habib; Yousaf,25,0,30,5
1713328419879,MATH 10B,B02,494046,Habib; Yousaf,30,0,30,0
1713328419879,MATH 10B,B03,494047,Habib; Yousaf,30,0,30,0
1713328419879,MATH 10B,B04,494048,Habib; Yousaf,30,0,30,0
1713328420909,MATH 18,A01,494050,Kemp; Todd Aahron,25,0,30,5
1713328420909,MATH 18,A02,494051,Kemp; Todd Aahron,29,0,30,1
1713328420909,MATH 18,B01,494054,Kemp; Todd Aahron,26,0,30,4
1713328420909,MATH 18,B02,494055,Kemp; Todd Aahron,29,0,30,1
1713328421934,MATH 20A,A01,494059,Suk; Andrew Hoon,30,0,30,0
1713328422959,MATH 20B,A01,494061,Briones; Jor-el Thomas Caparas,33,0,35,2
1713328422959,MATH 20B,B01,494063,Bach; Quang Tran,34,0,35,1
1713328423987,MATH 20C,A01,494065,Staff,28,0,30,2
1713328423987,MATH 20C,A02,494066,Staff,30,0,30,0
1713328423987,MATH 20C,A03,494067,Staff,30,0,30,0
1713328423987,MATH 20C,A04,494068,Staff,30,0,30,0
1713328423987,MATH 20C,B01,494070,Zhang; Ming,25,0,30,5
1713328423987,MATH 20C,B02,494071,Zhang; Ming,27,0,30,3
1713328423987,MATH 20C,B03,494072,Zhang; Ming,29,0,30,1
1713328423987,MATH 20C,B04,494073,Zhang; Ming,29,0,30,1
1713328425015,MATH 20D,A01,494075,Staff,22,0,30,8
1713328425015,MATH 20D,A02,494076,Staff,29,0,30,1
1713328426041,MATH 20E,A01,494079,Staff,24,0,30,6
1713328426041,MATH 20E,A02,494080,Staff,26,0,30,4
1713328426041,MATH 20E,B01,494082,Staff,25,0,30,5
1713328426041,MATH 20E,B02,494083,Staff,25,0,30,5
1713328427068,MATH 103A,A01,494085,Aliabadi Sr.; Mohsen,14,0,30,16
1713328427068,MATH 103A,A02,494086,Aliabadi Sr.; Mohsen,28,0,30,2
1713328427068,MATH 103A,B01,494088,Aliabadi Sr.; Mohsen,21,0,30,9
1713328427068,MATH 103A,B02,494089,Aliabadi Sr.; Mohsen,27,0,30,3
1713328428154,MATH 109,A01,494091,Staff,30,0,30,0
1713328428154,MATH 109,A02,494092,Staff,29,0,30,1
1713328428154,MATH 109,B01,494094,Staff,27,0,30,3
1713328428154,MATH 109,B02,494095,Staff,29,0,30,1
1713328429182,MATH 142A,A01,494097,Chow; Bennett,15,0,30,15
1713328429182,MATH 142A,A02,494098,Chow; Bennett,23,0,30,7
1713328429182,MATH 142A,B01,494100,Chow; Bennett,19,0,30,11
1713328429182,MATH 142A,B02,494101,Chow; Bennett,29,0,30,1
1713328431236,MATH 168A,A01,516677,Dumitriu; Ioana,16,0,35,19
1713328432264,MATH 170A,A01,516679,Dumitriu; Ioana,18,0,30,12
1713328432264,MATH 170A,A02,516680,Dumitriu; Ioana,28,0,30,2
1713328433291,MATH 193A,A01,494107,Staff,14,0,30,16
1713328433291,MATH 193A,A02,494108,Staff,20,0,30,10
1713328433291,MATH 193A,A03,494109,Staff,29,0,30,1
1713328433291,MATH 193A,A04,494110,Staff,22,0,30,8
1713328436369,MGT 16,A00,491930,McKay; Michael J,92,0,98,6
1713328437397,MGT 18,A00,491992,McKay; Michael J,96,0,98,2
1713328438423,MGT 71,A00,492003,Staff,66,0,98,32
1713328439451,MGT 103,A00,505209,Eberhard; Craig A,81,0,98,17
1713328440476,MGT 131A,A00,505210,Anderson; John Charles,89,0,98,9
1713328442527,MGT 153,A00,492077,Perols; Johan Lars,19,0,90,71
1713328445612,MGT 164,A00,492222,McKay; Mary A,91,0,98,7
1713328446638,MGT 172,A00,492245,Staff,59,0,60,1
1713328446638,MGT 172,B00,505526,Hedges; Kathleen,65,0,98,33
1713328447664,MGT 181,A00,505669,Dunn; Louis Jean,82,0,98,16
1713328448693,MMW 14,A01,494399,Staff,15,0,28,13
1713328448693,MMW 14,A02,494400,Staff,25,0,28,3
1713328448693,MMW 14,A03,494401,Staff,28,0,28,0
1713328448693,MMW 14,A04,494402,Staff,28,0,28,0
1713328448693,MMW 14,B01,494404,Carreras; Maria Victoria,8,0,28,20
1713328448693,MMW 14,B02,494405,Carreras; Maria Victoria,25,0,28,3
1713328448693,MMW 14,B03,494406,Carreras; Maria Victoria,27,0,28,1
1713328448693,MMW 14,B04,494407,Carreras; Maria Victoria,28,0,28,0
1713328449722,MMW 14GS,A00,506250,Chang; Edmond Yi-Teh,0,0,0,0
1713328450747,MMW 121R,A01,494415,Adamiak; Patrick John,10,0,28,18
1713328450747,MMW 121R,A02,494416,Adamiak; Patrick John,24,0,28,4
1713328451774,MUS 1A,A01,494113,Staff,12,0,25,13
1713328451774,MUS 1A,A02,494114,Staff,24,0,25,1
1713328452800,MUS 4,A01,494116,Staff,23,0,25,2
1713328452800,MUS 4,A02,494117,Staff,22,0,25,3
1713328453830,MUS 5R,A01,494236,Dubnov; Shlomo,6,0,25,19
1713328453830,MUS 5R,A02,494237,Dubnov; Shlomo,25,0,25,0
1713328454856,MUS 6,A01,494122,Staff,10,0,25,15
1713328454856,MUS 6,A02,494123,Staff,23,0,25,2
1713328455885,MUS 7,A01,494125,Staff,16,0,25,9
1713328455885,MUS 7,A02,494126,Staff,24,0,25,1
1713328456910,MUS 11,A01,494128,Staff,23,0,25,2
1713328456910,MUS 11,A02,494129,Staff,24,0,25,1
1713328457937,MUS 13,A01,494131,Staff,25,0,25,0
1713328457937,MUS 13,A02,494132,Staff,25,0,25,0
1713328458965,MUS 15,A01,494134,Staff,17,0,25,8
1713328458965,MUS 15,A02,494135,Staff,25,0,25,0
1713328458965,MUS 15,B01,494137,Staff,24,0,25,1
1713328459992,MUS 80,A00,494232,Staff,24,0,25,1
1713328459992,MUS 80,B00,494233,Staff,25,0,25,0
1713328459992,MUS 80,C00,494234,Staff,23,0,25,2
1713328461020,MUS 95C,A00,494141,Staff,70,0,75,5
1713328462048,MUS 114,A00,494142,Staff,40,0,50,10
1713328463072,NANO 15,A01,490636,Drews; Aaron,7,0,7,0
1713328464099,PHIL 1,A00,490578,Grush; Rick Scott,49,0,50,1
1713328465128,PHIL 10,A01,490580,Grush; Rick Scott,33,0,35,2
1713328465128,PHIL 10,A02,490586,Grush; Rick Scott,32,0,35,3
1713328466154,PHIL 27,A01,490591,Staff,22,0,25,3
1713328466154,PHIL 27,A02,490592,Staff,25,0,25,0
1713328466154,PHIL 27,A03,490593,Staff,25,0,25,0
1713328466154,PHIL 27,A04,490598,Staff,25,0,25,0
1713328467181,PHIL 32,A01,490611,Staff,20,0,20,0
1713328467181,PHIL 32,A02,490618,Staff,20,0,20,0
1713328468206,PHIL 90,A00,490624,Staff,40,0,40,0
1713328469230,PHIL 136,A00,490627,Cohen; Jonathan David,37,0,40,3
1713328470256,PHIL 155,A00,490634,Staff,62,0,70,8
1713328471280,PHYS 1A,A00,491610,Staff,245,0,250,5
1713328472305,PHYS 1AL,001,491616,Tsai; Philbert S,27,0,30,3
1713328472305,PHYS 1AL,002,491618,Tsai; Philbert S,30,0,30,0
1713328473328,PHYS 1B,A00,491623,Staff,236,0,250,14
1713328474357,PHYS 1BL,001,491626,Tsai; Philbert S,22,0,30,8
1713328474357,PHYS 1BL,002,491628,Tsai; Philbert S,26,0,30,4
1713328475382,PHYS 1C,A00,491632,Staff,214,0,245,31
1713328476405,PHYS 1CL,001,491635,Tsai; Philbert S,2,0,30,28
1713328476405,PHYS 1CL,002,491643,Tsai; Philbert S,22,0,30,8
1713328477437,PHYS 2AR,A01,491651,Meyertholen; Andrew D.,44,0,50,6
1713328478467,PHYS 2B,A01,491659,Staff,106,0,115,9
1713328479491,PHYS 2BL,A01,491685,Staff,21,0,24,3
1713328479491,PHYS 2BL,A02,491700,Staff,21,0,24,3
1713328480518,PHYS 2C,A01,505161,Staff,102,0,115,13
1713328481549,PHYS 4A,A01,491704,Grinstein; Benjamin,99,0,100,1
1713328482581,POLI 5D,A01,494144,Staff,3,0,5,2
1713328482581,POLI 5D,B01,626283,Dai; Yinlin,5,0,5,0
1713328483606,POLI 12,A00,494145,Staff,43,0,45,2
1713328484634,POLI 13R,A00,494146,Forman; Fonna,45,0,50,5
1713328485664,POLI 27,A01,494148,Staff,54,0,60,6
1713328486689,POLI 30,A00,494149,Staff,49,0,50,1
1713328487718,POLI 100DA,A00,494150,Staff,21,0,25,4
1713328489771,POLI 100I,A00,494152,Staff,27,0,30,3
1713328490802,POLI 104B,A00,494153,Smith; Glenn Chatmas,53,0,55,2
1713328491828,POLI 104F,A00,494154,Staff,28,0,30,2
1713328492854,POLI 104I,A00,494155,Smith; Glenn Chatmas,29,0,30,1
1713328493884,POLI 110C,A00,494156,Ingham; Sean,23,0,25,2
1713328494910,POLI 117R,A00,494157,Forman; Fonna,8,0,20,12
1713328495938,POLI 118,A00,494158,Ingham; Sean,21,0,25,4
1713328496967,POLI 120H,A00,494159,Fisk; David Lee,39,0,45,6
1713328497994,POLI 131CR,A00,494160,Hoston; Germaine,35,0,45,10
1713328499018,POLI 133J,A00,494161,Staff,32,0,35,3
1713328500043,POLI 135,A00,494162,Fisk; David Lee,33,0,35,2
1713328501071,POLI 140A,A00,494164,Staff,19,0,30,11
1713328502101,POLI 142I,A00,494165,Staff,30,0,30,0
1713328503125,POLI 144D,A00,494166,Staff,23,0,25,2
1713328504151,POLI 151,A00,494167,Staff,30,0,30,0
1713328505177,POLI 153,A00,494168,Staff,33,0,35,2
1713328506207,POLI 160AA,A00,494169,Staff,34,0,40,6
1713328507237,POLI 162,A00,494170,Mignozzetti; Umberto,19,0,25,6
1713328508262,POLI 171,A00,494171,Mignozzetti; Umberto,19,0,25,6
1713328509287,PSYC 1,A00,494172,Staff,96,0,100,4
1713328510313,PSYC 2,A00,494173,Moranton; Nirelia Melbina-,34,0,50,16
1713328511337,PSYC 3,A00,494174,Staff,29,0,30,1
1713328512363,PSYC 6,A00,494175,Staff,17,0,20,3
1713328513388,PSYC 60,A01,494177,Staff,38,0,45,7
1713328514418,PSYC 70,A01,505724,Geller; Emma Harlan,42,0,45,3
1713328515444,PSYC 101,A00,494180,Heyman; Gail D.,84,0,100,16
1713328516470,PSYC 105,A00,494181,Geller; Emma Harlan,51,0,90,39
1713328517502,PSYC 106,A00,494182,Dobkins; Karen R.,27,0,45,18
1713328518527,PSYC 108,A00,494183,Adrian; Julia Anna,89,0,100,11
1713328519557,PSYC 114,A01,494185,Winkielman; Piotr,0,2,30,30
1713328520582,PSYC 122,A00,494186,Moranton; Nirelia Melbina-,29,0,50,21
1713328521611,PSYC 124,A00,494187,Chapman; Eddie Nathaniel,71,0,80,9
1713328522636,PSYC 131,A00,494188,Anagnostaras; Stephan,42,0,80,38
1713328523659,PSYC 144,A00,494189,Staff,5,0,50,45
1713328524819,PSYC 154,A00,494190,Lacefield; Katharine I,107,0,180,73
1713328525849,PSYC 162,A00,494191,Wixted; John T,71,0,100,29
1713328526875,PSYC 172,A00,494192,Gorman; Michael R.,36,0,45,9
1713328527900,PSYC 178,A00,494193,Glaser; Dale,34,0,45,11
1713328528927,PSYC 193,A00,505725,Chapman; Eddie Nathaniel,20,0,20,0
1713328529953,RELI 145GS,A00,519817,Rahimi; Babak,18,0,20,2
1713328530983,SE 101A,A01,490862,Chadha; Mayank,23,0,25,2
1713328532064,SE 101C,A01,490924,Krysl; Petr,15,0,20,5
1713328533093,SE 110A,A01,490928,Staff,19,0,20,1
1713328534125,SE 130A,A00,490929,Morrison; Machel Leigh,55,0,70,15
1713328535152,SIO 1,A01,519325,Staff,39,0,40,1
1713328536180,SIO 30,A01,519327,Staff,38,0,40,2
1713328537205,SIO 40,A00,519328,Staff,39,0,40,1
1713328538233,SIO 46GS,A00,519819,Cook; Geoffrey W,17,0,25,8
1713328539260,SIO 109R,A00,494197,Forman; Fonna,0,3,20,20
1713328540288,SIO 121GS,A00,519827,Cook; Geoffrey W,17,0,25,8
1713328541314,SIO 132,A01,519330,Staff,38,0,40,2
1713328542340,SIO 133,A01,519397,Staff,37,0,40,3
1713328543364,SIO 139,A00,519396,Kacev; David,29,0,40,11
1713328544392,SOCI 1,A01,494199,Thorpe; Charles Robert,21,0,30,9
1713328544392,SOCI 1,A02,494200,Thorpe; Charles Robert,30,0,30,0
1713328544392,SOCI 1,A03,494201,Thorpe; Charles Robert,29,0,30,1
1713328544392,SOCI 1,A04,494202,Thorpe; Charles Robert,29,0,30,1
1713328544392,SOCI 1,A05,494203,Thorpe; Charles Robert,29,0,30,1
1713328544392,SOCI 1,A06,494204,Thorpe; Charles Robert,30,0,30,0
1713328544392,SOCI 1,A07,494205,Thorpe; Charles Robert,28,0,30,2
1713328545415,SOCI 60,A01,494207,Staff,34,0,40,6
1713328545415,SOCI 60,A02,494208,Staff,39,0,40,1
1713328546441,SOCI 100,A01,494210,Payne; Christine Anna,25,0,30,5
1713328546441,SOCI 100,A02,494211,Payne; Christine Anna,26,0,30,4
1713328547465,SOCI 109M,A00,494212,Staff,20,0,20,0
1713328548492,SOCI 110,A00,494213,Staff,34,0,40,6
1713328550546,SOCI 118E,A00,494215,Ng; Kwai,37,0,40,3
1713328551572,SOCI 125,A00,494216,Calderon-Zaks; Michael Aar,40,0,45,5
1713328552600,SOCI 126,A01,494218,Jones; Makeba,3,0,5,2
1713328553625,SOCI 131,A00,494219,Thorpe; Charles Robert,26,0,30,4
1713328555676,SOCI 135,A00,494221,Payne; Christine Anna,28,0,50,22
1713328556706,SOCI 136E,A00,626690,Ruiz; Jonathan Joseph,24,0,25,1
1713328557734,SOCI 138GS,A00,494222,Navon; Daniel,24,0,28,4
1713328559787,SOCI 145,A00,494224,Staff,40,0,45,5
1713328560815,SOCI 153,A00,494225,Staff,28,0,30,2
1713328561843,SOCI 160E,A00,494226,Ng; Kwai,29,0,40,11
1713328562868,SOCI 180,A00,494227,Staff,29,0,30,1
1713328563907,SOCI 189GS,A00,494228,Ribas Norris; Janet Vanesa,11,0,11,0
1713328564937,SOCI 190GS,A00,553232,Ribas Norris; Janet Vanesa,11,0,11,0
1713328565963,SOMI 220,A00,627178,Schneid; Stephen David,30,0,30,0
1713328566996,SYN 2,001,490768,Staff,13,0,15,2
1713328566996,SYN 2,002,490769,Staff,14,0,15,1
1713328566996,SYN 2,004,490775,Staff,0,0,0,0
1713328566996,SYN 2,003,490774,Staff,0,0,0,0
1713328566996,SYN 2,005,490776,Staff,0,0,0,0
1713328568026,SYN 2R,001,490779,Staff,11,0,15,4
1713328568026,SYN 2R,002,514635,Staff,14,0,15,1
1713328569053,SYN 100,A01,490783,Staff,9,0,20,11
1713328569053,SYN 100,B01,490787,Staff,9,0,20,11
1713328569053,SYN 100,C01,490789,Staff,10,0,20,10
1713328570082,SYN 150,A00,490817,Staff,14,0,15,1
1713328570082,SYN 150,B00,514610,Staff,15,0,15,0
1713328571116,TDAC 1,A00,492753,Walsh; Kim C.,19,0,20,1
1713328571116,TDAC 1,B00,492754,Harting; Carla Kelso,19,0,20,1
1713328571116,TDAC 1,C00,513995,Salovey; Todd,15,0,20,5
1713328572149,TDAC 101,A00,492766,Harting; Carla Kelso,17,0,20,3
1713328573181,TDAC 102,A00,492768,Basso; Beatrice,19,0,20,1
1713328574212,TDDE 111,A00,492769,Staff,25,0,25,0
1713328575360,TDDE 131,A00,492770,Staff,15,0,15,0
1713328575360,TDDE 131,B00,492771,Staff,15,0,15,0
1713328576387,TDDE 131GS,A00,523716,Guirguis; Mark C,23,0,28,5
1713328577414,TDGE 1,A01,492756,Salovey; Todd,56,0,60,4
1713328578437,TDGE 5,A01,492758,Staff,23,0,25,2
1713328579467,TDGE 10,A00,492759,Fulton; Julia,203,0,220,17
1713328580493,TDGE 11,A00,492760,Castro; Robert Jess,198,0,200,2
1713328582542,TDGE 124,A00,492772,Fulton; Julia,185,0,220,35
1713328583568,TDGE 125,A00,492773,Meyer; Ursula,38,0,50,12
1713328583568,TDGE 125,B00,492774,Staff,49,0,50,1
1713328583568,TDGE 125,C00,523565,Staff,48,0,50,2
1713328584594,TDGE 125GS,A00,523580,Guirguis; Mark C,23,0,28,5
1713328585619,TDGE 127,A00,492775,Havis; Allan,34,0,50,16
1713328586645,TDHT 101,A00,492776,Staff,34,0,35,1
1713328587672,TDMV 1,A00,492762,Caligagan; Maria T.,30,0,30,0
1713328587672,TDMV 1,B00,492763,Arcidiacono; Kristin,26,0,30,4
1713328588698,TDMV 2,A00,492764,Weinberg; Sadie,28,0,30,2
1713328589723,TDMV 3,A00,492765,Mack; Kara Shanai',37,0,40,3
1713328590752,TDMV 138,A00,492777,Mack; Kara Shanai',34,0,40,6
1713328591778,TDMV 140,A00,492778,Lima; Paulo Henrique,40,0,40,0
1713328592809,TDMV 142,A00,492779,Caligagan; Maria T.,33,0,40,7
1713328592809,TDMV 142,B00,492780,Caligagan; Tony,37,0,40,3
1713328593838,TDMV 143,A00,492781,Fyall; Daunte Edward,39,0,40,1
1713328594864,USP 1,A01,492401,Kwak; Nancy,27,0,35,8
1713328595890,USP 2,A01,492453,Hinds; Juli Beth,35,0,35,0
1713328596914,USP 3,A01,492516,Staff,28,0,35,7
1713328597946,USP 4,A00,492522,McTague; Sarah,16,0,25,9
1713328598974,USP 100,A00,492523,Staff,32,0,35,3
1713328599998,USP 101,A00,492524,Staff,13,0,15,2
1713328601024,USP 105,A00,492525,Staff,21,0,25,4
1713328602054,USP 151,A00,492526,Shenkman; Michael Thomas,32,0,35,3
1713328603079,USP 170,A00,492545,Hinds; Juli Beth,33,0,35,2
1713328604105,USP 171GS,A00,492608,Bussell; Mirle Rabinowitz,24,0,28,4
1713328605135,USP 183GS,A00,492613,Peerson; Susan,24,0,28,4
1713328606162,VIS 30,A01,490693,Yoldas; Pinar,19,0,22,3
1713328606162,VIS 30,A02,490694,Yoldas; Pinar,18,0,22,4
1713328607192,VIS 83,A00,490695,Kester; Grant,63,0,75,12
1713328608221,VIS 105D,A00,490696,Staff,22,0,25,3
1713328609251,VIS 124CN,A00,490699,Rose; Jordan M,65,0,75,10
1713328610277,VIS 125GS,A00,511221,Williams; Alena J,21,0,22,1
1713328611303,VIS 128D,A00,490700,Staff,73,0,75,2
1713328612330,VIS 151,A01,490717,Staff,33,0,34,1
1713328612330,VIS 151,A02,490766,Staff,33,0,34,1
1713328613359,VIS 154GS,A00,511972,Williams; Alena J,21,0,22,1
1713328614386,VIS 160A,A00,490767,Stone; Patricia,7,0,10,3
1713328615415,WCWP 10A,A00,490638,Staff,14,0,15,1
1713328615415,WCWP 10A,B00,490640,Staff,15,0,15,0
1713328616441,WCWP 10B,A00,490641,Staff,0,0,0,0
1713328616441,WCWP 10B,B00,490642,Staff,14,0,15,1
1713328616441,WCWP 10B,C00,490644,Staff,13,0,15,2
1713328616441,WCWP 10B,D00,490647,Staff,0,0,0,0
1713328617466,WCWP 100,A00,490655,Staff,0,0,0,0
1713328617466,WCWP 100,B00,490687,Staff,10,0,15,5
1713328619567,ANAR 153,A00,487222,Braswell; Geoffrey E.,54,0,60,6
1713328620595,ANBI 134,A00,487223,Staff,6,0,20,14
1713328621624,ANBI 143GS,A00,487224,Noel; Geoffroy Pierre Jean,18,0,24,6
1713328622650,ANBI 144GS,A00,519548,Noel; Geoffroy Pierre Jean,18,0,24,6
1713328623676,ANSC 101,A00,487225,Staff,18,0,20,2
1713328624702,ANSC 125,A00,487227,Brenner; Suzanne A,39,0,40,1
1713328626755,ANSC 146,A00,487229,Staff,35,0,40,5
1713328627781,ANSC 148,A00,487230,Olivas Hernandez; Olga Lid,39,0,40,1
1713328628808,ANSC 150,A00,504165,Sloane; Julia Kathryn,18,0,20,2
1713328629836,ANSC 180,A00,487232,Staff,14,0,15,1
1713328630864,ANSC 188,A00,627155,Staff,39,0,40,1
1713328631889,ANTH 5,A00,519529,Semendeferi; Ekaterini,15,0,15,0
1713328632918,ANTH 10,A00,487219,Staff,58,0,60,2
1713328633943,ANTH 23,A01,487221,Staff,17,0,20,3
1713328634968,ANTH 102,A00,487233,Wilder; Linnea Lorene,51,0,60,9
1713328636048,ANTH 103,A00,487234,Varma; Saiba,55,0,60,5
1713328637074,ANTH 105,A00,487235,Stewart; Alexander B,54,0,60,6
1713328638101,BENG 100,A01,516685,Taylor Amos; Alyssa C,27,0,30,3
1713328639135,BIBC 102,A01,491316,Flagg; Matthew Paul,13,0,88,75
1713328639135,BIBC 102,A02,491366,Flagg; Matthew Paul,78,0,88,10
1713328640162,BIBC 103,A01,491486,Boumechache; Miyyada,16,0,24,8
1713328640162,BIBC 103,A02,491487,Boumechache; Miyyada,24,0,24,0
1713328641195,BICD 100,A01,516882,Staff,73,0,75,2
1713328641195,BICD 100,A02,516890,Staff,69,0,75,6
1713328642221,BICD 102GS,A00,491488,Lo; Stanley M.,26,0,28,2
1713328643249,BIEB 136GS,A00,516940,Holway; David A. & Shurin; Jonathan,18,0,24,6
1713328644279,BIEB 137GS,A01,517034,Holway; David A. & Shurin; Jonathan,18,0,24,6
1713328645306,BIEB 138GS,A01,491492,Pirino; Giorgia,21,0,28,7
1713328646336,BILD 1,A01,491296,Staff,60,0,63,3
1713328646336,BILD 1,A02,491297,Staff,63,0,63,0
1713328647362,BILD 4,A01,517099,Gonzalez Gamboa; Ivonne,22,0,24,2
1713328647362,BILD 4,A02,517100,Gonzalez Gamboa; Ivonne,24,0,24,0
1713328648387,BILD 60GS,A00,491309,Lo; Stanley M.,26,0,28,2
1713328649414,BIMM 100,A01,517136,Staff,84,0,100,16
1713328650442,BIMM 110,A01,517182,Staff,55,0,100,45
1713328651469,BIMM 120,A01,517228,Pickett; Brooke Elizabeth,29,0,63,34
1713328651469,BIMM 120,A02,517240,Pickett; Brooke Elizabeth,44,0,63,19
1713328652494,BIMM 132GS,A01,491498,Pirino; Giorgia,21,0,28,7
1713328653520,BIMM 143,A01,491589,Bozinovic; Goran,13,0,40,27
1713328654547,BIPN 100,A01,491594,Armour; Jon Christopher,85,0,100,15
1713328655576,BIPN 140,A01,491602,Marino; Marc J,26,0,50,24
1713328657627,CAT 125,A00,515973,Staff,18,0,20,2
1713328658653,CAT 125GS,A00,515974,Rahimi; Babak,17,0,20,3
1713328659686,CAT 125R,A00,515980,Staff,12,0,20,8
1713328659686,CAT 125R,B00,515981,Tosun; Adriana,19,0,20,1
1713328659686,CAT 125R,C00,515987,Hyland; Tina Mae,0,2,20,20
1713328659686,CAT 125R,D00,515988,Bronstein; Phoebe Malan,16,0,20,4
1713328660718,CENG 15,A01,488699,Drews; Aaron,25,0,25,0
1713328661742,CENG 100,A00,505196,Opatkiewicz; Justin Paul,25,0,25,0
1713328662771,CGS 2A,A01,489598,Staff,33,0,35,2
1713328663797,CGS 112,A00,489599,Staff,15,0,15,0
1713328664826,CGS 119,A00,489603,Staff,10,0,10,0
1713328665852,CGS 120,A00,489604,Staff,14,0,15,1
1713328666879,CGS 150,A00,489607,Staff,15,0,15,0
1713328667908,CHEM 6A,A01,488715,Staff,98,0,100,2
1713328668939,CHEM 6B,A01,488719,Piercy; Marc Anthony,99,0,100,1
1713328669969,CHEM 6C,A01,488723,Albizati; Kim F.,93,0,100,7
1713328671006,CHEM 7L,A01,488728,Schurmeier; Kimberly,18,0,24,6
1713328671006,CHEM 7L,A02,488730,Schurmeier; Kimberly,23,0,24,1
1713328671006,CHEM 7L,A03,488734,Schurmeier; Kimberly,20,0,24,4
1713328671006,CHEM 7L,A04,488763,Schurmeier; Kimberly,23,0,24,1
1713328671006,CHEM 7L,B01,488798,Schurmeier; Kimberly,17,0,24,7
1713328671006,CHEM 7L,B02,488801,Schurmeier; Kimberly,22,0,24,2
1713328671006,CHEM 7L,B03,488808,Schurmeier; Kimberly,23,0,24,1
1713328671006,CHEM 7L,B04,488811,Schurmeier; Kimberly,24,0,24,0
1713328672030,CHEM 11,A01,488897,Stallings; Dontarie M,95,0,100,5
1713328673063,CHEM 40A,A01,488913,Albizati; Kim F.,84,0,100,16
1713328674088,CHEM 40B,A01,488920,Weizman; Haim,43,0,50,7
1713328674088,CHEM 40B,A02,488938,Weizman; Haim,45,0,50,5
1713328675119,CHEM 41A,A01,489029,Klosterman; Jeremy K,57,0,60,3
1713328676148,CHEM 41C,A01,500436,Tor; Yitzhak,55,0,60,5
1713328677174,CHEM 43A,A01,500426,Weizman; Haim,0,0,24,24
1713328677174,CHEM 43A,A02,500430,Weizman; Haim,8,0,24,16
1713328677174,CHEM 43A,B01,514041,Klosterman; Jeremy K,16,0,24,8
1713328677174,CHEM 43A,B02,514047,Klosterman; Jeremy K,23,0,24,1
1713328678200,CHEM 108,A01,489140,Jennings; Patricia A.,9,0,24,15
1713328678200,CHEM 108,A02,489142,Jennings; Patricia A.,14,0,24,10
1713328679226,CHEM 114A,A01,489147,Stallings; Dontarie M,68,0,100,32
1713328680254,CHIN 169A,A00,489171,Wang; Xiao,19,0,20,1
1713328682308,COGS 3,A01,518827,Boyle; Mary E. T.,26,0,40,14
1713328683334,COGS 11,A01,489175,Staff,27,0,30,3
1713328684359,COGS 14A,A01,518829,Staff,51,0,60,9
1713328685391,COGS 14B,A01,489177,Hoffman; Drew Ellen,63,0,75,12
1713328686417,COGS 100,A01,489181,Allen; Michael Gordon,63,0,75,12
1713328687446,COGS 101A,A01,489183,Staff,46,0,60,14
1713328688471,COGS 101B,A01,489185,Allen; Michael Gordon,8,0,30,22
1713328689498,COGS 101C,A01,526786,Staff,23,0,30,7
1713328691547,COGS 107A,A01,489189,Boyle; Mary E. T.,18,0,35,17
1713328692574,COGS 107B,A01,627144,Mooshagian; Eric Frederick,60,0,60,0
1713328693605,COGS 118A,A01,489191,Staff,0,44,40,40
1713328695661,COGS 171GS,A01,489194,Pineda; Jaime A,20,0,28,8
1713328696686,COGS 172,A01,489196,Staff,3,0,30,27
1713328697711,COGS 174GS,A01,489264,Pineda; Jaime A,20,0,28,8
1713328698739,COGS 180,A01,627150,Staff,28,0,30,2
1713328699764,COGS 186,A01,489274,Staff,0,1,30,30
1713328700788,COMM 10,A01,489276,Staff,23,0,25,2
1713328700788,COMM 10,A02,489303,Staff,23,0,25,2
1713328701817,COMM 100A,A01,489312,Staff,14,0,25,11
1713328701817,COMM 100A,A02,489313,Staff,24,0,25,1
1713328702843,COMM 106T,A00,512540,Staff,33,0,35,2
1713328703868,COMM 107,A00,489347,Staff,27,0,35,8
1713328704897,COMM 109P,A00,489358,Staff,31,0,35,4
1713328705926,COMM 132,A00,489361,McKenna; Denise,27,0,30,3
1713328706954,COMM 146,A00,489362,Halm; Gavin Patrick,26,0,30,4
1713328707980,COMM 190,A00,489363,Abuelhiga; Soraya Jill,17,0,23,6
1713328709013,CSE 8A,A50,489366,Staff,21,0,25,4
1713328709013,CSE 8A,A51,489367,Staff,24,0,25,1
1713328710040,CSE 11,A01,489398,Cao; Yingjun,74,0,100,26
1713328711067,CSE 12,A01,489487,Staff,43,0,50,7
1713328712094,CSE 20,A01,489497,Staff,48,0,50,2
1713328713122,CSE 21,A01,489517,Braun; Oliver,42,0,50,8
1713328714148,CSE 101,A01,489524,Braun; Oliver,0,29,50,50
1713328715180,CSE 105,A01,512594,Jones; Miles E,72,0,100,28
1713328715180,CSE 105,B01,512598,Jones; Miles E,52,0,100,48
1713328716421,CSE 140,A01,489538,Staff,41,0,50,9
1713328717454,CSE 141,A01,489550,Eldon; John,68,0,100,32
1713328718481,CSE 141L,A01,489571,Eldon; John,66,0,100,34
1713328719513,CSE 151A,A01,489583,Solares; Edwin A,141,0,200,59
1713328720539,CSE 175,A01,510886,Kumar; Rakesh,30,0,30,0
1713328721565,CSE 190,A00,516828,Dubnov; Shlomo,38,0,49,11
1713328722594,DOC 100D,A00,489667,Pass; Natalye Joann,19,0,25,6
1713328723620,DSC 10,A01,624268,Staff,72,0,75,3
1713328724647,DSC 20,A01,624476,Staff,50,0,50,0
1713328725673,DSC 40A,A01,624608,Staff,39,0,40,1
1713328726697,DSGN 1,A01,489179,Rill; Bryan,33,0,50,17
1713328727727,ECE 17,A01,490489,Sahay; Rajeev,18,0,30,12
1713328728756,ECE 65,A50,490492,Staff,12,0,20,8
1713328728756,ECE 65,A51,490493,Staff,18,0,20,2
1713328729787,ECON 1,A01,489715,Famulari; Melissa,68,0,70,2
1713328730815,ECON 2,A01,489717,Levkoff; Steven B.,68,0,70,2
1713328731841,ECON 3,A01,489948,Staff,70,0,70,0
1713328733895,ECON 5,A01,490103,Staff,27,0,30,3
1713328733895,ECON 5,B01,626281,Dai; Yinlin,45,0,45,0
1713328734921,ECON 100A,A01,490127,Famulari; Melissa,65,0,70,5
1713328735947,ECON 100B,A01,490129,Staff,64,0,70,6
1713328736978,ECON 109,A01,490187,Shishkin; Denis,27,0,35,8
1713328738006,ECON 110A,A01,490190,Levkoff; Steven B.,60,0,70,10
1713328739032,ECON 120A,A01,490245,Dai; Yinlin,61,0,70,9
1713328740112,ECON 120B,A01,490247,Nieto-Barthaburu; Augusto,41,0,70,29
1713328741144,ECON 120C,A01,490253,Sun; Yixiao,30,0,35,5
1713328741144,ECON 120C,B01,490255,Sun; Yixiao,34,0,35,1
1713328742169,ECON 129,A00,490256,Eckert; Fabian Paul,23,0,35,12
1713328743195,ECON 131,A00,490257,Nieto-Barthaburu; Augusto,0,6,35,35
1713328744230,ECON 138,A00,490258,Bharadwaj; Prashant,13,0,35,22
1713328744230,ECON 138,B00,490259,Bharadwaj; Prashant,15,0,35,20
1713328745256,ECON 159,A00,490260,Hendrickson; Gerald M.,0,9,0,0
1713328746282,ECON 178,A01,553995,Zhu; Ying,24,0,35,11
1713328747308,EDS 40,A01,512576,Black; Alison Michelle,20,0,20,0
1713328748338,EDS 107,A01,515848,Staff,30,0,30,0
1713328749362,EDS 110R,A01,490262,Staff,26,0,30,4
1713328750385,EDS 112,A01,490264,Chapman; Thandeka K,40,0,50,10
1713328751414,EDS 113,A00,490266,Staff,26,0,30,4
1713328752443,EDS 118,A00,490267,Warstadt; Melissa Fawn,20,0,30,10
1713328753467,EDS 124BR,A00,490268,Eguchi; Emi,4,0,25,21
1713328753467,EDS 124BR,B00,490269,Eguchi; Emi,23,0,25,2
1713328754498,EDS 126,A01,490271,Jones; Makeba,43,0,50,7
1713328755524,EDS 135,A01,490316,Staff,19,0,20,1
1713328756554,ENVR 142GS,A00,519514,Chang; Edmond Yi-Teh,27,0,28,1
1713328757583,ETHN 103,A00,490504,Staff,25,0,36,11
1713328758609,ETHN 103A,A00,490505,Man; Simeon S,4,0,9,5
1713328759633,ETHN 109,A00,490506,Staff,28,0,30,2
1713328760662,ETHN 118,A00,490507,Staff,35,0,36,1
1713328761691,ETHN 119,A00,490508,Staff,33,0,36,3
1713328762717,ETHN 121R,A00,490518,Choi; Esther Min,21,0,36,15
1713328763743,ETHN 127,A00,490528,Staff,14,0,15,1
1713328764767,ETHN 139,A00,490573,Staff,10,0,10,0
1713328765800,ETHN 150,A00,490575,Staff,15,0,15,0
1713328766828,GLBH 20,A00,491705,Elwardani; Nile Regina,38,0,40,2
1713328767854,GLBH 101,A00,491706,Staff,20,0,20,0
1713328768881,GLBH 111,A01,491708,Burgos; Jose L.,15,0,15,0
1713328769910,GLBH 146,A00,491709,Staff,9,0,20,11
1713328770935,GLBH 148,A00,491710,Olivas Hernandez; Olga Lid,11,0,20,9
1713328771962,GLBH 150,A00,491711,Sloane; Julia Kathryn,19,0,20,1
1713328772988,HIEA 131,A00,491760,Staff,28,0,32,4
1713328774015,HIEA 153,A00,491762,Staff,28,0,30,2
1713328775044,HIEU 124,A00,491811,Staff,26,0,32,6
1713328776074,HIEU 124GS,A00,491812,Markman; Kristina,27,0,28,1
1713328777102,HIEU 147,A00,491813,Staff,30,0,32,2
1713328778126,HIEU 149GS,A00,491816,Caldwell; Michael Alan,28,0,28,0
1713328779152,HILD 2C,A01,491713,Hendrickson; Gerald M.,26,0,30,4
1713328780177,HILD 7B,A01,491715,Kwak; Nancy,0,2,30,30
1713328781202,HILD 10,A01,491717,Staff,11,0,20,9
1713328782228,HILD 30GS,A00,491719,Edington; Claire Ellen,24,0,28,4
1713328783253,HINE 109,A00,491818,Shafir; Nir,27,0,32,5
1713328784281,HINE 128,A00,491821,Shafir; Nir,31,0,32,1
1713328785305,HISC 117,A00,491830,Staff,27,0,32,5
1713328786334,HIUS 103,A00,491834,Man; Simeon S,14,0,23,9
1713328787359,HIUS 108B,A00,491835,Staff,28,0,30,2
1713328788387,HIUS 141,A00,491836,Hendrickson; Gerald M.,28,0,32,4
1713328789411,HIUS 149,A00,491839,Staff,24,0,32,8
1713328790438,HUM 3,A01,512617,Crum; Matthew Stephen,43,0,50,7
1713328790438,HUM 3,A02,512618,Crum; Matthew Stephen,48,0,50,2
1713328791466,HUM 3GS,A00,512663,Markman; Kristina,0,0,0,1
1713328791466,HUM 3GS,B00,512664,Staff,0,0,0,0
1713328792491,HUM 4,A01,512620,West; Geoffrey Scott,27,0,50,23
1713328793519,HUM 4GS,A00,512666,Lyon; Antony J.,0,0,0,4
1713328794543,HUM 4R,A01,512625,Watkins; Eric,49,0,50,1
1713328795572,HUM 5,A01,512649,Zavodny; Tatiana Sophia,23,0,50,27
1713328795572,HUM 5,B01,512661,Zroka; Ryan Edward,48,0,50,2
1713328796598,INTL 190,A00,490577,Segui; Alan S,0,0,0,5
1713328797629,JAPN 20AR,A01,491267,Ross; Kayoko F,7,0,20,13
1713328798656,JAPN 180,A00,491285,Berman; Michael David,33,0,40,7
1713328799689,LATI 50,A01,502536,Kokinis; Troy Andreas,16,0,22,6
1713328799689,LATI 50,A02,502551,Kokinis; Troy Andreas,22,0,22,0
1713328799689,LATI 50,A03,502650,Kokinis; Troy Andreas,22,0,22,0
1713328799689,LATI 50,A04,502909,Kokinis; Troy Andreas,21,0,22,1
1713328800717,LATI 160,A01,502920,Kokinis; Troy Andreas,30,0,30,0
1713328801747,LIFR 1A,A00,490494,Van Moer; Vinciane G,17,0,20,3
1713328802772,LIFR 1AX,A00,490495,Van Moer; Vinciane G,17,0,20,3
1713328803801,LIFR 1B,A00,490496,Van Moer; Vinciane G,18,0,20,2
1713328804827,LIFR 1BX,A00,490497,Van Moer; Vinciane G,18,0,20,2
1713328805852,LIGN 8,A00,505198,McIntosh; Justin Daniel,134,0,150,16
1713328806879,LIGN 9GS,A00,491239,Lott; Margaret S.,18,0,20,2
1713328807904,LIGN 101,A01,505200,McIntosh; Justin Daniel,22,0,30,8
1713328808933,LIGN 120,A01,491244,Staff,23,0,30,7
1713328809959,LIGN 149GS,A00,491245,Lott; Margaret S.,18,0,20,2
1713328810989,LIGN 170,A00,491247,Staff,22,0,30,8
1713328812017,LISP 1D,A00,490498,Munoz Sanchez; Alicia,9,0,14,5
1713328812017,LISP 1D,B00,490499,Munoz Sanchez; Alicia,6,0,14,8
1713328812017,LISP 1D,C00,490500,Munoz Sanchez; Alicia,7,0,14,7
1713328812017,LISP 1D,D00,490501,Munoz Sanchez; Alicia,10,0,14,4
1713328813041,LISP 1DX,A00,490502,Munoz Sanchez; Alicia,14,0,28,14
1713328813041,LISP 1DX,B00,490503,Munoz Sanchez; Alicia,16,0,28,12
1713328815097,LTAM 110,A00,491847,Staff,22,0,25,3
1713328816122,LTCS 119,A00,491848,Staff,11,0,15,4
1713328817147,LTCS 130,A00,491849,Staff,24,0,25,1
1713328819198,LTEA 120C,A00,491852,Staff,32,0,40,8
1713328820224,LTEN 130GS,A00,491853,Lyon; Antony J.,24,0,28,4
1713328821250,LTEN 148,A00,491855,Staff,23,0,25,2
1713328822280,LTEN 159,A00,491856,Staff,20,0,25,5
1713328823309,LTEN 180,A00,491857,Staff,8,0,15,7
1713328825364,LTSP 123GS,A00,505928,Bessett; Ryan Matthew,24,0,28,4
1713328826389,LTSP 174GS,A00,506037,Bessett; Ryan Matthew,24,0,28,4
1713328828445,LTWR 102,A00,491861,Staff,9,0,15,6
1713328829472,LTWR 106,A00,491862,Staff,8,0,15,7
1713328830499,MAE 11,A00,490930,Bahadori; Mohammad Yousef,95,0,100,5
1713328831526,MAE 30A,A00,490931,Qi; Huihui,37,0,40,3
1713328832553,MAE 101A,A00,491036,Sadeghizadeh; Zahra,92,0,100,8
1713328833579,MAE 101C,A00,491037,Seshadri; Kalyanasundaram,67,0,100,33
1713328834607,MAE 113,A00,491040,Seshadri; Kalyanasundaram,66,0,80,14
1713328835637,MAE 131A,A00,491041,Ghazinejad; Maziar,37,0,40,3
1713328836662,MAE 142,A00,491053,Staff,39,0,40,1
1713328837688,MAE 143A,A00,491054,Staff,32,0,50,18
1713328838713,MAE 150,A00,491092,Truong; Phuong Thi Ngoc,23,0,35,12
1713328839738,MATH 3C,A01,494031,Pardo Guerra; Sebastian,30,0,30,0
1713328839738,MATH 3C,A02,494032,Pardo Guerra; Sebastian,29,0,30,1
1713328840765,MATH 10A,A01,494034,Staff,27,0,30,3
1713328840765,MATH 10A,A02,494035,Staff,28,0,30,2
1713328840765,MATH 10A,B01,494037,Staff,27,0,30,3
1713328840765,MATH 10A,B02,494038,Staff,29,0,30,1
1713328841799,MATH 10B,A01,494040,Habib; Yousaf,22,0,30,8
1713328841799,MATH 10B,A02,494041,Habib; Yousaf,28,0,30,2
1713328841799,MATH 10B,A03,494042,Habib; Yousaf,29,0,30,1
1713328841799,MATH 10B,A04,494043,Habib; Yousaf,30,0,30,0
1713328841799,MATH 10B,B01,494045,Habib; Yousaf,25,0,30,5
1713328841799,MATH 10B,B02,494046,Habib; Yousaf,30,0,30,0
1713328841799,MATH 10B,B03,494047,Habib; Yousaf,30,0,30,0
1713328841799,MATH 10B,B04,494048,Habib; Yousaf,30,0,30,0
1713328842829,MATH 18,A01,494050,Kemp; Todd Aahron,25,0,30,5
1713328842829,MATH 18,A02,494051,Kemp; Todd Aahron,29,0,30,1
1713328842829,MATH 18,B01,494054,Kemp; Todd Aahron,26,0,30,4
1713328842829,MATH 18,B02,494055,Kemp; Todd Aahron,29,0,30,1
1713328843907,MATH 20A,A01,494059,Suk; Andrew Hoon,30,0,30,0
1713328844938,MATH 20B,A01,494061,Briones; Jor-el Thomas Caparas,33,0,35,2
1713328844938,MATH 20B,B01,494063,Bach; Quang Tran,34,0,35,1
1713328845972,MATH 20C,A01,494065,Staff,28,0,30,2
1713328845972,MATH 20C,A02,494066,Staff,30,0,30,0
1713328845972,MATH 20C,A03,494067,Staff,30,0,30,0
1713328845972,MATH 20C,A04,494068,Staff,30,0,30,0
1713328845972,MATH 20C,B01,494070,Zhang; Ming,25,0,30,5
1713328845972,MATH 20C,B02,494071,Zhang; Ming,27,0,30,3
1713328845972,MATH 20C,B03,494072,Zhang; Ming,29,0,30,1
1713328845972,MATH 20C,B04,494073,Zhang; Ming,29,0,30,1
1713328847001,MATH 20D,A01,494075,Staff,22,0,30,8
1713328847001,MATH 20D,A02,494076,Staff,29,0,30,1
1713328848230,MATH 20E,A01,494079,Staff,24,0,30,6
1713328848230,MATH 20E,A02,494080,Staff,26,0,30,4
1713328848230,MATH 20E,B01,494082,Staff,25,0,30,5
1713328848230,MATH 20E,B02,494083,Staff,25,0,30,5
1713328849256,MATH 103A,A01,494085,Aliabadi Sr.; Mohsen,14,0,30,16
1713328849256,MATH 103A,A02,494086,Aliabadi Sr.; Mohsen,28,0,30,2
1713328849256,MATH 103A,B01,494088,Aliabadi Sr.; Mohsen,21,0,30,9
1713328849256,MATH 103A,B02,494089,Aliabadi Sr.; Mohsen,27,0,30,3
1713328850282,MATH 109,A01,494091,Staff,30,0,30,0
1713328850282,MATH 109,A02,494092,Staff,29,0,30,1
1713328850282,MATH 109,B01,494094,Staff,27,0,30,3
1713328850282,MATH 109,B02,494095,Staff,29,0,30,1
1713328851313,MATH 142A,A01,494097,Chow; Bennett,15,0,30,15
1713328851313,MATH 142A,A02,494098,Chow; Bennett,23,0,30,7
1713328851313,MATH 142A,B01,494100,Chow; Bennett,19,0,30,11
1713328851313,MATH 142A,B02,494101,Chow; Bennett,29,0,30,1
1713328853368,MATH 168A,A01,516677,Dumitriu; Ioana,16,0,35,19
1713328854398,MATH 170A,A01,516679,Dumitriu; Ioana,18,0,30,12
1713328854398,MATH 170A,A02,516680,Dumitriu; Ioana,28,0,30,2
1713328855425,MATH 193A,A01,494107,Staff,14,0,30,16
1713328855425,MATH 193A,A02,494108,Staff,19,0,30,11
1713328855425,MATH 193A,A03,494109,Staff,29,0,30,1
1713328855425,MATH 193A,A04,494110,Staff,22,0,30,8
1713328858501,MGT 16,A00,491930,McKay; Michael J,92,0,98,6
1713328859528,MGT 18,A00,491992,McKay; Michael J,96,0,98,2
1713328860555,MGT 71,A00,492003,Staff,65,0,98,33
1713328861582,MGT 103,A00,505209,Eberhard; Craig A,81,0,98,17
1713328862608,MGT 131A,A00,505210,Anderson; John Charles,89,0,98,9
1713328864663,MGT 153,A00,492077,Perols; Johan Lars,19,0,90,71
1713328867746,MGT 164,A00,492222,McKay; Mary A,91,0,98,7
1713328868778,MGT 172,A00,492245,Staff,59,0,60,1
1713328868778,MGT 172,B00,505526,Hedges; Kathleen,65,0,98,33
1713328869804,MGT 181,A00,505669,Dunn; Louis Jean,82,0,98,16
1713328870837,MMW 14,A01,494399,Staff,15,0,28,13
1713328870837,MMW 14,A02,494400,Staff,25,0,28,3
1713328870837,MMW 14,A03,494401,Staff,28,0,28,0
1713328870837,MMW 14,A04,494402,Staff,28,0,28,0
1713328870837,MMW 14,B01,494404,Carreras; Maria Victoria,8,0,28,20
1713328870837,MMW 14,B02,494405,Carreras; Maria Victoria,25,0,28,3
1713328870837,MMW 14,B03,494406,Carreras; Maria Victoria,27,0,28,1
1713328870837,MMW 14,B04,494407,Carreras; Maria Victoria,28,0,28,0
1713328871866,MMW 14GS,A00,506250,Chang; Edmond Yi-Teh,0,0,0,0
1713328872895,MMW 121R,A01,494415,Adamiak; Patrick John,10,0,28,18
1713328872895,MMW 121R,A02,494416,Adamiak; Patrick John,24,0,28,4
1713328873921,MUS 1A,A01,494113,Staff,12,0,25,13
1713328873921,MUS 1A,A02,494114,Staff,24,0,25,1
1713328874948,MUS 4,A01,494116,Staff,23,0,25,2
1713328874948,MUS 4,A02,494117,Staff,22,0,25,3
1713328875975,MUS 5R,A01,494236,Dubnov; Shlomo,6,0,25,19
1713328875975,MUS 5R,A02,494237,Dubnov; Shlomo,25,0,25,0
1713328877000,MUS 6,A01,494122,Staff,10,0,25,15
1713328877000,MUS 6,A02,494123,Staff,23,0,25,2
1713328878025,MUS 7,A01,494125,Staff,16,0,25,9
1713328878025,MUS 7,A02,494126,Staff,24,0,25,1
1713328879051,MUS 11,A01,494128,Staff,23,0,25,2
1713328879051,MUS 11,A02,494129,Staff,24,0,25,1
1713328880083,MUS 13,A01,494131,Staff,25,0,25,0
1713328880083,MUS 13,A02,494132,Staff,25,0,25,0
1713328881109,MUS 15,A01,494134,Staff,17,0,25,8
1713328881109,MUS 15,A02,494135,Staff,25,0,25,0
1713328881109,MUS 15,B01,494137,Staff,24,0,25,1
1713328882135,MUS 80,A00,494232,Staff,24,0,25,1
1713328882135,MUS 80,B00,494233,Staff,25,0,25,0
1713328882135,MUS 80,C00,494234,Staff,23,0,25,2
1713328883166,MUS 95C,A00,494141,Staff,70,0,75,5
1713328884190,MUS 114,A00,494142,Staff,40,0,50,10
1713328885223,NANO 15,A01,490636,Drews; Aaron,7,0,7,0
1713328886251,PHIL 1,A00,490578,Grush; Rick Scott,49,0,50,1
1713328887282,PHIL 10,A01,490580,Grush; Rick Scott,33,0,35,2
1713328887282,PHIL 10,A02,490586,Grush; Rick Scott,32,0,35,3
1713328888309,PHIL 27,A01,490591,Staff,22,0,25,3
1713328888309,PHIL 27,A02,490592,Staff,25,0,25,0
1713328888309,PHIL 27,A03,490593,Staff,25,0,25,0
1713328888309,PHIL 27,A04,490598,Staff,25,0,25,0
1713328889340,PHIL 32,A01,490611,Staff,20,0,20,0
1713328889340,PHIL 32,A02,490618,Staff,20,0,20,0
1713328890368,PHIL 90,A00,490624,Staff,40,0,40,0
1713328891399,PHIL 136,A00,490627,Cohen; Jonathan David,37,0,40,3
1713328892423,PHIL 155,A00,490634,Staff,62,0,70,8
1713328893449,PHYS 1A,A00,491610,Staff,245,0,250,5
1713328894476,PHYS 1AL,001,491616,Tsai; Philbert S,27,0,30,3
1713328894476,PHYS 1AL,002,491618,Tsai; Philbert S,30,0,30,0
1713328895501,PHYS 1B,A00,491623,Staff,236,0,250,14
1713328896554,PHYS 1BL,001,491626,Tsai; Philbert S,22,0,30,8
1713328896554,PHYS 1BL,002,491628,Tsai; Philbert S,26,0,30,4
1713328897578,PHYS 1C,A00,491632,Staff,214,0,245,31
1713328898604,PHYS 1CL,001,491635,Tsai; Philbert S,2,0,30,28
1713328898604,PHYS 1CL,002,491643,Tsai; Philbert S,22,0,30,8
1713328899632,PHYS 2AR,A01,491651,Meyertholen; Andrew D.,44,0,50,6
1713328900662,PHYS 2B,A01,491659,Staff,106,0,115,9
1713328901690,PHYS 2BL,A01,491685,Staff,21,0,24,3
1713328901690,PHYS 2BL,A02,491700,Staff,21,0,24,3
1713328902721,PHYS 2C,A01,505161,Staff,102,0,115,13
1713328903751,PHYS 4A,A01,491704,Grinstein; Benjamin,99,0,100,1
1713328904781,POLI 5D,A01,494144,Staff,3,0,5,2
1713328904781,POLI 5D,B01,626283,Dai; Yinlin,5,0,5,0
1713328905809,POLI 12,A00,494145,Staff,43,0,45,2
1713328906834,POLI 13R,A00,494146,Forman; Fonna,45,0,50,5
1713328907859,POLI 27,A01,494148,Staff,54,0,60,6
1713328908883,POLI 30,A00,494149,Staff,49,0,50,1
1713328909912,POLI 100DA,A00,494150,Staff,21,0,25,4
1713328911970,POLI 100I,A00,494152,Staff,27,0,30,3
1713328912998,POLI 104B,A00,494153,Smith; Glenn Chatmas,53,0,55,2
1713328914027,POLI 104F,A00,494154,Staff,28,0,30,2
1713328915052,POLI 104I,A00,494155,Smith; Glenn Chatmas,29,0,30,1
1713328916078,POLI 110C,A00,494156,Ingham; Sean,23,0,25,2
1713328917107,POLI 117R,A00,494157,Forman; Fonna,8,0,20,12
1713328918133,POLI 118,A00,494158,Ingham; Sean,21,0,25,4
1713328919160,POLI 120H,A00,494159,Fisk; David Lee,39,0,45,6
1713328920186,POLI 131CR,A00,494160,Hoston; Germaine,35,0,45,10
1713328921215,POLI 133J,A00,494161,Staff,32,0,35,3
1713328922241,POLI 135,A00,494162,Fisk; David Lee,33,0,35,2
1713328923273,POLI 140A,A00,494164,Staff,19,0,30,11
1713328924299,POLI 142I,A00,494165,Staff,30,0,30,0
1713328925331,POLI 144D,A00,494166,Staff,23,0,25,2
1713328926360,POLI 151,A00,494167,Staff,30,0,30,0
1713328927390,POLI 153,A00,494168,Staff,33,0,35,2
1713328928415,POLI 160AA,A00,494169,Staff,34,0,40,6
1713328929440,POLI 162,A00,494170,Mignozzetti; Umberto,19,0,25,6
1713328930463,POLI 171,A00,494171,Mignozzetti; Umberto,18,0,25,7
1713328931494,PSYC 1,A00,494172,Staff,96,0,100,4
1713328932524,PSYC 2,A00,494173,Moranton; Nirelia Melbina-,34,0,50,16
1713328933555,PSYC 3,A00,494174,Staff,29,0,30,1
1713328934585,PSYC 6,A00,494175,Staff,17,0,20,3
1713328935614,PSYC 60,A01,494177,Staff,38,0,45,7
1713328936641,PSYC 70,A01,505724,Geller; Emma Harlan,42,0,45,3
1713328937667,PSYC 101,A00,494180,Heyman; Gail D.,84,0,100,16
1713328938693,PSYC 105,A00,494181,Geller; Emma Harlan,51,0,90,39
1713328939722,PSYC 106,A00,494182,Dobkins; Karen R.,27,0,45,18
1713328940749,PSYC 108,A00,494183,Adrian; Julia Anna,89,0,100,11
1713328941776,PSYC 114,A01,494185,Winkielman; Piotr,0,2,30,30
1713328942801,PSYC 122,A00,494186,Moranton; Nirelia Melbina-,28,0,50,22
1713328943826,PSYC 124,A00,494187,Chapman; Eddie Nathaniel,71,0,80,9
1713328944855,PSYC 131,A00,494188,Anagnostaras; Stephan,41,0,80,39
1713328945883,PSYC 144,A00,494189,Staff,5,0,50,45
1713328946911,PSYC 154,A00,494190,Lacefield; Katharine I,107,0,180,73
1713328947999,PSYC 162,A00,494191,Wixted; John T,71,0,100,29
1713328949025,PSYC 172,A00,494192,Gorman; Michael R.,36,0,45,9
1713328950055,PSYC 178,A00,494193,Glaser; Dale,34,0,45,11
1713328951086,PSYC 193,A00,505725,Chapman; Eddie Nathaniel,20,0,20,0
1713328952114,RELI 145GS,A00,519817,Rahimi; Babak,18,0,20,2
1713328953147,SE 101A,A01,490862,Chadha; Mayank,23,0,25,2
1713328954171,SE 101C,A01,490924,Krysl; Petr,15,0,20,5
1713328955196,SE 110A,A01,490928,Staff,19,0,20,1
1713328956227,SE 130A,A00,490929,Morrison; Machel Leigh,55,0,70,15
1713328957257,SIO 1,A01,519325,Staff,39,0,40,1
1713328958285,SIO 30,A01,519327,Staff,38,0,40,2
1713328959308,SIO 40,A00,519328,Staff,39,0,40,1
1713328960339,SIO 46GS,A00,519819,Cook; Geoffrey W,17,0,25,8
1713328961364,SIO 109R,A00,494197,Forman; Fonna,0,3,20,20
1713328962391,SIO 121GS,A00,519827,Cook; Geoffrey W,17,0,25,8
1713328963420,SIO 132,A01,519330,Staff,38,0,40,2
1713328964446,SIO 133,A01,519397,Staff,37,0,40,3
1713328965470,SIO 139,A00,519396,Kacev; David,29,0,40,11
1713328966498,SOCI 1,A01,494199,Thorpe; Charles Robert,21,0,30,9
1713328966498,SOCI 1,A02,494200,Thorpe; Charles Robert,30,0,30,0
1713328966498,SOCI 1,A03,494201,Thorpe; Charles Robert,29,0,30,1
1713328966498,SOCI 1,A04,494202,Thorpe; Charles Robert,29,0,30,1
1713328966498,SOCI 1,A05,494203,Thorpe; Charles Robert,29,0,30,1
1713328966498,SOCI 1,A06,494204,Thorpe; Charles Robert,30,0,30,0
1713328966498,SOCI 1,A07,494205,Thorpe; Charles Robert,28,0,30,2
1713328967523,SOCI 60,A01,494207,Staff,34,0,40,6
1713328967523,SOCI 60,A02,494208,Staff,39,0,40,1
1713328968553,SOCI 100,A01,494210,Payne; Christine Anna,25,0,30,5
1713328968553,SOCI 100,A02,494211,Payne; Christine Anna,26,0,30,4
1713328969579,SOCI 109M,A00,494212,Staff,20,0,20,0
1713328970608,SOCI 110,A00,494213,Staff,34,0,40,6
1713328972661,SOCI 118E,A00,494215,Ng; Kwai,37,0,40,3
1713328973691,SOCI 125,A00,494216,Calderon-Zaks; Michael Aar,40,0,45,5
1713328974717,SOCI 126,A01,494218,Jones; Makeba,3,0,5,2
1713328975744,SOCI 131,A00,494219,Thorpe; Charles Robert,26,0,30,4
1713328977797,SOCI 135,A00,494221,Payne; Christine Anna,28,0,50,22
1713328978824,SOCI 136E,A00,626690,Ruiz; Jonathan Joseph,24,0,25,1
1713328979850,SOCI 138GS,A00,494222,Navon; Daniel,24,0,28,4
1713328981900,SOCI 145,A00,494224,Staff,40,0,45,5
1713328982927,SOCI 153,A00,494225,Staff,28,0,30,2
1713328983954,SOCI 160E,A00,494226,Ng; Kwai,29,0,40,11
1713328984982,SOCI 180,A00,494227,Staff,29,0,30,1
1713328986007,SOCI 189GS,A00,494228,Ribas Norris; Janet Vanesa,11,0,11,0
1713328987037,SOCI 190GS,A00,553232,Ribas Norris; Janet Vanesa,11,0,11,0
1713328988067,SOMI 220,A00,627178,Schneid; Stephen David,30,0,30,0
1713328989092,SYN 2,001,490768,Staff,13,0,15,2
1713328989092,SYN 2,002,490769,Staff,14,0,15,1
1713328989092,SYN 2,004,490775,Staff,0,0,0,0
1713328989092,SYN 2,003,490774,Staff,0,0,0,0
1713328989092,SYN 2,005,490776,Staff,0,0,0,0
1713328990118,SYN 2R,001,490779,Staff,11,0,15,4
1713328990118,SYN 2R,002,514635,Staff,14,0,15,1
1713328991143,SYN 100,A01,490783,Staff,9,0,20,11
1713328991143,SYN 100,B01,490787,Staff,9,0,20,11
1713328991143,SYN 100,C01,490789,Staff,10,0,20,10
1713328992169,SYN 150,A00,490817,Staff,14,0,15,1
1713328992169,SYN 150,B00,514610,Staff,15,0,15,0
1713328993197,TDAC 1,A00,492753,Walsh; Kim C.,19,0,20,1
1713328993197,TDAC 1,B00,492754,Harting; Carla Kelso,19,0,20,1
1713328993197,TDAC 1,C00,513995,Salovey; Todd,15,0,20,5
1713328994228,TDAC 101,A00,492766,Harting; Carla Kelso,17,0,20,3
1713328995259,TDAC 102,A00,492768,Basso; Beatrice,19,0,20,1
1713328996283,TDDE 111,A00,492769,Staff,25,0,25,0
1713328997313,TDDE 131,A00,492770,Staff,15,0,15,0
1713328997313,TDDE 131,B00,492771,Staff,15,0,15,0
1713328998342,TDDE 131GS,A00,523716,Guirguis; Mark C,23,0,28,5
1713328999368,TDGE 1,A01,492756,Salovey; Todd,56,0,60,4
1713329000393,TDGE 5,A01,492758,Staff,23,0,25,2
1713329001419,TDGE 10,A00,492759,Fulton; Julia,203,0,220,17
1713329002444,TDGE 11,A00,492760,Castro; Robert Jess,198,0,200,2
1713329004502,TDGE 124,A00,492772,Fulton; Julia,185,0,220,35
1713329005531,TDGE 125,A00,492773,Meyer; Ursula,38,0,50,12
1713329005531,TDGE 125,B00,492774,Staff,49,0,50,1
1713329005531,TDGE 125,C00,523565,Staff,48,0,50,2
1713329006561,TDGE 125GS,A00,523580,Guirguis; Mark C,23,0,28,5
1713329007589,TDGE 127,A00,492775,Havis; Allan,34,0,50,16
1713329008617,TDHT 101,A00,492776,Staff,34,0,35,1
1713329009644,TDMV 1,A00,492762,Caligagan; Maria T.,30,0,30,0
1713329009644,TDMV 1,B00,492763,Arcidiacono; Kristin,26,0,30,4
1713329010668,TDMV 2,A00,492764,Weinberg; Sadie,28,0,30,2
1713329011695,TDMV 3,A00,492765,Mack; Kara Shanai',37,0,40,3
1713329012719,TDMV 138,A00,492777,Mack; Kara Shanai',34,0,40,6
1713329013744,TDMV 140,A00,492778,Lima; Paulo Henrique,40,0,40,0
1713329014770,TDMV 142,A00,492779,Caligagan; Maria T.,33,0,40,7
1713329014770,TDMV 142,B00,492780,Caligagan; Tony,37,0,40,3
1713329015799,TDMV 143,A00,492781,Fyall; Daunte Edward,39,0,40,1
1713329016825,USP 1,A01,492401,Kwak; Nancy,27,0,35,8
1713329017851,USP 2,A01,492453,Hinds; Juli Beth,35,0,35,0
1713329018876,USP 3,A01,492516,Staff,28,0,35,7
1713329019902,USP 4,A00,492522,McTague; Sarah,16,0,25,9
1713329020929,USP 100,A00,492523,Staff,32,0,35,3
1713329021954,USP 101,A00,492524,Staff,13,0,15,2
1713329022977,USP 105,A00,492525,Staff,21,0,25,4
1713329024002,USP 151,A00,492526,Shenkman; Michael Thomas,32,0,35,3
1713329025029,USP 170,A00,492545,Hinds; Juli Beth,33,0,35,2
1713329026055,USP 171GS,A00,492608,Bussell; Mirle Rabinowitz,24,0,28,4
1713329027079,USP 183GS,A00,492613,Peerson; Susan,24,0,28,4
1713329028104,VIS 30,A01,490693,Yoldas; Pinar,19,0,22,3
1713329028104,VIS 30,A02,490694,Yoldas; Pinar,18,0,22,4
1713329029129,VIS 83,A00,490695,Kester; Grant,63,0,75,12
1713329030154,VIS 105D,A00,490696,Staff,22,0,25,3
1713329031178,VIS 124CN,A00,490699,Rose; Jordan M,65,0,75,10
1713329032210,VIS 125GS,A00,511221,Williams; Alena J,21,0,22,1
1713329033235,VIS 128D,A00,490700,Staff,73,0,75,2
1713329034261,VIS 151,A01,490717,Staff,33,0,34,1
1713329034261,VIS 151,A02,490766,Staff,33,0,34,1
1713329035288,VIS 154GS,A00,511972,Williams; Alena J,21,0,22,1
1713329036314,VIS 160A,A00,490767,Stone; Patricia,7,0,10,3
1713329037338,WCWP 10A,A00,490638,Staff,14,0,15,1
1713329037338,WCWP 10A,B00,490640,Staff,15,0,15,0
1713329038363,WCWP 10B,A00,490641,Staff,0,0,0,0
1713329038363,WCWP 10B,B00,490642,Staff,14,0,15,1
1713329038363,WCWP 10B,C00,490644,Staff,13,0,15,2
1713329038363,WCWP 10B,D00,490647,Staff,0,0,0,0
1713329039391,WCWP 100,A00,490655,Staff,0,0,0,0
1713329039391,WCWP 100,B00,490687,Staff,10,0,15,5
1713329041500,ANAR 153,A00,487222,Braswell; Geoffrey E.,53,0,60,7
1713329042525,ANBI 134,A00,487223,Staff,5,0,20,15
1713329043551,ANBI 143GS,A00,487224,Noel; Geoffroy Pierre Jean,18,0,24,6
1713329044575,ANBI 144GS,A00,519548,Noel; Geoffroy Pierre Jean,18,0,24,6
1713329045600,ANSC 101,A00,487225,Staff,18,0,20,2
1713329046628,ANSC 125,A00,487227,Brenner; Suzanne A,39,0,40,1
1713329048683,ANSC 146,A00,487229,Staff,35,0,40,5
1713329049708,ANSC 148,A00,487230,Olivas Hernandez; Olga Lid,39,0,40,1
1713329050735,ANSC 150,A00,504165,Sloane; Julia Kathryn,18,0,20,2
1713329051830,ANSC 180,A00,487232,Staff,14,0,15,1
1713329052856,ANSC 188,A00,627155,Staff,39,0,40,1
1713329053894,ANTH 5,A00,519529,Semendeferi; Ekaterini,15,0,15,0
1713329054918,ANTH 10,A00,487219,Staff,58,0,60,2
1713329055944,ANTH 23,A01,487221,Staff,17,0,20,3
1713329056973,ANTH 102,A00,487233,Wilder; Linnea Lorene,51,0,60,9
1713329057999,ANTH 103,A00,487234,Varma; Saiba,55,0,60,5
1713329059024,ANTH 105,A00,487235,Stewart; Alexander B,54,0,60,6
1713329060051,BENG 100,A01,516685,Taylor Amos; Alyssa C,27,0,30,3
1713329061077,BIBC 102,A01,491316,Flagg; Matthew Paul,13,0,88,75
1713329061077,BIBC 102,A02,491366,Flagg; Matthew Paul,78,0,88,10
1713329062107,BIBC 103,A01,491486,Boumechache; Miyyada,16,0,24,8
1713329062107,BIBC 103,A02,491487,Boumechache; Miyyada,24,0,24,0
1713329063137,BICD 100,A01,516882,Staff,73,0,75,2
1713329063137,BICD 100,A02,516890,Staff,69,0,75,6
1713329064160,BICD 102GS,A00,491488,Lo; Stanley M.,26,0,28,2
1713329065187,BIEB 136GS,A00,516940,Holway; David A. & Shurin; Jonathan,18,0,24,6
1713329066217,BIEB 137GS,A01,517034,Holway; David A. & Shurin; Jonathan,18,0,24,6
1713329067251,BIEB 138GS,A01,491492,Pirino; Giorgia,21,0,28,7
1713329068279,BILD 1,A01,491296,Staff,60,0,63,3
1713329068279,BILD 1,A02,491297,Staff,63,0,63,0
1713329069306,BILD 4,A01,517099,Gonzalez Gamboa; Ivonne,22,0,24,2
1713329069306,BILD 4,A02,517100,Gonzalez Gamboa; Ivonne,24,0,24,0
1713329070341,BILD 60GS,A00,491309,Lo; Stanley M.,26,0,28,2
1713329071371,BIMM 100,A01,517136,Staff,84,0,100,16
1713329072397,BIMM 110,A01,517182,Staff,55,0,100,45
1713329073428,BIMM 120,A01,517228,Pickett; Brooke Elizabeth,28,0,63,35
1713329073428,BIMM 120,A02,517240,Pickett; Brooke Elizabeth,44,0,63,19
1713329074459,BIMM 132GS,A01,491498,Pirino; Giorgia,21,0,28,7
1713329075485,BIMM 143,A01,491589,Bozinovic; Goran,13,0,40,27
1713329076512,BIPN 100,A01,491594,Armour; Jon Christopher,84,0,100,16
1713329077537,BIPN 140,A01,491602,Marino; Marc J,26,0,50,24
1713329079590,CAT 125,A00,515973,Staff,18,0,20,2
1713329080615,CAT 125GS,A00,515974,Rahimi; Babak,17,0,20,3
1713329081642,CAT 125R,A00,515980,Staff,12,0,20,8
1713329081642,CAT 125R,B00,515981,Tosun; Adriana,19,0,20,1
1713329081642,CAT 125R,C00,515987,Hyland; Tina Mae,0,2,20,20
1713329081642,CAT 125R,D00,515988,Bronstein; Phoebe Malan,16,0,20,4
1713329082669,CENG 15,A01,488699,Drews; Aaron,25,0,25,0
1713329083694,CENG 100,A00,505196,Opatkiewicz; Justin Paul,25,0,25,0
1713329084719,CGS 2A,A01,489598,Staff,33,0,35,2
1713329085744,CGS 112,A00,489599,Staff,15,0,15,0
1713329086770,CGS 119,A00,489603,Staff,10,0,10,0
1713329087796,CGS 120,A00,489604,Staff,14,0,15,1
1713329088821,CGS 150,A00,489607,Staff,15,0,15,0
1713329089854,CHEM 6A,A01,488715,Staff,98,0,100,2
1713329090881,CHEM 6B,A01,488719,Piercy; Marc Anthony,99,0,100,1
1713329091912,CHEM 6C,A01,488723,Albizati; Kim F.,93,0,100,7
1713329092946,CHEM 7L,A01,488728,Schurmeier; Kimberly,18,0,24,6
1713329092946,CHEM 7L,A02,488730,Schurmeier; Kimberly,23,0,24,1
1713329092946,CHEM 7L,A03,488734,Schurmeier; Kimberly,20,0,24,4
1713329092946,CHEM 7L,A04,488763,Schurmeier; Kimberly,23,0,24,1
1713329092946,CHEM 7L,B01,488798,Schurmeier; Kimberly,17,0,24,7
1713329092946,CHEM 7L,B02,488801,Schurmeier; Kimberly,22,0,24,2
1713329092946,CHEM 7L,B03,488808,Schurmeier; Kimberly,23,0,24,1
1713329092946,CHEM 7L,B04,488811,Schurmeier; Kimberly,24,0,24,0
1713329093972,CHEM 11,A01,488897,Stallings; Dontarie M,95,0,100,5
1713329095001,CHEM 40A,A01,488913,Albizati; Kim F.,84,0,100,16
1713329096034,CHEM 40B,A01,488920,Weizman; Haim,43,0,50,7
1713329096034,CHEM 40B,A02,488938,Weizman; Haim,45,0,50,5
1713329097066,CHEM 41A,A01,489029,Klosterman; Jeremy K,57,0,60,3
1713329098091,CHEM 41C,A01,500436,Tor; Yitzhak,55,0,60,5
1713329099319,CHEM 43A,A01,500426,Weizman; Haim,0,0,24,24
1713329099319,CHEM 43A,A02,500430,Weizman; Haim,8,0,24,16
1713329099319,CHEM 43A,B01,514041,Klosterman; Jeremy K,16,0,24,8
1713329099319,CHEM 43A,B02,514047,Klosterman; Jeremy K,23,0,24,1
1713329100572,CHEM 108,A01,489140,Jennings; Patricia A.,9,0,24,15
1713329100572,CHEM 108,A02,489142,Jennings; Patricia A.,14,0,24,10
1713329101601,CHEM 114A,A01,489147,Stallings; Dontarie M,68,0,100,32
1713329102633,CHIN 169A,A00,489171,Wang; Xiao,19,0,20,1
1713329104683,COGS 3,A01,518827,Boyle; Mary E. T.,26,0,40,14
1713329105712,COGS 11,A01,489175,Staff,27,0,30,3
1713329106738,COGS 14A,A01,518829,Staff,51,0,60,9
1713329107768,COGS 14B,A01,489177,Hoffman; Drew Ellen,63,0,75,12
1713329108795,COGS 100,A01,489181,Allen; Michael Gordon,63,0,75,12
1713329109821,COGS 101A,A01,489183,Staff,46,0,60,14
1713329110847,COGS 101B,A01,489185,Allen; Michael Gordon,8,0,30,22
1713329111876,COGS 101C,A01,526786,Staff,23,0,30,7
1713329113928,COGS 107A,A01,489189,Boyle; Mary E. T.,17,0,35,18
1713329114954,COGS 107B,A01,627144,Mooshagian; Eric Frederick,60,0,60,0
1713329115980,COGS 118A,A01,489191,Staff,0,44,40,40
1713329118034,COGS 171GS,A01,489194,Pineda; Jaime A,20,0,28,8
1713329119058,COGS 172,A01,489196,Staff,3,0,30,27
1713329120089,COGS 174GS,A01,489264,Pineda; Jaime A,20,0,28,8
1713329121116,COGS 180,A01,627150,Staff,28,0,30,2
1713329122141,COGS 186,A01,489274,Staff,0,1,30,30
1713329123166,COMM 10,A01,489276,Staff,23,0,25,2
1713329123166,COMM 10,A02,489303,Staff,23,0,25,2
1713329124190,COMM 100A,A01,489312,Staff,14,0,25,11
1713329124190,COMM 100A,A02,489313,Staff,24,0,25,1
1713329125220,COMM 106T,A00,512540,Staff,33,0,35,2
1713329126244,COMM 107,A00,489347,Staff,27,0,35,8
1713329127271,COMM 109P,A00,489358,Staff,31,0,35,4
1713329128298,COMM 132,A00,489361,McKenna; Denise,27,0,30,3
1713329129329,COMM 146,A00,489362,Halm; Gavin Patrick,26,0,30,4
1713329130361,COMM 190,A00,489363,Abuelhiga; Soraya Jill,17,0,23,6
1713329131391,CSE 8A,A50,489366,Staff,21,0,25,4
1713329131391,CSE 8A,A51,489367,Staff,24,0,25,1
1713329132418,CSE 11,A01,489398,Cao; Yingjun,73,0,100,27
1713329133444,CSE 12,A01,489487,Staff,43,0,50,7
1713329134469,CSE 20,A01,489497,Staff,48,0,50,2
1713329135494,CSE 21,A01,489517,Braun; Oliver,42,0,50,8
1713329136522,CSE 101,A01,489524,Braun; Oliver,0,29,50,50
1713329137555,CSE 105,A01,512594,Jones; Miles E,72,0,100,28
1713329137555,CSE 105,B01,512598,Jones; Miles E,52,0,100,48
1713329138589,CSE 140,A01,489538,Staff,41,0,50,9
1713329139627,CSE 141,A01,489550,Eldon; John,68,0,100,32
1713329140657,CSE 141L,A01,489571,Eldon; John,66,0,100,34
1713329141684,CSE 151A,A01,489583,Solares; Edwin A,141,0,200,59
1713329142713,CSE 175,A01,510886,Kumar; Rakesh,30,0,30,0
1713329143738,CSE 190,A00,516828,Dubnov; Shlomo,38,0,49,11
1713329144769,DOC 100D,A00,489667,Pass; Natalye Joann,19,0,25,6
1713329145796,DSC 10,A01,624268,Staff,72,0,75,3
1713329146822,DSC 20,A01,624476,Staff,50,0,50,0
1713329147845,DSC 40A,A01,624608,Staff,39,0,40,1
1713329148870,DSGN 1,A01,489179,Rill; Bryan,32,0,50,18
1713329149897,ECE 17,A01,490489,Sahay; Rajeev,18,0,30,12
1713329150923,ECE 65,A50,490492,Staff,12,0,20,8
1713329150923,ECE 65,A51,490493,Staff,18,0,20,2
1713329151952,ECON 1,A01,489715,Famulari; Melissa,67,0,70,3
1713329152981,ECON 2,A01,489717,Levkoff; Steven B.,68,0,70,2
1713329154011,ECON 3,A01,489948,Staff,70,0,70,0
1713329156128,ECON 5,A01,490103,Staff,27,0,30,3
1713329156128,ECON 5,B01,626281,Dai; Yinlin,45,0,45,0
1713329157154,ECON 100A,A01,490127,Famulari; Melissa,65,0,70,5
1713329158180,ECON 100B,A01,490129,Staff,64,0,70,6
1713329159211,ECON 109,A01,490187,Shishkin; Denis,27,0,35,8
1713329160241,ECON 110A,A01,490190,Levkoff; Steven B.,60,0,70,10
1713329161266,ECON 120A,A01,490245,Dai; Yinlin,61,0,70,9
1713329162297,ECON 120B,A01,490247,Nieto-Barthaburu; Augusto,40,0,70,30
1713329163324,ECON 120C,A01,490253,Sun; Yixiao,30,0,35,5
1713329163324,ECON 120C,B01,490255,Sun; Yixiao,34,0,35,1
1713329164357,ECON 129,A00,490256,Eckert; Fabian Paul,23,0,35,12
1713329165383,ECON 131,A00,490257,Nieto-Barthaburu; Augusto,0,6,35,35
1713329166410,ECON 138,A00,490258,Bharadwaj; Prashant,13,0,35,22
1713329166410,ECON 138,B00,490259,Bharadwaj; Prashant,15,0,35,20
1713329167442,ECON 159,A00,490260,Hendrickson; Gerald M.,0,9,0,0
1713329168477,ECON 178,A01,553995,Zhu; Ying,24,0,35,11
1713329169509,EDS 40,A01,512576,Black; Alison Michelle,20,0,20,0
1713329170538,EDS 107,A01,515848,Staff,30,0,30,0
1713329171569,EDS 110R,A01,490262,Staff,26,0,30,4
1713329172595,EDS 112,A01,490264,Chapman; Thandeka K,40,0,50,10
1713329173624,EDS 113,A00,490266,Staff,26,0,30,4
1713329174649,EDS 118,A00,490267,Warstadt; Melissa Fawn,20,0,30,10
1713329175678,EDS 124BR,A00,490268,Eguchi; Emi,4,0,25,21
1713329175678,EDS 124BR,B00,490269,Eguchi; Emi,23,0,25,2
1713329176705,EDS 126,A01,490271,Jones; Makeba,43,0,50,7
1713329177729,EDS 135,A01,490316,Staff,19,0,20,1
1713329178760,ENVR 142GS,A00,519514,Chang; Edmond Yi-Teh,26,0,28,2
1713329179787,ETHN 103,A00,490504,Staff,25,0,36,11
1713329180816,ETHN 103A,A00,490505,Man; Simeon S,4,0,9,5
1713329181841,ETHN 109,A00,490506,Staff,28,0,30,2
1713329182871,ETHN 118,A00,490507,Staff,35,0,36,1
1713329183903,ETHN 119,A00,490508,Staff,33,0,36,3
1713329184929,ETHN 121R,A00,490518,Choi; Esther Min,21,0,36,15
1713329185957,ETHN 127,A00,490528,Staff,14,0,15,1
1713329186983,ETHN 139,A00,490573,Staff,10,0,10,0
1713329188012,ETHN 150,A00,490575,Staff,15,0,15,0
1713329189044,GLBH 20,A00,491705,Elwardani; Nile Regina,38,0,40,2
1713329190069,GLBH 101,A00,491706,Staff,20,0,20,0
1713329191095,GLBH 111,A01,491708,Burgos; Jose L.,15,0,15,0
1713329192120,GLBH 146,A00,491709,Staff,9,0,20,11
1713329193149,GLBH 148,A00,491710,Olivas Hernandez; Olga Lid,11,0,20,9
1713329194176,GLBH 150,A00,491711,Sloane; Julia Kathryn,19,0,20,1
1713329195201,HIEA 131,A00,491760,Staff,28,0,32,4
1713329196226,HIEA 153,A00,491762,Staff,28,0,30,2
1713329197253,HIEU 124,A00,491811,Staff,26,0,32,6
1713329198284,HIEU 124GS,A00,491812,Markman; Kristina,27,0,28,1
1713329199308,HIEU 147,A00,491813,Staff,30,0,32,2
1713329200341,HIEU 149GS,A00,491816,Caldwell; Michael Alan,28,0,28,0
1713329201372,HILD 2C,A01,491713,Hendrickson; Gerald M.,26,0,30,4
1713329202399,HILD 7B,A01,491715,Kwak; Nancy,0,2,30,30
1713329203423,HILD 10,A01,491717,Staff,11,0,20,9
1713329204452,HILD 30GS,A00,491719,Edington; Claire Ellen,24,0,28,4
1713329205478,HINE 109,A00,491818,Shafir; Nir,27,0,32,5
1713329206503,HINE 128,A00,491821,Shafir; Nir,31,0,32,1
1713329207527,HISC 117,A00,491830,Staff,27,0,32,5
1713329208557,HIUS 103,A00,491834,Man; Simeon S,14,0,23,9
1713329209582,HIUS 108B,A00,491835,Staff,28,0,30,2
1713329210611,HIUS 141,A00,491836,Hendrickson; Gerald M.,28,0,32,4
1713329211641,HIUS 149,A00,491839,Staff,24,0,32,8
1713329212670,HUM 3,A01,512617,Crum; Matthew Stephen,42,0,50,8
1713329212670,HUM 3,A02,512618,Crum; Matthew Stephen,48,0,50,2
1713329213695,HUM 3GS,A00,512663,Markman; Kristina,0,0,0,1
1713329213695,HUM 3GS,B00,512664,Staff,0,0,0,0
1713329214721,HUM 4,A01,512620,West; Geoffrey Scott,26,0,50,24
1713329215750,HUM 4GS,A00,512666,Lyon; Antony J.,0,0,0,4
1713329216778,HUM 4R,A01,512625,Watkins; Eric,49,0,50,1
1713329217808,HUM 5,A01,512649,Zavodny; Tatiana Sophia,23,0,50,27
1713329217808,HUM 5,B01,512661,Zroka; Ryan Edward,48,0,50,2
1713329218834,INTL 190,A00,490577,Segui; Alan S,0,0,0,5
1713329219860,JAPN 20AR,A01,491267,Ross; Kayoko F,7,0,20,13
1713329220885,JAPN 180,A00,491285,Berman; Michael David,33,0,40,7
1713329221912,LATI 50,A01,502536,Kokinis; Troy Andreas,16,0,22,6
1713329221912,LATI 50,A02,502551,Kokinis; Troy Andreas,22,0,22,0
1713329221912,LATI 50,A03,502650,Kokinis; Troy Andreas,22,0,22,0
1713329221912,LATI 50,A04,502909,Kokinis; Troy Andreas,21,0,22,1
1713329222939,LATI 160,A01,502920,Kokinis; Troy Andreas,30,0,30,0
1713329223965,LIFR 1A,A00,490494,Van Moer; Vinciane G,17,0,20,3
1713329224994,LIFR 1AX,A00,490495,Van Moer; Vinciane G,17,0,20,3
1713329226019,LIFR 1B,A00,490496,Van Moer; Vinciane G,18,0,20,2
1713329227045,LIFR 1BX,A00,490497,Van Moer; Vinciane G,18,0,20,2
1713329228072,LIGN 8,A00,505198,McIntosh; Justin Daniel,134,0,150,16
1713329229103,LIGN 9GS,A00,491239,Lott; Margaret S.,18,0,20,2
1713329230128,LIGN 101,A01,505200,McIntosh; Justin Daniel,22,0,30,8
1713329231153,LIGN 120,A01,491244,Staff,22,0,30,8
1713329232179,LIGN 149GS,A00,491245,Lott; Margaret S.,18,0,20,2
1713329233205,LIGN 170,A00,491247,Staff,22,0,30,8
1713329234235,LISP 1D,A00,490498,Munoz Sanchez; Alicia,9,0,14,5
1713329234235,LISP 1D,B00,490499,Munoz Sanchez; Alicia,6,0,14,8
1713329234235,LISP 1D,C00,490500,Munoz Sanchez; Alicia,7,0,14,7
1713329234235,LISP 1D,D00,490501,Munoz Sanchez; Alicia,10,0,14,4
1713329235260,LISP 1DX,A00,490502,Munoz Sanchez; Alicia,14,0,28,14
1713329235260,LISP 1DX,B00,490503,Munoz Sanchez; Alicia,16,0,28,12
1713329237311,LTAM 110,A00,491847,Staff,22,0,25,3
1713329238335,LTCS 119,A00,491848,Staff,11,0,15,4
1713329239361,LTCS 130,A00,491849,Staff,24,0,25,1
1713329241412,LTEA 120C,A00,491852,Staff,32,0,40,8
1713329242437,LTEN 130GS,A00,491853,Lyon; Antony J.,24,0,28,4
1713329243464,LTEN 148,A00,491855,Staff,23,0,25,2
1713329244493,LTEN 159,A00,491856,Staff,20,0,25,5
1713329245521,LTEN 180,A00,491857,Staff,8,0,15,7
1713329247578,LTSP 123GS,A00,505928,Bessett; Ryan Matthew,24,0,28,4
1713329248605,LTSP 174GS,A00,506037,Bessett; Ryan Matthew,24,0,28,4
1713329250655,LTWR 102,A00,491861,Staff,9,0,15,6
1713329251684,LTWR 106,A00,491862,Staff,8,0,15,7
1713329252711,MAE 11,A00,490930,Bahadori; Mohammad Yousef,95,0,100,5
1713329253738,MAE 30A,A00,490931,Qi; Huihui,37,0,40,3
1713329254843,MAE 101A,A00,491036,Sadeghizadeh; Zahra,92,0,100,8
1713329255873,MAE 101C,A00,491037,Seshadri; Kalyanasundaram,67,0,100,33
1713329256901,MAE 113,A00,491040,Seshadri; Kalyanasundaram,66,0,80,14
1713329257926,MAE 131A,A00,491041,Ghazinejad; Maziar,37,0,40,3
1713329258950,MAE 142,A00,491053,Staff,39,0,40,1
1713329260030,MAE 143A,A00,491054,Staff,32,0,50,18
1713329261059,MAE 150,A00,491092,Truong; Phuong Thi Ngoc,23,0,35,12
1713329262086,MATH 3C,A01,494031,Pardo Guerra; Sebastian,30,0,30,0
1713329262086,MATH 3C,A02,494032,Pardo Guerra; Sebastian,29,0,30,1
1713329263113,MATH 10A,A01,494034,Staff,27,0,30,3
1713329263113,MATH 10A,A02,494035,Staff,28,0,30,2
1713329263113,MATH 10A,B01,494037,Staff,27,0,30,3
1713329263113,MATH 10A,B02,494038,Staff,29,0,30,1
1713329264140,MATH 10B,A01,494040,Habib; Yousaf,22,0,30,8
1713329264140,MATH 10B,A02,494041,Habib; Yousaf,28,0,30,2
1713329264140,MATH 10B,A03,494042,Habib; Yousaf,29,0,30,1
1713329264140,MATH 10B,A04,494043,Habib; Yousaf,30,0,30,0
1713329264140,MATH 10B,B01,494045,Habib; Yousaf,25,0,30,5
1713329264140,MATH 10B,B02,494046,Habib; Yousaf,30,0,30,0
1713329264140,MATH 10B,B03,494047,Habib; Yousaf,30,0,30,0
1713329264140,MATH 10B,B04,494048,Habib; Yousaf,30,0,30,0
1713329265169,MATH 18,A01,494050,Kemp; Todd Aahron,25,0,30,5
1713329265169,MATH 18,A02,494051,Kemp; Todd Aahron,29,0,30,1
1713329265169,MATH 18,B01,494054,Kemp; Todd Aahron,26,0,30,4
1713329265169,MATH 18,B02,494055,Kemp; Todd Aahron,29,0,30,1
1713329266195,MATH 20A,A01,494059,Suk; Andrew Hoon,30,0,30,0
1713329267221,MATH 20B,A01,494061,Briones; Jor-el Thomas Caparas,33,0,35,2
1713329267221,MATH 20B,B01,494063,Bach; Quang Tran,34,0,35,1
1713329268246,MATH 20C,A01,494065,Staff,28,0,30,2
1713329268246,MATH 20C,A02,494066,Staff,30,0,30,0
1713329268246,MATH 20C,A03,494067,Staff,30,0,30,0
1713329268246,MATH 20C,A04,494068,Staff,30,0,30,0
1713329268246,MATH 20C,B01,494070,Zhang; Ming,25,0,30,5
1713329268246,MATH 20C,B02,494071,Zhang; Ming,27,0,30,3
1713329268246,MATH 20C,B03,494072,Zhang; Ming,29,0,30,1
1713329268246,MATH 20C,B04,494073,Zhang; Ming,29,0,30,1
1713329269272,MATH 20D,A01,494075,Staff,22,0,30,8
1713329269272,MATH 20D,A02,494076,Staff,29,0,30,1
1713329270299,MATH 20E,A01,494079,Staff,24,0,30,6
1713329270299,MATH 20E,A02,494080,Staff,26,0,30,4
1713329270299,MATH 20E,B01,494082,Staff,25,0,30,5
1713329270299,MATH 20E,B02,494083,Staff,25,0,30,5
1713329271325,MATH 103A,A01,494085,Aliabadi Sr.; Mohsen,14,0,30,16
1713329271325,MATH 103A,A02,494086,Aliabadi Sr.; Mohsen,28,0,30,2
1713329271325,MATH 103A,B01,494088,Aliabadi Sr.; Mohsen,21,0,30,9
1713329271325,MATH 103A,B02,494089,Aliabadi Sr.; Mohsen,27,0,30,3
1713329272351,MATH 109,A01,494091,Staff,30,0,30,0
1713329272351,MATH 109,A02,494092,Staff,29,0,30,1
1713329272351,MATH 109,B01,494094,Staff,27,0,30,3
1713329272351,MATH 109,B02,494095,Staff,29,0,30,1
1713329273383,MATH 142A,A01,494097,Chow; Bennett,15,0,30,15
1713329273383,MATH 142A,A02,494098,Chow; Bennett,23,0,30,7
1713329273383,MATH 142A,B01,494100,Chow; Bennett,19,0,30,11
1713329273383,MATH 142A,B02,494101,Chow; Bennett,29,0,30,1
1713329275521,MATH 168A,A01,516677,Dumitriu; Ioana,16,0,35,19
1713329276548,MATH 170A,A01,516679,Dumitriu; Ioana,18,0,30,12
1713329276548,MATH 170A,A02,516680,Dumitriu; Ioana,28,0,30,2
1713329277572,MATH 193A,A01,494107,Staff,14,0,30,16
1713329277572,MATH 193A,A02,494108,Staff,19,0,30,11
1713329277572,MATH 193A,A03,494109,Staff,29,0,30,1
1713329277572,MATH 193A,A04,494110,Staff,22,0,30,8
1713329280651,MGT 16,A00,491930,McKay; Michael J,92,0,98,6
1713329292924,MGT 18,A00,491992,McKay; Michael J,96,0,98,2
1713329293952,MGT 71,A00,492003,Staff,65,0,98,33
1713329294984,MGT 103,A00,505209,Eberhard; Craig A,81,0,98,17
1713329296010,MGT 131A,A00,505210,Anderson; John Charles,89,0,98,9
1713329298060,MGT 153,A00,492077,Perols; Johan Lars,19,0,90,71
1713329301143,MGT 164,A00,492222,McKay; Mary A,91,0,98,7
1713329302175,MGT 172,A00,492245,Staff,59,0,60,1
1713329302175,MGT 172,B00,505526,Hedges; Kathleen,65,0,98,33
1713329303257,MGT 181,A00,505669,Dunn; Louis Jean,82,0,98,16
1713329304284,MMW 14,A01,494399,Staff,15,0,28,13
1713329304284,MMW 14,A02,494400,Staff,25,0,28,3
1713329304284,MMW 14,A03,494401,Staff,28,0,28,0
1713329304284,MMW 14,A04,494402,Staff,28,0,28,0
1713329304284,MMW 14,B01,494404,Carreras; Maria Victoria,8,0,28,20
1713329304284,MMW 14,B02,494405,Carreras; Maria Victoria,25,0,28,3
1713329304284,MMW 14,B03,494406,Carreras; Maria Victoria,27,0,28,1
1713329304284,MMW 14,B04,494407,Carreras; Maria Victoria,28,0,28,0
1713329305313,MMW 14GS,A00,506250,Chang; Edmond Yi-Teh,0,0,0,0
1713329306342,MMW 121R,A01,494415,Adamiak; Patrick John,10,0,28,18
1713329306342,MMW 121R,A02,494416,Adamiak; Patrick John,24,0,28,4
1713329307366,MUS 1A,A01,494113,Staff,12,0,25,13
1713329307366,MUS 1A,A02,494114,Staff,24,0,25,1
1713329308395,MUS 4,A01,494116,Staff,23,0,25,2
1713329308395,MUS 4,A02,494117,Staff,22,0,25,3
1713329309422,MUS 5R,A01,494236,Dubnov; Shlomo,6,0,25,19
1713329309422,MUS 5R,A02,494237,Dubnov; Shlomo,25,0,25,0
1713329310447,MUS 6,A01,494122,Staff,10,0,25,15
1713329310447,MUS 6,A02,494123,Staff,23,0,25,2
1713329311471,MUS 7,A01,494125,Staff,16,0,25,9
1713329311471,MUS 7,A02,494126,Staff,24,0,25,1
1713329312498,MUS 11,A01,494128,Staff,23,0,25,2
1713329312498,MUS 11,A02,494129,Staff,24,0,25,1
1713329313527,MUS 13,A01,494131,Staff,25,0,25,0
1713329313527,MUS 13,A02,494132,Staff,25,0,25,0
1713329314557,MUS 15,A01,494134,Staff,17,0,25,8
1713329314557,MUS 15,A02,494135,Staff,25,0,25,0
1713329314557,MUS 15,B01,494137,Staff,24,0,25,1
1713329315582,MUS 80,A00,494232,Staff,24,0,25,1
1713329315582,MUS 80,B00,494233,Staff,25,0,25,0
1713329315582,MUS 80,C00,494234,Staff,23,0,25,2
1713329316608,MUS 95C,A00,494141,Staff,70,0,75,5
1713329317637,MUS 114,A00,494142,Staff,40,0,50,10
1713329318664,NANO 15,A01,490636,Drews; Aaron,7,0,7,0
1713329319689,PHIL 1,A00,490578,Grush; Rick Scott,49,0,50,1
1713329320718,PHIL 10,A01,490580,Grush; Rick Scott,33,0,35,2
1713329320718,PHIL 10,A02,490586,Grush; Rick Scott,32,0,35,3
1713329321743,PHIL 27,A01,490591,Staff,22,0,25,3
1713329321743,PHIL 27,A02,490592,Staff,25,0,25,0
1713329321743,PHIL 27,A03,490593,Staff,25,0,25,0
1713329321743,PHIL 27,A04,490598,Staff,25,0,25,0
1713329322772,PHIL 32,A01,490611,Staff,20,0,20,0
1713329322772,PHIL 32,A02,490618,Staff,20,0,20,0
1713329323801,PHIL 90,A00,490624,Staff,40,0,40,0
1713329324826,PHIL 136,A00,490627,Cohen; Jonathan David,37,0,40,3
1713329325851,PHIL 155,A00,490634,Staff,62,0,70,8
1713329326953,PHYS 1A,A00,491610,Staff,245,0,250,5
1713329327983,PHYS 1AL,001,491616,Tsai; Philbert S,27,0,30,3
1713329327983,PHYS 1AL,002,491618,Tsai; Philbert S,30,0,30,0
1713329329010,PHYS 1B,A00,491623,Staff,236,0,250,14
1713329330039,PHYS 1BL,001,491626,Tsai; Philbert S,22,0,30,8
1713329330039,PHYS 1BL,002,491628,Tsai; Philbert S,26,0,30,4
1713329331068,PHYS 1C,A00,491632,Staff,214,0,245,31
1713329332092,PHYS 1CL,001,491635,Tsai; Philbert S,2,0,30,28
1713329332092,PHYS 1CL,002,491643,Tsai; Philbert S,22,0,30,8
1713329333117,PHYS 2AR,A01,491651,Meyertholen; Andrew D.,44,0,50,6
1713329334143,PHYS 2B,A01,491659,Staff,106,0,115,9
1713329335171,PHYS 2BL,A01,491685,Staff,21,0,24,3
1713329335171,PHYS 2BL,A02,491700,Staff,21,0,24,3
1713329336200,PHYS 2C,A01,505161,Staff,102,0,115,13
1713329337230,PHYS 4A,A01,491704,Grinstein; Benjamin,99,0,100,1
1713329338258,POLI 5D,A01,494144,Staff,3,0,5,2
1713329338258,POLI 5D,B01,626283,Dai; Yinlin,5,0,5,0
1713329339287,POLI 12,A00,494145,Staff,43,0,45,2
1713329340313,POLI 13R,A00,494146,Forman; Fonna,45,0,50,5
1713329341345,POLI 27,A01,494148,Staff,54,0,60,6
1713329342371,POLI 30,A00,494149,Staff,49,0,50,1
1713329343398,POLI 100DA,A00,494150,Staff,21,0,25,4
1713329345450,POLI 100I,A00,494152,Staff,27,0,30,3
1713329346479,POLI 104B,A00,494153,Smith; Glenn Chatmas,53,0,55,2
1713329347509,POLI 104F,A00,494154,Staff,28,0,30,2
1713329348536,POLI 104I,A00,494155,Smith; Glenn Chatmas,29,0,30,1
1713329349561,POLI 110C,A00,494156,Ingham; Sean,23,0,25,2
1713329350586,POLI 117R,A00,494157,Forman; Fonna,8,0,20,12
1713329351609,POLI 118,A00,494158,Ingham; Sean,21,0,25,4
1713329352634,POLI 120H,A00,494159,Fisk; David Lee,39,0,45,6
1713329353664,POLI 131CR,A00,494160,Hoston; Germaine,35,0,45,10
1713329354690,POLI 133J,A00,494161,Staff,32,0,35,3
1713329355717,POLI 135,A00,494162,Fisk; David Lee,33,0,35,2
1713329356745,POLI 140A,A00,494164,Staff,19,0,30,11
1713329357772,POLI 142I,A00,494165,Staff,30,0,30,0
1713329358800,POLI 144D,A00,494166,Staff,23,0,25,2
1713329359824,POLI 151,A00,494167,Staff,30,0,30,0
1713329360847,POLI 153,A00,494168,Staff,33,0,35,2
1713329361876,POLI 160AA,A00,494169,Staff,34,0,40,6
1713329362901,POLI 162,A00,494170,Mignozzetti; Umberto,18,0,25,7
1713329363926,POLI 171,A00,494171,Mignozzetti; Umberto,18,0,25,7
1713329364958,PSYC 1,A00,494172,Staff,96,0,100,4
1713329365984,PSYC 2,A00,494173,Moranton; Nirelia Melbina-,34,0,50,16
1713329367013,PSYC 3,A00,494174,Staff,29,0,30,1
1713329368037,PSYC 6,A00,494175,Staff,17,0,20,3
1713329369062,PSYC 60,A01,494177,Staff,38,0,45,7
1713329370087,PSYC 70,A01,505724,Geller; Emma Harlan,42,0,45,3
1713329371111,PSYC 101,A00,494180,Heyman; Gail D.,84,0,100,16
1713329372135,PSYC 105,A00,494181,Geller; Emma Harlan,51,0,90,39
1713329373163,PSYC 106,A00,494182,Dobkins; Karen R.,27,0,45,18
1713329374188,PSYC 108,A00,494183,Adrian; Julia Anna,89,0,100,11
1713329375268,PSYC 114,A01,494185,Winkielman; Piotr,0,2,30,30
1713329376296,PSYC 122,A00,494186,Moranton; Nirelia Melbina-,28,0,50,22
1713329377325,PSYC 124,A00,494187,Chapman; Eddie Nathaniel,71,0,80,9
1713329378354,PSYC 131,A00,494188,Anagnostaras; Stephan,40,0,80,40
1713329379378,PSYC 144,A00,494189,Staff,5,0,50,45
1713329380405,PSYC 154,A00,494190,Lacefield; Katharine I,107,0,180,73
1713329381432,PSYC 162,A00,494191,Wixted; John T,71,0,100,29
1713329382464,PSYC 172,A00,494192,Gorman; Michael R.,36,0,45,9
1713329383490,PSYC 178,A00,494193,Glaser; Dale,34,0,45,11
1713329384516,PSYC 193,A00,505725,Chapman; Eddie Nathaniel,20,0,20,0
1713329385545,RELI 145GS,A00,519817,Rahimi; Babak,18,0,20,2
1713329386572,SE 101A,A01,490862,Chadha; Mayank,23,0,25,2
1713329387597,SE 101C,A01,490924,Krysl; Petr,15,0,20,5
1713329388624,SE 110A,A01,490928,Staff,19,0,20,1
1713329389654,SE 130A,A00,490929,Morrison; Machel Leigh,55,0,70,15
1713329390679,SIO 1,A01,519325,Staff,39,0,40,1
1713329391705,SIO 30,A01,519327,Staff,38,0,40,2
1713329392730,SIO 40,A00,519328,Staff,39,0,40,1
1713329393756,SIO 46GS,A00,519819,Cook; Geoffrey W,17,0,25,8
1713329394782,SIO 109R,A00,494197,Forman; Fonna,0,3,20,20
1713329395809,SIO 121GS,A00,519827,Cook; Geoffrey W,17,0,25,8
1713329396835,SIO 132,A01,519330,Staff,38,0,40,2
1713329397862,SIO 133,A01,519397,Staff,37,0,40,3
1713329398891,SIO 139,A00,519396,Kacev; David,29,0,40,11
1713329399917,SOCI 1,A01,494199,Thorpe; Charles Robert,21,0,30,9
1713329399917,SOCI 1,A02,494200,Thorpe; Charles Robert,30,0,30,0
1713329399917,SOCI 1,A03,494201,Thorpe; Charles Robert,29,0,30,1
1713329399917,SOCI 1,A04,494202,Thorpe; Charles Robert,29,0,30,1
1713329399917,SOCI 1,A05,494203,Thorpe; Charles Robert,29,0,30,1
1713329399917,SOCI 1,A06,494204,Thorpe; Charles Robert,30,0,30,0
1713329399917,SOCI 1,A07,494205,Thorpe; Charles Robert,28,0,30,2
1713329400947,SOCI 60,A01,494207,Staff,34,0,40,6
1713329400947,SOCI 60,A02,494208,Staff,39,0,40,1
1713329401973,SOCI 100,A01,494210,Payne; Christine Anna,25,0,30,5
1713329401973,SOCI 100,A02,494211,Payne; Christine Anna,26,0,30,4
1713329403001,SOCI 109M,A00,494212,Staff,20,0,20,0
1713329404026,SOCI 110,A00,494213,Staff,34,0,40,6
1713329406085,SOCI 118E,A00,494215,Ng; Kwai,37,0,40,3
1713329407115,SOCI 125,A00,494216,Calderon-Zaks; Michael Aar,40,0,45,5
1713329408140,SOCI 126,A01,494218,Jones; Makeba,3,0,5,2
1713329409168,SOCI 131,A00,494219,Thorpe; Charles Robert,26,0,30,4
1713329411224,SOCI 135,A00,494221,Payne; Christine Anna,28,0,50,22
1713329412250,SOCI 136E,A00,626690,Ruiz; Jonathan Joseph,24,0,25,1
1713329413278,SOCI 138GS,A00,494222,Navon; Daniel,24,0,28,4
1713329415334,SOCI 145,A00,494224,Staff,40,0,45,5
1713329416360,SOCI 153,A00,494225,Staff,28,0,30,2
1713329417387,SOCI 160E,A00,494226,Ng; Kwai,29,0,40,11
1713329418412,SOCI 180,A00,494227,Staff,29,0,30,1
1713329419438,SOCI 189GS,A00,494228,Ribas Norris; Janet Vanesa,11,0,11,0
1713329420464,SOCI 190GS,A00,553232,Ribas Norris; Janet Vanesa,11,0,11,0
1713329421490,SOMI 220,A00,627178,Schneid; Stephen David,30,0,30,0
1713329422523,SYN 2,001,490768,Staff,13,0,15,2
1713329422523,SYN 2,002,490769,Staff,14,0,15,1
1713329422523,SYN 2,004,490775,Staff,0,0,0,0
1713329422523,SYN 2,003,490774,Staff,0,0,0,0
1713329422523,SYN 2,005,490776,Staff,0,0,0,0
1713329423548,SYN 2R,001,490779,Staff,11,0,15,4
1713329423548,SYN 2R,002,514635,Staff,14,0,15,1
1713329424574,SYN 100,A01,490783,Staff,9,0,20,11
1713329424574,SYN 100,B01,490787,Staff,9,0,20,11
1713329424574,SYN 100,C01,490789,Staff,10,0,20,10
1713329425605,SYN 150,A00,490817,Staff,14,0,15,1
1713329425605,SYN 150,B00,514610,Staff,15,0,15,0
1713329426636,TDAC 1,A00,492753,Walsh; Kim C.,19,0,20,1
1713329426636,TDAC 1,B00,492754,Harting; Carla Kelso,19,0,20,1
1713329426636,TDAC 1,C00,513995,Salovey; Todd,15,0,20,5
1713329427662,TDAC 101,A00,492766,Harting; Carla Kelso,17,0,20,3
1713329428688,TDAC 102,A00,492768,Basso; Beatrice,19,0,20,1
1713329429714,TDDE 111,A00,492769,Staff,25,0,25,0
1713329430742,TDDE 131,A00,492770,Staff,15,0,15,0
1713329430742,TDDE 131,B00,492771,Staff,15,0,15,0
1713329431768,TDDE 131GS,A00,523716,Guirguis; Mark C,23,0,28,5
1713329432797,TDGE 1,A01,492756,Salovey; Todd,56,0,60,4
1713329433826,TDGE 5,A01,492758,Staff,23,0,25,2
1713329434852,TDGE 10,A00,492759,Fulton; Julia,203,0,220,17
1713329435883,TDGE 11,A00,492760,Castro; Robert Jess,198,0,200,2
1713329437932,TDGE 124,A00,492772,Fulton; Julia,185,0,220,35
1713329438956,TDGE 125,A00,492773,Meyer; Ursula,38,0,50,12
1713329438956,TDGE 125,B00,492774,Staff,49,0,50,1
1713329438956,TDGE 125,C00,523565,Staff,48,0,50,2
1713329439982,TDGE 125GS,A00,523580,Guirguis; Mark C,23,0,28,5
1713329441012,TDGE 127,A00,492775,Havis; Allan,34,0,50,16
1713329442038,TDHT 101,A00,492776,Staff,34,0,35,1
1713329443068,TDMV 1,A00,492762,Caligagan; Maria T.,30,0,30,0
1713329443068,TDMV 1,B00,492763,Arcidiacono; Kristin,26,0,30,4
1713329444090,TDMV 2,A00,492764,Weinberg; Sadie,28,0,30,2
1713329445115,TDMV 3,A00,492765,Mack; Kara Shanai',37,0,40,3
1713329446143,TDMV 138,A00,492777,Mack; Kara Shanai',34,0,40,6
1713329447170,TDMV 140,A00,492778,Lima; Paulo Henrique,40,0,40,0
1713329448197,TDMV 142,A00,492779,Caligagan; Maria T.,33,0,40,7
1713329448197,TDMV 142,B00,492780,Caligagan; Tony,37,0,40,3
1713329449221,TDMV 143,A00,492781,Fyall; Daunte Edward,39,0,40,1
1713329450249,USP 1,A01,492401,Kwak; Nancy,27,0,35,8
1713329451278,USP 2,A01,492453,Hinds; Juli Beth,35,0,35,0
1713329452304,USP 3,A01,492516,Staff,28,0,35,7
1713329453331,USP 4,A00,492522,McTague; Sarah,16,0,25,9
1713329454356,USP 100,A00,492523,Staff,32,0,35,3
1713329455384,USP 101,A00,492524,Staff,13,0,15,2
1713329456413,USP 105,A00,492525,Staff,21,0,25,4
1713329457443,USP 151,A00,492526,Shenkman; Michael Thomas,32,0,35,3
1713329458477,USP 170,A00,492545,Hinds; Juli Beth,33,0,35,2
1713329459504,USP 171GS,A00,492608,Bussell; Mirle Rabinowitz,24,0,28,4
1713329460536,USP 183GS,A00,492613,Peerson; Susan,24,0,28,4
1713329461561,VIS 30,A01,490693,Yoldas; Pinar,19,0,22,3
1713329461561,VIS 30,A02,490694,Yoldas; Pinar,18,0,22,4
1713329462587,VIS 83,A00,490695,Kester; Grant,63,0,75,12
1713329463613,VIS 105D,A00,490696,Staff,22,0,25,3
1713329464637,VIS 124CN,A00,490699,Rose; Jordan M,65,0,75,10
1713329465665,VIS 125GS,A00,511221,Williams; Alena J,21,0,22,1
1713329466697,VIS 128D,A00,490700,Staff,73,0,75,2
1713329467722,VIS 151,A01,490717,Staff,33,0,34,1
1713329467722,VIS 151,A02,490766,Staff,33,0,34,1
1713329468752,VIS 154GS,A00,511972,Williams; Alena J,21,0,22,1
1713329469777,VIS 160A,A00,490767,Stone; Patricia,7,0,10,3
1713329470807,WCWP 10A,A00,490638,Staff,14,0,15,1
1713329470807,WCWP 10A,B00,490640,Staff,15,0,15,0
1713329471835,WCWP 10B,A00,490641,Staff,0,0,0,0
1713329471835,WCWP 10B,B00,490642,Staff,14,0,15,1
1713329471835,WCWP 10B,C00,490644,Staff,13,0,15,2
1713329471835,WCWP 10B,D00,490647,Staff,0,0,0,0
1713329472860,WCWP 100,A00,490655,Staff,0,0,0,0
1713329472860,WCWP 100,B00,490687,Staff,10,0,15,5
1713329474984,ANAR 153,A00,487222,Braswell; Geoffrey E.,53,0,60,7
1713329476012,ANBI 134,A00,487223,Staff,5,0,20,15
1713329477038,ANBI 143GS,A00,487224,Noel; Geoffroy Pierre Jean,18,0,24,6
1713329478064,ANBI 144GS,A00,519548,Noel; Geoffroy Pierre Jean,18,0,24,6
1713329479145,ANSC 101,A00,487225,Staff,18,0,20,2
1713329480195,ANSC 125,A00,487227,Brenner; Suzanne A,39,0,40,1
1713329482245,ANSC 146,A00,487229,Staff,35,0,40,5
1713329483271,ANSC 148,A00,487230,Olivas Hernandez; Olga Lid,39,0,40,1
1713329484304,ANSC 150,A00,504165,Sloane; Julia Kathryn,18,0,20,2
1713329485332,ANSC 180,A00,487232,Staff,14,0,15,1
1713329486357,ANSC 188,A00,627155,Staff,39,0,40,1
1713329487388,ANTH 5,A00,519529,Semendeferi; Ekaterini,15,0,15,0
1713329488413,ANTH 10,A00,487219,Staff,58,0,60,2
1713329489442,ANTH 23,A01,487221,Staff,17,0,20,3
1713329490467,ANTH 102,A00,487233,Wilder; Linnea Lorene,51,0,60,9
1713329491493,ANTH 103,A00,487234,Varma; Saiba,55,0,60,5
1713329492523,ANTH 105,A00,487235,Stewart; Alexander B,54,0,60,6
1713329493548,BENG 100,A01,516685,Taylor Amos; Alyssa C,27,0,30,3
1713329494576,BIBC 102,A01,491316,Flagg; Matthew Paul,13,0,88,75
1713329494576,BIBC 102,A02,491366,Flagg; Matthew Paul,78,0,88,10
1713329495606,BIBC 103,A01,491486,Boumechache; Miyyada,16,0,24,8
1713329495606,BIBC 103,A02,491487,Boumechache; Miyyada,24,0,24,0
1713329496631,BICD 100,A01,516882,Staff,73,0,75,2
1713329496631,BICD 100,A02,516890,Staff,69,0,75,6
1713329497658,BICD 102GS,A00,491488,Lo; Stanley M.,26,0,28,2
1713329498687,BIEB 136GS,A00,516940,Holway; David A. & Shurin; Jonathan,18,0,24,6
1713329499714,BIEB 137GS,A01,517034,Holway; David A. & Shurin; Jonathan,18,0,24,6
1713329500742,BIEB 138GS,A01,491492,Pirino; Giorgia,21,0,28,7
1713329501772,BILD 1,A01,491296,Staff,60,0,63,3
1713329501772,BILD 1,A02,491297,Staff,63,0,63,0
1713329502800,BILD 4,A01,517099,Gonzalez Gamboa; Ivonne,22,0,24,2
1713329502800,BILD 4,A02,517100,Gonzalez Gamboa; Ivonne,24,0,24,0
1713329503830,BILD 60GS,A00,491309,Lo; Stanley M.,26,0,28,2
1713329504861,BIMM 100,A01,517136,Staff,84,0,100,16
1713329505887,BIMM 110,A01,517182,Staff,55,0,100,45
1713329506914,BIMM 120,A01,517228,Pickett; Brooke Elizabeth,28,0,63,35
1713329506914,BIMM 120,A02,517240,Pickett; Brooke Elizabeth,44,0,63,19
1713329507940,BIMM 132GS,A01,491498,Pirino; Giorgia,21,0,28,7
1713329508970,BIMM 143,A01,491589,Bozinovic; Goran,13,0,40,27
1713329509995,BIPN 100,A01,491594,Armour; Jon Christopher,84,0,100,16
1713329511021,BIPN 140,A01,491602,Marino; Marc J,26,0,50,24
1713329513078,CAT 125,A00,515973,Staff,18,0,20,2
1713329514102,CAT 125GS,A00,515974,Rahimi; Babak,17,0,20,3
1713329515134,CAT 125R,A00,515980,Staff,12,0,20,8
1713329515134,CAT 125R,B00,515981,Tosun; Adriana,19,0,20,1
1713329515134,CAT 125R,C00,515987,Hyland; Tina Mae,0,2,20,20
1713329515134,CAT 125R,D00,515988,Bronstein; Phoebe Malan,16,0,20,4
1713329516161,CENG 15,A01,488699,Drews; Aaron,25,0,25,0
1713329517190,CENG 100,A00,505196,Opatkiewicz; Justin Paul,25,0,25,0
1713329518216,CGS 2A,A01,489598,Staff,33,0,35,2
1713329519242,CGS 112,A00,489599,Staff,15,0,15,0
1713329520267,CGS 119,A00,489603,Staff,10,0,10,0
1713329521293,CGS 120,A00,489604,Staff,14,0,15,1
1713329522319,CGS 150,A00,489607,Staff,15,0,15,0
1713329523344,CHEM 6A,A01,488715,Staff,98,0,100,2
1713329524371,CHEM 6B,A01,488719,Piercy; Marc Anthony,99,0,100,1
1713329525400,CHEM 6C,A01,488723,Albizati; Kim F.,93,0,100,7
1713329526428,CHEM 7L,A01,488728,Schurmeier; Kimberly,18,0,24,6
1713329526428,CHEM 7L,A02,488730,Schurmeier; Kimberly,23,0,24,1
1713329526428,CHEM 7L,A03,488734,Schurmeier; Kimberly,20,0,24,4
1713329526428,CHEM 7L,A04,488763,Schurmeier; Kimberly,23,0,24,1
1713329526428,CHEM 7L,B01,488798,Schurmeier; Kimberly,17,0,24,7
1713329526428,CHEM 7L,B02,488801,Schurmeier; Kimberly,22,0,24,2
1713329526428,CHEM 7L,B03,488808,Schurmeier; Kimberly,23,0,24,1
1713329526428,CHEM 7L,B04,488811,Schurmeier; Kimberly,24,0,24,0
1713329527458,CHEM 11,A01,488897,Stallings; Dontarie M,95,0,100,5
1713329528483,CHEM 40A,A01,488913,Albizati; Kim F.,84,0,100,16
1713329529507,CHEM 40B,A01,488920,Weizman; Haim,43,0,50,7
1713329529507,CHEM 40B,A02,488938,Weizman; Haim,45,0,50,5
1713329530531,CHEM 41A,A01,489029,Klosterman; Jeremy K,57,0,60,3
1713329531557,CHEM 41C,A01,500436,Tor; Yitzhak,55,0,60,5
1713329532585,CHEM 43A,A01,500426,Weizman; Haim,0,0,24,24
1713329532585,CHEM 43A,A02,500430,Weizman; Haim,8,0,24,16
1713329532585,CHEM 43A,B01,514041,Klosterman; Jeremy K,16,0,24,8
1713329532585,CHEM 43A,B02,514047,Klosterman; Jeremy K,23,0,24,1
1713329533612,CHEM 108,A01,489140,Jennings; Patricia A.,9,0,24,15
1713329533612,CHEM 108,A02,489142,Jennings; Patricia A.,14,0,24,10
1713329534637,CHEM 114A,A01,489147,Stallings; Dontarie M,68,0,100,32
1713329535666,CHIN 169A,A00,489171,Wang; Xiao,19,0,20,1
1713329537720,COGS 3,A01,518827,Boyle; Mary E. T.,26,0,40,14
1713329538746,COGS 11,A01,489175,Staff,27,0,30,3
1713329539771,COGS 14A,A01,518829,Staff,51,0,60,9
1713329540799,COGS 14B,A01,489177,Hoffman; Drew Ellen,63,0,75,12
1713329541828,COGS 100,A01,489181,Allen; Michael Gordon,63,0,75,12
1713329542852,COGS 101A,A01,489183,Staff,46,0,60,14
1713329543877,COGS 101B,A01,489185,Allen; Michael Gordon,8,0,30,22
1713329544905,COGS 101C,A01,526786,Staff,23,0,30,7
1713329546959,COGS 107A,A01,489189,Boyle; Mary E. T.,17,0,35,18
1713329547989,COGS 107B,A01,627144,Mooshagian; Eric Frederick,60,0,60,0
1713329549013,COGS 118A,A01,489191,Staff,0,44,40,40
1713329551065,COGS 171GS,A01,489194,Pineda; Jaime A,20,0,28,8
1713329552089,COGS 172,A01,489196,Staff,3,0,30,27
1713329553113,COGS 174GS,A01,489264,Pineda; Jaime A,20,0,28,8
1713329554143,COGS 180,A01,627150,Staff,28,0,30,2
1713329555169,COGS 186,A01,489274,Staff,0,1,30,30
1713329556200,COMM 10,A01,489276,Staff,23,0,25,2
1713329556200,COMM 10,A02,489303,Staff,23,0,25,2
1713329557235,COMM 100A,A01,489312,Staff,14,0,25,11
1713329557235,COMM 100A,A02,489313,Staff,24,0,25,1
1713329558262,COMM 106T,A00,512540,Staff,33,0,35,2
1713329559292,COMM 107,A00,489347,Staff,27,0,35,8
1713329560321,COMM 109P,A00,489358,Staff,31,0,35,4
1713329561350,COMM 132,A00,489361,McKenna; Denise,27,0,30,3
1713329562375,COMM 146,A00,489362,Halm; Gavin Patrick,26,0,30,4
1713329563404,COMM 190,A00,489363,Abuelhiga; Soraya Jill,17,0,23,6
1713329564432,CSE 8A,A50,489366,Staff,21,0,25,4
1713329564432,CSE 8A,A51,489367,Staff,24,0,25,1
1713329565461,CSE 11,A01,489398,Cao; Yingjun,73,0,100,27
1713329566491,CSE 12,A01,489487,Staff,43,0,50,7
1713329567517,CSE 20,A01,489497,Staff,48,0,50,2
1713329568546,CSE 21,A01,489517,Braun; Oliver,42,0,50,8
1713329569574,CSE 101,A01,489524,Braun; Oliver,0,29,50,50
1713329570599,CSE 105,A01,512594,Jones; Miles E,72,0,100,28
1713329570599,CSE 105,B01,512598,Jones; Miles E,52,0,100,48
1713329571759,CSE 140,A01,489538,Staff,41,0,50,9
1713329572787,CSE 141,A01,489550,Eldon; John,68,0,100,32
1713329573815,CSE 141L,A01,489571,Eldon; John,66,0,100,34
1713329574843,CSE 151A,A01,489583,Solares; Edwin A,141,0,200,59
1713329575870,CSE 175,A01,510886,Kumar; Rakesh,30,0,30,0
1713329576899,CSE 190,A00,516828,Dubnov; Shlomo,38,0,49,11
1713329577929,DOC 100D,A00,489667,Pass; Natalye Joann,19,0,25,6
1713329578953,DSC 10,A01,624268,Staff,72,0,75,3
1713329579981,DSC 20,A01,624476,Staff,50,0,50,0
1713329581013,DSC 40A,A01,624608,Staff,39,0,40,1
1713329582044,DSGN 1,A01,489179,Rill; Bryan,32,0,50,18
1713329583129,ECE 17,A01,490489,Sahay; Rajeev,18,0,30,12
1713329584154,ECE 65,A50,490492,Staff,12,0,20,8
1713329584154,ECE 65,A51,490493,Staff,18,0,20,2
1713329585181,ECON 1,A01,489715,Famulari; Melissa,67,0,70,3
1713329586206,ECON 2,A01,489717,Levkoff; Steven B.,68,0,70,2
1713329587231,ECON 3,A01,489948,Staff,70,0,70,0
1713329589284,ECON 5,A01,490103,Staff,27,0,30,3
1713329589284,ECON 5,B01,626281,Dai; Yinlin,45,0,45,0
1713329590312,ECON 100A,A01,490127,Famulari; Melissa,65,0,70,5
1713329591340,ECON 100B,A01,490129,Staff,64,0,70,6
1713329592365,ECON 109,A01,490187,Shishkin; Denis,27,0,35,8
1713329593391,ECON 110A,A01,490190,Levkoff; Steven B.,60,0,70,10
1713329594421,ECON 120A,A01,490245,Dai; Yinlin,61,0,70,9
1713329595449,ECON 120B,A01,490247,Nieto-Barthaburu; Augusto,40,0,70,30
1713329596475,ECON 120C,A01,490253,Sun; Yixiao,30,0,35,5
1713329596475,ECON 120C,B01,490255,Sun; Yixiao,34,0,35,1
1713329597502,ECON 129,A00,490256,Eckert; Fabian Paul,23,0,35,12
1713329598528,ECON 131,A00,490257,Nieto-Barthaburu; Augusto,0,6,35,35
1713329599554,ECON 138,A00,490258,Bharadwaj; Prashant,13,0,35,22
1713329599554,ECON 138,B00,490259,Bharadwaj; Prashant,15,0,35,20
1713329600583,ECON 159,A00,490260,Hendrickson; Gerald M.,0,9,0,0
1713329601609,ECON 178,A01,553995,Zhu; Ying,24,0,35,11
1713329602639,EDS 40,A01,512576,Black; Alison Michelle,20,0,20,0
1713329603668,EDS 107,A01,515848,Staff,30,0,30,0
1713329604692,EDS 110R,A01,490262,Staff,26,0,30,4
1713329605720,EDS 112,A01,490264,Chapman; Thandeka K,40,0,50,10
1713329606745,EDS 113,A00,490266,Staff,26,0,30,4
1713329607774,EDS 118,A00,490267,Warstadt; Melissa Fawn,20,0,30,10
1713329608802,EDS 124BR,A00,490268,Eguchi; Emi,4,0,25,21
1713329608802,EDS 124BR,B00,490269,Eguchi; Emi,23,0,25,2
1713329609827,EDS 126,A01,490271,Jones; Makeba,43,0,50,7
1713329610855,EDS 135,A01,490316,Staff,19,0,20,1
1713329611884,ENVR 142GS,A00,519514,Chang; Edmond Yi-Teh,26,0,28,2
1713329612909,ETHN 103,A00,490504,Staff,25,0,36,11
1713329613937,ETHN 103A,A00,490505,Man; Simeon S,4,0,9,5
1713329614962,ETHN 109,A00,490506,Staff,28,0,30,2
1713329615987,ETHN 118,A00,490507,Staff,35,0,36,1
1713329617023,ETHN 119,A00,490508,Staff,33,0,36,3
1713329618048,ETHN 121R,A00,490518,Choi; Esther Min,21,0,36,15
1713329619076,ETHN 127,A00,490528,Staff,14,0,15,1
1713329620106,ETHN 139,A00,490573,Staff,10,0,10,0
1713329621134,ETHN 150,A00,490575,Staff,15,0,15,0
1713329622158,GLBH 20,A00,491705,Elwardani; Nile Regina,38,0,40,2
1713329623183,GLBH 101,A00,491706,Staff,20,0,20,0
1713329624208,GLBH 111,A01,491708,Burgos; Jose L.,15,0,15,0
1713329625234,GLBH 146,A00,491709,Staff,9,0,20,11
1713329626260,GLBH 148,A00,491710,Olivas Hernandez; Olga Lid,11,0,20,9
1713329627290,GLBH 150,A00,491711,Sloane; Julia Kathryn,19,0,20,1
1713329628316,HIEA 131,A00,491760,Staff,28,0,32,4
1713329629342,HIEA 153,A00,491762,Staff,28,0,30,2
1713329630370,HIEU 124,A00,491811,Staff,26,0,32,6
1713329631395,HIEU 124GS,A00,491812,Markman; Kristina,27,0,28,1
1713329632421,HIEU 147,A00,491813,Staff,30,0,32,2
1713329633450,HIEU 149GS,A00,491816,Caldwell; Michael Alan,28,0,28,0
1713329634478,HILD 2C,A01,491713,Hendrickson; Gerald M.,26,0,30,4
1713329635508,HILD 7B,A01,491715,Kwak; Nancy,0,2,30,30
1713329636537,HILD 10,A01,491717,Staff,11,0,20,9
1713329637565,HILD 30GS,A00,491719,Edington; Claire Ellen,24,0,28,4
1713329638591,HINE 109,A00,491818,Shafir; Nir,27,0,32,5
1713329639618,HINE 128,A00,491821,Shafir; Nir,31,0,32,1
1713329640643,HISC 117,A00,491830,Staff,27,0,32,5
1713329641674,HIUS 103,A00,491834,Man; Simeon S,14,0,23,9
1713329642703,HIUS 108B,A00,491835,Staff,28,0,30,2
1713329643730,HIUS 141,A00,491836,Hendrickson; Gerald M.,28,0,32,4
1713329644754,HIUS 149,A00,491839,Staff,24,0,32,8
1713329645782,HUM 3,A01,512617,Crum; Matthew Stephen,42,0,50,8
1713329645782,HUM 3,A02,512618,Crum; Matthew Stephen,48,0,50,2
1713329646809,HUM 3GS,A00,512663,Markman; Kristina,0,0,0,1
1713329646809,HUM 3GS,B00,512664,Staff,0,0,0,0
1713329647837,HUM 4,A01,512620,West; Geoffrey Scott,26,0,50,24
1713329648866,HUM 4GS,A00,512666,Lyon; Antony J.,0,0,0,4
1713329649893,HUM 4R,A01,512625,Watkins; Eric,49,0,50,1
1713329650918,HUM 5,A01,512649,Zavodny; Tatiana Sophia,23,0,50,27
1713329650918,HUM 5,B01,512661,Zroka; Ryan Edward,48,0,50,2
1713329651945,INTL 190,A00,490577,Segui; Alan S,0,0,0,5
1713329652973,JAPN 20AR,A01,491267,Ross; Kayoko F,7,0,20,13
1713329654004,JAPN 180,A00,491285,Berman; Michael David,33,0,40,7
1713329655030,LATI 50,A01,502536,Kokinis; Troy Andreas,16,0,22,6
1713329655030,LATI 50,A02,502551,Kokinis; Troy Andreas,22,0,22,0
1713329655030,LATI 50,A03,502650,Kokinis; Troy Andreas,22,0,22,0
1713329655030,LATI 50,A04,502909,Kokinis; Troy Andreas,21,0,22,1
1713329656055,LATI 160,A01,502920,Kokinis; Troy Andreas,30,0,30,0
1713329657084,LIFR 1A,A00,490494,Van Moer; Vinciane G,17,0,20,3
1713329658111,LIFR 1AX,A00,490495,Van Moer; Vinciane G,17,0,20,3
1713329659135,LIFR 1B,A00,490496,Van Moer; Vinciane G,18,0,20,2
1713329660161,LIFR 1BX,A00,490497,Van Moer; Vinciane G,18,0,20,2
1713329661188,LIGN 8,A00,505198,McIntosh; Justin Daniel,134,0,150,16
1713329662218,LIGN 9GS,A00,491239,Lott; Margaret S.,18,0,20,2
1713329663243,LIGN 101,A01,505200,McIntosh; Justin Daniel,22,0,30,8
1713329664270,LIGN 120,A01,491244,Staff,22,0,30,8
1713329665297,LIGN 149GS,A00,491245,Lott; Margaret S.,18,0,20,2
1713329666324,LIGN 170,A00,491247,Staff,22,0,30,8
1713329667349,LISP 1D,A00,490498,Munoz Sanchez; Alicia,9,0,14,5
1713329667349,LISP 1D,B00,490499,Munoz Sanchez; Alicia,6,0,14,8
1713329667349,LISP 1D,C00,490500,Munoz Sanchez; Alicia,7,0,14,7
1713329667349,LISP 1D,D00,490501,Munoz Sanchez; Alicia,10,0,14,4
1713329668375,LISP 1DX,A00,490502,Munoz Sanchez; Alicia,14,0,28,14
1713329668375,LISP 1DX,B00,490503,Munoz Sanchez; Alicia,16,0,28,12
1713329670436,LTAM 110,A00,491847,Staff,22,0,25,3
1713329671465,LTCS 119,A00,491848,Staff,11,0,15,4
1713329672491,LTCS 130,A00,491849,Staff,24,0,25,1
1713329674545,LTEA 120C,A00,491852,Staff,32,0,40,8
1713329675571,LTEN 130GS,A00,491853,Lyon; Antony J.,24,0,28,4
1713329676596,LTEN 148,A00,491855,Staff,23,0,25,2
1713329677625,LTEN 159,A00,491856,Staff,20,0,25,5
1713329678652,LTEN 180,A00,491857,Staff,8,0,15,7
1713329680705,LTSP 123GS,A00,505928,Bessett; Ryan Matthew,24,0,28,4
1713329681731,LTSP 174GS,A00,506037,Bessett; Ryan Matthew,24,0,28,4
1713329683782,LTWR 102,A00,491861,Staff,9,0,15,6
1713329684807,LTWR 106,A00,491862,Staff,8,0,15,7
1713329685832,MAE 11,A00,490930,Bahadori; Mohammad Yousef,95,0,100,5
1713329686917,MAE 30A,A00,490931,Qi; Huihui,37,0,40,3
1713329687942,MAE 101A,A00,491036,Sadeghizadeh; Zahra,92,0,100,8
1713329688969,MAE 101C,A00,491037,Seshadri; Kalyanasundaram,67,0,100,33
1713329689998,MAE 113,A00,491040,Seshadri; Kalyanasundaram,66,0,80,14
1713329691023,MAE 131A,A00,491041,Ghazinejad; Maziar,37,0,40,3
1713329692053,MAE 142,A00,491053,Staff,39,0,40,1
1713329693078,MAE 143A,A00,491054,Staff,32,0,50,18
1713329694108,MAE 150,A00,491092,Truong; Phuong Thi Ngoc,23,0,35,12
1713329695138,MATH 3C,A01,494031,Pardo Guerra; Sebastian,30,0,30,0
1713329695138,MATH 3C,A02,494032,Pardo Guerra; Sebastian,29,0,30,1
1713329696166,MATH 10A,A01,494034,Staff,27,0,30,3
1713329696166,MATH 10A,A02,494035,Staff,28,0,30,2
1713329696166,MATH 10A,B01,494037,Staff,27,0,30,3
1713329696166,MATH 10A,B02,494038,Staff,29,0,30,1
1713329697200,MATH 10B,A01,494040,Habib; Yousaf,22,0,30,8
1713329697200,MATH 10B,A02,494041,Habib; Yousaf,28,0,30,2
1713329697200,MATH 10B,A03,494042,Habib; Yousaf,29,0,30,1
1713329697200,MATH 10B,A04,494043,Habib; Yousaf,30,0,30,0
1713329697200,MATH 10B,B01,494045,Habib; Yousaf,25,0,30,5
1713329697200,MATH 10B,B02,494046,Habib; Yousaf,30,0,30,0
1713329697200,MATH 10B,B03,494047,Habib; Yousaf,30,0,30,0
1713329697200,MATH 10B,B04,494048,Habib; Yousaf,30,0,30,0
1713329698232,MATH 18,A01,494050,Kemp; Todd Aahron,25,0,30,5
1713329698232,MATH 18,A02,494051,Kemp; Todd Aahron,29,0,30,1
1713329698232,MATH 18,B01,494054,Kemp; Todd Aahron,26,0,30,4
1713329698232,MATH 18,B02,494055,Kemp; Todd Aahron,29,0,30,1
1713329699258,MATH 20A,A01,494059,Suk; Andrew Hoon,30,0,30,0
1713329700283,MATH 20B,A01,494061,Briones; Jor-el Thomas Caparas,33,0,35,2
1713329700283,MATH 20B,B01,494063,Bach; Quang Tran,34,0,35,1
1713329701310,MATH 20C,A01,494065,Staff,28,0,30,2
1713329701310,MATH 20C,A02,494066,Staff,30,0,30,0
1713329701310,MATH 20C,A03,494067,Staff,30,0,30,0
1713329701310,MATH 20C,A04,494068,Staff,30,0,30,0
1713329701310,MATH 20C,B01,494070,Zhang; Ming,25,0,30,5
1713329701310,MATH 20C,B02,494071,Zhang; Ming,27,0,30,3
1713329701310,MATH 20C,B03,494072,Zhang; Ming,29,0,30,1
1713329701310,MATH 20C,B04,494073,Zhang; Ming,29,0,30,1
1713329702338,MATH 20D,A01,494075,Staff,22,0,30,8
1713329702338,MATH 20D,A02,494076,Staff,29,0,30,1
1713329703363,MATH 20E,A01,494079,Staff,24,0,30,6
1713329703363,MATH 20E,A02,494080,Staff,26,0,30,4
1713329703363,MATH 20E,B01,494082,Staff,25,0,30,5
1713329703363,MATH 20E,B02,494083,Staff,25,0,30,5
1713329704394,MATH 103A,A01,494085,Aliabadi Sr.; Mohsen,14,0,30,16
1713329704394,MATH 103A,A02,494086,Aliabadi Sr.; Mohsen,28,0,30,2
1713329704394,MATH 103A,B01,494088,Aliabadi Sr.; Mohsen,21,0,30,9
1713329704394,MATH 103A,B02,494089,Aliabadi Sr.; Mohsen,27,0,30,3
1713329705420,MATH 109,A01,494091,Staff,30,0,30,0
1713329705420,MATH 109,A02,494092,Staff,29,0,30,1
1713329705420,MATH 109,B01,494094,Staff,27,0,30,3
1713329705420,MATH 109,B02,494095,Staff,29,0,30,1
1713329706451,MATH 142A,A01,494097,Chow; Bennett,15,0,30,15
1713329706451,MATH 142A,A02,494098,Chow; Bennett,23,0,30,7
1713329706451,MATH 142A,B01,494100,Chow; Bennett,19,0,30,11
1713329706451,MATH 142A,B02,494101,Chow; Bennett,29,0,30,1
1713329708500,MATH 168A,A01,516677,Dumitriu; Ioana,16,0,35,19
1713329709523,MATH 170A,A01,516679,Dumitriu; Ioana,18,0,30,12
1713329709523,MATH 170A,A02,516680,Dumitriu; Ioana,28,0,30,2
1713329710550,MATH 193A,A01,494107,Staff,14,0,30,16
1713329710550,MATH 193A,A02,494108,Staff,19,0,30,11
1713329710550,MATH 193A,A03,494109,Staff,29,0,30,1
1713329710550,MATH 193A,A04,494110,Staff,22,0,30,8
1713329713628,MGT 16,A00,491930,McKay; Michael J,92,0,98,6
1713329714653,MGT 18,A00,491992,McKay; Michael J,96,0,98,2
1713329715680,MGT 71,A00,492003,Staff,65,0,98,33
1713329716708,MGT 103,A00,505209,Eberhard; Craig A,81,0,98,17
1713329717735,MGT 131A,A00,505210,Anderson; John Charles,89,0,98,9
1713329719791,MGT 153,A00,492077,Perols; Johan Lars,19,0,90,71
1713329722874,MGT 164,A00,492222,McKay; Mary A,91,0,98,7
1713329723901,MGT 172,A00,492245,Staff,59,0,60,1
1713329723901,MGT 172,B00,505526,Hedges; Kathleen,65,0,98,33
1713329724926,MGT 181,A00,505669,Dunn; Louis Jean,82,0,98,16
1713329725958,MMW 14,A01,494399,Staff,15,0,28,13
1713329725958,MMW 14,A02,494400,Staff,25,0,28,3
1713329725958,MMW 14,A03,494401,Staff,28,0,28,0
1713329725958,MMW 14,A04,494402,Staff,28,0,28,0
1713329725958,MMW 14,B01,494404,Carreras; Maria Victoria,8,0,28,20
1713329725958,MMW 14,B02,494405,Carreras; Maria Victoria,25,0,28,3
1713329725958,MMW 14,B03,494406,Carreras; Maria Victoria,27,0,28,1
1713329725958,MMW 14,B04,494407,Carreras; Maria Victoria,28,0,28,0
1713329726987,MMW 14GS,A00,506250,Chang; Edmond Yi-Teh,0,0,0,0
1713329728013,MMW 121R,A01,494415,Adamiak; Patrick John,10,0,28,18
1713329728013,MMW 121R,A02,494416,Adamiak; Patrick John,24,0,28,4
1713329729039,MUS 1A,A01,494113,Staff,12,0,25,13
1713329729039,MUS 1A,A02,494114,Staff,24,0,25,1
1713329730064,MUS 4,A01,494116,Staff,23,0,25,2
1713329730064,MUS 4,A02,494117,Staff,22,0,25,3
1713329731095,MUS 5R,A01,494236,Dubnov; Shlomo,6,0,25,19
1713329731095,MUS 5R,A02,494237,Dubnov; Shlomo,25,0,25,0
1713329732121,MUS 6,A01,494122,Staff,10,0,25,15
1713329732121,MUS 6,A02,494123,Staff,23,0,25,2
1713329733214,MUS 7,A01,494125,Staff,16,0,25,9
1713329733214,MUS 7,A02,494126,Staff,24,0,25,1
1713329734244,MUS 11,A01,494128,Staff,23,0,25,2
1713329734244,MUS 11,A02,494129,Staff,24,0,25,1
1713329735270,MUS 13,A01,494131,Staff,25,0,25,0
1713329735270,MUS 13,A02,494132,Staff,25,0,25,0
1713329736295,MUS 15,A01,494134,Staff,17,0,25,8
1713329736295,MUS 15,A02,494135,Staff,25,0,25,0
1713329736295,MUS 15,B01,494137,Staff,24,0,25,1
1713329737321,MUS 80,A00,494232,Staff,24,0,25,1
1713329737321,MUS 80,B00,494233,Staff,25,0,25,0
1713329737321,MUS 80,C00,494234,Staff,23,0,25,2
1713329738346,MUS 95C,A00,494141,Staff,70,0,75,5
1713329739375,MUS 114,A00,494142,Staff,40,0,50,10
1713329740402,NANO 15,A01,490636,Drews; Aaron,7,0,7,0
1713329741434,PHIL 1,A00,490578,Grush; Rick Scott,49,0,50,1
1713329742460,PHIL 10,A01,490580,Grush; Rick Scott,33,0,35,2
1713329742460,PHIL 10,A02,490586,Grush; Rick Scott,32,0,35,3
1713329743486,PHIL 27,A01,490591,Staff,22,0,25,3
1713329743486,PHIL 27,A02,490592,Staff,25,0,25,0
1713329743486,PHIL 27,A03,490593,Staff,25,0,25,0
1713329743486,PHIL 27,A04,490598,Staff,25,0,25,0
1713329744511,PHIL 32,A01,490611,Staff,20,0,20,0
1713329744511,PHIL 32,A02,490618,Staff,20,0,20,0
1713329745537,PHIL 90,A00,490624,Staff,40,0,40,0
1713329746562,PHIL 136,A00,490627,Cohen; Jonathan David,37,0,40,3
1713329747586,PHIL 155,A00,490634,Staff,62,0,70,8
1713329748615,PHYS 1A,A00,491610,Staff,245,0,250,5
1713329749647,PHYS 1AL,001,491616,Tsai; Philbert S,27,0,30,3
1713329749647,PHYS 1AL,002,491618,Tsai; Philbert S,30,0,30,0
1713329750673,PHYS 1B,A00,491623,Staff,236,0,250,14
1713329751702,PHYS 1BL,001,491626,Tsai; Philbert S,22,0,30,8
1713329751702,PHYS 1BL,002,491628,Tsai; Philbert S,26,0,30,4
1713329752728,PHYS 1C,A00,491632,Staff,214,0,245,31
1713329753757,PHYS 1CL,001,491635,Tsai; Philbert S,2,0,30,28
1713329753757,PHYS 1CL,002,491643,Tsai; Philbert S,22,0,30,8
1713329754782,PHYS 2AR,A01,491651,Meyertholen; Andrew D.,44,0,50,6
1713329755805,PHYS 2B,A01,491659,Staff,106,0,115,9
1713329756834,PHYS 2BL,A01,491685,Staff,21,0,24,3
1713329756834,PHYS 2BL,A02,491700,Staff,21,0,24,3
1713329757860,PHYS 2C,A01,505161,Staff,102,0,115,13
1713329758892,PHYS 4A,A01,491704,Grinstein; Benjamin,99,0,100,1
1713329759917,POLI 5D,A01,494144,Staff,3,0,5,2
1713329759917,POLI 5D,B01,626283,Dai; Yinlin,5,0,5,0
1713329760942,POLI 12,A00,494145,Staff,43,0,45,2
1713329761969,POLI 13R,A00,494146,Forman; Fonna,45,0,50,5
1713329762995,POLI 27,A01,494148,Staff,54,0,60,6
1713329764023,POLI 30,A00,494149,Staff,49,0,50,1
1713329765055,POLI 100DA,A00,494150,Staff,21,0,25,4
1713329767107,POLI 100I,A00,494152,Staff,27,0,30,3
1713329768133,POLI 104B,A00,494153,Smith; Glenn Chatmas,53,0,55,2
1713329769158,POLI 104F,A00,494154,Staff,28,0,30,2
1713329770188,POLI 104I,A00,494155,Smith; Glenn Chatmas,29,0,30,1
1713329771213,POLI 110C,A00,494156,Ingham; Sean,23,0,25,2
1713329772241,POLI 117R,A00,494157,Forman; Fonna,8,0,20,12
1713329773310,POLI 118,A00,494158,Ingham; Sean,21,0,25,4
1713329774336,POLI 120H,A00,494159,Fisk; David Lee,39,0,45,6
1713329775362,POLI 131CR,A00,494160,Hoston; Germaine,35,0,45,10
1713329776387,POLI 133J,A00,494161,Staff,32,0,35,3
1713329777412,POLI 135,A00,494162,Fisk; David Lee,33,0,35,2
1713329778441,POLI 140A,A00,494164,Staff,19,0,30,11
1713329779466,POLI 142I,A00,494165,Staff,30,0,30,0
1713329780492,POLI 144D,A00,494166,Staff,23,0,25,2
1713329781515,POLI 151,A00,494167,Staff,30,0,30,0
1713329782539,POLI 153,A00,494168,Staff,33,0,35,2
1713329783567,POLI 160AA,A00,494169,Staff,34,0,40,6
1713329784593,POLI 162,A00,494170,Mignozzetti; Umberto,18,0,25,7
1713329785622,POLI 171,A00,494171,Mignozzetti; Umberto,18,0,25,7
1713329786649,PSYC 1,A00,494172,Staff,96,0,100,4
1713329787677,PSYC 2,A00,494173,Moranton; Nirelia Melbina-,34,0,50,16
1713329788718,PSYC 3,A00,494174,Staff,29,0,30,1
1713329789746,PSYC 6,A00,494175,Staff,17,0,20,3
1713329790845,PSYC 60,A01,494177,Staff,38,0,45,7
1713329791871,PSYC 70,A01,505724,Geller; Emma Harlan,42,0,45,3
1713329792897,PSYC 101,A00,494180,Heyman; Gail D.,84,0,100,16
1713329793922,PSYC 105,A00,494181,Geller; Emma Harlan,51,0,90,39
1713329794947,PSYC 106,A00,494182,Dobkins; Karen R.,27,0,45,18
1713329795976,PSYC 108,A00,494183,Adrian; Julia Anna,89,0,100,11
1713329797002,PSYC 114,A01,494185,Winkielman; Piotr,0,2,30,30
1713329798031,PSYC 122,A00,494186,Moranton; Nirelia Melbina-,28,0,50,22
1713329799056,PSYC 124,A00,494187,Chapman; Eddie Nathaniel,71,0,80,9
1713329800083,PSYC 131,A00,494188,Anagnostaras; Stephan,40,0,80,40
1713329801112,PSYC 144,A00,494189,Staff,5,0,50,45
1713329802140,PSYC 154,A00,494190,Lacefield; Katharine I,107,0,180,73
1713329803163,PSYC 162,A00,494191,Wixted; John T,71,0,100,29
1713329804187,PSYC 172,A00,494192,Gorman; Michael R.,36,0,45,9
1713329805212,PSYC 178,A00,494193,Glaser; Dale,34,0,45,11
1713329806241,PSYC 193,A00,505725,Chapman; Eddie Nathaniel,20,0,20,0
1713329807267,RELI 145GS,A00,519817,Rahimi; Babak,18,0,20,2
1713329808293,SE 101A,A01,490862,Chadha; Mayank,23,0,25,2
1713329809322,SE 101C,A01,490924,Krysl; Petr,15,0,20,5
1713329810351,SE 110A,A01,490928,Staff,19,0,20,1
1713329811381,SE 130A,A00,490929,Morrison; Machel Leigh,55,0,70,15
1713329812409,SIO 1,A01,519325,Staff,39,0,40,1
1713329813437,SIO 30,A01,519327,Staff,38,0,40,2
1713329814465,SIO 40,A00,519328,Staff,39,0,40,1
1713329815491,SIO 46GS,A00,519819,Cook; Geoffrey W,17,0,25,8
1713329816520,SIO 109R,A00,494197,Forman; Fonna,0,3,20,20
1713329817544,SIO 121GS,A00,519827,Cook; Geoffrey W,17,0,25,8
1713329818573,SIO 132,A01,519330,Staff,38,0,40,2
1713329819601,SIO 133,A01,519397,Staff,37,0,40,3
1713329820628,SIO 139,A00,519396,Kacev; David,29,0,40,11
1713329821654,SOCI 1,A01,494199,Thorpe; Charles Robert,21,0,30,9
1713329821654,SOCI 1,A02,494200,Thorpe; Charles Robert,30,0,30,0
1713329821654,SOCI 1,A03,494201,Thorpe; Charles Robert,29,0,30,1
1713329821654,SOCI 1,A04,494202,Thorpe; Charles Robert,29,0,30,1
1713329821654,SOCI 1,A05,494203,Thorpe; Charles Robert,29,0,30,1
1713329821654,SOCI 1,A06,494204,Thorpe; Charles Robert,30,0,30,0
1713329821654,SOCI 1,A07,494205,Thorpe; Charles Robert,28,0,30,2
1713329822679,SOCI 60,A01,494207,Staff,34,0,40,6
1713329822679,SOCI 60,A02,494208,Staff,39,0,40,1
1713329823707,SOCI 100,A01,494210,Payne; Christine Anna,25,0,30,5
1713329823707,SOCI 100,A02,494211,Payne; Christine Anna,26,0,30,4
1713329824732,SOCI 109M,A00,494212,Staff,20,0,20,0
1713329825758,SOCI 110,A00,494213,Staff,34,0,40,6
1713329827815,SOCI 118E,A00,494215,Ng; Kwai,37,0,40,3
1713329828841,SOCI 125,A00,494216,Calderon-Zaks; Michael Aar,40,0,45,5
1713329829867,SOCI 126,A01,494218,Jones; Makeba,3,0,5,2
1713329830895,SOCI 131,A00,494219,Thorpe; Charles Robert,26,0,30,4
1713329832953,SOCI 135,A00,494221,Payne; Christine Anna,28,0,50,22
1713329833979,SOCI 136E,A00,626690,Ruiz; Jonathan Joseph,24,0,25,1
1713329835006,SOCI 138GS,A00,494222,Navon; Daniel,24,0,28,4
1713329837061,SOCI 145,A00,494224,Staff,40,0,45,5
1713329838087,SOCI 153,A00,494225,Staff,28,0,30,2
1713329839114,SOCI 160E,A00,494226,Ng; Kwai,29,0,40,11
1713329840143,SOCI 180,A00,494227,Staff,29,0,30,1
1713329841172,SOCI 189GS,A00,494228,Ribas Norris; Janet Vanesa,11,0,11,0
1713329842204,SOCI 190GS,A00,553232,Ribas Norris; Janet Vanesa,11,0,11,0
1713329843230,SOMI 220,A00,627178,Schneid; Stephen David,30,0,30,0
1713329844255,SYN 2,001,490768,Staff,13,0,15,2
1713329844255,SYN 2,002,490769,Staff,14,0,15,1
1713329844255,SYN 2,004,490775,Staff,0,0,0,0
1713329844255,SYN 2,003,490774,Staff,0,0,0,0
1713329844255,SYN 2,005,490776,Staff,0,0,0,0
1713329845285,SYN 2R,001,490779,Staff,11,0,15,4
1713329845285,SYN 2R,002,514635,Staff,14,0,15,1
1713329846310,SYN 100,A01,490783,Staff,9,0,20,11
1713329846310,SYN 100,B01,490787,Staff,9,0,20,11
1713329846310,SYN 100,C01,490789,Staff,10,0,20,10
1713329847335,SYN 150,A00,490817,Staff,14,0,15,1
1713329847335,SYN 150,B00,514610,Staff,15,0,15,0
1713329848365,TDAC 1,A00,492753,Walsh; Kim C.,19,0,20,1
1713329848365,TDAC 1,B00,492754,Harting; Carla Kelso,19,0,20,1
1713329848365,TDAC 1,C00,513995,Salovey; Todd,15,0,20,5
1713329849391,TDAC 101,A00,492766,Harting; Carla Kelso,17,0,20,3
1713329850415,TDAC 102,A00,492768,Basso; Beatrice,19,0,20,1
1713329851442,TDDE 111,A00,492769,Staff,25,0,25,0
1713329852472,TDDE 131,A00,492770,Staff,15,0,15,0
1713329852472,TDDE 131,B00,492771,Staff,15,0,15,0
1713329853500,TDDE 131GS,A00,523716,Guirguis; Mark C,23,0,28,5
1713329854526,TDGE 1,A01,492756,Salovey; Todd,56,0,60,4
1713329855552,TDGE 5,A01,492758,Staff,23,0,25,2
1713329856579,TDGE 10,A00,492759,Fulton; Julia,203,0,220,17
1713329857603,TDGE 11,A00,492760,Castro; Robert Jess,198,0,200,2
1713329859655,TDGE 124,A00,492772,Fulton; Julia,185,0,220,35
1713329860682,TDGE 125,A00,492773,Meyer; Ursula,38,0,50,12
1713329860682,TDGE 125,B00,492774,Staff,49,0,50,1
1713329860682,TDGE 125,C00,523565,Staff,48,0,50,2
1713329861706,TDGE 125GS,A00,523580,Guirguis; Mark C,23,0,28,5
1713329862737,TDGE 127,A00,492775,Havis; Allan,34,0,50,16
1713329863763,TDHT 101,A00,492776,Staff,34,0,35,1
1713329864788,TDMV 1,A00,492762,Caligagan; Maria T.,30,0,30,0
1713329864788,TDMV 1,B00,492763,Arcidiacono; Kristin,26,0,30,4
1713329865815,TDMV 2,A00,492764,Weinberg; Sadie,28,0,30,2
1713329866841,TDMV 3,A00,492765,Mack; Kara Shanai',37,0,40,3
1713329867865,TDMV 138,A00,492777,Mack; Kara Shanai',34,0,40,6
1713329868895,TDMV 140,A00,492778,Lima; Paulo Henrique,40,0,40,0
1713329869922,TDMV 142,A00,492779,Caligagan; Maria T.,33,0,40,7
1713329869922,TDMV 142,B00,492780,Caligagan; Tony,37,0,40,3
1713329870947,TDMV 143,A00,492781,Fyall; Daunte Edward,39,0,40,1
1713329871974,USP 1,A01,492401,Kwak; Nancy,27,0,35,8
1713329873003,USP 2,A01,492453,Hinds; Juli Beth,35,0,35,0
1713329874031,USP 3,A01,492516,Staff,28,0,35,7
1713329875062,USP 4,A00,492522,McTague; Sarah,16,0,25,9
1713329876089,USP 100,A00,492523,Staff,32,0,35,3
1713329877119,USP 101,A00,492524,Staff,13,0,15,2
1713329878145,USP 105,A00,492525,Staff,21,0,25,4
1713329879176,USP 151,A00,492526,Shenkman; Michael Thomas,32,0,35,3
1713329880200,USP 170,A00,492545,Hinds; Juli Beth,33,0,35,2
1713329881230,USP 171GS,A00,492608,Bussell; Mirle Rabinowitz,24,0,28,4
1713329882255,USP 183GS,A00,492613,Peerson; Susan,24,0,28,4
1713329883284,VIS 30,A01,490693,Yoldas; Pinar,19,0,22,3
1713329883284,VIS 30,A02,490694,Yoldas; Pinar,18,0,22,4
1713329884311,VIS 83,A00,490695,Kester; Grant,63,0,75,12
1713329885338,VIS 105D,A00,490696,Staff,22,0,25,3
1713329886365,VIS 124CN,A00,490699,Rose; Jordan M,65,0,75,10
1713329887391,VIS 125GS,A00,511221,Williams; Alena J,21,0,22,1
1713329888418,VIS 128D,A00,490700,Staff,73,0,75,2
1713329889442,VIS 151,A01,490717,Staff,33,0,34,1
1713329889442,VIS 151,A02,490766,Staff,33,0,34,1
1713329890467,VIS 154GS,A00,511972,Williams; Alena J,21,0,22,1
1713329891498,VIS 160A,A00,490767,Stone; Patricia,7,0,10,3
1713329892523,WCWP 10A,A00,490638,Staff,14,0,15,1
1713329892523,WCWP 10A,B00,490640,Staff,15,0,15,0
1713329893551,WCWP 10B,A00,490641,Staff,0,0,0,0
1713329893551,WCWP 10B,B00,490642,Staff,14,0,15,1
1713329893551,WCWP 10B,C00,490644,Staff,13,0,15,2
1713329893551,WCWP 10B,D00,490647,Staff,0,0,0,0
1713329894634,WCWP 100,A00,490655,Staff,0,0,0,0
1713329894634,WCWP 100,B00,490687,Staff,10,0,15,5
1713329896724,ANAR 153,A00,487222,Braswell; Geoffrey E.,53,0,60,7
1713329897749,ANBI 134,A00,487223,Staff,5,0,20,15
1713329898775,ANBI 143GS,A00,487224,Noel; Geoffroy Pierre Jean,18,0,24,6
1713329899803,ANBI 144GS,A00,519548,Noel; Geoffroy Pierre Jean,18,0,24,6
1713329900831,ANSC 101,A00,487225,Staff,18,0,20,2
1713329901862,ANSC 125,A00,487227,Brenner; Suzanne A,39,0,40,1
1713329903914,ANSC 146,A00,487229,Staff,35,0,40,5
1713329904940,ANSC 148,A00,487230,Olivas Hernandez; Olga Lid,39,0,40,1
1713329905969,ANSC 150,A00,504165,Sloane; Julia Kathryn,18,0,20,2
1713329906998,ANSC 180,A00,487232,Staff,14,0,15,1
1713329908026,ANSC 188,A00,627155,Staff,39,0,40,1
1713329909052,ANTH 5,A00,519529,Semendeferi; Ekaterini,15,0,15,0
1713329910082,ANTH 10,A00,487219,Staff,58,0,60,2
1713329911107,ANTH 23,A01,487221,Staff,17,0,20,3
1713329912134,ANTH 102,A00,487233,Wilder; Linnea Lorene,51,0,60,9
1713329913161,ANTH 103,A00,487234,Varma; Saiba,55,0,60,5
1713329914190,ANTH 105,A00,487235,Stewart; Alexander B,54,0,60,6
1713329915214,BENG 100,A01,516685,Taylor Amos; Alyssa C,26,0,30,4
1713329916244,BIBC 102,A01,491316,Flagg; Matthew Paul,13,0,88,75
1713329916244,BIBC 102,A02,491366,Flagg; Matthew Paul,78,0,88,10
1713329917270,BIBC 103,A01,491486,Boumechache; Miyyada,16,0,24,8
1713329917270,BIBC 103,A02,491487,Boumechache; Miyyada,24,0,24,0
1713329918300,BICD 100,A01,516882,Staff,73,0,75,2
1713329918300,BICD 100,A02,516890,Staff,69,0,75,6
1713329919325,BICD 102GS,A00,491488,Lo; Stanley M.,26,0,28,2
1713329920351,BIEB 136GS,A00,516940,Holway; David A. & Shurin; Jonathan,18,0,24,6
1713329921377,BIEB 137GS,A01,517034,Holway; David A. & Shurin; Jonathan,18,0,24,6
1713329922405,BIEB 138GS,A01,491492,Pirino; Giorgia,21,0,28,7
1713329923431,BILD 1,A01,491296,Staff,60,0,63,3
1713329923431,BILD 1,A02,491297,Staff,63,0,63,0
1713329924457,BILD 4,A01,517099,Gonzalez Gamboa; Ivonne,22,0,24,2
1713329924457,BILD 4,A02,517100,Gonzalez Gamboa; Ivonne,24,0,24,0
1713329925483,BILD 60GS,A00,491309,Lo; Stanley M.,26,0,28,2
1713329926511,BIMM 100,A01,517136,Staff,84,0,100,16
1713329927539,BIMM 110,A01,517182,Staff,55,0,100,45
1713329928566,BIMM 120,A01,517228,Pickett; Brooke Elizabeth,28,0,63,35
1713329928566,BIMM 120,A02,517240,Pickett; Brooke Elizabeth,44,0,63,19
1713329929596,BIMM 132GS,A01,491498,Pirino; Giorgia,21,0,28,7
1713329930622,BIMM 143,A01,491589,Bozinovic; Goran,13,0,40,27
1713329931648,BIPN 100,A01,491594,Armour; Jon Christopher,84,0,100,16
1713329932674,BIPN 140,A01,491602,Marino; Marc J,26,0,50,24
1713329934728,CAT 125,A00,515973,Staff,18,0,20,2
1713329935754,CAT 125GS,A00,515974,Rahimi; Babak,17,0,20,3
1713329936781,CAT 125R,A00,515980,Staff,12,0,20,8
1713329936781,CAT 125R,B00,515981,Tosun; Adriana,19,0,20,1
1713329936781,CAT 125R,C00,515987,Hyland; Tina Mae,0,2,20,20
1713329936781,CAT 125R,D00,515988,Bronstein; Phoebe Malan,16,0,20,4
1713329937811,CENG 15,A01,488699,Drews; Aaron,25,0,25,0
1713329938839,CENG 100,A00,505196,Opatkiewicz; Justin Paul,25,0,25,0
1713329939868,CGS 2A,A01,489598,Staff,33,0,35,2
1713329940897,CGS 112,A00,489599,Staff,15,0,15,0
1713329941924,CGS 119,A00,489603,Staff,10,0,10,0
1713329942949,CGS 120,A00,489604,Staff,14,0,15,1
1713329943978,CGS 150,A00,489607,Staff,15,0,15,0
1713329945002,CHEM 6A,A01,488715,Staff,98,0,100,2
1713329946027,CHEM 6B,A01,488719,Piercy; Marc Anthony,99,0,100,1
1713329947054,CHEM 6C,A01,488723,Albizati; Kim F.,93,0,100,7
1713329948082,CHEM 7L,A01,488728,Schurmeier; Kimberly,18,0,24,6
1713329948082,CHEM 7L,A02,488730,Schurmeier; Kimberly,23,0,24,1
1713329948082,CHEM 7L,A03,488734,Schurmeier; Kimberly,20,0,24,4
1713329948082,CHEM 7L,A04,488763,Schurmeier; Kimberly,23,0,24,1
1713329948082,CHEM 7L,B01,488798,Schurmeier; Kimberly,17,0,24,7
1713329948082,CHEM 7L,B02,488801,Schurmeier; Kimberly,22,0,24,2
1713329948082,CHEM 7L,B03,488808,Schurmeier; Kimberly,23,0,24,1
1713329948082,CHEM 7L,B04,488811,Schurmeier; Kimberly,24,0,24,0
1713329949108,CHEM 11,A01,488897,Stallings; Dontarie M,95,0,100,5
1713329950137,CHEM 40A,A01,488913,Albizati; Kim F.,83,0,100,17
1713329951166,CHEM 40B,A01,488920,Weizman; Haim,43,0,50,7
1713329951166,CHEM 40B,A02,488938,Weizman; Haim,45,0,50,5
1713329952196,CHEM 41A,A01,489029,Klosterman; Jeremy K,57,0,60,3
1713329953225,CHEM 41C,A01,500436,Tor; Yitzhak,55,0,60,5
1713329954255,CHEM 43A,A01,500426,Weizman; Haim,0,0,24,24
1713329954255,CHEM 43A,A02,500430,Weizman; Haim,8,0,24,16
1713329954255,CHEM 43A,B01,514041,Klosterman; Jeremy K,16,0,24,8
1713329954255,CHEM 43A,B02,514047,Klosterman; Jeremy K,23,0,24,1
1713329955281,CHEM 108,A01,489140,Jennings; Patricia A.,9,0,24,15
1713329955281,CHEM 108,A02,489142,Jennings; Patricia A.,14,0,24,10
1713329956308,CHEM 114A,A01,489147,Stallings; Dontarie M,68,0,100,32
1713329957337,CHIN 169A,A00,489171,Wang; Xiao,19,0,20,1
1713329959390,COGS 3,A01,518827,Boyle; Mary E. T.,26,0,40,14
1713329960414,COGS 11,A01,489175,Staff,27,0,30,3
1713329961438,COGS 14A,A01,518829,Staff,51,0,60,9
1713329962466,COGS 14B,A01,489177,Hoffman; Drew Ellen,63,0,75,12
1713329963491,COGS 100,A01,489181,Allen; Michael Gordon,63,0,75,12
1713329964517,COGS 101A,A01,489183,Staff,46,0,60,14
1713329965543,COGS 101B,A01,489185,Allen; Michael Gordon,8,0,30,22
1713329966571,COGS 101C,A01,526786,Staff,23,0,30,7
1713329968623,COGS 107A,A01,489189,Boyle; Mary E. T.,17,0,35,18
1713329969648,COGS 107B,A01,627144,Mooshagian; Eric Frederick,60,0,60,0
1713329970673,COGS 118A,A01,489191,Staff,0,44,40,40
1713329972731,COGS 171GS,A01,489194,Pineda; Jaime A,20,0,28,8
1713329973759,COGS 172,A01,489196,Staff,3,0,30,27
1713329974785,COGS 174GS,A01,489264,Pineda; Jaime A,20,0,28,8
1713329975811,COGS 180,A01,627150,Staff,28,0,30,2
1713329976835,COGS 186,A01,489274,Staff,0,1,30,30
1713329977862,COMM 10,A01,489276,Staff,23,0,25,2
1713329977862,COMM 10,A02,489303,Staff,23,0,25,2
1713329978887,COMM 100A,A01,489312,Staff,14,0,25,11
1713329978887,COMM 100A,A02,489313,Staff,24,0,25,1
1713329979915,COMM 106T,A00,512540,Staff,33,0,35,2
1713329980940,COMM 107,A00,489347,Staff,27,0,35,8
1713329981965,COMM 109P,A00,489358,Staff,31,0,35,4
1713329982991,COMM 132,A00,489361,McKenna; Denise,27,0,30,3
1713329984020,COMM 146,A00,489362,Halm; Gavin Patrick,26,0,30,4
1713329985049,COMM 190,A00,489363,Abuelhiga; Soraya Jill,17,0,23,6
1713329986073,CSE 8A,A50,489366,Staff,21,0,25,4
1713329986073,CSE 8A,A51,489367,Staff,24,0,25,1
1713329987098,CSE 11,A01,489398,Cao; Yingjun,73,0,100,27
1713329988124,CSE 12,A01,489487,Staff,43,0,50,7
1713329989149,CSE 20,A01,489497,Staff,48,0,50,2
1713329990175,CSE 21,A01,489517,Braun; Oliver,42,0,50,8
1713329991198,CSE 101,A01,489524,Braun; Oliver,0,29,50,50
1713329992226,CSE 105,A01,512594,Jones; Miles E,72,0,100,28
1713329992226,CSE 105,B01,512598,Jones; Miles E,52,0,100,48
1713329993254,CSE 140,A01,489538,Staff,41,0,50,9
1713329994279,CSE 141,A01,489550,Eldon; John,67,0,100,33
1713329995309,CSE 141L,A01,489571,Eldon; John,65,0,100,35
1713329996335,CSE 151A,A01,489583,Solares; Edwin A,141,0,200,59
1713329997360,CSE 175,A01,510886,Kumar; Rakesh,30,0,30,0
1713329998441,CSE 190,A00,516828,Dubnov; Shlomo,38,0,49,11
1713329999472,DOC 100D,A00,489667,Pass; Natalye Joann,19,0,25,6
1713330000500,DSC 10,A01,624268,Staff,72,0,75,3
1713330001528,DSC 20,A01,624476,Staff,50,0,50,0
1713330002559,DSC 40A,A01,624608,Staff,39,0,40,1
1713330003582,DSGN 1,A01,489179,Rill; Bryan,32,0,50,18
1713330004616,ECE 17,A01,490489,Sahay; Rajeev,18,0,30,12
1713330005641,ECE 65,A50,490492,Staff,11,0,20,9
1713330005641,ECE 65,A51,490493,Staff,18,0,20,2
1713330006673,ECON 1,A01,489715,Famulari; Melissa,67,0,70,3
1713330007704,ECON 2,A01,489717,Levkoff; Steven B.,68,0,70,2
1713330008731,ECON 3,A01,489948,Staff,70,0,70,0
1713330010893,ECON 5,A01,490103,Staff,27,0,30,3
1713330010893,ECON 5,B01,626281,Dai; Yinlin,45,0,45,0
1713330011917,ECON 100A,A01,490127,Famulari; Melissa,65,0,70,5
1713330012943,ECON 100B,A01,490129,Staff,64,0,70,6
1713330013968,ECON 109,A01,490187,Shishkin; Denis,27,0,35,8
1713330014996,ECON 110A,A01,490190,Levkoff; Steven B.,60,0,70,10
1713330016025,ECON 120A,A01,490245,Dai; Yinlin,61,0,70,9
1713330017054,ECON 120B,A01,490247,Nieto-Barthaburu; Augusto,40,0,70,30
1713330018087,ECON 120C,A01,490253,Sun; Yixiao,30,0,35,5
1713330018087,ECON 120C,B01,490255,Sun; Yixiao,34,0,35,1
1713330019115,ECON 129,A00,490256,Eckert; Fabian Paul,23,0,35,12
1713330020139,ECON 131,A00,490257,Nieto-Barthaburu; Augusto,0,6,35,35
1713330021165,ECON 138,A00,490258,Bharadwaj; Prashant,13,0,35,22
1713330021165,ECON 138,B00,490259,Bharadwaj; Prashant,15,0,35,20
1713330022195,ECON 159,A00,490260,Hendrickson; Gerald M.,0,9,0,0
1713330023222,ECON 178,A01,553995,Zhu; Ying,24,0,35,11
1713330024248,EDS 40,A01,512576,Black; Alison Michelle,20,0,20,0
1713330025271,EDS 107,A01,515848,Staff,30,0,30,0
1713330026297,EDS 110R,A01,490262,Staff,26,0,30,4
1713330027333,EDS 112,A01,490264,Chapman; Thandeka K,40,0,50,10
1713330028362,EDS 113,A00,490266,Staff,26,0,30,4
1713330029389,EDS 118,A00,490267,Warstadt; Melissa Fawn,20,0,30,10
1713330030416,EDS 124BR,A00,490268,Eguchi; Emi,4,0,25,21
1713330030416,EDS 124BR,B00,490269,Eguchi; Emi,23,0,25,2
1713330031444,EDS 126,A01,490271,Jones; Makeba,43,0,50,7
1713330032471,EDS 135,A01,490316,Staff,19,0,20,1
1713330033500,ENVR 142GS,A00,519514,Chang; Edmond Yi-Teh,26,0,28,2
1713330034528,ETHN 103,A00,490504,Staff,25,0,36,11
1713330035554,ETHN 103A,A00,490505,Man; Simeon S,4,0,9,5
1713330036580,ETHN 109,A00,490506,Staff,28,0,30,2
1713330037722,ETHN 118,A00,490507,Staff,35,0,36,1
1713330038748,ETHN 119,A00,490508,Staff,33,0,36,3
1713330039773,ETHN 121R,A00,490518,Choi; Esther Min,21,0,36,15
1713330040802,ETHN 127,A00,490528,Staff,14,0,15,1
1713330041828,ETHN 139,A00,490573,Staff,10,0,10,0
1713330042857,ETHN 150,A00,490575,Staff,15,0,15,0
1713330043898,GLBH 20,A00,491705,Elwardani; Nile Regina,38,0,40,2
1713330044922,GLBH 101,A00,491706,Staff,20,0,20,0
1713330045949,GLBH 111,A01,491708,Burgos; Jose L.,15,0,15,0
1713330046976,GLBH 146,A00,491709,Staff,9,0,20,11
1713330048000,GLBH 148,A00,491710,Olivas Hernandez; Olga Lid,11,0,20,9
1713330049026,GLBH 150,A00,491711,Sloane; Julia Kathryn,19,0,20,1
1713330050065,HIEA 131,A00,491760,Staff,28,0,32,4
1713330051089,HIEA 153,A00,491762,Staff,28,0,30,2
1713330052115,HIEU 124,A00,491811,Staff,26,0,32,6
1713330053140,HIEU 124GS,A00,491812,Markman; Kristina,27,0,28,1
1713330054166,HIEU 147,A00,491813,Staff,30,0,32,2
1713330055194,HIEU 149GS,A00,491816,Caldwell; Michael Alan,28,0,28,0
1713330056223,HILD 2C,A01,491713,Hendrickson; Gerald M.,26,0,30,4
1713330057248,HILD 7B,A01,491715,Kwak; Nancy,0,2,30,30
1713330058272,HILD 10,A01,491717,Staff,11,0,20,9
1713330059304,HILD 30GS,A00,491719,Edington; Claire Ellen,24,0,28,4
1713330060328,HINE 109,A00,491818,Shafir; Nir,27,0,32,5
1713330061352,HINE 128,A00,491821,Shafir; Nir,31,0,32,1
1713330062375,HISC 117,A00,491830,Staff,27,0,32,5
1713330063400,HIUS 103,A00,491834,Man; Simeon S,14,0,23,9
1713330064430,HIUS 108B,A00,491835,Staff,27,0,30,3
1713330065458,HIUS 141,A00,491836,Hendrickson; Gerald M.,28,0,32,4
1713330066486,HIUS 149,A00,491839,Staff,24,0,32,8
1713330067512,HUM 3,A01,512617,Crum; Matthew Stephen,42,0,50,8
1713330067512,HUM 3,A02,512618,Crum; Matthew Stephen,48,0,50,2
1713330068539,HUM 3GS,A00,512663,Markman; Kristina,0,0,0,1
1713330068539,HUM 3GS,B00,512664,Staff,0,0,0,0
1713330069563,HUM 4,A01,512620,West; Geoffrey Scott,25,0,50,25
1713330070589,HUM 4GS,A00,512666,Lyon; Antony J.,0,0,0,5
1713330071620,HUM 4R,A01,512625,Watkins; Eric,49,0,50,1
1713330072646,HUM 5,A01,512649,Zavodny; Tatiana Sophia,23,0,50,27
1713330072646,HUM 5,B01,512661,Zroka; Ryan Edward,48,0,50,2
1713330073672,INTL 190,A00,490577,Segui; Alan S,0,0,0,5
1713330074702,JAPN 20AR,A01,491267,Ross; Kayoko F,7,0,20,13
1713330075732,JAPN 180,A00,491285,Berman; Michael David,33,0,40,7
1713330076759,LATI 50,A01,502536,Kokinis; Troy Andreas,16,0,22,6
1713330076759,LATI 50,A02,502551,Kokinis; Troy Andreas,22,0,22,0
1713330076759,LATI 50,A03,502650,Kokinis; Troy Andreas,22,0,22,0
1713330076759,LATI 50,A04,502909,Kokinis; Troy Andreas,21,0,22,1
1713330077786,LATI 160,A01,502920,Kokinis; Troy Andreas,30,0,30,0
1713330078816,LIFR 1A,A00,490494,Van Moer; Vinciane G,17,0,20,3
1713330079841,LIFR 1AX,A00,490495,Van Moer; Vinciane G,17,0,20,3
1713330080868,LIFR 1B,A00,490496,Van Moer; Vinciane G,18,0,20,2
1713330081895,LIFR 1BX,A00,490497,Van Moer; Vinciane G,18,0,20,2
1713330082924,LIGN 8,A00,505198,McIntosh; Justin Daniel,134,0,150,16
1713330083954,LIGN 9GS,A00,491239,Lott; Margaret S.,18,0,20,2
1713330084978,LIGN 101,A01,505200,McIntosh; Justin Daniel,22,0,30,8
1713330086006,LIGN 120,A01,491244,Staff,22,0,30,8
1713330087031,LIGN 149GS,A00,491245,Lott; Margaret S.,18,0,20,2
1713330088058,LIGN 170,A00,491247,Staff,22,0,30,8
1713330089083,LISP 1D,A00,490498,Munoz Sanchez; Alicia,9,0,14,5
1713330089083,LISP 1D,B00,490499,Munoz Sanchez; Alicia,6,0,14,8
1713330089083,LISP 1D,C00,490500,Munoz Sanchez; Alicia,7,0,14,7
1713330089083,LISP 1D,D00,490501,Munoz Sanchez; Alicia,10,0,14,4
1713330090109,LISP 1DX,A00,490502,Munoz Sanchez; Alicia,14,0,28,14
1713330090109,LISP 1DX,B00,490503,Munoz Sanchez; Alicia,16,0,28,12
1713330092159,LTAM 110,A00,491847,Staff,22,0,25,3
1713330093184,LTCS 119,A00,491848,Staff,11,0,15,4
1713330094210,LTCS 130,A00,491849,Staff,24,0,25,1
1713330096271,LTEA 120C,A00,491852,Staff,32,0,40,8
1713330097298,LTEN 130GS,A00,491853,Lyon; Antony J.,23,0,28,5
1713330098323,LTEN 148,A00,491855,Staff,23,0,25,2
1713330099347,LTEN 159,A00,491856,Staff,20,0,25,5
1713330100370,LTEN 180,A00,491857,Staff,8,0,15,7
1713330102471,LTSP 123GS,A00,505928,Bessett; Ryan Matthew,24,0,28,4
1713330103497,LTSP 174GS,A00,506037,Bessett; Ryan Matthew,24,0,28,4
1713330105546,LTWR 102,A00,491861,Staff,9,0,15,6
1713330106574,LTWR 106,A00,491862,Staff,8,0,15,7
1713330107603,MAE 11,A00,490930,Bahadori; Mohammad Yousef,95,0,100,5
1713330108636,MAE 30A,A00,490931,Qi; Huihui,37,0,40,3
1713330109662,MAE 101A,A00,491036,Sadeghizadeh; Zahra,92,0,100,8
1713330110688,MAE 101C,A00,491037,Seshadri; Kalyanasundaram,67,0,100,33
1713330111712,MAE 113,A00,491040,Seshadri; Kalyanasundaram,66,0,80,14
1713330112739,MAE 131A,A00,491041,Ghazinejad; Maziar,37,0,40,3
1713330113764,MAE 142,A00,491053,Staff,39,0,40,1
1713330114793,MAE 143A,A00,491054,Staff,32,0,50,18
1713330115819,MAE 150,A00,491092,Truong; Phuong Thi Ngoc,23,0,35,12
1713330116845,MATH 3C,A01,494031,Pardo Guerra; Sebastian,30,0,30,0
1713330116845,MATH 3C,A02,494032,Pardo Guerra; Sebastian,29,0,30,1
1713330117872,MATH 10A,A01,494034,Staff,27,0,30,3
1713330117872,MATH 10A,A02,494035,Staff,28,0,30,2
1713330117872,MATH 10A,B01,494037,Staff,27,0,30,3
1713330117872,MATH 10A,B02,494038,Staff,29,0,30,1
1713330118901,MATH 10B,A01,494040,Habib; Yousaf,22,0,30,8
1713330118901,MATH 10B,A02,494041,Habib; Yousaf,28,0,30,2
1713330118901,MATH 10B,A03,494042,Habib; Yousaf,29,0,30,1
1713330118901,MATH 10B,A04,494043,Habib; Yousaf,30,0,30,0
1713330118901,MATH 10B,B01,494045,Habib; Yousaf,25,0,30,5
1713330118901,MATH 10B,B02,494046,Habib; Yousaf,30,0,30,0
1713330118901,MATH 10B,B03,494047,Habib; Yousaf,30,0,30,0
1713330118901,MATH 10B,B04,494048,Habib; Yousaf,30,0,30,0
1713330119929,MATH 18,A01,494050,Kemp; Todd Aahron,25,0,30,5
1713330119929,MATH 18,A02,494051,Kemp; Todd Aahron,29,0,30,1
1713330119929,MATH 18,B01,494054,Kemp; Todd Aahron,26,0,30,4
1713330119929,MATH 18,B02,494055,Kemp; Todd Aahron,29,0,30,1
1713330120959,MATH 20A,A01,494059,Suk; Andrew Hoon,30,0,30,0
1713330121991,MATH 20B,A01,494061,Briones; Jor-el Thomas Caparas,33,0,35,2
1713330121991,MATH 20B,B01,494063,Bach; Quang Tran,34,0,35,1
1713330123018,MATH 20C,A01,494065,Staff,28,0,30,2
1713330123018,MATH 20C,A02,494066,Staff,30,0,30,0
1713330123018,MATH 20C,A03,494067,Staff,30,0,30,0
1713330123018,MATH 20C,A04,494068,Staff,30,0,30,0
1713330123018,MATH 20C,B01,494070,Zhang; Ming,25,0,30,5
1713330123018,MATH 20C,B02,494071,Zhang; Ming,27,0,30,3
1713330123018,MATH 20C,B03,494072,Zhang; Ming,29,0,30,1
1713330123018,MATH 20C,B04,494073,Zhang; Ming,29,0,30,1
1713330124047,MATH 20D,A01,494075,Staff,22,0,30,8
1713330124047,MATH 20D,A02,494076,Staff,29,0,30,1
1713330125074,MATH 20E,A01,494079,Staff,24,0,30,6
1713330125074,MATH 20E,A02,494080,Staff,26,0,30,4
1713330125074,MATH 20E,B01,494082,Staff,25,0,30,5
1713330125074,MATH 20E,B02,494083,Staff,25,0,30,5
1713330126101,MATH 103A,A01,494085,Aliabadi Sr.; Mohsen,14,0,30,16
1713330126101,MATH 103A,A02,494086,Aliabadi Sr.; Mohsen,28,0,30,2
1713330126101,MATH 103A,B01,494088,Aliabadi Sr.; Mohsen,21,0,30,9
1713330126101,MATH 103A,B02,494089,Aliabadi Sr.; Mohsen,27,0,30,3
1713330127128,MATH 109,A01,494091,Staff,30,0,30,0
1713330127128,MATH 109,A02,494092,Staff,29,0,30,1
1713330127128,MATH 109,B01,494094,Staff,27,0,30,3
1713330127128,MATH 109,B02,494095,Staff,29,0,30,1
1713330128161,MATH 142A,A01,494097,Chow; Bennett,15,0,30,15
1713330128161,MATH 142A,A02,494098,Chow; Bennett,23,0,30,7
1713330128161,MATH 142A,B01,494100,Chow; Bennett,19,0,30,11
1713330128161,MATH 142A,B02,494101,Chow; Bennett,29,0,30,1
1713330130215,MATH 168A,A01,516677,Dumitriu; Ioana,16,0,35,19
1713330131245,MATH 170A,A01,516679,Dumitriu; Ioana,18,0,30,12
1713330131245,MATH 170A,A02,516680,Dumitriu; Ioana,28,0,30,2
1713330132282,MATH 193A,A01,494107,Staff,14,0,30,16
1713330132282,MATH 193A,A02,494108,Staff,19,0,30,11
1713330132282,MATH 193A,A03,494109,Staff,29,0,30,1
1713330132282,MATH 193A,A04,494110,Staff,22,0,30,8
1713330135361,MGT 16,A00,491930,McKay; Michael J,92,0,98,6
1713330136389,MGT 18,A00,491992,McKay; Michael J,96,0,98,2
1713330137415,MGT 71,A00,492003,Staff,65,0,98,33
1713330138440,MGT 103,A00,505209,Eberhard; Craig A,81,0,98,17
1713330139473,MGT 131A,A00,505210,Anderson; John Charles,89,0,98,9
1713330141522,MGT 153,A00,492077,Perols; Johan Lars,19,0,90,71
1713330144605,MGT 164,A00,492222,McKay; Mary A,91,0,98,7
1713330145638,MGT 172,A00,492245,Staff,59,0,60,1
1713330145638,MGT 172,B00,505526,Hedges; Kathleen,65,0,98,33
1713330146664,MGT 181,A00,505669,Dunn; Louis Jean,82,0,98,16
1713330147690,MMW 14,A01,494399,Staff,15,0,28,13
1713330147690,MMW 14,A02,494400,Staff,25,0,28,3
1713330147690,MMW 14,A03,494401,Staff,28,0,28,0
1713330147690,MMW 14,A04,494402,Staff,28,0,28,0
1713330147690,MMW 14,B01,494404,Carreras; Maria Victoria,8,0,28,20
1713330147690,MMW 14,B02,494405,Carreras; Maria Victoria,25,0,28,3
1713330147690,MMW 14,B03,494406,Carreras; Maria Victoria,27,0,28,1
1713330147690,MMW 14,B04,494407,Carreras; Maria Victoria,28,0,28,0
1713330148716,MMW 14GS,A00,506250,Chang; Edmond Yi-Teh,0,0,0,0
1713330149741,MMW 121R,A01,494415,Adamiak; Patrick John,10,0,28,18
1713330149741,MMW 121R,A02,494416,Adamiak; Patrick John,24,0,28,4
1713330150767,MUS 1A,A01,494113,Staff,12,0,25,13
1713330150767,MUS 1A,A02,494114,Staff,24,0,25,1
1713330151798,MUS 4,A01,494116,Staff,23,0,25,2
1713330151798,MUS 4,A02,494117,Staff,22,0,25,3
1713330152826,MUS 5R,A01,494236,Dubnov; Shlomo,6,0,25,19
1713330152826,MUS 5R,A02,494237,Dubnov; Shlomo,25,0,25,0
1713330153859,MUS 6,A01,494122,Staff,10,0,25,15
1713330153859,MUS 6,A02,494123,Staff,23,0,25,2
1713330154887,MUS 7,A01,494125,Staff,16,0,25,9
1713330154887,MUS 7,A02,494126,Staff,24,0,25,1
1713330155913,MUS 11,A01,494128,Staff,23,0,25,2
1713330155913,MUS 11,A02,494129,Staff,24,0,25,1
1713330156939,MUS 13,A01,494131,Staff,25,0,25,0
1713330156939,MUS 13,A02,494132,Staff,25,0,25,0
1713330157964,MUS 15,A01,494134,Staff,17,0,25,8
1713330157964,MUS 15,A02,494135,Staff,25,0,25,0
1713330157964,MUS 15,B01,494137,Staff,24,0,25,1
1713330158992,MUS 80,A00,494232,Staff,24,0,25,1
1713330158992,MUS 80,B00,494233,Staff,25,0,25,0
1713330158992,MUS 80,C00,494234,Staff,23,0,25,2
1713330160018,MUS 95C,A00,494141,Staff,70,0,75,5
1713330161043,MUS 114,A00,494142,Staff,40,0,50,10
1713330162070,NANO 15,A01,490636,Drews; Aaron,7,0,7,0
1713330163100,PHIL 1,A00,490578,Grush; Rick Scott,49,0,50,1
1713330164125,PHIL 10,A01,490580,Grush; Rick Scott,33,0,35,2
1713330164125,PHIL 10,A02,490586,Grush; Rick Scott,32,0,35,3
1713330165154,PHIL 27,A01,490591,Staff,22,0,25,3
1713330165154,PHIL 27,A02,490592,Staff,25,0,25,0
1713330165154,PHIL 27,A03,490593,Staff,25,0,25,0
1713330165154,PHIL 27,A04,490598,Staff,25,0,25,0
1713330166180,PHIL 32,A01,490611,Staff,20,0,20,0
1713330166180,PHIL 32,A02,490618,Staff,20,0,20,0
1713330167209,PHIL 90,A00,490624,Staff,40,0,40,0
1713330168239,PHIL 136,A00,490627,Cohen; Jonathan David,37,0,40,3
1713330169269,PHIL 155,A00,490634,Staff,62,0,70,8
1713330170294,PHYS 1A,A00,491610,Staff,245,0,250,5
1713330171319,PHYS 1AL,001,491616,Tsai; Philbert S,27,0,30,3
1713330171319,PHYS 1AL,002,491618,Tsai; Philbert S,30,0,30,0
1713330172346,PHYS 1B,A00,491623,Staff,236,0,250,14
1713330173372,PHYS 1BL,001,491626,Tsai; Philbert S,22,0,30,8
1713330173372,PHYS 1BL,002,491628,Tsai; Philbert S,26,0,30,4
1713330174397,PHYS 1C,A00,491632,Staff,213,0,245,32
1713330175423,PHYS 1CL,001,491635,Tsai; Philbert S,2,0,30,28
1713330175423,PHYS 1CL,002,491643,Tsai; Philbert S,22,0,30,8
1713330176454,PHYS 2AR,A01,491651,Meyertholen; Andrew D.,44,0,50,6
1713330177483,PHYS 2B,A01,491659,Staff,106,0,115,9
1713330178512,PHYS 2BL,A01,491685,Staff,21,0,24,3
1713330178512,PHYS 2BL,A02,491700,Staff,21,0,24,3
1713330179539,PHYS 2C,A01,505161,Staff,102,0,115,13
1713330180565,PHYS 4A,A01,491704,Grinstein; Benjamin,99,0,100,1
1713330181591,POLI 5D,A01,494144,Staff,3,0,5,2
1713330181591,POLI 5D,B01,626283,Dai; Yinlin,5,0,5,0
1713330182620,POLI 12,A00,494145,Staff,43,0,45,2
1713330183650,POLI 13R,A00,494146,Forman; Fonna,45,0,50,5
1713330184676,POLI 27,A01,494148,Staff,54,0,60,6
1713330185703,POLI 30,A00,494149,Staff,49,0,50,1
1713330186727,POLI 100DA,A00,494150,Staff,21,0,25,4
1713330188778,POLI 100I,A00,494152,Staff,27,0,30,3
1713330189805,POLI 104B,A00,494153,Smith; Glenn Chatmas,53,0,55,2
1713330190832,POLI 104F,A00,494154,Staff,28,0,30,2
1713330191856,POLI 104I,A00,494155,Smith; Glenn Chatmas,29,0,30,1
1713330192887,POLI 110C,A00,494156,Ingham; Sean,23,0,25,2
1713330193916,POLI 117R,A00,494157,Forman; Fonna,8,0,20,12
1713330194945,POLI 118,A00,494158,Ingham; Sean,21,0,25,4
1713330195971,POLI 120H,A00,494159,Fisk; David Lee,39,0,45,6
1713330196997,POLI 131CR,A00,494160,Hoston; Germaine,35,0,45,10
1713330198026,POLI 133J,A00,494161,Staff,32,0,35,3
1713330199052,POLI 135,A00,494162,Fisk; David Lee,33,0,35,2
1713330200080,POLI 140A,A00,494164,Staff,19,0,30,11
1713330201105,POLI 142I,A00,494165,Staff,30,0,30,0
1713330202130,POLI 144D,A00,494166,Staff,23,0,25,2
1713330203154,POLI 151,A00,494167,Staff,30,0,30,0
1713330204191,POLI 153,A00,494168,Staff,33,0,35,2
1713330205219,POLI 160AA,A00,494169,Staff,34,0,40,6
1713330206298,POLI 162,A00,494170,Mignozzetti; Umberto,18,0,25,7
1713330207323,POLI 171,A00,494171,Mignozzetti; Umberto,18,0,25,7
1713330208349,PSYC 1,A00,494172,Staff,96,0,100,4
1713330209376,PSYC 2,A00,494173,Moranton; Nirelia Melbina-,34,0,50,16
1713330210404,PSYC 3,A00,494174,Staff,29,0,30,1
1713330211428,PSYC 6,A00,494175,Staff,17,0,20,3
1713330212456,PSYC 60,A01,494177,Staff,38,0,45,7
1713330213485,PSYC 70,A01,505724,Geller; Emma Harlan,42,0,45,3
1713330214512,PSYC 101,A00,494180,Heyman; Gail D.,84,0,100,16
1713330215538,PSYC 105,A00,494181,Geller; Emma Harlan,51,0,90,39
1713330216564,PSYC 106,A00,494182,Dobkins; Karen R.,27,0,45,18
1713330217590,PSYC 108,A00,494183,Adrian; Julia Anna,89,0,100,11
1713330218616,PSYC 114,A01,494185,Winkielman; Piotr,0,3,30,30
1713330219642,PSYC 122,A00,494186,Moranton; Nirelia Melbina-,28,0,50,22
1713330220672,PSYC 124,A00,494187,Chapman; Eddie Nathaniel,71,0,80,9
1713330221699,PSYC 131,A00,494188,Anagnostaras; Stephan,40,0,80,40
1713330222725,PSYC 144,A00,494189,Staff,5,0,50,45
1713330223750,PSYC 154,A00,494190,Lacefield; Katharine I,107,0,180,73
1713330224780,PSYC 162,A00,494191,Wixted; John T,71,0,100,29
1713330225806,PSYC 172,A00,494192,Gorman; Michael R.,36,0,45,9
1713330226834,PSYC 178,A00,494193,Glaser; Dale,34,0,45,11
1713330227865,PSYC 193,A00,505725,Chapman; Eddie Nathaniel,20,0,20,0
1713330228890,RELI 145GS,A00,519817,Rahimi; Babak,18,0,20,2
1713330229919,SE 101A,A01,490862,Chadha; Mayank,23,0,25,2
1713330230944,SE 101C,A01,490924,Krysl; Petr,15,0,20,5
1713330231974,SE 110A,A01,490928,Staff,19,0,20,1
1713330233002,SE 130A,A00,490929,Morrison; Machel Leigh,55,0,70,15
1713330234030,SIO 1,A01,519325,Staff,39,0,40,1
1713330235054,SIO 30,A01,519327,Staff,38,0,40,2
1713330236080,SIO 40,A00,519328,Staff,39,0,40,1
1713330237109,SIO 46GS,A00,519819,Cook; Geoffrey W,17,0,25,8
1713330238135,SIO 109R,A00,494197,Forman; Fonna,0,3,20,20
1713330239160,SIO 121GS,A00,519827,Cook; Geoffrey W,17,0,25,8
1713330240190,SIO 132,A01,519330,Staff,38,0,40,2
1713330241215,SIO 133,A01,519397,Staff,37,0,40,3
1713330242246,SIO 139,A00,519396,Kacev; David,29,0,40,11
1713330243278,SOCI 1,A01,494199,Thorpe; Charles Robert,21,0,30,9
1713330243278,SOCI 1,A02,494200,Thorpe; Charles Robert,30,0,30,0
1713330243278,SOCI 1,A03,494201,Thorpe; Charles Robert,29,0,30,1
1713330243278,SOCI 1,A04,494202,Thorpe; Charles Robert,29,0,30,1
1713330243278,SOCI 1,A05,494203,Thorpe; Charles Robert,29,0,30,1
1713330243278,SOCI 1,A06,494204,Thorpe; Charles Robert,30,0,30,0
1713330243278,SOCI 1,A07,494205,Thorpe; Charles Robert,28,0,30,2
1713330244304,SOCI 60,A01,494207,Staff,34,0,40,6
1713330244304,SOCI 60,A02,494208,Staff,39,0,40,1
1713330245330,SOCI 100,A01,494210,Payne; Christine Anna,25,0,30,5
1713330245330,SOCI 100,A02,494211,Payne; Christine Anna,26,0,30,4
1713330246355,SOCI 109M,A00,494212,Staff,20,0,20,0
1713330247395,SOCI 110,A00,494213,Staff,34,0,40,6
1713330249446,SOCI 118E,A00,494215,Ng; Kwai,37,0,40,3
1713330250470,SOCI 125,A00,494216,Calderon-Zaks; Michael Aar,40,0,45,5
1713330251500,SOCI 126,A01,494218,Jones; Makeba,3,0,5,2
1713330252526,SOCI 131,A00,494219,Thorpe; Charles Robert,26,0,30,4
1713330254581,SOCI 135,A00,494221,Payne; Christine Anna,28,0,50,22
1713330255608,SOCI 136E,A00,626690,Ruiz; Jonathan Joseph,24,0,25,1
1713330256633,SOCI 138GS,A00,494222,Navon; Daniel,24,0,28,4
1713330258685,SOCI 145,A00,494224,Staff,40,0,45,5
1713330259710,SOCI 153,A00,494225,Staff,28,0,30,2
1713330260740,SOCI 160E,A00,494226,Ng; Kwai,29,0,40,11
1713330261766,SOCI 180,A00,494227,Staff,29,0,30,1
1713330262791,SOCI 189GS,A00,494228,Ribas Norris; Janet Vanesa,11,0,11,0
1713330263820,SOCI 190GS,A00,553232,Ribas Norris; Janet Vanesa,11,0,11,0
1713330264846,SOMI 220,A00,627178,Schneid; Stephen David,30,0,30,0
1713330265876,SYN 2,001,490768,Staff,13,0,15,2
1713330265876,SYN 2,002,490769,Staff,14,0,15,1
1713330265876,SYN 2,004,490775,Staff,0,0,0,0
1713330265876,SYN 2,003,490774,Staff,0,0,0,0
1713330265876,SYN 2,005,490776,Staff,0,0,0,0
1713330266904,SYN 2R,001,490779,Staff,11,0,15,4
1713330266904,SYN 2R,002,514635,Staff,14,0,15,1
1713330267929,SYN 100,A01,490783,Staff,9,0,20,11
1713330267929,SYN 100,B01,490787,Staff,9,0,20,11
1713330267929,SYN 100,C01,490789,Staff,10,0,20,10
1713330268955,SYN 150,A00,490817,Staff,14,0,15,1
1713330268955,SYN 150,B00,514610,Staff,15,0,15,0
1713330269989,TDAC 1,A00,492753,Walsh; Kim C.,19,0,20,1
1713330269989,TDAC 1,B00,492754,Harting; Carla Kelso,19,0,20,1
1713330269989,TDAC 1,C00,513995,Salovey; Todd,15,0,20,5
1713330271014,TDAC 101,A00,492766,Harting; Carla Kelso,17,0,20,3
1713330272044,TDAC 102,A00,492768,Basso; Beatrice,19,0,20,1
1713330273070,TDDE 111,A00,492769,Staff,25,0,25,0
1713330274095,TDDE 131,A00,492770,Staff,15,0,15,0
1713330274095,TDDE 131,B00,492771,Staff,15,0,15,0
1713330275120,TDDE 131GS,A00,523716,Guirguis; Mark C,23,0,28,5
1713330276146,TDGE 1,A01,492756,Salovey; Todd,56,0,60,4
1713330277171,TDGE 5,A01,492758,Staff,23,0,25,2
1713330278197,TDGE 10,A00,492759,Fulton; Julia,203,0,220,17
1713330279222,TDGE 11,A00,492760,Castro; Robert Jess,198,0,200,2
1713330281273,TDGE 124,A00,492772,Fulton; Julia,185,0,220,35
1713330282305,TDGE 125,A00,492773,Meyer; Ursula,38,0,50,12
1713330282305,TDGE 125,B00,492774,Staff,49,0,50,1
1713330282305,TDGE 125,C00,523565,Staff,48,0,50,2
1713330283333,TDGE 125GS,A00,523580,Guirguis; Mark C,23,0,28,5
1713330284359,TDGE 127,A00,492775,Havis; Allan,34,0,50,16
1713330285389,TDHT 101,A00,492776,Staff,34,0,35,1
1713330286415,TDMV 1,A00,492762,Caligagan; Maria T.,30,0,30,0
1713330286415,TDMV 1,B00,492763,Arcidiacono; Kristin,26,0,30,4
1713330287445,TDMV 2,A00,492764,Weinberg; Sadie,28,0,30,2
1713330288471,TDMV 3,A00,492765,Mack; Kara Shanai',37,0,40,3
1713330289496,TDMV 138,A00,492777,Mack; Kara Shanai',34,0,40,6
1713330290522,TDMV 140,A00,492778,Lima; Paulo Henrique,40,0,40,0
1713330291548,TDMV 142,A00,492779,Caligagan; Maria T.,33,0,40,7
1713330291548,TDMV 142,B00,492780,Caligagan; Tony,37,0,40,3
1713330292573,TDMV 143,A00,492781,Fyall; Daunte Edward,39,0,40,1
1713330293605,USP 1,A01,492401,Kwak; Nancy,27,0,35,8
1713330294630,USP 2,A01,492453,Hinds; Juli Beth,35,0,35,0
1713330295658,USP 3,A01,492516,Staff,28,0,35,7
1713330296683,USP 4,A00,492522,McTague; Sarah,16,0,25,9
1713330297709,USP 100,A00,492523,Staff,32,0,35,3
1713330298735,USP 101,A00,492524,Staff,13,0,15,2
1713330299761,USP 105,A00,492525,Staff,21,0,25,4
1713330300787,USP 151,A00,492526,Shenkman; Michael Thomas,32,0,35,3
1713330301814,USP 170,A00,492545,Hinds; Juli Beth,33,0,35,2
1713330302843,USP 171GS,A00,492608,Bussell; Mirle Rabinowitz,24,0,28,4
1713330303872,USP 183GS,A00,492613,Peerson; Susan,24,0,28,4
1713330304902,VIS 30,A01,490693,Yoldas; Pinar,19,0,22,3
1713330304902,VIS 30,A02,490694,Yoldas; Pinar,18,0,22,4
1713330305933,VIS 83,A00,490695,Kester; Grant,63,0,75,12
1713330306958,VIS 105D,A00,490696,Staff,22,0,25,3
1713330307982,VIS 124CN,A00,490699,Rose; Jordan M,65,0,75,10
1713330309008,VIS 125GS,A00,511221,Williams; Alena J,21,0,22,1
1713330310092,VIS 128D,A00,490700,Staff,73,0,75,2
1713330311118,VIS 151,A01,490717,Staff,33,0,34,1
1713330311118,VIS 151,A02,490766,Staff,33,0,34,1
1713330312148,VIS 154GS,A00,511972,Williams; Alena J,21,0,22,1
1713330313176,VIS 160A,A00,490767,Stone; Patricia,7,0,10,3
1713330314209,WCWP 10A,A00,490638,Staff,14,0,15,1
1713330314209,WCWP 10A,B00,490640,Staff,15,0,15,0
1713330315233,WCWP 10B,A00,490641,Staff,0,0,0,0
1713330315233,WCWP 10B,B00,490642,Staff,14,0,15,1
1713330315233,WCWP 10B,C00,490644,Staff,13,0,15,2
1713330315233,WCWP 10B,D00,490647,Staff,0,0,0,0
1713330316259,WCWP 100,A00,490655,Staff,0,0,0,0
1713330316259,WCWP 100,B00,490687,Staff,10,0,15,5
1713330318335,ANAR 153,A00,487222,Braswell; Geoffrey E.,53,0,60,7
1713330319364,ANBI 134,A00,487223,Staff,5,0,20,15
1713330320389,ANBI 143GS,A00,487224,Noel; Geoffroy Pierre Jean,18,0,24,6
1713330321416,ANBI 144GS,A00,519548,Noel; Geoffroy Pierre Jean,18,0,24,6
1713330322441,ANSC 101,A00,487225,Staff,18,0,20,2
1713330323470,ANSC 125,A00,487227,Brenner; Suzanne A,39,0,40,1
1713330325520,ANSC 146,A00,487229,Staff,35,0,40,5
1713330326545,ANSC 148,A00,487230,Olivas Hernandez; Olga Lid,39,0,40,1
1713330327576,ANSC 150,A00,504165,Sloane; Julia Kathryn,18,0,20,2
1713330328604,ANSC 180,A00,487232,Staff,14,0,15,1
1713330329633,ANSC 188,A00,627155,Staff,39,0,40,1
1713330330658,ANTH 5,A00,519529,Semendeferi; Ekaterini,15,0,15,0
1713330331687,ANTH 10,A00,487219,Staff,58,0,60,2
1713330332714,ANTH 23,A01,487221,Staff,17,0,20,3
1713330333745,ANTH 102,A00,487233,Wilder; Linnea Lorene,51,0,60,9
1713330334771,ANTH 103,A00,487234,Varma; Saiba,55,0,60,5
1713330335798,ANTH 105,A00,487235,Stewart; Alexander B,54,0,60,6
1713330336828,BENG 100,A01,516685,Taylor Amos; Alyssa C,26,0,30,4
1713330337861,BIBC 102,A01,491316,Flagg; Matthew Paul,11,0,88,77
1713330337861,BIBC 102,A02,491366,Flagg; Matthew Paul,78,0,88,10
1713330338886,BIBC 103,A01,491486,Boumechache; Miyyada,16,0,24,8
1713330338886,BIBC 103,A02,491487,Boumechache; Miyyada,24,0,24,0
1713330339911,BICD 100,A01,516882,Staff,73,0,75,2
1713330339911,BICD 100,A02,516890,Staff,69,0,75,6
1713330340936,BICD 102GS,A00,491488,Lo; Stanley M.,26,0,28,2
1713330341962,BIEB 136GS,A00,516940,Holway; David A. & Shurin; Jonathan,18,0,24,6
1713330342989,BIEB 137GS,A01,517034,Holway; David A. & Shurin; Jonathan,18,0,24,6
1713330344015,BIEB 138GS,A01,491492,Pirino; Giorgia,21,0,28,7
1713330345042,BILD 1,A01,491296,Staff,60,0,63,3
1713330345042,BILD 1,A02,491297,Staff,63,0,63,0
1713330346068,BILD 4,A01,517099,Gonzalez Gamboa; Ivonne,22,0,24,2
1713330346068,BILD 4,A02,517100,Gonzalez Gamboa; Ivonne,24,0,24,0
1713330347097,BILD 60GS,A00,491309,Lo; Stanley M.,26,0,28,2
1713330348127,BIMM 100,A01,517136,Staff,84,0,100,16
1713330349156,BIMM 110,A01,517182,Staff,55,0,100,45
1713330350187,BIMM 120,A01,517228,Pickett; Brooke Elizabeth,28,0,63,35
1713330350187,BIMM 120,A02,517240,Pickett; Brooke Elizabeth,44,0,63,19
1713330351211,BIMM 132GS,A01,491498,Pirino; Giorgia,21,0,28,7
1713330352241,BIMM 143,A01,491589,Bozinovic; Goran,13,0,40,27
1713330353271,BIPN 100,A01,491594,Armour; Jon Christopher,83,0,100,17
1713330354302,BIPN 140,A01,491602,Marino; Marc J,25,0,50,25
1713330356354,CAT 125,A00,515973,Staff,18,0,20,2
1713330357378,CAT 125GS,A00,515974,Rahimi; Babak,17,0,20,3
1713330358410,CAT 125R,A00,515980,Staff,12,0,20,8
1713330358410,CAT 125R,B00,515981,Tosun; Adriana,19,0,20,1
1713330358410,CAT 125R,C00,515987,Hyland; Tina Mae,0,3,20,20
1713330358410,CAT 125R,D00,515988,Bronstein; Phoebe Malan,16,0,20,4
1713330359438,CENG 15,A01,488699,Drews; Aaron,25,0,25,0
1713330360465,CENG 100,A00,505196,Opatkiewicz; Justin Paul,25,0,25,0
1713330361490,CGS 2A,A01,489598,Staff,33,0,35,2
1713330362519,CGS 112,A00,489599,Staff,15,0,15,0
1713330363549,CGS 119,A00,489603,Staff,10,0,10,0
1713330364578,CGS 120,A00,489604,Staff,14,0,15,1
1713330365606,CGS 150,A00,489607,Staff,15,0,15,0
1713330366712,CHEM 6A,A01,488715,Staff,98,0,100,2
1713330367737,CHEM 6B,A01,488719,Piercy; Marc Anthony,99,0,100,1
1713330368763,CHEM 6C,A01,488723,Albizati; Kim F.,93,0,100,7
1713330369793,CHEM 7L,A01,488728,Schurmeier; Kimberly,18,0,24,6
1713330369793,CHEM 7L,A02,488730,Schurmeier; Kimberly,23,0,24,1
1713330369793,CHEM 7L,A03,488734,Schurmeier; Kimberly,20,0,24,4
1713330369793,CHEM 7L,A04,488763,Schurmeier; Kimberly,23,0,24,1
1713330369793,CHEM 7L,B01,488798,Schurmeier; Kimberly,17,0,24,7
1713330369793,CHEM 7L,B02,488801,Schurmeier; Kimberly,22,0,24,2
1713330369793,CHEM 7L,B03,488808,Schurmeier; Kimberly,23,0,24,1
1713330369793,CHEM 7L,B04,488811,Schurmeier; Kimberly,24,0,24,0
1713330370823,CHEM 11,A01,488897,Stallings; Dontarie M,95,0,100,5
1713330371849,CHEM 40A,A01,488913,Albizati; Kim F.,83,0,100,17
1713330372874,CHEM 40B,A01,488920,Weizman; Haim,43,0,50,7
1713330372874,CHEM 40B,A02,488938,Weizman; Haim,44,0,50,6
1713330373903,CHEM 41A,A01,489029,Klosterman; Jeremy K,57,0,60,3
1713330374930,CHEM 41C,A01,500436,Tor; Yitzhak,55,0,60,5
1713330375959,CHEM 43A,A01,500426,Weizman; Haim,0,0,24,24
1713330375959,CHEM 43A,A02,500430,Weizman; Haim,8,0,24,16
1713330375959,CHEM 43A,B01,514041,Klosterman; Jeremy K,16,0,24,8
1713330375959,CHEM 43A,B02,514047,Klosterman; Jeremy K,23,0,24,1
1713330376985,CHEM 108,A01,489140,Jennings; Patricia A.,9,0,24,15
1713330376985,CHEM 108,A02,489142,Jennings; Patricia A.,14,0,24,10
1713330378013,CHEM 114A,A01,489147,Stallings; Dontarie M,68,0,100,32
1713330379040,CHIN 169A,A00,489171,Wang; Xiao,19,0,20,1
1713330381093,COGS 3,A01,518827,Boyle; Mary E. T.,26,0,40,14
1713330382120,COGS 11,A01,489175,Staff,27,0,30,3
1713330383149,COGS 14A,A01,518829,Staff,51,0,60,9
1713330384175,COGS 14B,A01,489177,Hoffman; Drew Ellen,63,0,75,12
1713330385204,COGS 100,A01,489181,Allen; Michael Gordon,62,0,75,13
1713330386230,COGS 101A,A01,489183,Staff,46,0,60,14
1713330387256,COGS 101B,A01,489185,Allen; Michael Gordon,8,0,30,22
1713330388286,COGS 101C,A01,526786,Staff,23,0,30,7
1713330390341,COGS 107A,A01,489189,Boyle; Mary E. T.,17,0,35,18
1713330391375,COGS 107B,A01,627144,Mooshagian; Eric Frederick,60,0,60,0
1713330392401,COGS 118A,A01,489191,Staff,0,44,40,40
1713330394457,COGS 171GS,A01,489194,Pineda; Jaime A,19,0,28,9
1713330395486,COGS 172,A01,489196,Staff,3,0,30,27
1713330396513,COGS 174GS,A01,489264,Pineda; Jaime A,19,0,28,9
1713330397541,COGS 180,A01,627150,Staff,28,0,30,2
1713330398568,COGS 186,A01,489274,Staff,0,1,30,30
1713330399594,COMM 10,A01,489276,Staff,23,0,25,2
1713330399594,COMM 10,A02,489303,Staff,23,0,25,2
1713330400620,COMM 100A,A01,489312,Staff,14,0,25,11
1713330400620,COMM 100A,A02,489313,Staff,24,0,25,1
1713330401645,COMM 106T,A00,512540,Staff,33,0,35,2
1713330402671,COMM 107,A00,489347,Staff,27,0,35,8
1713330403696,COMM 109P,A00,489358,Staff,31,0,35,4
1713330404725,COMM 132,A00,489361,McKenna; Denise,27,0,30,3
1713330405752,COMM 146,A00,489362,Halm; Gavin Patrick,26,0,30,4
1713330406776,COMM 190,A00,489363,Abuelhiga; Soraya Jill,17,0,23,6
1713330407802,CSE 8A,A50,489366,Staff,21,0,25,4
1713330407802,CSE 8A,A51,489367,Staff,24,0,25,1
1713330408828,CSE 11,A01,489398,Cao; Yingjun,73,0,100,27
1713330409854,CSE 12,A01,489487,Staff,43,0,50,7
1713330410883,CSE 20,A01,489497,Staff,48,0,50,2
1713330411907,CSE 21,A01,489517,Braun; Oliver,42,0,50,8
1713330412936,CSE 101,A01,489524,Braun; Oliver,0,30,50,50
1713330414018,CSE 105,A01,512594,Jones; Miles E,72,0,100,28
1713330414018,CSE 105,B01,512598,Jones; Miles E,52,0,100,48
1713330415048,CSE 140,A01,489538,Staff,41,0,50,9
1713330416079,CSE 141,A01,489550,Eldon; John,67,0,100,33
1713330417105,CSE 141L,A01,489571,Eldon; John,65,0,100,35
1713330418132,CSE 151A,A01,489583,Solares; Edwin A,141,0,200,59
1713330419161,CSE 175,A01,510886,Kumar; Rakesh,30,0,30,0
1713330420185,CSE 190,A00,516828,Dubnov; Shlomo,38,0,49,11
1713330421211,DOC 100D,A00,489667,Pass; Natalye Joann,19,0,25,6
1713330422237,DSC 10,A01,624268,Staff,72,0,75,3
1713330423262,DSC 20,A01,624476,Staff,50,0,50,0
1713330424287,DSC 40A,A01,624608,Staff,39,0,40,1
1713330425313,DSGN 1,A01,489179,Rill; Bryan,32,0,50,18
1713330426338,ECE 17,A01,490489,Sahay; Rajeev,18,0,30,12
1713330427368,ECE 65,A50,490492,Staff,11,0,20,9
1713330427368,ECE 65,A51,490493,Staff,18,0,20,2
1713330428394,ECON 1,A01,489715,Famulari; Melissa,67,0,70,3
1713330429418,ECON 2,A01,489717,Levkoff; Steven B.,68,0,70,2
1713330430448,ECON 3,A01,489948,Staff,70,0,70,0
1713330432502,ECON 5,A01,490103,Staff,27,0,30,3
1713330432502,ECON 5,B01,626281,Dai; Yinlin,45,0,45,0
1713330433535,ECON 100A,A01,490127,Famulari; Melissa,65,0,70,5
1713330434559,ECON 100B,A01,490129,Staff,64,0,70,6
1713330435586,ECON 109,A01,490187,Shishkin; Denis,27,0,35,8
1713330436616,ECON 110A,A01,490190,Levkoff; Steven B.,60,0,70,10
1713330437643,ECON 120A,A01,490245,Dai; Yinlin,61,0,70,9
1713330438672,ECON 120B,A01,490247,Nieto-Barthaburu; Augusto,40,0,70,30
1713330439699,ECON 120C,A01,490253,Sun; Yixiao,30,0,35,5
1713330439699,ECON 120C,B01,490255,Sun; Yixiao,34,0,35,1
1713330440728,ECON 129,A00,490256,Eckert; Fabian Paul,23,0,35,12
1713330441758,ECON 131,A00,490257,Nieto-Barthaburu; Augusto,0,6,35,35
1713330442784,ECON 138,A00,490258,Bharadwaj; Prashant,13,0,35,22
1713330442784,ECON 138,B00,490259,Bharadwaj; Prashant,15,0,35,20
1713330443812,ECON 159,A00,490260,Hendrickson; Gerald M.,0,9,0,0
1713330444839,ECON 178,A01,553995,Zhu; Ying,24,0,35,11
1713330445864,EDS 40,A01,512576,Black; Alison Michelle,20,0,20,0
1713330446891,EDS 107,A01,515848,Staff,30,0,30,0
1713330447917,EDS 110R,A01,490262,Staff,26,0,30,4
1713330448943,EDS 112,A01,490264,Chapman; Thandeka K,40,0,50,10
1713330449972,EDS 113,A00,490266,Staff,26,0,30,4
1713330450999,EDS 118,A00,490267,Warstadt; Melissa Fawn,20,0,30,10
1713330452028,EDS 124BR,A00,490268,Eguchi; Emi,4,0,25,21
1713330452028,EDS 124BR,B00,490269,Eguchi; Emi,23,0,25,2
1713330453053,EDS 126,A01,490271,Jones; Makeba,43,0,50,7
1713330454084,EDS 135,A01,490316,Staff,19,0,20,1
1713330455110,ENVR 142GS,A00,519514,Chang; Edmond Yi-Teh,26,0,28,2
1713330456135,ETHN 103,A00,490504,Staff,25,0,36,11
1713330457163,ETHN 103A,A00,490505,Man; Simeon S,4,0,9,5
1713330458189,ETHN 109,A00,490506,Staff,28,0,30,2
1713330459214,ETHN 118,A00,490507,Staff,35,0,36,1
1713330460240,ETHN 119,A00,490508,Staff,33,0,36,3
1713330461266,ETHN 121R,A00,490518,Choi; Esther Min,21,0,36,15
1713330462294,ETHN 127,A00,490528,Staff,14,0,15,1
1713330463320,ETHN 139,A00,490573,Staff,10,0,10,0
1713330464346,ETHN 150,A00,490575,Staff,15,0,15,0
1713330465373,GLBH 20,A00,491705,Elwardani; Nile Regina,38,0,40,2
1713330466400,GLBH 101,A00,491706,Staff,20,0,20,0
1713330467429,GLBH 111,A01,491708,Burgos; Jose L.,15,0,15,0
1713330468454,GLBH 146,A00,491709,Staff,9,0,20,11
1713330469484,GLBH 148,A00,491710,Olivas Hernandez; Olga Lid,11,0,20,9
1713330470510,GLBH 150,A00,491711,Sloane; Julia Kathryn,19,0,20,1
1713330471536,HIEA 131,A00,491760,Staff,28,0,32,4
1713330472565,HIEA 153,A00,491762,Staff,28,0,30,2
1713330473590,HIEU 124,A00,491811,Staff,26,0,32,6
1713330474617,HIEU 124GS,A00,491812,Markman; Kristina,27,0,28,1
1713330475681,HIEU 147,A00,491813,Staff,30,0,32,2
1713330476707,HIEU 149GS,A00,491816,Caldwell; Michael Alan,28,0,28,0
1713330477732,HILD 2C,A01,491713,Hendrickson; Gerald M.,26,0,30,4
1713330478764,HILD 7B,A01,491715,Kwak; Nancy,0,2,30,30
1713330479791,HILD 10,A01,491717,Staff,11,0,20,9
1713330480820,HILD 30GS,A00,491719,Edington; Claire Ellen,24,0,28,4
1713330481845,HINE 109,A00,491818,Shafir; Nir,27,0,32,5
1713330482871,HINE 128,A00,491821,Shafir; Nir,31,0,32,1
1713330483896,HISC 117,A00,491830,Staff,27,0,32,5
1713330484923,HIUS 103,A00,491834,Man; Simeon S,14,0,23,9
1713330485948,HIUS 108B,A00,491835,Staff,27,0,30,3
1713330486974,HIUS 141,A00,491836,Hendrickson; Gerald M.,28,0,32,4
1713330487999,HIUS 149,A00,491839,Staff,24,0,32,8
1713330489029,HUM 3,A01,512617,Crum; Matthew Stephen,42,0,50,8
1713330489029,HUM 3,A02,512618,Crum; Matthew Stephen,48,0,50,2
1713330490054,HUM 3GS,A00,512663,Markman; Kristina,0,0,0,1
1713330490054,HUM 3GS,B00,512664,Staff,0,0,0,0
1713330491078,HUM 4,A01,512620,West; Geoffrey Scott,25,0,50,25
1713330492104,HUM 4GS,A00,512666,Lyon; Antony J.,0,0,0,5
1713330493133,HUM 4R,A01,512625,Watkins; Eric,49,0,50,1
1713330494166,HUM 5,A01,512649,Zavodny; Tatiana Sophia,23,0,50,27
1713330494166,HUM 5,B01,512661,Zroka; Ryan Edward,48,0,50,2
1713330495193,INTL 190,A00,490577,Segui; Alan S,0,0,0,5
1713330496219,JAPN 20AR,A01,491267,Ross; Kayoko F,7,0,20,13
1713330497245,JAPN 180,A00,491285,Berman; Michael David,33,0,40,7
1713330498270,LATI 50,A01,502536,Kokinis; Troy Andreas,16,0,22,6
1713330498270,LATI 50,A02,502551,Kokinis; Troy Andreas,22,0,22,0
1713330498270,LATI 50,A03,502650,Kokinis; Troy Andreas,22,0,22,0
1713330498270,LATI 50,A04,502909,Kokinis; Troy Andreas,21,0,22,1
1713330499300,LATI 160,A01,502920,Kokinis; Troy Andreas,30,0,30,0
1713330500325,LIFR 1A,A00,490494,Van Moer; Vinciane G,17,0,20,3
1713330501350,LIFR 1AX,A00,490495,Van Moer; Vinciane G,17,0,20,3
1713330502379,LIFR 1B,A00,490496,Van Moer; Vinciane G,18,0,20,2
1713330503408,LIFR 1BX,A00,490497,Van Moer; Vinciane G,18,0,20,2
1713330504434,LIGN 8,A00,505198,McIntosh; Justin Daniel,134,0,150,16
1713330505459,LIGN 9GS,A00,491239,Lott; Margaret S.,18,0,20,2
1713330506486,LIGN 101,A01,505200,McIntosh; Justin Daniel,22,0,30,8
1713330507512,LIGN 120,A01,491244,Staff,22,0,30,8
1713330508541,LIGN 149GS,A00,491245,Lott; Margaret S.,18,0,20,2
1713330509566,LIGN 170,A00,491247,Staff,22,0,30,8
1713330510591,LISP 1D,A00,490498,Munoz Sanchez; Alicia,9,0,14,5
1713330510591,LISP 1D,B00,490499,Munoz Sanchez; Alicia,6,0,14,8
1713330510591,LISP 1D,C00,490500,Munoz Sanchez; Alicia,7,0,14,7
1713330510591,LISP 1D,D00,490501,Munoz Sanchez; Alicia,10,0,14,4
1713330511620,LISP 1DX,A00,490502,Munoz Sanchez; Alicia,14,0,28,14
1713330511620,LISP 1DX,B00,490503,Munoz Sanchez; Alicia,16,0,28,12
1713330513673,LTAM 110,A00,491847,Staff,22,0,25,3
1713330514696,LTCS 119,A00,491848,Staff,11,0,15,4
1713330515723,LTCS 130,A00,491849,Staff,24,0,25,1
1713330517837,LTEA 120C,A00,491852,Staff,32,0,40,8
1713330518862,LTEN 130GS,A00,491853,Lyon; Antony J.,23,0,28,5
1713330519886,LTEN 148,A00,491855,Staff,23,0,25,2
1713330520916,LTEN 159,A00,491856,Staff,20,0,25,5
1713330521945,LTEN 180,A00,491857,Staff,8,0,15,7
1713330524005,LTSP 123GS,A00,505928,Bessett; Ryan Matthew,24,0,28,4
1713330525035,LTSP 174GS,A00,506037,Bessett; Ryan Matthew,24,0,28,4
1713330527084,LTWR 102,A00,491861,Staff,9,0,15,6
1713330528109,LTWR 106,A00,491862,Staff,8,0,15,7
1713330529139,MAE 11,A00,490930,Bahadori; Mohammad Yousef,95,0,100,5
1713330530165,MAE 30A,A00,490931,Qi; Huihui,37,0,40,3
1713330531191,MAE 101A,A00,491036,Sadeghizadeh; Zahra,92,0,100,8
1713330532219,MAE 101C,A00,491037,Seshadri; Kalyanasundaram,66,0,100,34
1713330533242,MAE 113,A00,491040,Seshadri; Kalyanasundaram,66,0,80,14
1713330534267,MAE 131A,A00,491041,Ghazinejad; Maziar,37,0,40,3
1713330535294,MAE 142,A00,491053,Staff,39,0,40,1
1713330536317,MAE 143A,A00,491054,Staff,31,0,50,19
1713330537342,MAE 150,A00,491092,Truong; Phuong Thi Ngoc,24,0,35,11
1713330538369,MATH 3C,A01,494031,Pardo Guerra; Sebastian,30,0,30,0
1713330538369,MATH 3C,A02,494032,Pardo Guerra; Sebastian,29,0,30,1
1713330539394,MATH 10A,A01,494034,Staff,27,0,30,3
1713330539394,MATH 10A,A02,494035,Staff,28,0,30,2
1713330539394,MATH 10A,B01,494037,Staff,27,0,30,3
1713330539394,MATH 10A,B02,494038,Staff,29,0,30,1
1713330540427,MATH 10B,A01,494040,Habib; Yousaf,22,0,30,8
1713330540427,MATH 10B,A02,494041,Habib; Yousaf,28,0,30,2
1713330540427,MATH 10B,A03,494042,Habib; Yousaf,29,0,30,1
1713330540427,MATH 10B,A04,494043,Habib; Yousaf,30,0,30,0
1713330540427,MATH 10B,B01,494045,Habib; Yousaf,25,0,30,5
1713330540427,MATH 10B,B02,494046,Habib; Yousaf,30,0,30,0
1713330540427,MATH 10B,B03,494047,Habib; Yousaf,30,0,30,0
1713330540427,MATH 10B,B04,494048,Habib; Yousaf,30,0,30,0
1713330541454,MATH 18,A01,494050,Kemp; Todd Aahron,25,0,30,5
1713330541454,MATH 18,A02,494051,Kemp; Todd Aahron,29,0,30,1
1713330541454,MATH 18,B01,494054,Kemp; Todd Aahron,26,0,30,4
1713330541454,MATH 18,B02,494055,Kemp; Todd Aahron,29,0,30,1
1713330542488,MATH 20A,A01,494059,Suk; Andrew Hoon,30,0,30,0
1713330543520,MATH 20B,A01,494061,Briones; Jor-el Thomas Caparas,33,0,35,2
1713330543520,MATH 20B,B01,494063,Bach; Quang Tran,34,0,35,1
1713330544552,MATH 20C,A01,494065,Staff,28,0,30,2
1713330544552,MATH 20C,A02,494066,Staff,30,0,30,0
1713330544552,MATH 20C,A03,494067,Staff,30,0,30,0
1713330544552,MATH 20C,A04,494068,Staff,30,0,30,0
1713330544552,MATH 20C,B01,494070,Zhang; Ming,25,0,30,5
1713330544552,MATH 20C,B02,494071,Zhang; Ming,27,0,30,3
1713330544552,MATH 20C,B03,494072,Zhang; Ming,29,0,30,1
1713330544552,MATH 20C,B04,494073,Zhang; Ming,29,0,30,1
1713330545583,MATH 20D,A01,494075,Staff,22,0,30,8
1713330545583,MATH 20D,A02,494076,Staff,29,0,30,1
1713330546611,MATH 20E,A01,494079,Staff,24,0,30,6
1713330546611,MATH 20E,A02,494080,Staff,26,0,30,4
1713330546611,MATH 20E,B01,494082,Staff,25,0,30,5
1713330546611,MATH 20E,B02,494083,Staff,25,0,30,5
1713330547636,MATH 103A,A01,494085,Aliabadi Sr.; Mohsen,14,0,30,16
1713330547636,MATH 103A,A02,494086,Aliabadi Sr.; Mohsen,28,0,30,2
1713330547636,MATH 103A,B01,494088,Aliabadi Sr.; Mohsen,21,0,30,9
1713330547636,MATH 103A,B02,494089,Aliabadi Sr.; Mohsen,27,0,30,3
1713330548664,MATH 109,A01,494091,Staff,30,0,30,0
1713330548664,MATH 109,A02,494092,Staff,29,0,30,1
1713330548664,MATH 109,B01,494094,Staff,27,0,30,3
1713330548664,MATH 109,B02,494095,Staff,29,0,30,1
1713330549698,MATH 142A,A01,494097,Chow; Bennett,15,0,30,15
1713330549698,MATH 142A,A02,494098,Chow; Bennett,23,0,30,7
1713330549698,MATH 142A,B01,494100,Chow; Bennett,19,0,30,11
1713330549698,MATH 142A,B02,494101,Chow; Bennett,29,0,30,1
1713330551747,MATH 168A,A01,516677,Dumitriu; Ioana,16,0,35,19
1713330552777,MATH 170A,A01,516679,Dumitriu; Ioana,18,0,30,12
1713330552777,MATH 170A,A02,516680,Dumitriu; Ioana,28,0,30,2
1713330553802,MATH 193A,A01,494107,Staff,14,0,30,16
1713330553802,MATH 193A,A02,494108,Staff,19,0,30,11
1713330553802,MATH 193A,A03,494109,Staff,29,0,30,1
1713330553802,MATH 193A,A04,494110,Staff,22,0,30,8
1713330556880,MGT 16,A00,491930,McKay; Michael J,92,0,98,6
1713330557906,MGT 18,A00,491992,McKay; Michael J,96,0,98,2
1713330558935,MGT 71,A00,492003,Staff,65,0,98,33
1713330559960,MGT 103,A00,505209,Eberhard; Craig A,81,0,98,17
1713330560986,MGT 131A,A00,505210,Anderson; John Charles,89,0,98,9
1713330563041,MGT 153,A00,492077,Perols; Johan Lars,19,0,90,71
1713330566125,MGT 164,A00,492222,McKay; Mary A,91,0,98,7
1713330567154,MGT 172,A00,492245,Staff,59,0,60,1
1713330567154,MGT 172,B00,505526,Hedges; Kathleen,65,0,98,33
1713330568181,MGT 181,A00,505669,Dunn; Louis Jean,81,0,98,17
1713330569214,MMW 14,A01,494399,Staff,15,0,28,13
1713330569214,MMW 14,A02,494400,Staff,25,0,28,3
1713330569214,MMW 14,A03,494401,Staff,28,0,28,0
1713330569214,MMW 14,A04,494402,Staff,28,0,28,0
1713330569214,MMW 14,B01,494404,Carreras; Maria Victoria,8,0,28,20
1713330569214,MMW 14,B02,494405,Carreras; Maria Victoria,25,0,28,3
1713330569214,MMW 14,B03,494406,Carreras; Maria Victoria,27,0,28,1
1713330569214,MMW 14,B04,494407,Carreras; Maria Victoria,28,0,28,0
1713330570248,MMW 14GS,A00,506250,Chang; Edmond Yi-Teh,0,0,0,0
1713330571277,MMW 121R,A01,494415,Adamiak; Patrick John,10,0,28,18
1713330571277,MMW 121R,A02,494416,Adamiak; Patrick John,24,0,28,4
1713330572302,MUS 1A,A01,494113,Staff,12,0,25,13
1713330572302,MUS 1A,A02,494114,Staff,24,0,25,1
1713330573326,MUS 4,A01,494116,Staff,23,0,25,2
1713330573326,MUS 4,A02,494117,Staff,22,0,25,3
1713330574357,MUS 5R,A01,494236,Dubnov; Shlomo,6,0,25,19
1713330574357,MUS 5R,A02,494237,Dubnov; Shlomo,25,0,25,0
1713330575386,MUS 6,A01,494122,Staff,10,0,25,15
1713330575386,MUS 6,A02,494123,Staff,23,0,25,2
1713330576415,MUS 7,A01,494125,Staff,16,0,25,9
1713330576415,MUS 7,A02,494126,Staff,24,0,25,1
1713330577440,MUS 11,A01,494128,Staff,23,0,25,2
1713330577440,MUS 11,A02,494129,Staff,24,0,25,1
1713330578465,MUS 13,A01,494131,Staff,25,0,25,0
1713330578465,MUS 13,A02,494132,Staff,25,0,25,0
1713330579495,MUS 15,A01,494134,Staff,17,0,25,8
1713330579495,MUS 15,A02,494135,Staff,25,0,25,0
1713330579495,MUS 15,B01,494137,Staff,24,0,25,1
1713330580521,MUS 80,A00,494232,Staff,24,0,25,1
1713330580521,MUS 80,B00,494233,Staff,25,0,25,0
1713330580521,MUS 80,C00,494234,Staff,23,0,25,2
1713330581547,MUS 95C,A00,494141,Staff,70,0,75,5
1713330582572,MUS 114,A00,494142,Staff,40,0,50,10
1713330583601,NANO 15,A01,490636,Drews; Aaron,7,0,7,0
1713330584627,PHIL 1,A00,490578,Grush; Rick Scott,49,0,50,1
1713330585652,PHIL 10,A01,490580,Grush; Rick Scott,33,0,35,2
1713330585652,PHIL 10,A02,490586,Grush; Rick Scott,32,0,35,3
1713330586678,PHIL 27,A01,490591,Staff,22,0,25,3
1713330586678,PHIL 27,A02,490592,Staff,25,0,25,0
1713330586678,PHIL 27,A03,490593,Staff,25,0,25,0
1713330586678,PHIL 27,A04,490598,Staff,25,0,25,0
1713330587709,PHIL 32,A01,490611,Staff,20,0,20,0
1713330587709,PHIL 32,A02,490618,Staff,20,0,20,0
1713330588739,PHIL 90,A00,490624,Staff,40,0,40,0
1713330589764,PHIL 136,A00,490627,Cohen; Jonathan David,37,0,40,3
1713330590789,PHIL 155,A00,490634,Staff,62,0,70,8
1713330591815,PHYS 1A,A00,491610,Staff,245,0,250,5
1713330592840,PHYS 1AL,001,491616,Tsai; Philbert S,27,0,30,3
1713330592840,PHYS 1AL,002,491618,Tsai; Philbert S,30,0,30,0
1713330593868,PHYS 1B,A00,491623,Staff,236,0,250,14
1713330594893,PHYS 1BL,001,491626,Tsai; Philbert S,22,0,30,8
1713330594893,PHYS 1BL,002,491628,Tsai; Philbert S,26,0,30,4
1713330595918,PHYS 1C,A00,491632,Staff,213,0,245,32
1713330596944,PHYS 1CL,001,491635,Tsai; Philbert S,2,0,30,28
1713330596944,PHYS 1CL,002,491643,Tsai; Philbert S,22,0,30,8
1713330597969,PHYS 2AR,A01,491651,Meyertholen; Andrew D.,44,0,50,6
1713330598998,PHYS 2B,A01,491659,Staff,106,0,115,9
1713330600034,PHYS 2BL,A01,491685,Staff,21,0,24,3
1713330600034,PHYS 2BL,A02,491700,Staff,21,0,24,3
1713330601065,PHYS 2C,A01,505161,Staff,101,0,115,14
1713330602091,PHYS 4A,A01,491704,Grinstein; Benjamin,99,0,100,1
1713330603125,POLI 5D,A01,494144,Staff,3,0,5,2
1713330603125,POLI 5D,B01,626283,Dai; Yinlin,5,0,5,0
1713330604150,POLI 12,A00,494145,Staff,43,0,45,2
1713330605176,POLI 13R,A00,494146,Forman; Fonna,45,0,50,5
1713330606200,POLI 27,A01,494148,Staff,54,0,60,6
1713330607229,POLI 30,A00,494149,Staff,49,0,50,1
1713330608255,POLI 100DA,A00,494150,Staff,21,0,25,4
1713330610311,POLI 100I,A00,494152,Staff,27,0,30,3
1713330611340,POLI 104B,A00,494153,Smith; Glenn Chatmas,53,0,55,2
1713330612368,POLI 104F,A00,494154,Staff,28,0,30,2
1713330613395,POLI 104I,A00,494155,Smith; Glenn Chatmas,29,0,30,1
1713330614427,POLI 110C,A00,494156,Ingham; Sean,23,0,25,2
1713330615453,POLI 117R,A00,494157,Forman; Fonna,8,0,20,12
1713330616478,POLI 118,A00,494158,Ingham; Sean,21,0,25,4
1713330617507,POLI 120H,A00,494159,Fisk; David Lee,39,0,45,6
1713330618532,POLI 131CR,A00,494160,Hoston; Germaine,35,0,45,10
1713330619562,POLI 133J,A00,494161,Staff,32,0,35,3
1713330620588,POLI 135,A00,494162,Fisk; David Lee,33,0,35,2
1713330621671,POLI 140A,A00,494164,Staff,19,0,30,11
1713330622697,POLI 142I,A00,494165,Staff,30,0,30,0
1713330623721,POLI 144D,A00,494166,Staff,23,0,25,2
1713330624745,POLI 151,A00,494167,Staff,30,0,30,0
1713330625770,POLI 153,A00,494168,Staff,33,0,35,2
1713330626800,POLI 160AA,A00,494169,Staff,34,0,40,6
1713330627828,POLI 162,A00,494170,Mignozzetti; Umberto,18,0,25,7
1713330628856,POLI 171,A00,494171,Mignozzetti; Umberto,18,0,25,7
1713330629882,PSYC 1,A00,494172,Staff,96,0,100,4
1713330630907,PSYC 2,A00,494173,Moranton; Nirelia Melbina-,34,0,50,16
1713330631932,PSYC 3,A00,494174,Staff,29,0,30,1
1713330632957,PSYC 6,A00,494175,Staff,17,0,20,3
1713330633984,PSYC 60,A01,494177,Staff,38,0,45,7
1713330635009,PSYC 70,A01,505724,Geller; Emma Harlan,42,0,45,3
1713330636036,PSYC 101,A00,494180,Heyman; Gail D.,84,0,100,16
1713330637060,PSYC 105,A00,494181,Geller; Emma Harlan,51,0,90,39
1713330638090,PSYC 106,A00,494182,Dobkins; Karen R.,27,0,45,18
1713330639115,PSYC 108,A00,494183,Adrian; Julia Anna,89,0,100,11
1713330640142,PSYC 114,A01,494185,Winkielman; Piotr,0,3,30,30
1713330641166,PSYC 122,A00,494186,Moranton; Nirelia Melbina-,28,0,50,22
1713330642193,PSYC 124,A00,494187,Chapman; Eddie Nathaniel,71,0,80,9
1713330643218,PSYC 131,A00,494188,Anagnostaras; Stephan,40,0,80,40
1713330644247,PSYC 144,A00,494189,Staff,5,0,50,45
1713330645273,PSYC 154,A00,494190,Lacefield; Katharine I,107,0,180,73
1713330646302,PSYC 162,A00,494191,Wixted; John T,71,0,100,29
1713330647330,PSYC 172,A00,494192,Gorman; Michael R.,36,0,45,9
1713330648360,PSYC 178,A00,494193,Glaser; Dale,34,0,45,11
1713330649389,PSYC 193,A00,505725,Chapman; Eddie Nathaniel,20,0,20,0
1713330650414,RELI 145GS,A00,519817,Rahimi; Babak,18,0,20,2
1713330651439,SE 101A,A01,490862,Chadha; Mayank,23,0,25,2
1713330652465,SE 101C,A01,490924,Krysl; Petr,15,0,20,5
1713330653490,SE 110A,A01,490928,Staff,19,0,20,1
1713330654514,SE 130A,A00,490929,Morrison; Machel Leigh,55,0,70,15
1713330655541,SIO 1,A01,519325,Staff,39,0,40,1
1713330656570,SIO 30,A01,519327,Staff,38,0,40,2
1713330657595,SIO 40,A00,519328,Staff,39,0,40,1
1713330658621,SIO 46GS,A00,519819,Cook; Geoffrey W,17,0,25,8
1713330659649,SIO 109R,A00,494197,Forman; Fonna,0,3,20,20
1713330660677,SIO 121GS,A00,519827,Cook; Geoffrey W,17,0,25,8
1713330661703,SIO 132,A01,519330,Staff,38,0,40,2
1713330662728,SIO 133,A01,519397,Staff,37,0,40,3
1713330663755,SIO 139,A00,519396,Kacev; David,29,0,40,11
1713330664786,SOCI 1,A01,494199,Thorpe; Charles Robert,21,0,30,9
1713330664786,SOCI 1,A02,494200,Thorpe; Charles Robert,30,0,30,0
1713330664786,SOCI 1,A03,494201,Thorpe; Charles Robert,29,0,30,1
1713330664786,SOCI 1,A04,494202,Thorpe; Charles Robert,29,0,30,1
1713330664786,SOCI 1,A05,494203,Thorpe; Charles Robert,29,0,30,1
1713330664786,SOCI 1,A06,494204,Thorpe; Charles Robert,30,0,30,0
1713330664786,SOCI 1,A07,494205,Thorpe; Charles Robert,28,0,30,2
1713330665812,SOCI 60,A01,494207,Staff,34,0,40,6
1713330665812,SOCI 60,A02,494208,Staff,39,0,40,1
1713330666838,SOCI 100,A01,494210,Payne; Christine Anna,25,0,30,5
1713330666838,SOCI 100,A02,494211,Payne; Christine Anna,26,0,30,4
1713330667864,SOCI 109M,A00,494212,Staff,20,0,20,0
1713330668888,SOCI 110,A00,494213,Staff,34,0,40,6
1713330670940,SOCI 118E,A00,494215,Ng; Kwai,37,0,40,3
1713330671969,SOCI 125,A00,494216,Calderon-Zaks; Michael Aar,40,0,45,5
1713330672997,SOCI 126,A01,494218,Jones; Makeba,3,0,5,2
1713330674022,SOCI 131,A00,494219,Thorpe; Charles Robert,26,0,30,4
1713330676074,SOCI 135,A00,494221,Payne; Christine Anna,28,0,50,22
1713330677101,SOCI 136E,A00,626690,Ruiz; Jonathan Joseph,24,0,25,1
1713330678130,SOCI 138GS,A00,494222,Navon; Daniel,24,0,28,4
1713330680181,SOCI 145,A00,494224,Staff,40,0,45,5
1713330681206,SOCI 153,A00,494225,Staff,28,0,30,2
1713330682235,SOCI 160E,A00,494226,Ng; Kwai,29,0,40,11
1713330683260,SOCI 180,A00,494227,Staff,29,0,30,1
1713330684289,SOCI 189GS,A00,494228,Ribas Norris; Janet Vanesa,11,0,11,0
1713330685313,SOCI 190GS,A00,553232,Ribas Norris; Janet Vanesa,11,0,11,0
1713330686339,SOMI 220,A00,627178,Schneid; Stephen David,30,0,30,0
1713330687367,SYN 2,001,490768,Staff,13,0,15,2
1713330687367,SYN 2,002,490769,Staff,14,0,15,1
1713330687367,SYN 2,004,490775,Staff,0,0,0,0
1713330687367,SYN 2,003,490774,Staff,0,0,0,0
1713330687367,SYN 2,005,490776,Staff,0,0,0,0
1713330688393,SYN 2R,001,490779,Staff,11,0,15,4
1713330688393,SYN 2R,002,514635,Staff,14,0,15,1
1713330689418,SYN 100,A01,490783,Staff,9,0,20,11
1713330689418,SYN 100,B01,490787,Staff,9,0,20,11
1713330689418,SYN 100,C01,490789,Staff,10,0,20,10
1713330690443,SYN 150,A00,490817,Staff,14,0,15,1
1713330690443,SYN 150,B00,514610,Staff,15,0,15,0
1713330691469,TDAC 1,A00,492753,Walsh; Kim C.,19,0,20,1
1713330691469,TDAC 1,B00,492754,Harting; Carla Kelso,19,0,20,1
1713330691469,TDAC 1,C00,513995,Salovey; Todd,15,0,20,5
1713330692497,TDAC 101,A00,492766,Harting; Carla Kelso,17,0,20,3
1713330693522,TDAC 102,A00,492768,Basso; Beatrice,19,0,20,1
1713330694546,TDDE 111,A00,492769,Staff,25,0,25,0
1713330695570,TDDE 131,A00,492770,Staff,15,0,15,0
1713330695570,TDDE 131,B00,492771,Staff,15,0,15,0
1713330696599,TDDE 131GS,A00,523716,Guirguis; Mark C,23,0,28,5
1713330697624,TDGE 1,A01,492756,Salovey; Todd,56,0,60,4
1713330698651,TDGE 5,A01,492758,Staff,23,0,25,2
1713330699676,TDGE 10,A00,492759,Fulton; Julia,203,0,220,17
1713330700706,TDGE 11,A00,492760,Castro; Robert Jess,198,0,200,2
1713330702757,TDGE 124,A00,492772,Fulton; Julia,185,0,220,35
1713330703784,TDGE 125,A00,492773,Meyer; Ursula,38,0,50,12
1713330703784,TDGE 125,B00,492774,Staff,49,0,50,1
1713330703784,TDGE 125,C00,523565,Staff,48,0,50,2
1713330704812,TDGE 125GS,A00,523580,Guirguis; Mark C,23,0,28,5
1713330705836,TDGE 127,A00,492775,Havis; Allan,34,0,50,16
1713330706861,TDHT 101,A00,492776,Staff,34,0,35,1
1713330707887,TDMV 1,A00,492762,Caligagan; Maria T.,30,0,30,0
1713330707887,TDMV 1,B00,492763,Arcidiacono; Kristin,26,0,30,4
1713330708914,TDMV 2,A00,492764,Weinberg; Sadie,28,0,30,2
1713330709940,TDMV 3,A00,492765,Mack; Kara Shanai',37,0,40,3
1713330710968,TDMV 138,A00,492777,Mack; Kara Shanai',34,0,40,6
1713330711991,TDMV 140,A00,492778,Lima; Paulo Henrique,40,0,40,0
1713330713017,TDMV 142,A00,492779,Caligagan; Maria T.,33,0,40,7
1713330713017,TDMV 142,B00,492780,Caligagan; Tony,37,0,40,3
1713330714042,TDMV 143,A00,492781,Fyall; Daunte Edward,39,0,40,1
1713330715075,USP 1,A01,492401,Kwak; Nancy,27,0,35,8
1713330716099,USP 2,A01,492453,Hinds; Juli Beth,35,0,35,0
1713330717125,USP 3,A01,492516,Staff,28,0,35,7
1713330718151,USP 4,A00,492522,McTague; Sarah,16,0,25,9
1713330719176,USP 100,A00,492523,Staff,32,0,35,3
1713330720206,USP 101,A00,492524,Staff,13,0,15,2
1713330721236,USP 105,A00,492525,Staff,21,0,25,4
1713330722263,USP 151,A00,492526,Shenkman; Michael Thomas,32,0,35,3
1713330723291,USP 170,A00,492545,Hinds; Juli Beth,33,0,35,2
1713330724321,USP 171GS,A00,492608,Bussell; Mirle Rabinowitz,24,0,28,4
1713330725404,USP 183GS,A00,492613,Peerson; Susan,24,0,28,4
1713330726433,VIS 30,A01,490693,Yoldas; Pinar,19,0,22,3
1713330726433,VIS 30,A02,490694,Yoldas; Pinar,18,0,22,4
1713330727462,VIS 83,A00,490695,Kester; Grant,63,0,75,12
1713330728487,VIS 105D,A00,490696,Staff,22,0,25,3
1713330729512,VIS 124CN,A00,490699,Rose; Jordan M,65,0,75,10
1713330730534,VIS 125GS,A00,511221,Williams; Alena J,21,0,22,1
1713330731561,VIS 128D,A00,490700,Staff,73,0,75,2
1713330732586,VIS 151,A01,490717,Staff,33,0,34,1
1713330732586,VIS 151,A02,490766,Staff,33,0,34,1
1713330733611,VIS 154GS,A00,511972,Williams; Alena J,21,0,22,1
1713330734638,VIS 160A,A00,490767,Stone; Patricia,7,0,10,3
1713330735668,WCWP 10A,A00,490638,Staff,14,0,15,1
1713330735668,WCWP 10A,B00,490640,Staff,15,0,15,0
1713330736693,WCWP 10B,A00,490641,Staff,0,0,0,0
1713330736693,WCWP 10B,B00,490642,Staff,14,0,15,1
1713330736693,WCWP 10B,C00,490644,Staff,13,0,15,2
1713330736693,WCWP 10B,D00,490647,Staff,0,0,0,0
1713330737727,WCWP 100,A00,490655,Staff,0,0,0,0
1713330737727,WCWP 100,B00,490687,Staff,10,0,15,5
1713330739923,ANAR 153,A00,487222,Braswell; Geoffrey E.,53,0,60,7
1713330740947,ANBI 134,A00,487223,Staff,5,0,20,15
1713330741975,ANBI 143GS,A00,487224,Noel; Geoffroy Pierre Jean,18,0,24,6
1713330743000,ANBI 144GS,A00,519548,Noel; Geoffroy Pierre Jean,18,0,24,6
1713330744026,ANSC 101,A00,487225,Staff,18,0,20,2
1713330745052,ANSC 125,A00,487227,Brenner; Suzanne A,39,0,40,1
1713330747102,ANSC 146,A00,487229,Staff,35,0,40,5
1713330748126,ANSC 148,A00,487230,Olivas Hernandez; Olga Lid,39,0,40,1
1713330749154,ANSC 150,A00,504165,Sloane; Julia Kathryn,18,0,20,2
1713330750184,ANSC 180,A00,487232,Staff,14,0,15,1
1713330751212,ANSC 188,A00,627155,Staff,39,0,40,1
1713330752236,ANTH 5,A00,519529,Semendeferi; Ekaterini,15,0,15,0
1713330753261,ANTH 10,A00,487219,Staff,58,0,60,2
1713330754286,ANTH 23,A01,487221,Staff,17,0,20,3
1713330755311,ANTH 102,A00,487233,Wilder; Linnea Lorene,51,0,60,9
1713330756342,ANTH 103,A00,487234,Varma; Saiba,55,0,60,5
1713330757372,ANTH 105,A00,487235,Stewart; Alexander B,54,0,60,6
1713330758398,BENG 100,A01,516685,Taylor Amos; Alyssa C,26,0,30,4
1713330759426,BIBC 102,A01,491316,Flagg; Matthew Paul,11,0,88,77
1713330759426,BIBC 102,A02,491366,Flagg; Matthew Paul,78,0,88,10
1713330760455,BIBC 103,A01,491486,Boumechache; Miyyada,16,0,24,8
1713330760455,BIBC 103,A02,491487,Boumechache; Miyyada,24,0,24,0
1713330761486,BICD 100,A01,516882,Staff,73,0,75,2
1713330761486,BICD 100,A02,516890,Staff,69,0,75,6
1713330762511,BICD 102GS,A00,491488,Lo; Stanley M.,26,0,28,2
1713330763542,BIEB 136GS,A00,516940,Holway; David A. & Shurin; Jonathan,18,0,24,6
1713330764572,BIEB 137GS,A01,517034,Holway; David A. & Shurin; Jonathan,18,0,24,6
1713330765603,BIEB 138GS,A01,491492,Pirino; Giorgia,21,0,28,7
1713330766632,BILD 1,A01,491296,Staff,60,0,63,3
1713330766632,BILD 1,A02,491297,Staff,63,0,63,0
1713330767658,BILD 4,A01,517099,Gonzalez Gamboa; Ivonne,22,0,24,2
1713330767658,BILD 4,A02,517100,Gonzalez Gamboa; Ivonne,24,0,24,0
1713330768685,BILD 60GS,A00,491309,Lo; Stanley M.,26,0,28,2
1713330769711,BIMM 100,A01,517136,Staff,84,0,100,16
1713330770742,BIMM 110,A01,517182,Staff,54,0,100,46
1713330771767,BIMM 120,A01,517228,Pickett; Brooke Elizabeth,28,0,63,35
1713330771767,BIMM 120,A02,517240,Pickett; Brooke Elizabeth,44,0,63,19
1713330772794,BIMM 132GS,A01,491498,Pirino; Giorgia,21,0,28,7
1713330773821,BIMM 143,A01,491589,Bozinovic; Goran,13,0,40,27
1713330774850,BIPN 100,A01,491594,Armour; Jon Christopher,83,0,100,17
1713330775875,BIPN 140,A01,491602,Marino; Marc J,25,0,50,25
1713330777952,CAT 125,A00,515973,Staff,18,0,20,2
1713330778977,CAT 125GS,A00,515974,Rahimi; Babak,17,0,20,3
1713330780011,CAT 125R,A00,515980,Staff,12,0,20,8
1713330780011,CAT 125R,B00,515981,Tosun; Adriana,19,0,20,1
1713330780011,CAT 125R,C00,515987,Hyland; Tina Mae,0,3,20,20
1713330780011,CAT 125R,D00,515988,Bronstein; Phoebe Malan,16,0,20,4
1713330781037,CENG 15,A01,488699,Drews; Aaron,25,0,25,0
1713330782068,CENG 100,A00,505196,Opatkiewicz; Justin Paul,25,0,25,0
1713330783094,CGS 2A,A01,489598,Staff,33,0,35,2
1713330784120,CGS 112,A00,489599,Staff,15,0,15,0
1713330785145,CGS 119,A00,489603,Staff,10,0,10,0
1713330786173,CGS 120,A00,489604,Staff,14,0,15,1
1713330787203,CGS 150,A00,489607,Staff,15,0,15,0
1713330788228,CHEM 6A,A01,488715,Staff,98,0,100,2
1713330789255,CHEM 6B,A01,488719,Piercy; Marc Anthony,99,0,100,1
1713330790281,CHEM 6C,A01,488723,Albizati; Kim F.,93,0,100,7
1713330791306,CHEM 7L,A01,488728,Schurmeier; Kimberly,18,0,24,6
1713330791306,CHEM 7L,A02,488730,Schurmeier; Kimberly,23,0,24,1
1713330791306,CHEM 7L,A03,488734,Schurmeier; Kimberly,20,0,24,4
1713330791306,CHEM 7L,A04,488763,Schurmeier; Kimberly,23,0,24,1
1713330791306,CHEM 7L,B01,488798,Schurmeier; Kimberly,17,0,24,7
1713330791306,CHEM 7L,B02,488801,Schurmeier; Kimberly,22,0,24,2
1713330791306,CHEM 7L,B03,488808,Schurmeier; Kimberly,23,0,24,1
1713330791306,CHEM 7L,B04,488811,Schurmeier; Kimberly,24,0,24,0
1713330792332,CHEM 11,A01,488897,Stallings; Dontarie M,95,0,100,5
1713330793602,CHEM 40A,A01,488913,Albizati; Kim F.,83,0,100,17
1713330794631,CHEM 40B,A01,488920,Weizman; Haim,43,0,50,7
1713330794631,CHEM 40B,A02,488938,Weizman; Haim,44,0,50,6
1713330795659,CHEM 41A,A01,489029,Klosterman; Jeremy K,57,0,60,3
1713330796691,CHEM 41C,A01,500436,Tor; Yitzhak,55,0,60,5
1713330797753,CHEM 43A,A01,500426,Weizman; Haim,0,0,24,24
1713330797753,CHEM 43A,A02,500430,Weizman; Haim,7,0,24,17
1713330797753,CHEM 43A,B01,514041,Klosterman; Jeremy K,16,0,24,8
1713330797753,CHEM 43A,B02,514047,Klosterman; Jeremy K,23,0,24,1
1713330798783,CHEM 108,A01,489140,Jennings; Patricia A.,9,0,24,15
1713330798783,CHEM 108,A02,489142,Jennings; Patricia A.,14,0,24,10
1713330799808,CHEM 114A,A01,489147,Stallings; Dontarie M,68,0,100,32
1713330800833,CHIN 169A,A00,489171,Wang; Xiao,19,0,20,1
1713330802889,COGS 3,A01,518827,Boyle; Mary E. T.,25,0,40,15
1713330803914,COGS 11,A01,489175,Staff,27,0,30,3
1713330804939,COGS 14A,A01,518829,Staff,51,0,60,9
1713330805969,COGS 14B,A01,489177,Hoffman; Drew Ellen,63,0,75,12
1713330806998,COGS 100,A01,489181,Allen; Michael Gordon,62,0,75,13
1713330808028,COGS 101A,A01,489183,Staff,46,0,60,14
1713330809054,COGS 101B,A01,489185,Allen; Michael Gordon,8,0,30,22
1713330810082,COGS 101C,A01,526786,Staff,23,0,30,7
1713330812139,COGS 107A,A01,489189,Boyle; Mary E. T.,17,0,35,18
1713330813171,COGS 107B,A01,627144,Mooshagian; Eric Frederick,60,0,60,0
1713330814204,COGS 118A,A01,489191,Staff,0,44,40,40
1713330816255,COGS 171GS,A01,489194,Pineda; Jaime A,19,0,28,9
1713330817281,COGS 172,A01,489196,Staff,3,0,30,27
1713330818311,COGS 174GS,A01,489264,Pineda; Jaime A,19,0,28,9
1713330819338,COGS 180,A01,627150,Staff,28,0,30,2
1713330820364,COGS 186,A01,489274,Staff,0,1,30,30
1713330821388,COMM 10,A01,489276,Staff,23,0,25,2
1713330821388,COMM 10,A02,489303,Staff,23,0,25,2
1713330822410,COMM 100A,A01,489312,Staff,14,0,25,11
1713330822410,COMM 100A,A02,489313,Staff,24,0,25,1
1713330823442,COMM 106T,A00,512540,Staff,33,0,35,2
1713330824469,COMM 107,A00,489347,Staff,27,0,35,8
1713330825492,COMM 109P,A00,489358,Staff,31,0,35,4
1713330826521,COMM 132,A00,489361,McKenna; Denise,27,0,30,3
1713330827551,COMM 146,A00,489362,Halm; Gavin Patrick,26,0,30,4
1713330828577,COMM 190,A00,489363,Abuelhiga; Soraya Jill,17,0,23,6
1713330829666,CSE 8A,A50,489366,Staff,21,0,25,4
1713330829666,CSE 8A,A51,489367,Staff,24,0,25,1
1713330830696,CSE 11,A01,489398,Cao; Yingjun,73,0,100,27
1713330831724,CSE 12,A01,489487,Staff,43,0,50,7
1713330832749,CSE 20,A01,489497,Staff,48,0,50,2
1713330833776,CSE 21,A01,489517,Braun; Oliver,42,0,50,8
1713330834805,CSE 101,A01,489524,Braun; Oliver,0,30,50,50
1713330835837,CSE 105,A01,512594,Jones; Miles E,72,0,100,28
1713330835837,CSE 105,B01,512598,Jones; Miles E,52,0,100,48
1713330836863,CSE 140,A01,489538,Staff,41,0,50,9
1713330837890,CSE 141,A01,489550,Eldon; John,67,0,100,33
1713330838920,CSE 141L,A01,489571,Eldon; John,65,0,100,35
1713330839949,CSE 151A,A01,489583,Solares; Edwin A,141,0,200,59
1713330840975,CSE 175,A01,510886,Kumar; Rakesh,30,0,30,0
1713330842001,CSE 190,A00,516828,Dubnov; Shlomo,38,0,49,11
1713330843026,DOC 100D,A00,489667,Pass; Natalye Joann,19,0,25,6
1713330844056,DSC 10,A01,624268,Staff,72,0,75,3
1713330845083,DSC 20,A01,624476,Staff,50,0,50,0
1713330846111,DSC 40A,A01,624608,Staff,39,0,40,1
1713330847137,DSGN 1,A01,489179,Rill; Bryan,32,0,50,18
1713330848163,ECE 17,A01,490489,Sahay; Rajeev,18,0,30,12
1713330849186,ECE 65,A50,490492,Staff,11,0,20,9
1713330849186,ECE 65,A51,490493,Staff,18,0,20,2
1713330850215,ECON 1,A01,489715,Famulari; Melissa,67,0,70,3
1713330851240,ECON 2,A01,489717,Levkoff; Steven B.,68,0,70,2
1713330852267,ECON 3,A01,489948,Staff,70,0,70,0
1713330854322,ECON 5,A01,490103,Staff,27,0,30,3
1713330854322,ECON 5,B01,626281,Dai; Yinlin,45,0,45,0
1713330855347,ECON 100A,A01,490127,Famulari; Melissa,65,0,70,5
1713330856373,ECON 100B,A01,490129,Staff,64,0,70,6
1713330857398,ECON 109,A01,490187,Shishkin; Denis,27,0,35,8
1713330858424,ECON 110A,A01,490190,Levkoff; Steven B.,60,0,70,10
1713330859454,ECON 120A,A01,490245,Dai; Yinlin,61,0,70,9
1713330860483,ECON 120B,A01,490247,Nieto-Barthaburu; Augusto,40,0,70,30
1713330861513,ECON 120C,A01,490253,Sun; Yixiao,30,0,35,5
1713330861513,ECON 120C,B01,490255,Sun; Yixiao,34,0,35,1
1713330862538,ECON 129,A00,490256,Eckert; Fabian Paul,23,0,35,12
1713330863566,ECON 131,A00,490257,Nieto-Barthaburu; Augusto,0,6,35,35
1713330864595,ECON 138,A00,490258,Bharadwaj; Prashant,13,0,35,22
1713330864595,ECON 138,B00,490259,Bharadwaj; Prashant,15,0,35,20
1713330865622,ECON 159,A00,490260,Hendrickson; Gerald M.,0,9,0,0
1713330866648,ECON 178,A01,553995,Zhu; Ying,24,0,35,11
1713330867675,EDS 40,A01,512576,Black; Alison Michelle,20,0,20,0
1713330868699,EDS 107,A01,515848,Staff,30,0,30,0
1713330869727,EDS 110R,A01,490262,Staff,26,0,30,4
1713330870755,EDS 112,A01,490264,Chapman; Thandeka K,40,0,50,10
1713330871781,EDS 113,A00,490266,Staff,26,0,30,4
1713330872810,EDS 118,A00,490267,Warstadt; Melissa Fawn,20,0,30,10
1713330873838,EDS 124BR,A00,490268,Eguchi; Emi,4,0,25,21
1713330873838,EDS 124BR,B00,490269,Eguchi; Emi,23,0,25,2
1713330874864,EDS 126,A01,490271,Jones; Makeba,43,0,50,7
1713330875887,EDS 135,A01,490316,Staff,19,0,20,1
1713330876916,ENVR 142GS,A00,519514,Chang; Edmond Yi-Teh,26,0,28,2
1713330877942,ETHN 103,A00,490504,Staff,25,0,36,11
1713330878973,ETHN 103A,A00,490505,Man; Simeon S,4,0,9,5
1713330879997,ETHN 109,A00,490506,Staff,28,0,30,2
1713330881024,ETHN 118,A00,490507,Staff,35,0,36,1
1713330882051,ETHN 119,A00,490508,Staff,33,0,36,3
1713330883081,ETHN 121R,A00,490518,Choi; Esther Min,21,0,36,15
1713330884110,ETHN 127,A00,490528,Staff,14,0,15,1
1713330885137,ETHN 139,A00,490573,Staff,10,0,10,0
1713330886161,ETHN 150,A00,490575,Staff,15,0,15,0
1713330887188,GLBH 20,A00,491705,Elwardani; Nile Regina,38,0,40,2
1713330888214,GLBH 101,A00,491706,Staff,20,0,20,0
1713330889245,GLBH 111,A01,491708,Burgos; Jose L.,15,0,15,0
1713330890270,GLBH 146,A00,491709,Staff,9,0,20,11
1713330891297,GLBH 148,A00,491710,Olivas Hernandez; Olga Lid,11,0,20,9
1713330892323,GLBH 150,A00,491711,Sloane; Julia Kathryn,19,0,20,1
1713330893350,HIEA 131,A00,491760,Staff,28,0,32,4
1713330894375,HIEA 153,A00,491762,Staff,28,0,30,2
1713330895399,HIEU 124,A00,491811,Staff,26,0,32,6
1713330896429,HIEU 124GS,A00,491812,Markman; Kristina,27,0,28,1
1713330897456,HIEU 147,A00,491813,Staff,30,0,32,2
1713330898485,HIEU 149GS,A00,491816,Caldwell; Michael Alan,28,0,28,0
1713330899511,HILD 2C,A01,491713,Hendrickson; Gerald M.,26,0,30,4
1713330900537,HILD 7B,A01,491715,Kwak; Nancy,0,2,30,30
1713330901561,HILD 10,A01,491717,Staff,11,0,20,9
1713330902587,HILD 30GS,A00,491719,Edington; Claire Ellen,24,0,28,4
1713330903613,HINE 109,A00,491818,Shafir; Nir,27,0,32,5
1713330904641,HINE 128,A00,491821,Shafir; Nir,31,0,32,1
1713330905669,HISC 117,A00,491830,Staff,27,0,32,5
1713330906695,HIUS 103,A00,491834,Man; Simeon S,14,0,23,9
1713330907723,HIUS 108B,A00,491835,Staff,27,0,30,3
1713330908747,HIUS 141,A00,491836,Hendrickson; Gerald M.,28,0,32,4
1713330909772,HIUS 149,A00,491839,Staff,24,0,32,8
1713330910799,HUM 3,A01,512617,Crum; Matthew Stephen,42,0,50,8
1713330910799,HUM 3,A02,512618,Crum; Matthew Stephen,48,0,50,2
1713330911822,HUM 3GS,A00,512663,Markman; Kristina,0,0,0,1
1713330911822,HUM 3GS,B00,512664,Staff,0,0,0,0
1713330912852,HUM 4,A01,512620,West; Geoffrey Scott,25,0,50,25
1713330913876,HUM 4GS,A00,512666,Lyon; Antony J.,0,0,0,5
1713330914904,HUM 4R,A01,512625,Watkins; Eric,49,0,50,1
1713330915934,HUM 5,A01,512649,Zavodny; Tatiana Sophia,23,0,50,27
1713330915934,HUM 5,B01,512661,Zroka; Ryan Edward,48,0,50,2
1713330916962,INTL 190,A00,490577,Segui; Alan S,0,0,0,5
1713330917989,JAPN 20AR,A01,491267,Ross; Kayoko F,7,0,20,13
1713330919023,JAPN 180,A00,491285,Berman; Michael David,33,0,40,7
1713330920050,LATI 50,A01,502536,Kokinis; Troy Andreas,16,0,22,6
1713330920050,LATI 50,A02,502551,Kokinis; Troy Andreas,22,0,22,0
1713330920050,LATI 50,A03,502650,Kokinis; Troy Andreas,22,0,22,0
1713330920050,LATI 50,A04,502909,Kokinis; Troy Andreas,21,0,22,1
1713330921076,LATI 160,A01,502920,Kokinis; Troy Andreas,30,0,30,0
1713330922101,LIFR 1A,A00,490494,Van Moer; Vinciane G,17,0,20,3
1713330923130,LIFR 1AX,A00,490495,Van Moer; Vinciane G,17,0,20,3
1713330924160,LIFR 1B,A00,490496,Van Moer; Vinciane G,17,0,20,3
1713330925186,LIFR 1BX,A00,490497,Van Moer; Vinciane G,17,0,20,3
1713330926217,LIGN 8,A00,505198,McIntosh; Justin Daniel,134,0,150,16
1713330927246,LIGN 9GS,A00,491239,Lott; Margaret S.,18,0,20,2
1713330928271,LIGN 101,A01,505200,McIntosh; Justin Daniel,22,0,30,8
1713330929304,LIGN 120,A01,491244,Staff,22,0,30,8
1713330930327,LIGN 149GS,A00,491245,Lott; Margaret S.,18,0,20,2
1713330931352,LIGN 170,A00,491247,Staff,22,0,30,8
1713330932379,LISP 1D,A00,490498,Munoz Sanchez; Alicia,9,0,14,5
1713330932379,LISP 1D,B00,490499,Munoz Sanchez; Alicia,6,0,14,8
1713330932379,LISP 1D,C00,490500,Munoz Sanchez; Alicia,7,0,14,7
1713330932379,LISP 1D,D00,490501,Munoz Sanchez; Alicia,10,0,14,4
1713330933457,LISP 1DX,A00,490502,Munoz Sanchez; Alicia,14,0,28,14
1713330933457,LISP 1DX,B00,490503,Munoz Sanchez; Alicia,16,0,28,12
1713330935510,LTAM 110,A00,491847,Staff,22,0,25,3
1713330936534,LTCS 119,A00,491848,Staff,11,0,15,4
1713330937560,LTCS 130,A00,491849,Staff,24,0,25,1
1713330939615,LTEA 120C,A00,491852,Staff,32,0,40,8
1713330940641,LTEN 130GS,A00,491853,Lyon; Antony J.,23,0,28,5
1713330941668,LTEN 148,A00,491855,Staff,23,0,25,2
1713330942694,LTEN 159,A00,491856,Staff,20,0,25,5
1713330943720,LTEN 180,A00,491857,Staff,8,0,15,7
1713330945780,LTSP 123GS,A00,505928,Bessett; Ryan Matthew,24,0,28,4
1713330946806,LTSP 174GS,A00,506037,Bessett; Ryan Matthew,24,0,28,4
1713330948859,LTWR 102,A00,491861,Staff,9,0,15,6
1713330949886,LTWR 106,A00,491862,Staff,8,0,15,7
1713330950916,MAE 11,A00,490930,Bahadori; Mohammad Yousef,95,0,100,5
1713330951948,MAE 30A,A00,490931,Qi; Huihui,37,0,40,3
1713330952979,MAE 101A,A00,491036,Sadeghizadeh; Zahra,92,0,100,8
1713330954017,MAE 101C,A00,491037,Seshadri; Kalyanasundaram,66,0,100,34
1713330955042,MAE 113,A00,491040,Seshadri; Kalyanasundaram,66,0,80,14
1713330956071,MAE 131A,A00,491041,Ghazinejad; Maziar,37,0,40,3
1713330957095,MAE 142,A00,491053,Staff,39,0,40,1
1713330958130,MAE 143A,A00,491054,Staff,31,0,50,19
1713330959159,MAE 150,A00,491092,Truong; Phuong Thi Ngoc,24,0,35,11
1713330960184,MATH 3C,A01,494031,Pardo Guerra; Sebastian,30,0,30,0
1713330960184,MATH 3C,A02,494032,Pardo Guerra; Sebastian,29,0,30,1
1713330961212,MATH 10A,A01,494034,Staff,27,0,30,3
1713330961212,MATH 10A,A02,494035,Staff,28,0,30,2
1713330961212,MATH 10A,B01,494037,Staff,27,0,30,3
1713330961212,MATH 10A,B02,494038,Staff,29,0,30,1
1713330962238,MATH 10B,A01,494040,Habib; Yousaf,22,0,30,8
1713330962238,MATH 10B,A02,494041,Habib; Yousaf,28,0,30,2
1713330962238,MATH 10B,A03,494042,Habib; Yousaf,29,0,30,1
1713330962238,MATH 10B,A04,494043,Habib; Yousaf,30,0,30,0
1713330962238,MATH 10B,B01,494045,Habib; Yousaf,25,0,30,5
1713330962238,MATH 10B,B02,494046,Habib; Yousaf,30,0,30,0
1713330962238,MATH 10B,B03,494047,Habib; Yousaf,30,0,30,0
1713330962238,MATH 10B,B04,494048,Habib; Yousaf,30,0,30,0
1713330963271,MATH 18,A01,494050,Kemp; Todd Aahron,25,0,30,5
1713330963271,MATH 18,A02,494051,Kemp; Todd Aahron,29,0,30,1
1713330963271,MATH 18,B01,494054,Kemp; Todd Aahron,26,0,30,4
1713330963271,MATH 18,B02,494055,Kemp; Todd Aahron,29,0,30,1
1713330964305,MATH 20A,A01,494059,Suk; Andrew Hoon,30,0,30,0
1713330965333,MATH 20B,A01,494061,Briones; Jor-el Thomas Caparas,33,0,35,2
1713330965333,MATH 20B,B01,494063,Bach; Quang Tran,34,0,35,1
1713330966365,MATH 20C,A01,494065,Staff,28,0,30,2
1713330966365,MATH 20C,A02,494066,Staff,30,0,30,0
1713330966365,MATH 20C,A03,494067,Staff,30,0,30,0
1713330966365,MATH 20C,A04,494068,Staff,30,0,30,0
1713330966365,MATH 20C,B01,494070,Zhang; Ming,25,0,30,5
1713330966365,MATH 20C,B02,494071,Zhang; Ming,27,0,30,3
1713330966365,MATH 20C,B03,494072,Zhang; Ming,29,0,30,1
1713330966365,MATH 20C,B04,494073,Zhang; Ming,29,0,30,1
1713330967395,MATH 20D,A01,494075,Staff,22,0,30,8
1713330967395,MATH 20D,A02,494076,Staff,29,0,30,1
1713330968421,MATH 20E,A01,494079,Staff,24,0,30,6
1713330968421,MATH 20E,A02,494080,Staff,26,0,30,4
1713330968421,MATH 20E,B01,494082,Staff,25,0,30,5
1713330968421,MATH 20E,B02,494083,Staff,25,0,30,5
1713330969446,MATH 103A,A01,494085,Aliabadi Sr.; Mohsen,14,0,30,16
1713330969446,MATH 103A,A02,494086,Aliabadi Sr.; Mohsen,28,0,30,2
1713330969446,MATH 103A,B01,494088,Aliabadi Sr.; Mohsen,21,0,30,9
1713330969446,MATH 103A,B02,494089,Aliabadi Sr.; Mohsen,27,0,30,3
1713330970472,MATH 109,A01,494091,Staff,30,0,30,0
1713330970472,MATH 109,A02,494092,Staff,29,0,30,1
1713330970472,MATH 109,B01,494094,Staff,27,0,30,3
1713330970472,MATH 109,B02,494095,Staff,29,0,30,1
1713330971499,MATH 142A,A01,494097,Chow; Bennett,15,0,30,15
1713330971499,MATH 142A,A02,494098,Chow; Bennett,23,0,30,7
1713330971499,MATH 142A,B01,494100,Chow; Bennett,19,0,30,11
1713330971499,MATH 142A,B02,494101,Chow; Bennett,29,0,30,1
1713330973556,MATH 168A,A01,516677,Dumitriu; Ioana,16,0,35,19
1713330974582,MATH 170A,A01,516679,Dumitriu; Ioana,18,0,30,12
1713330974582,MATH 170A,A02,516680,Dumitriu; Ioana,28,0,30,2
1713330975611,MATH 193A,A01,494107,Staff,14,0,30,16
1713330975611,MATH 193A,A02,494108,Staff,19,0,30,11
1713330975611,MATH 193A,A03,494109,Staff,29,0,30,1
1713330975611,MATH 193A,A04,494110,Staff,22,0,30,8
1713330978693,MGT 16,A00,491930,McKay; Michael J,92,0,98,6
1713330979718,MGT 18,A00,491992,McKay; Michael J,96,0,98,2
1713330980745,MGT 71,A00,492003,Staff,65,0,98,33
1713330981773,MGT 103,A00,505209,Eberhard; Craig A,81,0,98,17
1713330982797,MGT 131A,A00,505210,Anderson; John Charles,89,0,98,9
1713330984852,MGT 153,A00,492077,Perols; Johan Lars,19,0,90,71
1713330987931,MGT 164,A00,492222,McKay; Mary A,91,0,98,7
1713330988962,MGT 172,A00,492245,Staff,59,0,60,1
1713330988962,MGT 172,B00,505526,Hedges; Kathleen,65,0,98,33
1713330989989,MGT 181,A00,505669,Dunn; Louis Jean,81,0,98,17
1713330991019,MMW 14,A01,494399,Staff,15,0,28,13
1713330991019,MMW 14,A02,494400,Staff,25,0,28,3
1713330991019,MMW 14,A03,494401,Staff,28,0,28,0
1713330991019,MMW 14,A04,494402,Staff,28,0,28,0
1713330991019,MMW 14,B01,494404,Carreras; Maria Victoria,8,0,28,20
1713330991019,MMW 14,B02,494405,Carreras; Maria Victoria,25,0,28,3
1713330991019,MMW 14,B03,494406,Carreras; Maria Victoria,27,0,28,1
1713330991019,MMW 14,B04,494407,Carreras; Maria Victoria,28,0,28,0
1713330992049,MMW 14GS,A00,506250,Chang; Edmond Yi-Teh,0,0,0,0
1713330993074,MMW 121R,A01,494415,Adamiak; Patrick John,10,0,28,18
1713330993074,MMW 121R,A02,494416,Adamiak; Patrick John,24,0,28,4
1713330994103,MUS 1A,A01,494113,Staff,12,0,25,13
1713330994103,MUS 1A,A02,494114,Staff,24,0,25,1
1713330995126,MUS 4,A01,494116,Staff,23,0,25,2
1713330995126,MUS 4,A02,494117,Staff,22,0,25,3
1713330996152,MUS 5R,A01,494236,Dubnov; Shlomo,6,0,25,19
1713330996152,MUS 5R,A02,494237,Dubnov; Shlomo,25,0,25,0
1713330997177,MUS 6,A01,494122,Staff,10,0,25,15
1713330997177,MUS 6,A02,494123,Staff,23,0,25,2
1713330998203,MUS 7,A01,494125,Staff,16,0,25,9
1713330998203,MUS 7,A02,494126,Staff,24,0,25,1
1713330999228,MUS 11,A01,494128,Staff,23,0,25,2
1713330999228,MUS 11,A02,494129,Staff,24,0,25,1
1713331000255,MUS 13,A01,494131,Staff,25,0,25,0
1713331000255,MUS 13,A02,494132,Staff,25,0,25,0
1713331001284,MUS 15,A01,494134,Staff,16,0,25,9
1713331001284,MUS 15,A02,494135,Staff,25,0,25,0
1713331001284,MUS 15,B01,494137,Staff,24,0,25,1
1713331002312,MUS 80,A00,494232,Staff,24,0,25,1
1713331002312,MUS 80,B00,494233,Staff,25,0,25,0
1713331002312,MUS 80,C00,494234,Staff,23,0,25,2
1713331003337,MUS 95C,A00,494141,Staff,70,0,75,5
1713331004362,MUS 114,A00,494142,Staff,40,0,50,10
1713331005388,NANO 15,A01,490636,Drews; Aaron,7,0,7,0
1713331006415,PHIL 1,A00,490578,Grush; Rick Scott,49,0,50,1
1713331007440,PHIL 10,A01,490580,Grush; Rick Scott,33,0,35,2
1713331007440,PHIL 10,A02,490586,Grush; Rick Scott,32,0,35,3
1713331008468,PHIL 27,A01,490591,Staff,22,0,25,3
1713331008468,PHIL 27,A02,490592,Staff,25,0,25,0
1713331008468,PHIL 27,A03,490593,Staff,25,0,25,0
1713331008468,PHIL 27,A04,490598,Staff,25,0,25,0
1713331009493,PHIL 32,A01,490611,Staff,20,0,20,0
1713331009493,PHIL 32,A02,490618,Staff,20,0,20,0
1713331010516,PHIL 90,A00,490624,Staff,40,0,40,0
1713331011543,PHIL 136,A00,490627,Cohen; Jonathan David,37,0,40,3
1713331012568,PHIL 155,A00,490634,Staff,62,0,70,8
1713331013594,PHYS 1A,A00,491610,Staff,245,0,250,5
1713331014628,PHYS 1AL,001,491616,Tsai; Philbert S,27,0,30,3
1713331014628,PHYS 1AL,002,491618,Tsai; Philbert S,30,0,30,0
1713331015653,PHYS 1B,A00,491623,Staff,236,0,250,14
1713331016679,PHYS 1BL,001,491626,Tsai; Philbert S,22,0,30,8
1713331016679,PHYS 1BL,002,491628,Tsai; Philbert S,26,0,30,4
1713331017704,PHYS 1C,A00,491632,Staff,213,0,245,32
1713331018727,PHYS 1CL,001,491635,Tsai; Philbert S,2,0,30,28
1713331018727,PHYS 1CL,002,491643,Tsai; Philbert S,22,0,30,8
1713331019752,PHYS 2AR,A01,491651,Meyertholen; Andrew D.,44,0,50,6
1713331020782,PHYS 2B,A01,491659,Staff,106,0,115,9
1713331021806,PHYS 2BL,A01,491685,Staff,21,0,24,3
1713331021806,PHYS 2BL,A02,491700,Staff,21,0,24,3
1713331022831,PHYS 2C,A01,505161,Staff,101,0,115,14
1713331023868,PHYS 4A,A01,491704,Grinstein; Benjamin,99,0,100,1
1713331024893,POLI 5D,A01,494144,Staff,3,0,5,2
1713331024893,POLI 5D,B01,626283,Dai; Yinlin,5,0,5,0
1713331025921,POLI 12,A00,494145,Staff,43,0,45,2
1713331026946,POLI 13R,A00,494146,Forman; Fonna,45,0,50,5
1713331027974,POLI 27,A01,494148,Staff,54,0,60,6
1713331029002,POLI 30,A00,494149,Staff,49,0,50,1
1713331030029,POLI 100DA,A00,494150,Staff,21,0,25,4
1713331032081,POLI 100I,A00,494152,Staff,27,0,30,3
1713331033111,POLI 104B,A00,494153,Smith; Glenn Chatmas,53,0,55,2
1713331034135,POLI 104F,A00,494154,Staff,28,0,30,2
1713331035165,POLI 104I,A00,494155,Smith; Glenn Chatmas,29,0,30,1
1713331036192,POLI 110C,A00,494156,Ingham; Sean,23,0,25,2
1713331037269,POLI 117R,A00,494157,Forman; Fonna,8,0,20,12
1713331038294,POLI 118,A00,494158,Ingham; Sean,21,0,25,4
1713331039324,POLI 120H,A00,494159,Fisk; David Lee,39,0,45,6
1713331040353,POLI 131CR,A00,494160,Hoston; Germaine,35,0,45,10
1713331041376,POLI 133J,A00,494161,Staff,32,0,35,3
1713331042403,POLI 135,A00,494162,Fisk; David Lee,33,0,35,2
1713331043433,POLI 140A,A00,494164,Staff,19,0,30,11
1713331044459,POLI 142I,A00,494165,Staff,30,0,30,0
1713331045488,POLI 144D,A00,494166,Staff,23,0,25,2
1713331046513,POLI 151,A00,494167,Staff,30,0,30,0
1713331047537,POLI 153,A00,494168,Staff,33,0,35,2
1713331048566,POLI 160AA,A00,494169,Staff,34,0,40,6
1713331049593,POLI 162,A00,494170,Mignozzetti; Umberto,18,0,25,7
1713331050622,POLI 171,A00,494171,Mignozzetti; Umberto,18,0,25,7
1713331051652,PSYC 1,A00,494172,Staff,96,0,100,4
1713331052679,PSYC 2,A00,494173,Moranton; Nirelia Melbina-,34,0,50,16
1713331053706,PSYC 3,A00,494174,Staff,29,0,30,1
1713331054730,PSYC 6,A00,494175,Staff,17,0,20,3
1713331055760,PSYC 60,A01,494177,Staff,38,0,45,7
1713331056786,PSYC 70,A01,505724,Geller; Emma Harlan,42,0,45,3
1713331057814,PSYC 101,A00,494180,Heyman; Gail D.,84,0,100,16
1713331058840,PSYC 105,A00,494181,Geller; Emma Harlan,51,0,90,39
1713331059867,PSYC 106,A00,494182,Dobkins; Karen R.,27,0,45,18
1713331060896,PSYC 108,A00,494183,Adrian; Julia Anna,89,0,100,11
1713331061922,PSYC 114,A01,494185,Winkielman; Piotr,0,3,30,30
1713331062948,PSYC 122,A00,494186,Moranton; Nirelia Melbina-,28,0,50,22
1713331063977,PSYC 124,A00,494187,Chapman; Eddie Nathaniel,70,0,80,10
1713331065003,PSYC 131,A00,494188,Anagnostaras; Stephan,41,0,80,39
1713331066031,PSYC 144,A00,494189,Staff,4,0,50,46
1713331067057,PSYC 154,A00,494190,Lacefield; Katharine I,107,0,180,73
1713331068083,PSYC 162,A00,494191,Wixted; John T,71,0,100,29
1713331069108,PSYC 172,A00,494192,Gorman; Michael R.,36,0,45,9
1713331070133,PSYC 178,A00,494193,Glaser; Dale,34,0,45,11
1713331071159,PSYC 193,A00,505725,Chapman; Eddie Nathaniel,20,0,20,0
1713331072188,RELI 145GS,A00,519817,Rahimi; Babak,18,0,20,2
1713331073219,SE 101A,A01,490862,Chadha; Mayank,23,0,25,2
1713331074244,SE 101C,A01,490924,Krysl; Petr,15,0,20,5
1713331075270,SE 110A,A01,490928,Staff,19,0,20,1
1713331076301,SE 130A,A00,490929,Morrison; Machel Leigh,55,0,70,15
1713331077327,SIO 1,A01,519325,Staff,39,0,40,1
1713331078352,SIO 30,A01,519327,Staff,38,0,40,2
1713331079379,SIO 40,A00,519328,Staff,39,0,40,1
1713331080406,SIO 46GS,A00,519819,Cook; Geoffrey W,17,0,25,8
1713331081431,SIO 109R,A00,494197,Forman; Fonna,0,3,20,20
1713331082460,SIO 121GS,A00,519827,Cook; Geoffrey W,17,0,25,8
1713331083484,SIO 132,A01,519330,Staff,38,0,40,2
1713331084508,SIO 133,A01,519397,Staff,37,0,40,3
1713331085537,SIO 139,A00,519396,Kacev; David,29,0,40,11
1713331086571,SOCI 1,A01,494199,Thorpe; Charles Robert,21,0,30,9
1713331086571,SOCI 1,A02,494200,Thorpe; Charles Robert,30,0,30,0
1713331086571,SOCI 1,A03,494201,Thorpe; Charles Robert,29,0,30,1
1713331086571,SOCI 1,A04,494202,Thorpe; Charles Robert,29,0,30,1
1713331086571,SOCI 1,A05,494203,Thorpe; Charles Robert,29,0,30,1
1713331086571,SOCI 1,A06,494204,Thorpe; Charles Robert,30,0,30,0
1713331086571,SOCI 1,A07,494205,Thorpe; Charles Robert,28,0,30,2
1713331087597,SOCI 60,A01,494207,Staff,34,0,40,6
1713331087597,SOCI 60,A02,494208,Staff,39,0,40,1
1713331088625,SOCI 100,A01,494210,Payne; Christine Anna,25,0,30,5
1713331088625,SOCI 100,A02,494211,Payne; Christine Anna,26,0,30,4
1713331089649,SOCI 109M,A00,494212,Staff,20,0,20,0
1713331090696,SOCI 110,A00,494213,Staff,34,0,40,6
1713331092748,SOCI 118E,A00,494215,Ng; Kwai,37,0,40,3
1713331093776,SOCI 125,A00,494216,Calderon-Zaks; Michael Aar,40,0,45,5
1713331094805,SOCI 126,A01,494218,Jones; Makeba,3,0,5,2
1713331095834,SOCI 131,A00,494219,Thorpe; Charles Robert,26,0,30,4
1713331097883,SOCI 135,A00,494221,Payne; Christine Anna,28,0,50,22
1713331098908,SOCI 136E,A00,626690,Ruiz; Jonathan Joseph,24,0,25,1
1713331099934,SOCI 138GS,A00,494222,Navon; Daniel,24,0,28,4
1713331101994,SOCI 145,A00,494224,Staff,40,0,45,5
1713331103020,SOCI 153,A00,494225,Staff,28,0,30,2
1713331104089,SOCI 160E,A00,494226,Ng; Kwai,29,0,40,11
1713331105115,SOCI 180,A00,494227,Staff,29,0,30,1
1713331106139,SOCI 189GS,A00,494228,Ribas Norris; Janet Vanesa,11,0,11,0
1713331107169,SOCI 190GS,A00,553232,Ribas Norris; Janet Vanesa,11,0,11,0
1713331108199,SOMI 220,A00,627178,Schneid; Stephen David,30,0,30,0
1713331109228,SYN 2,001,490768,Staff,13,0,15,2
1713331109228,SYN 2,002,490769,Staff,14,0,15,1
1713331109228,SYN 2,004,490775,Staff,0,0,0,0
1713331109228,SYN 2,003,490774,Staff,0,0,0,0
1713331109228,SYN 2,005,490776,Staff,0,0,0,0
1713331110254,SYN 2R,001,490779,Staff,11,0,15,4
1713331110254,SYN 2R,002,514635,Staff,14,0,15,1
1713331111284,SYN 100,A01,490783,Staff,9,0,20,11
1713331111284,SYN 100,B01,490787,Staff,9,0,20,11
1713331111284,SYN 100,C01,490789,Staff,10,0,20,10
1713331112309,SYN 150,A00,490817,Staff,14,0,15,1
1713331112309,SYN 150,B00,514610,Staff,15,0,15,0
1713331113337,TDAC 1,A00,492753,Walsh; Kim C.,19,0,20,1
1713331113337,TDAC 1,B00,492754,Harting; Carla Kelso,19,0,20,1
1713331113337,TDAC 1,C00,513995,Salovey; Todd,15,0,20,5
1713331114363,TDAC 101,A00,492766,Harting; Carla Kelso,17,0,20,3
1713331115390,TDAC 102,A00,492768,Basso; Beatrice,19,0,20,1
1713331116416,TDDE 111,A00,492769,Staff,25,0,25,0
1713331117448,TDDE 131,A00,492770,Staff,15,0,15,0
1713331117448,TDDE 131,B00,492771,Staff,15,0,15,0
1713331118473,TDDE 131GS,A00,523716,Guirguis; Mark C,23,0,28,5
1713331119502,TDGE 1,A01,492756,Salovey; Todd,56,0,60,4
1713331120530,TDGE 5,A01,492758,Staff,23,0,25,2
1713331121557,TDGE 10,A00,492759,Fulton; Julia,203,0,220,17
1713331122582,TDGE 11,A00,492760,Castro; Robert Jess,198,0,200,2
1713331124639,TDGE 124,A00,492772,Fulton; Julia,185,0,220,35
1713331125670,TDGE 125,A00,492773,Meyer; Ursula,38,0,50,12
1713331125670,TDGE 125,B00,492774,Staff,49,0,50,1
1713331125670,TDGE 125,C00,523565,Staff,48,0,50,2
1713331126696,TDGE 125GS,A00,523580,Guirguis; Mark C,23,0,28,5
1713331127722,TDGE 127,A00,492775,Havis; Allan,34,0,50,16
1713331128750,TDHT 101,A00,492776,Staff,34,0,35,1
1713331129780,TDMV 1,A00,492762,Caligagan; Maria T.,30,0,30,0
1713331129780,TDMV 1,B00,492763,Arcidiacono; Kristin,26,0,30,4
1713331130812,TDMV 2,A00,492764,Weinberg; Sadie,28,0,30,2
1713331131838,TDMV 3,A00,492765,Mack; Kara Shanai',37,0,40,3
1713331132867,TDMV 138,A00,492777,Mack; Kara Shanai',34,0,40,6
1713331133892,TDMV 140,A00,492778,Lima; Paulo Henrique,40,0,40,0
1713331134923,TDMV 142,A00,492779,Caligagan; Maria T.,33,0,40,7
1713331134923,TDMV 142,B00,492780,Caligagan; Tony,37,0,40,3
1713331135947,TDMV 143,A00,492781,Fyall; Daunte Edward,39,0,40,1
1713331136972,USP 1,A01,492401,Kwak; Nancy,27,0,35,8
1713331138002,USP 2,A01,492453,Hinds; Juli Beth,35,0,35,0
1713331139030,USP 3,A01,492516,Staff,28,0,35,7
1713331140056,USP 4,A00,492522,McTague; Sarah,16,0,25,9
1713331141137,USP 100,A00,492523,Staff,32,0,35,3
1713331142166,USP 101,A00,492524,Staff,13,0,15,2
1713331143193,USP 105,A00,492525,Staff,21,0,25,4
1713331144219,USP 151,A00,492526,Shenkman; Michael Thomas,32,0,35,3
1713331145246,USP 170,A00,492545,Hinds; Juli Beth,33,0,35,2
1713331146273,USP 171GS,A00,492608,Bussell; Mirle Rabinowitz,24,0,28,4
1713331147299,USP 183GS,A00,492613,Peerson; Susan,24,0,28,4
1713331148325,VIS 30,A01,490693,Yoldas; Pinar,19,0,22,3
1713331148325,VIS 30,A02,490694,Yoldas; Pinar,18,0,22,4
1713331149355,VIS 83,A00,490695,Kester; Grant,63,0,75,12
1713331150383,VIS 105D,A00,490696,Staff,22,0,25,3
1713331151411,VIS 124CN,A00,490699,Rose; Jordan M,65,0,75,10
1713331152437,VIS 125GS,A00,511221,Williams; Alena J,21,0,22,1
1713331153467,VIS 128D,A00,490700,Staff,73,0,75,2
1713331154493,VIS 151,A01,490717,Staff,33,0,34,1
1713331154493,VIS 151,A02,490766,Staff,33,0,34,1
1713331155518,VIS 154GS,A00,511972,Williams; Alena J,21,0,22,1
1713331156543,VIS 160A,A00,490767,Stone; Patricia,7,0,10,3
1713331157571,WCWP 10A,A00,490638,Staff,14,0,15,1
1713331157571,WCWP 10A,B00,490640,Staff,15,0,15,0
1713331158601,WCWP 10B,A00,490641,Staff,0,0,0,0
1713331158601,WCWP 10B,B00,490642,Staff,14,0,15,1
1713331158601,WCWP 10B,C00,490644,Staff,13,0,15,2
1713331158601,WCWP 10B,D00,490647,Staff,0,0,0,0
1713331159627,WCWP 100,A00,490655,Staff,0,0,0,0
1713331159627,WCWP 100,B00,490687,Staff,10,0,15,5
1713331161729,ANAR 153,A00,487222,Braswell; Geoffrey E.,53,0,60,7
1713331162758,ANBI 134,A00,487223,Staff,5,0,20,15
1713331163786,ANBI 143GS,A00,487224,Noel; Geoffroy Pierre Jean,18,0,24,6
1713331164815,ANBI 144GS,A00,519548,Noel; Geoffroy Pierre Jean,18,0,24,6
1713331165840,ANSC 101,A00,487225,Staff,18,0,20,2
1713331166866,ANSC 125,A00,487227,Brenner; Suzanne A,39,0,40,1
1713331168916,ANSC 146,A00,487229,Staff,35,0,40,5
1713331169945,ANSC 148,A00,487230,Olivas Hernandez; Olga Lid,39,0,40,1
1713331170977,ANSC 150,A00,504165,Sloane; Julia Kathryn,18,0,20,2
1713331172002,ANSC 180,A00,487232,Staff,14,0,15,1
1713331173031,ANSC 188,A00,627155,Staff,38,0,40,2
1713331174061,ANTH 5,A00,519529,Semendeferi; Ekaterini,15,0,15,0
1713331175090,ANTH 10,A00,487219,Staff,58,0,60,2
1713331176120,ANTH 23,A01,487221,Staff,17,0,20,3
1713331177144,ANTH 102,A00,487233,Wilder; Linnea Lorene,51,0,60,9
1713331178171,ANTH 103,A00,487234,Varma; Saiba,55,0,60,5
1713331179196,ANTH 105,A00,487235,Stewart; Alexander B,54,0,60,6
1713331180230,BENG 100,A01,516685,Taylor Amos; Alyssa C,26,0,30,4
1713331181263,BIBC 102,A01,491316,Flagg; Matthew Paul,10,0,88,78
1713331181263,BIBC 102,A02,491366,Flagg; Matthew Paul,78,0,88,10
1713331182293,BIBC 103,A01,491486,Boumechache; Miyyada,16,0,24,8
1713331182293,BIBC 103,A02,491487,Boumechache; Miyyada,24,0,24,0
1713331183325,BICD 100,A01,516882,Staff,73,0,75,2
1713331183325,BICD 100,A02,516890,Staff,69,0,75,6
1713331184350,BICD 102GS,A00,491488,Lo; Stanley M.,26,0,28,2
1713331185376,BIEB 136GS,A00,516940,Holway; David A. & Shurin; Jonathan,18,0,24,6
1713331186403,BIEB 137GS,A01,517034,Holway; David A. & Shurin; Jonathan,18,0,24,6
1713331187428,BIEB 138GS,A01,491492,Pirino; Giorgia,21,0,28,7
1713331188454,BILD 1,A01,491296,Staff,60,0,63,3
1713331188454,BILD 1,A02,491297,Staff,63,0,63,0
1713331189485,BILD 4,A01,517099,Gonzalez Gamboa; Ivonne,22,0,24,2
1713331189485,BILD 4,A02,517100,Gonzalez Gamboa; Ivonne,24,0,24,0
1713331190514,BILD 60GS,A00,491309,Lo; Stanley M.,26,0,28,2
1713331191541,BIMM 100,A01,517136,Staff,83,0,100,17
1713331192571,BIMM 110,A01,517182,Staff,54,0,100,46
1713331193601,BIMM 120,A01,517228,Pickett; Brooke Elizabeth,28,0,63,35
1713331193601,BIMM 120,A02,517240,Pickett; Brooke Elizabeth,44,0,63,19
1713331194633,BIMM 132GS,A01,491498,Pirino; Giorgia,21,0,28,7
1713331195660,BIMM 143,A01,491589,Bozinovic; Goran,13,0,40,27
1713331196691,BIPN 100,A01,491594,Armour; Jon Christopher,83,0,100,17
1713331197718,BIPN 140,A01,491602,Marino; Marc J,25,0,50,25
1713331199768,CAT 125,A00,515973,Staff,18,0,20,2
1713331200799,CAT 125GS,A00,515974,Rahimi; Babak,17,0,20,3
1713331201833,CAT 125R,A00,515980,Staff,12,0,20,8
1713331201833,CAT 125R,B00,515981,Tosun; Adriana,19,0,20,1
1713331201833,CAT 125R,C00,515987,Hyland; Tina Mae,0,3,20,20
1713331201833,CAT 125R,D00,515988,Bronstein; Phoebe Malan,16,0,20,4
1713331202863,CENG 15,A01,488699,Drews; Aaron,25,0,25,0
1713331203890,CENG 100,A00,505196,Opatkiewicz; Justin Paul,25,0,25,0
1713331204916,CGS 2A,A01,489598,Staff,33,0,35,2
1713331205945,CGS 112,A00,489599,Staff,15,0,15,0
1713331206970,CGS 119,A00,489603,Staff,10,0,10,0
1713331208008,CGS 120,A00,489604,Staff,14,0,15,1
1713331209039,CGS 150,A00,489607,Staff,15,0,15,0
1713331210065,CHEM 6A,A01,488715,Staff,98,0,100,2
1713331211091,CHEM 6B,A01,488719,Piercy; Marc Anthony,99,0,100,1
1713331212117,CHEM 6C,A01,488723,Albizati; Kim F.,93,0,100,7
1713331213146,CHEM 7L,A01,488728,Schurmeier; Kimberly,18,0,24,6
1713331213146,CHEM 7L,A02,488730,Schurmeier; Kimberly,23,0,24,1
1713331213146,CHEM 7L,A03,488734,Schurmeier; Kimberly,20,0,24,4
1713331213146,CHEM 7L,A04,488763,Schurmeier; Kimberly,23,0,24,1
1713331213146,CHEM 7L,B01,488798,Schurmeier; Kimberly,17,0,24,7
1713331213146,CHEM 7L,B02,488801,Schurmeier; Kimberly,22,0,24,2
1713331213146,CHEM 7L,B03,488808,Schurmeier; Kimberly,22,0,24,2
1713331213146,CHEM 7L,B04,488811,Schurmeier; Kimberly,24,0,24,0
1713331214175,CHEM 11,A01,488897,Stallings; Dontarie M,95,0,100,5
1713331215202,CHEM 40A,A01,488913,Albizati; Kim F.,83,0,100,17
1713331216234,CHEM 40B,A01,488920,Weizman; Haim,43,0,50,7
1713331216234,CHEM 40B,A02,488938,Weizman; Haim,44,0,50,6
1713331217265,CHEM 41A,A01,489029,Klosterman; Jeremy K,57,0,60,3
1713331218296,CHEM 41C,A01,500436,Tor; Yitzhak,55,0,60,5
1713331219325,CHEM 43A,A01,500426,Weizman; Haim,0,0,24,24
1713331219325,CHEM 43A,A02,500430,Weizman; Haim,7,0,24,17
1713331219325,CHEM 43A,B01,514041,Klosterman; Jeremy K,16,0,24,8
1713331219325,CHEM 43A,B02,514047,Klosterman; Jeremy K,23,0,24,1
1713331220350,CHEM 108,A01,489140,Jennings; Patricia A.,9,0,24,15
1713331220350,CHEM 108,A02,489142,Jennings; Patricia A.,14,0,24,10
1713331221378,CHEM 114A,A01,489147,Stallings; Dontarie M,68,0,100,32
1713331222406,CHIN 169A,A00,489171,Wang; Xiao,19,0,20,1
1713331224456,COGS 3,A01,518827,Boyle; Mary E. T.,25,0,40,15
1713331225485,COGS 11,A01,489175,Staff,27,0,30,3
1713331226515,COGS 14A,A01,518829,Staff,51,0,60,9
1713331227540,COGS 14B,A01,489177,Hoffman; Drew Ellen,62,0,75,13
1713331228569,COGS 100,A01,489181,Allen; Michael Gordon,62,0,75,13
1713331229593,COGS 101A,A01,489183,Staff,46,0,60,14
1713331230618,COGS 101B,A01,489185,Allen; Michael Gordon,8,0,30,22
1713331231644,COGS 101C,A01,526786,Staff,23,0,30,7
1713331233698,COGS 107A,A01,489189,Boyle; Mary E. T.,17,0,35,18
1713331234727,COGS 107B,A01,627144,Mooshagian; Eric Frederick,60,0,60,0
1713331235753,COGS 118A,A01,489191,Staff,0,44,40,40
1713331237810,COGS 171GS,A01,489194,Pineda; Jaime A,19,0,28,9
1713331238836,COGS 172,A01,489196,Staff,2,0,30,28
1713331239859,COGS 174GS,A01,489264,Pineda; Jaime A,19,0,28,9
1713331240886,COGS 180,A01,627150,Staff,28,0,30,2
1713331241914,COGS 186,A01,489274,Staff,0,1,30,30
1713331242943,COMM 10,A01,489276,Staff,23,0,25,2
1713331242943,COMM 10,A02,489303,Staff,23,0,25,2
1713331243970,COMM 100A,A01,489312,Staff,14,0,25,11
1713331243970,COMM 100A,A02,489313,Staff,24,0,25,1
1713331245075,COMM 106T,A00,512540,Staff,33,0,35,2
1713331246099,COMM 107,A00,489347,Staff,27,0,35,8
1713331247125,COMM 109P,A00,489358,Staff,31,0,35,4
1713331248155,COMM 132,A00,489361,McKenna; Denise,27,0,30,3
1713331249181,COMM 146,A00,489362,Halm; Gavin Patrick,26,0,30,4
1713331250205,COMM 190,A00,489363,Abuelhiga; Soraya Jill,17,0,23,6
1713331251232,CSE 8A,A50,489366,Staff,21,0,25,4
1713331251232,CSE 8A,A51,489367,Staff,24,0,25,1
1713331252260,CSE 11,A01,489398,Cao; Yingjun,73,0,100,27
1713331253293,CSE 12,A01,489487,Staff,43,0,50,7
1713331254322,CSE 20,A01,489497,Staff,48,0,50,2
1713331255348,CSE 21,A01,489517,Braun; Oliver,42,0,50,8
1713331256375,CSE 101,A01,489524,Braun; Oliver,0,32,50,50
1713331257402,CSE 105,A01,512594,Jones; Miles E,72,0,100,28
1713331257402,CSE 105,B01,512598,Jones; Miles E,52,0,100,48
1713331258433,CSE 140,A01,489538,Staff,41,0,50,9
1713331259460,CSE 141,A01,489550,Eldon; John,67,0,100,33
1713331260485,CSE 141L,A01,489571,Eldon; John,65,0,100,35
1713331261511,CSE 151A,A01,489583,Solares; Edwin A,141,0,200,59
1713331262536,CSE 175,A01,510886,Kumar; Rakesh,30,0,30,0
1713331263561,CSE 190,A00,516828,Dubnov; Shlomo,38,0,49,11
1713331264591,DOC 100D,A00,489667,Pass; Natalye Joann,19,0,25,6
1713331265617,DSC 10,A01,624268,Staff,72,0,75,3
1713331266710,DSC 20,A01,624476,Staff,50,0,50,0
1713331267739,DSC 40A,A01,624608,Staff,39,0,40,1
1713331268765,DSGN 1,A01,489179,Rill; Bryan,32,0,50,18
1713331269792,ECE 17,A01,490489,Sahay; Rajeev,18,0,30,12
1713331270820,ECE 65,A50,490492,Staff,11,0,20,9
1713331270820,ECE 65,A51,490493,Staff,18,0,20,2
1713331271846,ECON 1,A01,489715,Famulari; Melissa,67,0,70,3
1713331272871,ECON 2,A01,489717,Levkoff; Steven B.,68,0,70,2
1713331273902,ECON 3,A01,489948,Staff,70,0,70,0
1713331275954,ECON 5,A01,490103,Staff,27,0,30,3
1713331275954,ECON 5,B01,626281,Dai; Yinlin,45,0,45,0
1713331276986,ECON 100A,A01,490127,Famulari; Melissa,65,0,70,5
1713331278009,ECON 100B,A01,490129,Staff,64,0,70,6
1713331279036,ECON 109,A01,490187,Shishkin; Denis,27,0,35,8
1713331280066,ECON 110A,A01,490190,Levkoff; Steven B.,60,0,70,10
1713331281096,ECON 120A,A01,490245,Dai; Yinlin,61,0,70,9
1713331282127,ECON 120B,A01,490247,Nieto-Barthaburu; Augusto,40,0,70,30
1713331283153,ECON 120C,A01,490253,Sun; Yixiao,30,0,35,5
1713331283153,ECON 120C,B01,490255,Sun; Yixiao,34,0,35,1
1713331284184,ECON 129,A00,490256,Eckert; Fabian Paul,23,0,35,12
1713331285208,ECON 131,A00,490257,Nieto-Barthaburu; Augusto,0,6,35,35
1713331286237,ECON 138,A00,490258,Bharadwaj; Prashant,13,0,35,22
1713331286237,ECON 138,B00,490259,Bharadwaj; Prashant,15,0,35,20
1713331287266,ECON 159,A00,490260,Hendrickson; Gerald M.,0,9,0,0
1713331288293,ECON 178,A01,553995,Zhu; Ying,24,0,35,11
1713331289320,EDS 40,A01,512576,Black; Alison Michelle,20,0,20,0
1713331290347,EDS 107,A01,515848,Staff,30,0,30,0
1713331291372,EDS 110R,A01,490262,Staff,26,0,30,4
1713331292397,EDS 112,A01,490264,Chapman; Thandeka K,40,0,50,10
1713331293423,EDS 113,A00,490266,Staff,26,0,30,4
1713331294446,EDS 118,A00,490267,Warstadt; Melissa Fawn,20,0,30,10
1713331295475,EDS 124BR,A00,490268,Eguchi; Emi,4,0,25,21
1713331295475,EDS 124BR,B00,490269,Eguchi; Emi,23,0,25,2
1713331296499,EDS 126,A01,490271,Jones; Makeba,43,0,50,7
1713331297525,EDS 135,A01,490316,Staff,19,0,20,1
1713331298552,ENVR 142GS,A00,519514,Chang; Edmond Yi-Teh,26,0,28,2
1713331299582,ETHN 103,A00,490504,Staff,25,0,36,11
1713331300612,ETHN 103A,A00,490505,Man; Simeon S,4,0,9,5
1713331301638,ETHN 109,A00,490506,Staff,28,0,30,2
1713331302668,ETHN 118,A00,490507,Staff,35,0,36,1
1713331303696,ETHN 119,A00,490508,Staff,33,0,36,3
1713331304721,ETHN 121R,A00,490518,Choi; Esther Min,21,0,36,15
1713331305748,ETHN 127,A00,490528,Staff,14,0,15,1
1713331306774,ETHN 139,A00,490573,Staff,10,0,10,0
1713331307799,ETHN 150,A00,490575,Staff,15,0,15,0
1713331308825,GLBH 20,A00,491705,Elwardani; Nile Regina,38,0,40,2
1713331309850,GLBH 101,A00,491706,Staff,20,0,20,0
1713331310877,GLBH 111,A01,491708,Burgos; Jose L.,15,0,15,0
1713331311903,GLBH 146,A00,491709,Staff,9,0,20,11
1713331312931,GLBH 148,A00,491710,Olivas Hernandez; Olga Lid,11,0,20,9
1713331313957,GLBH 150,A00,491711,Sloane; Julia Kathryn,19,0,20,1
1713331314982,HIEA 131,A00,491760,Staff,28,0,32,4
1713331316010,HIEA 153,A00,491762,Staff,28,0,30,2
1713331317037,HIEU 124,A00,491811,Staff,26,0,32,6
1713331318068,HIEU 124GS,A00,491812,Markman; Kristina,27,0,28,1
1713331319098,HIEU 147,A00,491813,Staff,30,0,32,2
1713331320127,HIEU 149GS,A00,491816,Caldwell; Michael Alan,28,0,28,0
1713331321152,HILD 2C,A01,491713,Hendrickson; Gerald M.,26,0,30,4
1713331322180,HILD 7B,A01,491715,Kwak; Nancy,0,2,30,30
1713331323204,HILD 10,A01,491717,Staff,11,0,20,9
1713331324231,HILD 30GS,A00,491719,Edington; Claire Ellen,24,0,28,4
1713331325258,HINE 109,A00,491818,Shafir; Nir,27,0,32,5
1713331326283,HINE 128,A00,491821,Shafir; Nir,31,0,32,1
1713331327309,HISC 117,A00,491830,Staff,27,0,32,5
1713331328338,HIUS 103,A00,491834,Man; Simeon S,14,0,23,9
1713331329363,HIUS 108B,A00,491835,Staff,27,0,30,3
1713331330390,HIUS 141,A00,491836,Hendrickson; Gerald M.,28,0,32,4
1713331331418,HIUS 149,A00,491839,Staff,24,0,32,8
1713331332443,HUM 3,A01,512617,Crum; Matthew Stephen,42,0,50,8
1713331332443,HUM 3,A02,512618,Crum; Matthew Stephen,48,0,50,2
1713331333468,HUM 3GS,A00,512663,Markman; Kristina,0,0,0,1
1713331333468,HUM 3GS,B00,512664,Staff,0,0,0,0
1713331334499,HUM 4,A01,512620,West; Geoffrey Scott,25,0,50,25
1713331335527,HUM 4GS,A00,512666,Lyon; Antony J.,0,0,0,5
1713331336559,HUM 4R,A01,512625,Watkins; Eric,49,0,50,1
1713331337590,HUM 5,A01,512649,Zavodny; Tatiana Sophia,23,0,50,27
1713331337590,HUM 5,B01,512661,Zroka; Ryan Edward,48,0,50,2
1713331338616,INTL 190,A00,490577,Segui; Alan S,0,0,0,5
1713331339647,JAPN 20AR,A01,491267,Ross; Kayoko F,7,0,20,13
1713331340676,JAPN 180,A00,491285,Berman; Michael David,33,0,40,7
1713331341707,LATI 50,A01,502536,Kokinis; Troy Andreas,16,0,22,6
1713331341707,LATI 50,A02,502551,Kokinis; Troy Andreas,22,0,22,0
1713331341707,LATI 50,A03,502650,Kokinis; Troy Andreas,22,0,22,0
1713331341707,LATI 50,A04,502909,Kokinis; Troy Andreas,21,0,22,1
1713331342732,LATI 160,A01,502920,Kokinis; Troy Andreas,30,0,30,0
1713331343759,LIFR 1A,A00,490494,Van Moer; Vinciane G,17,0,20,3
1713331344784,LIFR 1AX,A00,490495,Van Moer; Vinciane G,17,0,20,3
1713331345810,LIFR 1B,A00,490496,Van Moer; Vinciane G,17,0,20,3
1713331346840,LIFR 1BX,A00,490497,Van Moer; Vinciane G,17,0,20,3
1713331347871,LIGN 8,A00,505198,McIntosh; Justin Daniel,134,0,150,16
1713331348955,LIGN 9GS,A00,491239,Lott; Margaret S.,18,0,20,2
1713331349980,LIGN 101,A01,505200,McIntosh; Justin Daniel,22,0,30,8
1713331351006,LIGN 120,A01,491244,Staff,22,0,30,8
1713331352030,LIGN 149GS,A00,491245,Lott; Margaret S.,18,0,20,2
1713331353054,LIGN 170,A00,491247,Staff,22,0,30,8
1713331354078,LISP 1D,A00,490498,Munoz Sanchez; Alicia,9,0,14,5
1713331354078,LISP 1D,B00,490499,Munoz Sanchez; Alicia,6,0,14,8
1713331354078,LISP 1D,C00,490500,Munoz Sanchez; Alicia,7,0,14,7
1713331354078,LISP 1D,D00,490501,Munoz Sanchez; Alicia,10,0,14,4
1713331355103,LISP 1DX,A00,490502,Munoz Sanchez; Alicia,14,0,28,14
1713331355103,LISP 1DX,B00,490503,Munoz Sanchez; Alicia,16,0,28,12
1713331357158,LTAM 110,A00,491847,Staff,22,0,25,3
1713331358182,LTCS 119,A00,491848,Staff,11,0,15,4
1713331359207,LTCS 130,A00,491849,Staff,24,0,25,1
1713331361257,LTEA 120C,A00,491852,Staff,32,0,40,8
1713331362282,LTEN 130GS,A00,491853,Lyon; Antony J.,23,0,28,5
1713331363306,LTEN 148,A00,491855,Staff,23,0,25,2
1713331364331,LTEN 159,A00,491856,Staff,20,0,25,5
1713331365356,LTEN 180,A00,491857,Staff,8,0,15,7
1713331367408,LTSP 123GS,A00,505928,Bessett; Ryan Matthew,24,0,28,4
1713331368437,LTSP 174GS,A00,506037,Bessett; Ryan Matthew,24,0,28,4
1713331370492,LTWR 102,A00,491861,Staff,9,0,15,6
1713331371518,LTWR 106,A00,491862,Staff,8,0,15,7
1713331372565,MAE 11,A00,490930,Bahadori; Mohammad Yousef,95,0,100,5
1713331373591,MAE 30A,A00,490931,Qi; Huihui,37,0,40,3
1713331374618,MAE 101A,A00,491036,Sadeghizadeh; Zahra,92,0,100,8
1713331375649,MAE 101C,A00,491037,Seshadri; Kalyanasundaram,66,0,100,34
1713331376673,MAE 113,A00,491040,Seshadri; Kalyanasundaram,65,0,80,15
1713331377701,MAE 131A,A00,491041,Ghazinejad; Maziar,37,0,40,3
1713331378727,MAE 142,A00,491053,Staff,39,0,40,1
1713331379752,MAE 143A,A00,491054,Staff,31,0,50,19
1713331380778,MAE 150,A00,491092,Truong; Phuong Thi Ngoc,24,0,35,11
1713331381804,MATH 3C,A01,494031,Pardo Guerra; Sebastian,30,0,30,0
1713331381804,MATH 3C,A02,494032,Pardo Guerra; Sebastian,29,0,30,1
1713331382832,MATH 10A,A01,494034,Staff,27,0,30,3
1713331382832,MATH 10A,A02,494035,Staff,28,0,30,2
1713331382832,MATH 10A,B01,494037,Staff,27,0,30,3
1713331382832,MATH 10A,B02,494038,Staff,29,0,30,1
1713331383865,MATH 10B,A01,494040,Habib; Yousaf,22,0,30,8
1713331383865,MATH 10B,A02,494041,Habib; Yousaf,28,0,30,2
1713331383865,MATH 10B,A03,494042,Habib; Yousaf,29,0,30,1
1713331383865,MATH 10B,A04,494043,Habib; Yousaf,30,0,30,0
1713331383865,MATH 10B,B01,494045,Habib; Yousaf,25,0,30,5
1713331383865,MATH 10B,B02,494046,Habib; Yousaf,30,0,30,0
1713331383865,MATH 10B,B03,494047,Habib; Yousaf,30,0,30,0
1713331383865,MATH 10B,B04,494048,Habib; Yousaf,30,0,30,0
1713331384897,MATH 18,A01,494050,Kemp; Todd Aahron,25,0,30,5
1713331384897,MATH 18,A02,494051,Kemp; Todd Aahron,29,0,30,1
1713331384897,MATH 18,B01,494054,Kemp; Todd Aahron,26,0,30,4
1713331384897,MATH 18,B02,494055,Kemp; Todd Aahron,29,0,30,1
1713331385926,MATH 20A,A01,494059,Suk; Andrew Hoon,30,0,30,0
1713331386951,MATH 20B,A01,494061,Briones; Jor-el Thomas Caparas,33,0,35,2
1713331386951,MATH 20B,B01,494063,Bach; Quang Tran,34,0,35,1
1713331387983,MATH 20C,A01,494065,Staff,28,0,30,2
1713331387983,MATH 20C,A02,494066,Staff,30,0,30,0
1713331387983,MATH 20C,A03,494067,Staff,30,0,30,0
1713331387983,MATH 20C,A04,494068,Staff,30,0,30,0
1713331387983,MATH 20C,B01,494070,Zhang; Ming,25,0,30,5
1713331387983,MATH 20C,B02,494071,Zhang; Ming,27,0,30,3
1713331387983,MATH 20C,B03,494072,Zhang; Ming,29,0,30,1
1713331387983,MATH 20C,B04,494073,Zhang; Ming,29,0,30,1
1713331389013,MATH 20D,A01,494075,Staff,22,0,30,8
1713331389013,MATH 20D,A02,494076,Staff,29,0,30,1
1713331390042,MATH 20E,A01,494079,Staff,24,0,30,6
1713331390042,MATH 20E,A02,494080,Staff,26,0,30,4
1713331390042,MATH 20E,B01,494082,Staff,25,0,30,5
1713331390042,MATH 20E,B02,494083,Staff,25,0,30,5
1713331391075,MATH 103A,A01,494085,Aliabadi Sr.; Mohsen,13,0,30,17
1713331391075,MATH 103A,A02,494086,Aliabadi Sr.; Mohsen,28,0,30,2
1713331391075,MATH 103A,B01,494088,Aliabadi Sr.; Mohsen,21,0,30,9
1713331391075,MATH 103A,B02,494089,Aliabadi Sr.; Mohsen,27,0,30,3
1713331392103,MATH 109,A01,494091,Staff,30,0,30,0
1713331392103,MATH 109,A02,494092,Staff,29,0,30,1
1713331392103,MATH 109,B01,494094,Staff,27,0,30,3
1713331392103,MATH 109,B02,494095,Staff,29,0,30,1
1713331393134,MATH 142A,A01,494097,Chow; Bennett,15,0,30,15
1713331393134,MATH 142A,A02,494098,Chow; Bennett,23,0,30,7
1713331393134,MATH 142A,B01,494100,Chow; Bennett,19,0,30,11
1713331393134,MATH 142A,B02,494101,Chow; Bennett,29,0,30,1
1713331395188,MATH 168A,A01,516677,Dumitriu; Ioana,16,0,35,19
1713331396217,MATH 170A,A01,516679,Dumitriu; Ioana,18,0,30,12
1713331396217,MATH 170A,A02,516680,Dumitriu; Ioana,28,0,30,2
1713331397243,MATH 193A,A01,494107,Staff,14,0,30,16
1713331397243,MATH 193A,A02,494108,Staff,19,0,30,11
1713331397243,MATH 193A,A03,494109,Staff,29,0,30,1
1713331397243,MATH 193A,A04,494110,Staff,22,0,30,8
1713331400329,MGT 16,A00,491930,McKay; Michael J,92,0,98,6
1713331401355,MGT 18,A00,491992,McKay; Michael J,96,0,98,2
1713331402384,MGT 71,A00,492003,Staff,65,0,98,33
1713331403410,MGT 103,A00,505209,Eberhard; Craig A,81,0,98,17
1713331404471,MGT 131A,A00,505210,Anderson; John Charles,89,0,98,9
1713331406522,MGT 153,A00,492077,Perols; Johan Lars,19,0,90,71
1713331409607,MGT 164,A00,492222,McKay; Mary A,91,0,98,7
1713331410632,MGT 172,A00,492245,Staff,59,0,60,1
1713331410632,MGT 172,B00,505526,Hedges; Kathleen,65,0,98,33
1713331411662,MGT 181,A00,505669,Dunn; Louis Jean,81,0,98,17
1713331412691,MMW 14,A01,494399,Staff,15,0,28,13
1713331412691,MMW 14,A02,494400,Staff,25,0,28,3
1713331412691,MMW 14,A03,494401,Staff,28,0,28,0
1713331412691,MMW 14,A04,494402,Staff,28,0,28,0
1713331412691,MMW 14,B01,494404,Carreras; Maria Victoria,8,0,28,20
1713331412691,MMW 14,B02,494405,Carreras; Maria Victoria,25,0,28,3
1713331412691,MMW 14,B03,494406,Carreras; Maria Victoria,27,0,28,1
1713331412691,MMW 14,B04,494407,Carreras; Maria Victoria,28,0,28,0
1713331413717,MMW 14GS,A00,506250,Chang; Edmond Yi-Teh,0,0,0,0
1713331414744,MMW 121R,A01,494415,Adamiak; Patrick John,10,0,28,18
1713331414744,MMW 121R,A02,494416,Adamiak; Patrick John,24,0,28,4
1713331415768,MUS 1A,A01,494113,Staff,12,0,25,13
1713331415768,MUS 1A,A02,494114,Staff,24,0,25,1
1713331416803,MUS 4,A01,494116,Staff,23,0,25,2
1713331416803,MUS 4,A02,494117,Staff,22,0,25,3
1713331417833,MUS 5R,A01,494236,Dubnov; Shlomo,6,0,25,19
1713331417833,MUS 5R,A02,494237,Dubnov; Shlomo,25,0,25,0
1713331418858,MUS 6,A01,494122,Staff,10,0,25,15
1713331418858,MUS 6,A02,494123,Staff,23,0,25,2
1713331419884,MUS 7,A01,494125,Staff,16,0,25,9
1713331419884,MUS 7,A02,494126,Staff,24,0,25,1
1713331420911,MUS 11,A01,494128,Staff,23,0,25,2
1713331420911,MUS 11,A02,494129,Staff,24,0,25,1
1713331421941,MUS 13,A01,494131,Staff,25,0,25,0
1713331421941,MUS 13,A02,494132,Staff,25,0,25,0
1713331422968,MUS 15,A01,494134,Staff,16,0,25,9
1713331422968,MUS 15,A02,494135,Staff,25,0,25,0
1713331422968,MUS 15,B01,494137,Staff,24,0,25,1
1713331423997,MUS 80,A00,494232,Staff,24,0,25,1
1713331423997,MUS 80,B00,494233,Staff,25,0,25,0
1713331423997,MUS 80,C00,494234,Staff,23,0,25,2
1713331425023,MUS 95C,A00,494141,Staff,70,0,75,5
1713331426048,MUS 114,A00,494142,Staff,40,0,50,10
1713331427074,NANO 15,A01,490636,Drews; Aaron,7,0,7,0
1713331428119,PHIL 1,A00,490578,Grush; Rick Scott,49,0,50,1
1713331429149,PHIL 10,A01,490580,Grush; Rick Scott,33,0,35,2
1713331429149,PHIL 10,A02,490586,Grush; Rick Scott,32,0,35,3
1713331430174,PHIL 27,A01,490591,Staff,22,0,25,3
1713331430174,PHIL 27,A02,490592,Staff,25,0,25,0
1713331430174,PHIL 27,A03,490593,Staff,25,0,25,0
1713331430174,PHIL 27,A04,490598,Staff,25,0,25,0
1713331431199,PHIL 32,A01,490611,Staff,20,0,20,0
1713331431199,PHIL 32,A02,490618,Staff,20,0,20,0
1713331432227,PHIL 90,A00,490624,Staff,40,0,40,0
1713331433253,PHIL 136,A00,490627,Cohen; Jonathan David,37,0,40,3
1713331434279,PHIL 155,A00,490634,Staff,62,0,70,8
1713331435304,PHYS 1A,A00,491610,Staff,245,0,250,5
1713331436332,PHYS 1AL,001,491616,Tsai; Philbert S,27,0,30,3
1713331436332,PHYS 1AL,002,491618,Tsai; Philbert S,30,0,30,0
1713331437357,PHYS 1B,A00,491623,Staff,236,0,250,14
1713331438384,PHYS 1BL,001,491626,Tsai; Philbert S,22,0,30,8
1713331438384,PHYS 1BL,002,491628,Tsai; Philbert S,26,0,30,4
1713331439409,PHYS 1C,A00,491632,Staff,213,0,245,32
1713331440434,PHYS 1CL,001,491635,Tsai; Philbert S,2,0,30,28
1713331440434,PHYS 1CL,002,491643,Tsai; Philbert S,22,0,30,8
1713331441465,PHYS 2AR,A01,491651,Meyertholen; Andrew D.,44,0,50,6
1713331442490,PHYS 2B,A01,491659,Staff,106,0,115,9
1713331443516,PHYS 2BL,A01,491685,Staff,21,0,24,3
1713331443516,PHYS 2BL,A02,491700,Staff,21,0,24,3
1713331444543,PHYS 2C,A01,505161,Staff,101,0,115,14
1713331445569,PHYS 4A,A01,491704,Grinstein; Benjamin,99,0,100,1
1713331446597,POLI 5D,A01,494144,Staff,3,0,5,2
1713331446597,POLI 5D,B01,626283,Dai; Yinlin,5,0,5,0
1713331447623,POLI 12,A00,494145,Staff,43,0,45,2
1713331448647,POLI 13R,A00,494146,Forman; Fonna,45,0,50,5
1713331449675,POLI 27,A01,494148,Staff,54,0,60,6
1713331450700,POLI 30,A00,494149,Staff,49,0,50,1
1713331451727,POLI 100DA,A00,494150,Staff,21,0,25,4
1713331453854,POLI 100I,A00,494152,Staff,27,0,30,3
1713331454882,POLI 104B,A00,494153,Smith; Glenn Chatmas,53,0,55,2
1713331455907,POLI 104F,A00,494154,Staff,28,0,30,2
1713331456932,POLI 104I,A00,494155,Smith; Glenn Chatmas,29,0,30,1
1713331457958,POLI 110C,A00,494156,Ingham; Sean,23,0,25,2
1713331458984,POLI 117R,A00,494157,Forman; Fonna,8,0,20,12
1713331460008,POLI 118,A00,494158,Ingham; Sean,21,0,25,4
1713331461033,POLI 120H,A00,494159,Fisk; David Lee,39,0,45,6
1713331462059,POLI 131CR,A00,494160,Hoston; Germaine,35,0,45,10
1713331463086,POLI 133J,A00,494161,Staff,32,0,35,3
1713331464114,POLI 135,A00,494162,Fisk; David Lee,33,0,35,2
1713331465141,POLI 140A,A00,494164,Staff,19,0,30,11
1713331466170,POLI 142I,A00,494165,Staff,30,0,30,0
1713331467194,POLI 144D,A00,494166,Staff,23,0,25,2
1713331468223,POLI 151,A00,494167,Staff,30,0,30,0
1713331469249,POLI 153,A00,494168,Staff,33,0,35,2
1713331470280,POLI 160AA,A00,494169,Staff,34,0,40,6
1713331471307,POLI 162,A00,494170,Mignozzetti; Umberto,18,0,25,7
1713331472331,POLI 171,A00,494171,Mignozzetti; Umberto,18,0,25,7
1713331473355,PSYC 1,A00,494172,Staff,96,0,100,4
1713331474384,PSYC 2,A00,494173,Moranton; Nirelia Melbina-,34,0,50,16
1713331475411,PSYC 3,A00,494174,Staff,29,0,30,1
1713331476440,PSYC 6,A00,494175,Staff,17,0,20,3
1713331477467,PSYC 60,A01,494177,Staff,38,0,45,7
1713331478493,PSYC 70,A01,505724,Geller; Emma Harlan,42,0,45,3
1713331479520,PSYC 101,A00,494180,Heyman; Gail D.,84,0,100,16
1713331480548,PSYC 105,A00,494181,Geller; Emma Harlan,51,0,90,39
1713331481576,PSYC 106,A00,494182,Dobkins; Karen R.,27,0,45,18
1713331482604,PSYC 108,A00,494183,Adrian; Julia Anna,89,0,100,11
1713331483632,PSYC 114,A01,494185,Winkielman; Piotr,0,3,30,30
1713331484658,PSYC 122,A00,494186,Moranton; Nirelia Melbina-,28,0,50,22
1713331485684,PSYC 124,A00,494187,Chapman; Eddie Nathaniel,70,0,80,10
1713331486712,PSYC 131,A00,494188,Anagnostaras; Stephan,41,0,80,39
1713331487737,PSYC 144,A00,494189,Staff,3,0,50,47
1713331488763,PSYC 154,A00,494190,Lacefield; Katharine I,107,0,180,73
1713331489792,PSYC 162,A00,494191,Wixted; John T,71,0,100,29
1713331490821,PSYC 172,A00,494192,Gorman; Michael R.,36,0,45,9
1713331491845,PSYC 178,A00,494193,Glaser; Dale,34,0,45,11
1713331492872,PSYC 193,A00,505725,Chapman; Eddie Nathaniel,20,0,20,0
1713331493903,RELI 145GS,A00,519817,Rahimi; Babak,18,0,20,2
1713331494935,SE 101A,A01,490862,Chadha; Mayank,23,0,25,2
1713331495959,SE 101C,A01,490924,Krysl; Petr,15,0,20,5
1713331496988,SE 110A,A01,490928,Staff,19,0,20,1
1713331498016,SE 130A,A00,490929,Morrison; Machel Leigh,55,0,70,15
1713331499042,SIO 1,A01,519325,Staff,39,0,40,1
1713331500073,SIO 30,A01,519327,Staff,38,0,40,2
1713331501103,SIO 40,A00,519328,Staff,39,0,40,1
1713331502130,SIO 46GS,A00,519819,Cook; Geoffrey W,17,0,25,8
1713331503186,SIO 109R,A00,494197,Forman; Fonna,0,3,20,20
1713331504211,SIO 121GS,A00,519827,Cook; Geoffrey W,17,0,25,8
1713331505239,SIO 132,A01,519330,Staff,38,0,40,2
1713331506265,SIO 133,A01,519397,Staff,37,0,40,3
1713331507291,SIO 139,A00,519396,Kacev; David,29,0,40,11
1713331508322,SOCI 1,A01,494199,Thorpe; Charles Robert,21,0,30,9
1713331508322,SOCI 1,A02,494200,Thorpe; Charles Robert,30,0,30,0
1713331508322,SOCI 1,A03,494201,Thorpe; Charles Robert,29,0,30,1
1713331508322,SOCI 1,A04,494202,Thorpe; Charles Robert,29,0,30,1
1713331508322,SOCI 1,A05,494203,Thorpe; Charles Robert,29,0,30,1
1713331508322,SOCI 1,A06,494204,Thorpe; Charles Robert,30,0,30,0
1713331508322,SOCI 1,A07,494205,Thorpe; Charles Robert,28,0,30,2
1713331509347,SOCI 60,A01,494207,Staff,34,0,40,6
1713331509347,SOCI 60,A02,494208,Staff,39,0,40,1
1713331510372,SOCI 100,A01,494210,Payne; Christine Anna,25,0,30,5
1713331510372,SOCI 100,A02,494211,Payne; Christine Anna,26,0,30,4
1713331511398,SOCI 109M,A00,494212,Staff,20,0,20,0
1713331512423,SOCI 110,A00,494213,Staff,34,0,40,6
1713331514476,SOCI 118E,A00,494215,Ng; Kwai,37,0,40,3
1713331515505,SOCI 125,A00,494216,Calderon-Zaks; Michael Aar,40,0,45,5
1713331516532,SOCI 126,A01,494218,Jones; Makeba,3,0,5,2
1713331517559,SOCI 131,A00,494219,Thorpe; Charles Robert,26,0,30,4
1713331519613,SOCI 135,A00,494221,Payne; Christine Anna,28,0,50,22
1713331520639,SOCI 136E,A00,626690,Ruiz; Jonathan Joseph,24,0,25,1
1713331521665,SOCI 138GS,A00,494222,Navon; Daniel,24,0,28,4
1713331523719,SOCI 145,A00,494224,Staff,40,0,45,5
1713331524747,SOCI 153,A00,494225,Staff,28,0,30,2
1713331525776,SOCI 160E,A00,494226,Ng; Kwai,29,0,40,11
1713331526800,SOCI 180,A00,494227,Staff,29,0,30,1
1713331527829,SOCI 189GS,A00,494228,Ribas Norris; Janet Vanesa,11,0,11,0
1713331528855,SOCI 190GS,A00,553232,Ribas Norris; Janet Vanesa,11,0,11,0
1713331529881,SOMI 220,A00,627178,Schneid; Stephen David,30,0,30,0
1713331530909,SYN 2,001,490768,Staff,13,0,15,2
1713331530909,SYN 2,002,490769,Staff,14,0,15,1
1713331530909,SYN 2,004,490775,Staff,0,0,0,0
1713331530909,SYN 2,003,490774,Staff,0,0,0,0
1713331530909,SYN 2,005,490776,Staff,0,0,0,0
1713331531935,SYN 2R,001,490779,Staff,11,0,15,4
1713331531935,SYN 2R,002,514635,Staff,14,0,15,1
1713331532961,SYN 100,A01,490783,Staff,9,0,20,11
1713331532961,SYN 100,B01,490787,Staff,9,0,20,11
1713331532961,SYN 100,C01,490789,Staff,10,0,20,10
1713331533992,SYN 150,A00,490817,Staff,14,0,15,1
1713331533992,SYN 150,B00,514610,Staff,15,0,15,0
1713331535030,TDAC 1,A00,492753,Walsh; Kim C.,19,0,20,1
1713331535030,TDAC 1,B00,492754,Harting; Carla Kelso,19,0,20,1
1713331535030,TDAC 1,C00,513995,Salovey; Todd,15,0,20,5
1713331536058,TDAC 101,A00,492766,Harting; Carla Kelso,17,0,20,3
1713331537084,TDAC 102,A00,492768,Basso; Beatrice,19,0,20,1
1713331538114,TDDE 111,A00,492769,Staff,25,0,25,0
1713331539139,TDDE 131,A00,492770,Staff,15,0,15,0
1713331539139,TDDE 131,B00,492771,Staff,15,0,15,0
1713331540165,TDDE 131GS,A00,523716,Guirguis; Mark C,23,0,28,5
1713331541195,TDGE 1,A01,492756,Salovey; Todd,56,0,60,4
1713331542221,TDGE 5,A01,492758,Staff,23,0,25,2
1713331543247,TDGE 10,A00,492759,Fulton; Julia,203,0,220,17
1713331544272,TDGE 11,A00,492760,Castro; Robert Jess,198,0,200,2
1713331546327,TDGE 124,A00,492772,Fulton; Julia,184,0,220,36
1713331547358,TDGE 125,A00,492773,Meyer; Ursula,38,0,50,12
1713331547358,TDGE 125,B00,492774,Staff,49,0,50,1
1713331547358,TDGE 125,C00,523565,Staff,48,0,50,2
1713331548383,TDGE 125GS,A00,523580,Guirguis; Mark C,23,0,28,5
1713331549408,TDGE 127,A00,492775,Havis; Allan,33,0,50,17
1713331550437,TDHT 101,A00,492776,Staff,34,0,35,1
1713331551462,TDMV 1,A00,492762,Caligagan; Maria T.,30,0,30,0
1713331551462,TDMV 1,B00,492763,Arcidiacono; Kristin,26,0,30,4
1713331552492,TDMV 2,A00,492764,Weinberg; Sadie,28,0,30,2
1713331553518,TDMV 3,A00,492765,Mack; Kara Shanai',37,0,40,3
1713331554546,TDMV 138,A00,492777,Mack; Kara Shanai',34,0,40,6
1713331555572,TDMV 140,A00,492778,Lima; Paulo Henrique,40,0,40,0
1713331556657,TDMV 142,A00,492779,Caligagan; Maria T.,33,0,40,7
1713331556657,TDMV 142,B00,492780,Caligagan; Tony,37,0,40,3
1713331557681,TDMV 143,A00,492781,Fyall; Daunte Edward,39,0,40,1
1713331558711,USP 1,A01,492401,Kwak; Nancy,27,0,35,8
1713331559741,USP 2,A01,492453,Hinds; Juli Beth,35,0,35,0
1713331560771,USP 3,A01,492516,Staff,28,0,35,7
1713331561801,USP 4,A00,492522,McTague; Sarah,16,0,25,9
1713331562827,USP 100,A00,492523,Staff,32,0,35,3
1713331563857,USP 101,A00,492524,Staff,13,0,15,2
1713331564884,USP 105,A00,492525,Staff,21,0,25,4
1713331565917,USP 151,A00,492526,Shenkman; Michael Thomas,32,0,35,3
1713331566943,USP 170,A00,492545,Hinds; Juli Beth,33,0,35,2
1713331567969,USP 171GS,A00,492608,Bussell; Mirle Rabinowitz,24,0,28,4
1713331568994,USP 183GS,A00,492613,Peerson; Susan,24,0,28,4
1713331570020,VIS 30,A01,490693,Yoldas; Pinar,19,0,22,3
1713331570020,VIS 30,A02,490694,Yoldas; Pinar,18,0,22,4
1713331571051,VIS 83,A00,490695,Kester; Grant,63,0,75,12
1713331572079,VIS 105D,A00,490696,Staff,22,0,25,3
1713331573108,VIS 124CN,A00,490699,Rose; Jordan M,65,0,75,10
1713331574136,VIS 125GS,A00,511221,Williams; Alena J,21,0,22,1
1713331575161,VIS 128D,A00,490700,Staff,73,0,75,2
1713331576186,VIS 151,A01,490717,Staff,33,0,34,1
1713331576186,VIS 151,A02,490766,Staff,33,0,34,1
1713331577211,VIS 154GS,A00,511972,Williams; Alena J,21,0,22,1
1713331578260,VIS 160A,A00,490767,Stone; Patricia,7,0,10,3
1713331579288,WCWP 10A,A00,490638,Staff,14,0,15,1
1713331579288,WCWP 10A,B00,490640,Staff,15,0,15,0
1713331580314,WCWP 10B,A00,490641,Staff,0,0,0,0
1713331580314,WCWP 10B,B00,490642,Staff,14,0,15,1
1713331580314,WCWP 10B,C00,490644,Staff,13,0,15,2
1713331580314,WCWP 10B,D00,490647,Staff,0,0,0,0
1713331581339,WCWP 100,A00,490655,Staff,0,0,0,0
1713331581339,WCWP 100,B00,490687,Staff,10,0,15,5
1713331583424,ANAR 153,A00,487222,Braswell; Geoffrey E.,53,0,60,7
1713331584451,ANBI 134,A00,487223,Staff,5,0,20,15
1713331585480,ANBI 143GS,A00,487224,Noel; Geoffroy Pierre Jean,18,0,24,6
1713331586504,ANBI 144GS,A00,519548,Noel; Geoffroy Pierre Jean,18,0,24,6
1713331587529,ANSC 101,A00,487225,Staff,18,0,20,2
1713331588560,ANSC 125,A00,487227,Brenner; Suzanne A,39,0,40,1
1713331590610,ANSC 146,A00,487229,Staff,35,0,40,5
1713331591636,ANSC 148,A00,487230,Olivas Hernandez; Olga Lid,39,0,40,1
1713331592663,ANSC 150,A00,504165,Sloane; Julia Kathryn,18,0,20,2
1713331593689,ANSC 180,A00,487232,Staff,14,0,15,1
1713331594718,ANSC 188,A00,627155,Staff,38,0,40,2
1713331595744,ANTH 5,A00,519529,Semendeferi; Ekaterini,15,0,15,0
1713331596769,ANTH 10,A00,487219,Staff,58,0,60,2
1713331597797,ANTH 23,A01,487221,Staff,17,0,20,3
1713331598824,ANTH 102,A00,487233,Wilder; Linnea Lorene,51,0,60,9
1713331599853,ANTH 103,A00,487234,Varma; Saiba,55,0,60,5
1713331600879,ANTH 105,A00,487235,Stewart; Alexander B,54,0,60,6
1713331601908,BENG 100,A01,516685,Taylor Amos; Alyssa C,26,0,30,4
1713331602940,BIBC 102,A01,491316,Flagg; Matthew Paul,10,0,88,78
1713331602940,BIBC 102,A02,491366,Flagg; Matthew Paul,78,0,88,10
1713331603965,BIBC 103,A01,491486,Boumechache; Miyyada,16,0,24,8
1713331603965,BIBC 103,A02,491487,Boumechache; Miyyada,24,0,24,0
1713331604991,BICD 100,A01,516882,Staff,73,0,75,2
1713331604991,BICD 100,A02,516890,Staff,69,0,75,6
1713331606019,BICD 102GS,A00,491488,Lo; Stanley M.,26,0,28,2
1713331607048,BIEB 136GS,A00,516940,Holway; David A. & Shurin; Jonathan,18,0,24,6
1713331608076,BIEB 137GS,A01,517034,Holway; David A. & Shurin; Jonathan,18,0,24,6
1713331609101,BIEB 138GS,A01,491492,Pirino; Giorgia,21,0,28,7
1713331610126,BILD 1,A01,491296,Staff,60,0,63,3
1713331610126,BILD 1,A02,491297,Staff,63,0,63,0
1713331611157,BILD 4,A01,517099,Gonzalez Gamboa; Ivonne,22,0,24,2
1713331611157,BILD 4,A02,517100,Gonzalez Gamboa; Ivonne,24,0,24,0
1713331612183,BILD 60GS,A00,491309,Lo; Stanley M.,26,0,28,2
1713331613208,BIMM 100,A01,517136,Staff,83,0,100,17
1713331614234,BIMM 110,A01,517182,Staff,54,0,100,46
1713331615265,BIMM 120,A01,517228,Pickett; Brooke Elizabeth,28,0,63,35
1713331615265,BIMM 120,A02,517240,Pickett; Brooke Elizabeth,44,0,63,19
1713331616291,BIMM 132GS,A01,491498,Pirino; Giorgia,21,0,28,7
1713331617316,BIMM 143,A01,491589,Bozinovic; Goran,13,0,40,27
1713331618348,BIPN 100,A01,491594,Armour; Jon Christopher,83,0,100,17
1713331619374,BIPN 140,A01,491602,Marino; Marc J,25,0,50,25
1713331621425,CAT 125,A00,515973,Staff,18,0,20,2
1713331622452,CAT 125GS,A00,515974,Rahimi; Babak,17,0,20,3
1713331623482,CAT 125R,A00,515980,Staff,12,0,20,8
1713331623482,CAT 125R,B00,515981,Tosun; Adriana,19,0,20,1
1713331623482,CAT 125R,C00,515987,Hyland; Tina Mae,0,3,20,20
1713331623482,CAT 125R,D00,515988,Bronstein; Phoebe Malan,16,0,20,4
1713331624509,CENG 15,A01,488699,Drews; Aaron,25,0,25,0
1713331625533,CENG 100,A00,505196,Opatkiewicz; Justin Paul,25,0,25,0
1713331626560,CGS 2A,A01,489598,Staff,33,0,35,2
1713331627586,CGS 112,A00,489599,Staff,15,0,15,0
1713331628611,CGS 119,A00,489603,Staff,10,0,10,0
1713331629636,CGS 120,A00,489604,Staff,14,0,15,1
1713331630662,CGS 150,A00,489607,Staff,15,0,15,0
1713331631689,CHEM 6A,A01,488715,Staff,98,0,100,2
1713331632715,CHEM 6B,A01,488719,Piercy; Marc Anthony,99,0,100,1
1713331633742,CHEM 6C,A01,488723,Albizati; Kim F.,93,0,100,7
1713331634769,CHEM 7L,A01,488728,Schurmeier; Kimberly,18,0,24,6
1713331634769,CHEM 7L,A02,488730,Schurmeier; Kimberly,23,0,24,1
1713331634769,CHEM 7L,A03,488734,Schurmeier; Kimberly,20,0,24,4
1713331634769,CHEM 7L,A04,488763,Schurmeier; Kimberly,23,0,24,1
1713331634769,CHEM 7L,B01,488798,Schurmeier; Kimberly,17,0,24,7
1713331634769,CHEM 7L,B02,488801,Schurmeier; Kimberly,22,0,24,2
1713331634769,CHEM 7L,B03,488808,Schurmeier; Kimberly,22,0,24,2
1713331634769,CHEM 7L,B04,488811,Schurmeier; Kimberly,24,0,24,0
1713331635796,CHEM 11,A01,488897,Stallings; Dontarie M,95,0,100,5
1713331636826,CHEM 40A,A01,488913,Albizati; Kim F.,83,0,100,17
1713331637852,CHEM 40B,A01,488920,Weizman; Haim,43,0,50,7
1713331637852,CHEM 40B,A02,488938,Weizman; Haim,44,0,50,6
1713331638883,CHEM 41A,A01,489029,Klosterman; Jeremy K,57,0,60,3
1713331639909,CHEM 41C,A01,500436,Tor; Yitzhak,55,0,60,5
1713331640932,CHEM 43A,A01,500426,Weizman; Haim,0,0,24,24
1713331640932,CHEM 43A,A02,500430,Weizman; Haim,7,0,24,17
1713331640932,CHEM 43A,B01,514041,Klosterman; Jeremy K,16,0,24,8
1713331640932,CHEM 43A,B02,514047,Klosterman; Jeremy K,23,0,24,1
1713331641960,CHEM 108,A01,489140,Jennings; Patricia A.,9,0,24,15
1713331641960,CHEM 108,A02,489142,Jennings; Patricia A.,14,0,24,10
1713331642987,CHEM 114A,A01,489147,Stallings; Dontarie M,68,0,100,32
1713331644017,CHIN 169A,A00,489171,Wang; Xiao,19,0,20,1
1713331646070,COGS 3,A01,518827,Boyle; Mary E. T.,25,0,40,15
1713331647096,COGS 11,A01,489175,Staff,27,0,30,3
1713331648122,COGS 14A,A01,518829,Staff,51,0,60,9
1713331649148,COGS 14B,A01,489177,Hoffman; Drew Ellen,62,0,75,13
1713331650176,COGS 100,A01,489181,Allen; Michael Gordon,62,0,75,13
1713331651202,COGS 101A,A01,489183,Staff,46,0,60,14
1713331652230,COGS 101B,A01,489185,Allen; Michael Gordon,8,0,30,22
1713331653257,COGS 101C,A01,526786,Staff,23,0,30,7
1713331655313,COGS 107A,A01,489189,Boyle; Mary E. T.,17,0,35,18
1713331656344,COGS 107B,A01,627144,Mooshagian; Eric Frederick,60,0,60,0
1713331657370,COGS 118A,A01,489191,Staff,0,44,40,40
1713331659427,COGS 171GS,A01,489194,Pineda; Jaime A,19,0,28,9
1713331660513,COGS 172,A01,489196,Staff,2,0,30,28
1713331661538,COGS 174GS,A01,489264,Pineda; Jaime A,19,0,28,9
1713331662563,COGS 180,A01,627150,Staff,28,0,30,2
1713331663592,COGS 186,A01,489274,Staff,0,1,30,30
1713331664619,COMM 10,A01,489276,Staff,23,0,25,2
1713331664619,COMM 10,A02,489303,Staff,23,0,25,2
1713331665648,COMM 100A,A01,489312,Staff,14,0,25,11
1713331665648,COMM 100A,A02,489313,Staff,24,0,25,1
1713331666675,COMM 106T,A00,512540,Staff,33,0,35,2
1713331667701,COMM 107,A00,489347,Staff,27,0,35,8
1713331668731,COMM 109P,A00,489358,Staff,31,0,35,4
1713331669762,COMM 132,A00,489361,McKenna; Denise,27,0,30,3
1713331670792,COMM 146,A00,489362,Halm; Gavin Patrick,26,0,30,4
1713331671816,COMM 190,A00,489363,Abuelhiga; Soraya Jill,17,0,23,6
1713331672844,CSE 8A,A50,489366,Staff,21,0,25,4
1713331672844,CSE 8A,A51,489367,Staff,24,0,25,1
1713331673870,CSE 11,A01,489398,Cao; Yingjun,73,0,100,27
1713331674896,CSE 12,A01,489487,Staff,43,0,50,7
1713331675921,CSE 20,A01,489497,Staff,48,0,50,2
1713331676945,CSE 21,A01,489517,Braun; Oliver,42,0,50,8
1713331677975,CSE 101,A01,489524,Braun; Oliver,0,32,50,50
1713331679003,CSE 105,A01,512594,Jones; Miles E,72,0,100,28
1713331679003,CSE 105,B01,512598,Jones; Miles E,52,0,100,48
1713331680030,CSE 140,A01,489538,Staff,41,0,50,9
1713331681055,CSE 141,A01,489550,Eldon; John,67,0,100,33
1713331682086,CSE 141L,A01,489571,Eldon; John,65,0,100,35
1713331683116,CSE 151A,A01,489583,Solares; Edwin A,141,0,200,59
1713331684149,CSE 175,A01,510886,Kumar; Rakesh,30,0,30,0
1713331685176,CSE 190,A00,516828,Dubnov; Shlomo,38,0,49,11
1713331686200,DOC 100D,A00,489667,Pass; Natalye Joann,19,0,25,6
1713331687229,DSC 10,A01,624268,Staff,72,0,75,3
1713331688257,DSC 20,A01,624476,Staff,50,0,50,0
1713331689288,DSC 40A,A01,624608,Staff,39,0,40,1
1713331690313,DSGN 1,A01,489179,Rill; Bryan,32,0,50,18
1713331691345,ECE 17,A01,490489,Sahay; Rajeev,18,0,30,12
1713331692369,ECE 65,A50,490492,Staff,11,0,20,9
1713331692369,ECE 65,A51,490493,Staff,18,0,20,2
1713331693400,ECON 1,A01,489715,Famulari; Melissa,67,0,70,3
1713331694432,ECON 2,A01,489717,Levkoff; Steven B.,68,0,70,2
1713331695458,ECON 3,A01,489948,Staff,70,0,70,0
1713331697520,ECON 5,A01,490103,Staff,27,0,30,3
1713331697520,ECON 5,B01,626281,Dai; Yinlin,45,0,45,0
1713331698552,ECON 100A,A01,490127,Famulari; Melissa,65,0,70,5
1713331699577,ECON 100B,A01,490129,Staff,64,0,70,6
1713331700607,ECON 109,A01,490187,Shishkin; Denis,27,0,35,8
1713331701632,ECON 110A,A01,490190,Levkoff; Steven B.,60,0,70,10
1713331702658,ECON 120A,A01,490245,Dai; Yinlin,61,0,70,9
1713331703684,ECON 120B,A01,490247,Nieto-Barthaburu; Augusto,40,0,70,30
1713331704712,ECON 120C,A01,490253,Sun; Yixiao,30,0,35,5
1713331704712,ECON 120C,B01,490255,Sun; Yixiao,34,0,35,1
1713331705738,ECON 129,A00,490256,Eckert; Fabian Paul,23,0,35,12
1713331706767,ECON 131,A00,490257,Nieto-Barthaburu; Augusto,0,6,35,35
1713331707793,ECON 138,A00,490258,Bharadwaj; Prashant,13,0,35,22
1713331707793,ECON 138,B00,490259,Bharadwaj; Prashant,15,0,35,20
1713331708818,ECON 159,A00,490260,Hendrickson; Gerald M.,0,9,0,0
1713331709851,ECON 178,A01,553995,Zhu; Ying,24,0,35,11
1713331710880,EDS 40,A01,512576,Black; Alison Michelle,20,0,20,0
1713331711907,EDS 107,A01,515848,Staff,30,0,30,0
1713331712933,EDS 110R,A01,490262,Staff,26,0,30,4
1713331713965,EDS 112,A01,490264,Chapman; Thandeka K,40,0,50,10
1713331714994,EDS 113,A00,490266,Staff,26,0,30,4
1713331716019,EDS 118,A00,490267,Warstadt; Melissa Fawn,20,0,30,10
1713331717045,EDS 124BR,A00,490268,Eguchi; Emi,4,0,25,21
1713331717045,EDS 124BR,B00,490269,Eguchi; Emi,23,0,25,2
1713331718071,EDS 126,A01,490271,Jones; Makeba,43,0,50,7
1713331719102,EDS 135,A01,490316,Staff,19,0,20,1
1713331720133,ENVR 142GS,A00,519514,Chang; Edmond Yi-Teh,26,0,28,2
1713331721159,ETHN 103,A00,490504,Staff,25,0,36,11
1713331722185,ETHN 103A,A00,490505,Man; Simeon S,4,0,9,5
1713331723211,ETHN 109,A00,490506,Staff,28,0,30,2
1713331724235,ETHN 118,A00,490507,Staff,35,0,36,1
1713331725259,ETHN 119,A00,490508,Staff,33,0,36,3
1713331726291,ETHN 121R,A00,490518,Choi; Esther Min,21,0,36,15
1713331727319,ETHN 127,A00,490528,Staff,14,0,15,1
1713331728345,ETHN 139,A00,490573,Staff,10,0,10,0
1713331729370,ETHN 150,A00,490575,Staff,15,0,15,0
1713331730396,GLBH 20,A00,491705,Elwardani; Nile Regina,38,0,40,2
1713331731422,GLBH 101,A00,491706,Staff,20,0,20,0
1713331732451,GLBH 111,A01,491708,Burgos; Jose L.,15,0,15,0
1713331733479,GLBH 146,A00,491709,Staff,9,0,20,11
1713331734504,GLBH 148,A00,491710,Olivas Hernandez; Olga Lid,11,0,20,9
1713331735533,GLBH 150,A00,491711,Sloane; Julia Kathryn,19,0,20,1
1713331736559,HIEA 131,A00,491760,Staff,28,0,32,4
1713331737586,HIEA 153,A00,491762,Staff,28,0,30,2
1713331738610,HIEU 124,A00,491811,Staff,26,0,32,6
1713331739640,HIEU 124GS,A00,491812,Markman; Kristina,27,0,28,1
1713331740666,HIEU 147,A00,491813,Staff,30,0,32,2
1713331741692,HIEU 149GS,A00,491816,Caldwell; Michael Alan,28,0,28,0
1713331742721,HILD 2C,A01,491713,Hendrickson; Gerald M.,26,0,30,4
1713331743749,HILD 7B,A01,491715,Kwak; Nancy,0,2,30,30
1713331744776,HILD 10,A01,491717,Staff,11,0,20,9
1713331745802,HILD 30GS,A00,491719,Edington; Claire Ellen,24,0,28,4
1713331746830,HINE 109,A00,491818,Shafir; Nir,27,0,32,5
1713331747855,HINE 128,A00,491821,Shafir; Nir,31,0,32,1
1713331748883,HISC 117,A00,491830,Staff,27,0,32,5
1713331749910,HIUS 103,A00,491834,Man; Simeon S,14,0,23,9
1713331750936,HIUS 108B,A00,491835,Staff,27,0,30,3
1713331751966,HIUS 141,A00,491836,Hendrickson; Gerald M.,28,0,32,4
1713331752991,HIUS 149,A00,491839,Staff,24,0,32,8
1713331754021,HUM 3,A01,512617,Crum; Matthew Stephen,42,0,50,8
1713331754021,HUM 3,A02,512618,Crum; Matthew Stephen,48,0,50,2
1713331755050,HUM 3GS,A00,512663,Markman; Kristina,0,0,0,1
1713331755050,HUM 3GS,B00,512664,Staff,0,0,0,0
1713331756079,HUM 4,A01,512620,West; Geoffrey Scott,25,0,50,25
1713331757107,HUM 4GS,A00,512666,Lyon; Antony J.,0,0,0,5
1713331758133,HUM 4R,A01,512625,Watkins; Eric,49,0,50,1
1713331759160,HUM 5,A01,512649,Zavodny; Tatiana Sophia,23,0,50,27
1713331759160,HUM 5,B01,512661,Zroka; Ryan Edward,48,0,50,2
1713331760186,INTL 190,A00,490577,Segui; Alan S,0,0,0,5
1713331761209,JAPN 20AR,A01,491267,Ross; Kayoko F,7,0,20,13
1713331762235,JAPN 180,A00,491285,Berman; Michael David,33,0,40,7
1713331763263,LATI 50,A01,502536,Kokinis; Troy Andreas,16,0,22,6
1713331763263,LATI 50,A02,502551,Kokinis; Troy Andreas,22,0,22,0
1713331763263,LATI 50,A03,502650,Kokinis; Troy Andreas,22,0,22,0
1713331763263,LATI 50,A04,502909,Kokinis; Troy Andreas,21,0,22,1
1713331764347,LATI 160,A01,502920,Kokinis; Troy Andreas,30,0,30,0
1713331765374,LIFR 1A,A00,490494,Van Moer; Vinciane G,17,0,20,3
1713331766399,LIFR 1AX,A00,490495,Van Moer; Vinciane G,17,0,20,3
1713331767427,LIFR 1B,A00,490496,Van Moer; Vinciane G,17,0,20,3
1713331768453,LIFR 1BX,A00,490497,Van Moer; Vinciane G,17,0,20,3
1713331769477,LIGN 8,A00,505198,McIntosh; Justin Daniel,134,0,150,16
1713331770502,LIGN 9GS,A00,491239,Lott; Margaret S.,18,0,20,2
1713331771527,LIGN 101,A01,505200,McIntosh; Justin Daniel,22,0,30,8
1713331772555,LIGN 120,A01,491244,Staff,22,0,30,8
1713331773585,LIGN 149GS,A00,491245,Lott; Margaret S.,18,0,20,2
1713331774611,LIGN 170,A00,491247,Staff,22,0,30,8
1713331775635,LISP 1D,A00,490498,Munoz Sanchez; Alicia,9,0,14,5
1713331775635,LISP 1D,B00,490499,Munoz Sanchez; Alicia,6,0,14,8
1713331775635,LISP 1D,C00,490500,Munoz Sanchez; Alicia,7,0,14,7
1713331775635,LISP 1D,D00,490501,Munoz Sanchez; Alicia,10,0,14,4
1713331776661,LISP 1DX,A00,490502,Munoz Sanchez; Alicia,14,0,28,14
1713331776661,LISP 1DX,B00,490503,Munoz Sanchez; Alicia,16,0,28,12
1713331778716,LTAM 110,A00,491847,Staff,22,0,25,3
1713331779739,LTCS 119,A00,491848,Staff,11,0,15,4
1713331780769,LTCS 130,A00,491849,Staff,24,0,25,1
1713331782822,LTEA 120C,A00,491852,Staff,32,0,40,8
1713331783848,LTEN 130GS,A00,491853,Lyon; Antony J.,23,0,28,5
1713331784874,LTEN 148,A00,491855,Staff,23,0,25,2
1713331785903,LTEN 159,A00,491856,Staff,20,0,25,5
1713331786932,LTEN 180,A00,491857,Staff,8,0,15,7
1713331788988,LTSP 123GS,A00,505928,Bessett; Ryan Matthew,24,0,28,4
1713331790013,LTSP 174GS,A00,506037,Bessett; Ryan Matthew,24,0,28,4
1713331792064,LTWR 102,A00,491861,Staff,9,0,15,6
1713331793092,LTWR 106,A00,491862,Staff,8,0,15,7
1713331794117,MAE 11,A00,490930,Bahadori; Mohammad Yousef,95,0,100,5
1713331795144,MAE 30A,A00,490931,Qi; Huihui,37,0,40,3
1713331796174,MAE 101A,A00,491036,Sadeghizadeh; Zahra,92,0,100,8
1713331797201,MAE 101C,A00,491037,Seshadri; Kalyanasundaram,66,0,100,34
1713331798301,MAE 113,A00,491040,Seshadri; Kalyanasundaram,65,0,80,15
1713331799328,MAE 131A,A00,491041,Ghazinejad; Maziar,37,0,40,3
1713331800356,MAE 142,A00,491053,Staff,39,0,40,1
1713331801380,MAE 143A,A00,491054,Staff,31,0,50,19
1713331802409,MAE 150,A00,491092,Truong; Phuong Thi Ngoc,24,0,35,11
1713331803434,MATH 3C,A01,494031,Pardo Guerra; Sebastian,30,0,30,0
1713331803434,MATH 3C,A02,494032,Pardo Guerra; Sebastian,29,0,30,1
1713331804461,MATH 10A,A01,494034,Staff,27,0,30,3
1713331804461,MATH 10A,A02,494035,Staff,28,0,30,2
1713331804461,MATH 10A,B01,494037,Staff,27,0,30,3
1713331804461,MATH 10A,B02,494038,Staff,29,0,30,1
1713331805501,MATH 10B,A01,494040,Habib; Yousaf,22,0,30,8
1713331805501,MATH 10B,A02,494041,Habib; Yousaf,28,0,30,2
1713331805501,MATH 10B,A03,494042,Habib; Yousaf,29,0,30,1
1713331805501,MATH 10B,A04,494043,Habib; Yousaf,30,0,30,0
1713331805501,MATH 10B,B01,494045,Habib; Yousaf,25,0,30,5
1713331805501,MATH 10B,B02,494046,Habib; Yousaf,30,0,30,0
1713331805501,MATH 10B,B03,494047,Habib; Yousaf,30,0,30,0
1713331805501,MATH 10B,B04,494048,Habib; Yousaf,30,0,30,0
1713331806534,MATH 18,A01,494050,Kemp; Todd Aahron,25,0,30,5
1713331806534,MATH 18,A02,494051,Kemp; Todd Aahron,29,0,30,1
1713331806534,MATH 18,B01,494054,Kemp; Todd Aahron,26,0,30,4
1713331806534,MATH 18,B02,494055,Kemp; Todd Aahron,29,0,30,1
1713331807560,MATH 20A,A01,494059,Suk; Andrew Hoon,30,0,30,0
1713331808588,MATH 20B,A01,494061,Briones; Jor-el Thomas Caparas,33,0,35,2
1713331808588,MATH 20B,B01,494063,Bach; Quang Tran,34,0,35,1
1713331809623,MATH 20C,A01,494065,Staff,28,0,30,2
1713331809623,MATH 20C,A02,494066,Staff,30,0,30,0
1713331809623,MATH 20C,A03,494067,Staff,30,0,30,0
1713331809623,MATH 20C,A04,494068,Staff,30,0,30,0
1713331809623,MATH 20C,B01,494070,Zhang; Ming,25,0,30,5
1713331809623,MATH 20C,B02,494071,Zhang; Ming,27,0,30,3
1713331809623,MATH 20C,B03,494072,Zhang; Ming,29,0,30,1
1713331809623,MATH 20C,B04,494073,Zhang; Ming,29,0,30,1
1713331810648,MATH 20D,A01,494075,Staff,22,0,30,8
1713331810648,MATH 20D,A02,494076,Staff,29,0,30,1
1713331811675,MATH 20E,A01,494079,Staff,24,0,30,6
1713331811675,MATH 20E,A02,494080,Staff,26,0,30,4
1713331811675,MATH 20E,B01,494082,Staff,25,0,30,5
1713331811675,MATH 20E,B02,494083,Staff,25,0,30,5
1713331812701,MATH 103A,A01,494085,Aliabadi Sr.; Mohsen,13,0,30,17
1713331812701,MATH 103A,A02,494086,Aliabadi Sr.; Mohsen,28,0,30,2
1713331812701,MATH 103A,B01,494088,Aliabadi Sr.; Mohsen,21,0,30,9
1713331812701,MATH 103A,B02,494089,Aliabadi Sr.; Mohsen,27,0,30,3
1713331813727,MATH 109,A01,494091,Staff,30,0,30,0
1713331813727,MATH 109,A02,494092,Staff,29,0,30,1
1713331813727,MATH 109,B01,494094,Staff,27,0,30,3
1713331813727,MATH 109,B02,494095,Staff,29,0,30,1
1713331814755,MATH 142A,A01,494097,Chow; Bennett,15,0,30,15
1713331814755,MATH 142A,A02,494098,Chow; Bennett,23,0,30,7
1713331814755,MATH 142A,B01,494100,Chow; Bennett,19,0,30,11
1713331814755,MATH 142A,B02,494101,Chow; Bennett,29,0,30,1
1713331816809,MATH 168A,A01,516677,Dumitriu; Ioana,16,0,35,19
1713331817837,MATH 170A,A01,516679,Dumitriu; Ioana,18,0,30,12
1713331817837,MATH 170A,A02,516680,Dumitriu; Ioana,28,0,30,2
1713331818864,MATH 193A,A01,494107,Staff,14,0,30,16
1713331818864,MATH 193A,A02,494108,Staff,19,0,30,11
1713331818864,MATH 193A,A03,494109,Staff,29,0,30,1
1713331818864,MATH 193A,A04,494110,Staff,22,0,30,8
1713331821941,MGT 16,A00,491930,McKay; Michael J,92,0,98,6
1713331822967,MGT 18,A00,491992,McKay; Michael J,96,0,98,2
1713331823993,MGT 71,A00,492003,Staff,65,0,98,33
1713331825019,MGT 103,A00,505209,Eberhard; Craig A,81,0,98,17
1713331826045,MGT 131A,A00,505210,Anderson; John Charles,89,0,98,9
1713331828102,MGT 153,A00,492077,Perols; Johan Lars,19,0,90,71
1713331831178,MGT 164,A00,492222,McKay; Mary A,91,0,98,7
1713331832208,MGT 172,A00,492245,Staff,59,0,60,1
1713331832208,MGT 172,B00,505526,Hedges; Kathleen,65,0,98,33
1713331833234,MGT 181,A00,505669,Dunn; Louis Jean,81,0,98,17
1713331834266,MMW 14,A01,494399,Staff,15,0,28,13
1713331834266,MMW 14,A02,494400,Staff,25,0,28,3
1713331834266,MMW 14,A03,494401,Staff,28,0,28,0
1713331834266,MMW 14,A04,494402,Staff,28,0,28,0
1713331834266,MMW 14,B01,494404,Carreras; Maria Victoria,8,0,28,20
1713331834266,MMW 14,B02,494405,Carreras; Maria Victoria,25,0,28,3
1713331834266,MMW 14,B03,494406,Carreras; Maria Victoria,27,0,28,1
1713331834266,MMW 14,B04,494407,Carreras; Maria Victoria,28,0,28,0
1713331835291,MMW 14GS,A00,506250,Chang; Edmond Yi-Teh,0,0,0,0
1713331836317,MMW 121R,A01,494415,Adamiak; Patrick John,10,0,28,18
1713331836317,MMW 121R,A02,494416,Adamiak; Patrick John,24,0,28,4
1713331837351,MUS 1A,A01,494113,Staff,12,0,25,13
1713331837351,MUS 1A,A02,494114,Staff,24,0,25,1
1713331838378,MUS 4,A01,494116,Staff,23,0,25,2
1713331838378,MUS 4,A02,494117,Staff,22,0,25,3
1713331839404,MUS 5R,A01,494236,Dubnov; Shlomo,6,0,25,19
1713331839404,MUS 5R,A02,494237,Dubnov; Shlomo,25,0,25,0
1713331840429,MUS 6,A01,494122,Staff,10,0,25,15
1713331840429,MUS 6,A02,494123,Staff,23,0,25,2
1713331841459,MUS 7,A01,494125,Staff,16,0,25,9
1713331841459,MUS 7,A02,494126,Staff,24,0,25,1
1713331842486,MUS 11,A01,494128,Staff,23,0,25,2
1713331842486,MUS 11,A02,494129,Staff,24,0,25,1
1713331843510,MUS 13,A01,494131,Staff,25,0,25,0
1713331843510,MUS 13,A02,494132,Staff,25,0,25,0
1713331844547,MUS 15,A01,494134,Staff,16,0,25,9
1713331844547,MUS 15,A02,494135,Staff,25,0,25,0
1713331844547,MUS 15,B01,494137,Staff,24,0,25,1
1713331845577,MUS 80,A00,494232,Staff,24,0,25,1
1713331845577,MUS 80,B00,494233,Staff,25,0,25,0
1713331845577,MUS 80,C00,494234,Staff,23,0,25,2
1713331846605,MUS 95C,A00,494141,Staff,70,0,75,5
1713331847634,MUS 114,A00,494142,Staff,40,0,50,10
1713331848659,NANO 15,A01,490636,Drews; Aaron,7,0,7,0
1713331849686,PHIL 1,A00,490578,Grush; Rick Scott,49,0,50,1
1713331850713,PHIL 10,A01,490580,Grush; Rick Scott,33,0,35,2
1713331850713,PHIL 10,A02,490586,Grush; Rick Scott,32,0,35,3
1713331851737,PHIL 27,A01,490591,Staff,22,0,25,3
1713331851737,PHIL 27,A02,490592,Staff,25,0,25,0
1713331851737,PHIL 27,A03,490593,Staff,25,0,25,0
1713331851737,PHIL 27,A04,490598,Staff,25,0,25,0
1713331852763,PHIL 32,A01,490611,Staff,20,0,20,0
1713331852763,PHIL 32,A02,490618,Staff,20,0,20,0
1713331853788,PHIL 90,A00,490624,Staff,40,0,40,0
1713331854817,PHIL 136,A00,490627,Cohen; Jonathan David,37,0,40,3
1713331855842,PHIL 155,A00,490634,Staff,62,0,70,8
1713331856870,PHYS 1A,A00,491610,Staff,245,0,250,5
1713331857899,PHYS 1AL,001,491616,Tsai; Philbert S,27,0,30,3
1713331857899,PHYS 1AL,002,491618,Tsai; Philbert S,30,0,30,0
1713331858928,PHYS 1B,A00,491623,Staff,236,0,250,14
1713331859952,PHYS 1BL,001,491626,Tsai; Philbert S,22,0,30,8
1713331859952,PHYS 1BL,002,491628,Tsai; Philbert S,26,0,30,4
1713331860981,PHYS 1C,A00,491632,Staff,213,0,245,32
1713331862007,PHYS 1CL,001,491635,Tsai; Philbert S,2,0,30,28
1713331862007,PHYS 1CL,002,491643,Tsai; Philbert S,22,0,30,8
1713331863039,PHYS 2AR,A01,491651,Meyertholen; Andrew D.,44,0,50,6
1713331864067,PHYS 2B,A01,491659,Staff,106,0,115,9
1713331865099,PHYS 2BL,A01,491685,Staff,21,0,24,3
1713331865099,PHYS 2BL,A02,491700,Staff,21,0,24,3
1713331866128,PHYS 2C,A01,505161,Staff,101,0,115,14
1713331867161,PHYS 4A,A01,491704,Grinstein; Benjamin,99,0,100,1
1713331868260,POLI 5D,A01,494144,Staff,3,0,5,2
1713331868260,POLI 5D,B01,626283,Dai; Yinlin,5,0,5,0
1713331869291,POLI 12,A00,494145,Staff,43,0,45,2
1713331870316,POLI 13R,A00,494146,Forman; Fonna,45,0,50,5
1713331871345,POLI 27,A01,494148,Staff,54,0,60,6
1713331872375,POLI 30,A00,494149,Staff,49,0,50,1
1713331873404,POLI 100DA,A00,494150,Staff,21,0,25,4
1713331875459,POLI 100I,A00,494152,Staff,27,0,30,3
1713331876485,POLI 104B,A00,494153,Smith; Glenn Chatmas,53,0,55,2
1713331877510,POLI 104F,A00,494154,Staff,28,0,30,2
1713331878535,POLI 104I,A00,494155,Smith; Glenn Chatmas,29,0,30,1
1713331879562,POLI 110C,A00,494156,Ingham; Sean,23,0,25,2
1713331880588,POLI 117R,A00,494157,Forman; Fonna,6,0,20,14
1713331881617,POLI 118,A00,494158,Ingham; Sean,21,0,25,4
1713331882643,POLI 120H,A00,494159,Fisk; David Lee,39,0,45,6
1713331883668,POLI 131CR,A00,494160,Hoston; Germaine,35,0,45,10
1713331884693,POLI 133J,A00,494161,Staff,32,0,35,3
1713331885718,POLI 135,A00,494162,Fisk; David Lee,33,0,35,2
1713331886746,POLI 140A,A00,494164,Staff,19,0,30,11
1713331887771,POLI 142I,A00,494165,Staff,30,0,30,0
1713331888796,POLI 144D,A00,494166,Staff,23,0,25,2
1713331889821,POLI 151,A00,494167,Staff,30,0,30,0
1713331890843,POLI 153,A00,494168,Staff,33,0,35,2
1713331891869,POLI 160AA,A00,494169,Staff,34,0,40,6
1713331892895,POLI 162,A00,494170,Mignozzetti; Umberto,18,0,25,7
1713331893919,POLI 171,A00,494171,Mignozzetti; Umberto,18,0,25,7
1713331894945,PSYC 1,A00,494172,Staff,95,0,100,5
1713331895970,PSYC 2,A00,494173,Moranton; Nirelia Melbina-,34,0,50,16
1713331897001,PSYC 3,A00,494174,Staff,29,0,30,1
1713331898030,PSYC 6,A00,494175,Staff,17,0,20,3
1713331899058,PSYC 60,A01,494177,Staff,38,0,45,7
1713331900084,PSYC 70,A01,505724,Geller; Emma Harlan,42,0,45,3
1713331901111,PSYC 101,A00,494180,Heyman; Gail D.,84,0,100,16
1713331902137,PSYC 105,A00,494181,Geller; Emma Harlan,51,0,90,39
1713331903167,PSYC 106,A00,494182,Dobkins; Karen R.,27,0,45,18
1713331904193,PSYC 108,A00,494183,Adrian; Julia Anna,89,0,100,11
1713331905222,PSYC 114,A01,494185,Winkielman; Piotr,0,3,30,30
1713331906247,PSYC 122,A00,494186,Moranton; Nirelia Melbina-,28,0,50,22
1713331907275,PSYC 124,A00,494187,Chapman; Eddie Nathaniel,70,0,80,10
1713331908302,PSYC 131,A00,494188,Anagnostaras; Stephan,41,0,80,39
1713331909329,PSYC 144,A00,494189,Staff,3,0,50,47
1713331910354,PSYC 154,A00,494190,Lacefield; Katharine I,107,0,180,73
1713331911379,PSYC 162,A00,494191,Wixted; John T,71,0,100,29
1713331912406,PSYC 172,A00,494192,Gorman; Michael R.,36,0,45,9
1713331913433,PSYC 178,A00,494193,Glaser; Dale,34,0,45,11
1713331914460,PSYC 193,A00,505725,Chapman; Eddie Nathaniel,20,0,20,0
1713331915484,RELI 145GS,A00,519817,Rahimi; Babak,18,0,20,2
1713331916509,SE 101A,A01,490862,Chadha; Mayank,23,0,25,2
1713331917535,SE 101C,A01,490924,Krysl; Petr,15,0,20,5
1713331918564,SE 110A,A01,490928,Staff,19,0,20,1
1713331919594,SE 130A,A00,490929,Morrison; Machel Leigh,55,0,70,15
1713331920625,SIO 1,A01,519325,Staff,39,0,40,1
1713331921653,SIO 30,A01,519327,Staff,38,0,40,2
1713331922681,SIO 40,A00,519328,Staff,39,0,40,1
1713331923709,SIO 46GS,A00,519819,Cook; Geoffrey W,17,0,25,8
1713331924738,SIO 109R,A00,494197,Forman; Fonna,0,3,20,20
1713331925766,SIO 121GS,A00,519827,Cook; Geoffrey W,17,0,25,8
1713331926797,SIO 132,A01,519330,Staff,38,0,40,2
1713331927825,SIO 133,A01,519397,Staff,37,0,40,3
1713331928853,SIO 139,A00,519396,Kacev; David,29,0,40,11
1713331929884,SOCI 1,A01,494199,Thorpe; Charles Robert,21,0,30,9
1713331929884,SOCI 1,A02,494200,Thorpe; Charles Robert,30,0,30,0
1713331929884,SOCI 1,A03,494201,Thorpe; Charles Robert,29,0,30,1
1713331929884,SOCI 1,A04,494202,Thorpe; Charles Robert,29,0,30,1
1713331929884,SOCI 1,A05,494203,Thorpe; Charles Robert,29,0,30,1
1713331929884,SOCI 1,A06,494204,Thorpe; Charles Robert,30,0,30,0
1713331929884,SOCI 1,A07,494205,Thorpe; Charles Robert,28,0,30,2
1713331930914,SOCI 60,A01,494207,Staff,34,0,40,6
1713331930914,SOCI 60,A02,494208,Staff,39,0,40,1
1713331931938,SOCI 100,A01,494210,Payne; Christine Anna,25,0,30,5
1713331931938,SOCI 100,A02,494211,Payne; Christine Anna,26,0,30,4
1713331932965,SOCI 109M,A00,494212,Staff,20,0,20,0
1713331933990,SOCI 110,A00,494213,Staff,34,0,40,6
1713331936043,SOCI 118E,A00,494215,Ng; Kwai,37,0,40,3
1713331937069,SOCI 125,A00,494216,Calderon-Zaks; Michael Aar,40,0,45,5
1713331938098,SOCI 126,A01,494218,Jones; Makeba,3,0,5,2
1713331939127,SOCI 131,A00,494219,Thorpe; Charles Robert,26,0,30,4
1713331941176,SOCI 135,A00,494221,Payne; Christine Anna,28,0,50,22
1713331942207,SOCI 136E,A00,626690,Ruiz; Jonathan Joseph,24,0,25,1
1713331943233,SOCI 138GS,A00,494222,Navon; Daniel,24,0,28,4
1713331945283,SOCI 145,A00,494224,Staff,40,0,45,5
1713331946311,SOCI 153,A00,494225,Staff,28,0,30,2
1713331947336,SOCI 160E,A00,494226,Ng; Kwai,29,0,40,11
1713331948362,SOCI 180,A00,494227,Staff,29,0,30,1
1713331949387,SOCI 189GS,A00,494228,Ribas Norris; Janet Vanesa,11,0,11,0
1713331950412,SOCI 190GS,A00,553232,Ribas Norris; Janet Vanesa,11,0,11,0
1713331951442,SOMI 220,A00,627178,Schneid; Stephen David,30,0,30,0
1713331952469,SYN 2,001,490768,Staff,13,0,15,2
1713331952469,SYN 2,002,490769,Staff,14,0,15,1
1713331952469,SYN 2,004,490775,Staff,0,0,0,0
1713331952469,SYN 2,003,490774,Staff,0,0,0,0
1713331952469,SYN 2,005,490776,Staff,0,0,0,0
1713331953494,SYN 2R,001,490779,Staff,11,0,15,4
1713331953494,SYN 2R,002,514635,Staff,14,0,15,1
1713331954526,SYN 100,A01,490783,Staff,9,0,20,11
1713331954526,SYN 100,B01,490787,Staff,9,0,20,11
1713331954526,SYN 100,C01,490789,Staff,10,0,20,10
1713331955554,SYN 150,A00,490817,Staff,14,0,15,1
1713331955554,SYN 150,B00,514610,Staff,15,0,15,0
1713331956583,TDAC 1,A00,492753,Walsh; Kim C.,19,0,20,1
1713331956583,TDAC 1,B00,492754,Harting; Carla Kelso,19,0,20,1
1713331956583,TDAC 1,C00,513995,Salovey; Todd,15,0,20,5
1713331957611,TDAC 101,A00,492766,Harting; Carla Kelso,17,0,20,3
1713331958638,TDAC 102,A00,492768,Basso; Beatrice,19,0,20,1
1713331959662,TDDE 111,A00,492769,Staff,25,0,25,0
1713331960800,TDDE 131,A00,492770,Staff,15,0,15,0
1713331960800,TDDE 131,B00,492771,Staff,15,0,15,0
1713331961826,TDDE 131GS,A00,523716,Guirguis; Mark C,23,0,28,5
1713331962854,TDGE 1,A01,492756,Salovey; Todd,56,0,60,4
1713331963891,TDGE 5,A01,492758,Staff,23,0,25,2
1713331964918,TDGE 10,A00,492759,Fulton; Julia,203,0,220,17
1713331965943,TDGE 11,A00,492760,Castro; Robert Jess,198,0,200,2
1713331967998,TDGE 124,A00,492772,Fulton; Julia,184,0,220,36
1713331969027,TDGE 125,A00,492773,Meyer; Ursula,38,0,50,12
1713331969027,TDGE 125,B00,492774,Staff,49,0,50,1
1713331969027,TDGE 125,C00,523565,Staff,48,0,50,2
1713331970053,TDGE 125GS,A00,523580,Guirguis; Mark C,23,0,28,5
1713331971083,TDGE 127,A00,492775,Havis; Allan,33,0,50,17
1713331972161,TDHT 101,A00,492776,Staff,34,0,35,1
1713331973188,TDMV 1,A00,492762,Caligagan; Maria T.,30,0,30,0
1713331973188,TDMV 1,B00,492763,Arcidiacono; Kristin,26,0,30,4
1713331974213,TDMV 2,A00,492764,Weinberg; Sadie,28,0,30,2
1713331975241,TDMV 3,A00,492765,Mack; Kara Shanai',37,0,40,3
1713331976267,TDMV 138,A00,492777,Mack; Kara Shanai',34,0,40,6
1713331977291,TDMV 140,A00,492778,Lima; Paulo Henrique,40,0,40,0
1713331978318,TDMV 142,A00,492779,Caligagan; Maria T.,33,0,40,7
1713331978318,TDMV 142,B00,492780,Caligagan; Tony,37,0,40,3
1713331979347,TDMV 143,A00,492781,Fyall; Daunte Edward,39,0,40,1
1713331980377,USP 1,A01,492401,Kwak; Nancy,27,0,35,8
1713331981402,USP 2,A01,492453,Hinds; Juli Beth,35,0,35,0
1713331982427,USP 3,A01,492516,Staff,28,0,35,7
1713331983459,USP 4,A00,492522,McTague; Sarah,16,0,25,9
1713331984484,USP 100,A00,492523,Staff,32,0,35,3
1713331985512,USP 101,A00,492524,Staff,13,0,15,2
1713331986541,USP 105,A00,492525,Staff,21,0,25,4
1713331987569,USP 151,A00,492526,Shenkman; Michael Thomas,32,0,35,3
1713331988597,USP 170,A00,492545,Hinds; Juli Beth,33,0,35,2
1713331989626,USP 171GS,A00,492608,Bussell; Mirle Rabinowitz,24,0,28,4
1713331990652,USP 183GS,A00,492613,Peerson; Susan,24,0,28,4
1713331991679,VIS 30,A01,490693,Yoldas; Pinar,19,0,22,3
1713331991679,VIS 30,A02,490694,Yoldas; Pinar,18,0,22,4
1713331992708,VIS 83,A00,490695,Kester; Grant,63,0,75,12
1713331993733,VIS 105D,A00,490696,Staff,22,0,25,3
1713331994763,VIS 124CN,A00,490699,Rose; Jordan M,65,0,75,10
1713331995790,VIS 125GS,A00,511221,Williams; Alena J,21,0,22,1
1713331996819,VIS 128D,A00,490700,Staff,73,0,75,2
1713331997843,VIS 151,A01,490717,Staff,33,0,34,1
1713331997843,VIS 151,A02,490766,Staff,33,0,34,1
1713331998872,VIS 154GS,A00,511972,Williams; Alena J,21,0,22,1
1713331999897,VIS 160A,A00,490767,Stone; Patricia,7,0,10,3
1713332000923,WCWP 10A,A00,490638,Staff,14,0,15,1
1713332000923,WCWP 10A,B00,490640,Staff,15,0,15,0
1713332001954,WCWP 10B,A00,490641,Staff,0,0,0,0
1713332001954,WCWP 10B,B00,490642,Staff,14,0,15,1
1713332001954,WCWP 10B,C00,490644,Staff,13,0,15,2
1713332001954,WCWP 10B,D00,490647,Staff,0,0,0,0
1713332002981,WCWP 100,A00,490655,Staff,0,0,0,0
1713332002981,WCWP 100,B00,490687,Staff,10,0,15,5
1713332005078,ANAR 153,A00,487222,Braswell; Geoffrey E.,53,0,60,7
1713332006103,ANBI 134,A00,487223,Staff,5,0,20,15
1713332007128,ANBI 143GS,A00,487224,Noel; Geoffroy Pierre Jean,18,0,24,6
1713332008152,ANBI 144GS,A00,519548,Noel; Geoffroy Pierre Jean,18,0,24,6
1713332009179,ANSC 101,A00,487225,Staff,18,0,20,2
1713332010205,ANSC 125,A00,487227,Brenner; Suzanne A,39,0,40,1
1713332012258,ANSC 146,A00,487229,Staff,35,0,40,5
1713332013286,ANSC 148,A00,487230,Olivas Hernandez; Olga Lid,39,0,40,1
1713332014311,ANSC 150,A00,504165,Sloane; Julia Kathryn,18,0,20,2
1713332015336,ANSC 180,A00,487232,Staff,14,0,15,1
1713332016359,ANSC 188,A00,627155,Staff,38,0,40,2
1713332017386,ANTH 5,A00,519529,Semendeferi; Ekaterini,15,0,15,0
1713332018410,ANTH 10,A00,487219,Staff,58,0,60,2
1713332019439,ANTH 23,A01,487221,Staff,17,0,20,3
1713332020466,ANTH 102,A00,487233,Wilder; Linnea Lorene,51,0,60,9
1713332021496,ANTH 103,A00,487234,Varma; Saiba,55,0,60,5
1713332022522,ANTH 105,A00,487235,Stewart; Alexander B,54,0,60,6
1713332023548,BENG 100,A01,516685,Taylor Amos; Alyssa C,26,0,30,4
1713332024573,BIBC 102,A01,491316,Flagg; Matthew Paul,10,0,88,78
1713332024573,BIBC 102,A02,491366,Flagg; Matthew Paul,78,0,88,10
1713332025597,BIBC 103,A01,491486,Boumechache; Miyyada,16,0,24,8
1713332025597,BIBC 103,A02,491487,Boumechache; Miyyada,24,0,24,0
1713332026627,BICD 100,A01,516882,Staff,73,0,75,2
1713332026627,BICD 100,A02,516890,Staff,69,0,75,6
1713332027651,BICD 102GS,A00,491488,Lo; Stanley M.,26,0,28,2
1713332028675,BIEB 136GS,A00,516940,Holway; David A. & Shurin; Jonathan,18,0,24,6
1713332029702,BIEB 137GS,A01,517034,Holway; David A. & Shurin; Jonathan,18,0,24,6
1713332030727,BIEB 138GS,A01,491492,Pirino; Giorgia,21,0,28,7
1713332031753,BILD 1,A01,491296,Staff,60,0,63,3
1713332031753,BILD 1,A02,491297,Staff,63,0,63,0
1713332032781,BILD 4,A01,517099,Gonzalez Gamboa; Ivonne,22,0,24,2
1713332032781,BILD 4,A02,517100,Gonzalez Gamboa; Ivonne,24,0,24,0
1713332033806,BILD 60GS,A00,491309,Lo; Stanley M.,26,0,28,2
1713332034834,BIMM 100,A01,517136,Staff,83,0,100,17
1713332035865,BIMM 110,A01,517182,Staff,54,0,100,46
1713332036902,BIMM 120,A01,517228,Pickett; Brooke Elizabeth,28,0,63,35
1713332036902,BIMM 120,A02,517240,Pickett; Brooke Elizabeth,44,0,63,19
1713332037932,BIMM 132GS,A01,491498,Pirino; Giorgia,21,0,28,7
1713332038958,BIMM 143,A01,491589,Bozinovic; Goran,13,0,40,27
1713332039984,BIPN 100,A01,491594,Armour; Jon Christopher,83,0,100,17
1713332041012,BIPN 140,A01,491602,Marino; Marc J,25,0,50,25
1713332043072,CAT 125,A00,515973,Staff,18,0,20,2
1713332044097,CAT 125GS,A00,515974,Rahimi; Babak,17,0,20,3
1713332045127,CAT 125R,A00,515980,Staff,12,0,20,8
1713332045127,CAT 125R,B00,515981,Tosun; Adriana,19,0,20,1
1713332045127,CAT 125R,C00,515987,Hyland; Tina Mae,0,3,20,20
1713332045127,CAT 125R,D00,515988,Bronstein; Phoebe Malan,16,0,20,4
1713332046158,CENG 15,A01,488699,Drews; Aaron,25,0,25,0
1713332047191,CENG 100,A00,505196,Opatkiewicz; Justin Paul,25,0,25,0
1713332048229,CGS 2A,A01,489598,Staff,33,0,35,2
1713332049257,CGS 112,A00,489599,Staff,15,0,15,0
1713332050284,CGS 119,A00,489603,Staff,10,0,10,0
1713332051309,CGS 120,A00,489604,Staff,14,0,15,1
1713332052335,CGS 150,A00,489607,Staff,15,0,15,0
1713332053360,CHEM 6A,A01,488715,Staff,97,0,100,3
1713332054386,CHEM 6B,A01,488719,Piercy; Marc Anthony,99,0,100,1
1713332055412,CHEM 6C,A01,488723,Albizati; Kim F.,93,0,100,7
1713332056447,CHEM 7L,A01,488728,Schurmeier; Kimberly,18,0,24,6
1713332056447,CHEM 7L,A02,488730,Schurmeier; Kimberly,23,0,24,1
1713332056447,CHEM 7L,A03,488734,Schurmeier; Kimberly,20,0,24,4
1713332056447,CHEM 7L,A04,488763,Schurmeier; Kimberly,23,0,24,1
1713332056447,CHEM 7L,B01,488798,Schurmeier; Kimberly,17,0,24,7
1713332056447,CHEM 7L,B02,488801,Schurmeier; Kimberly,22,0,24,2
1713332056447,CHEM 7L,B03,488808,Schurmeier; Kimberly,22,0,24,2
1713332056447,CHEM 7L,B04,488811,Schurmeier; Kimberly,24,0,24,0
1713332057475,CHEM 11,A01,488897,Stallings; Dontarie M,95,0,100,5
1713332058499,CHEM 40A,A01,488913,Albizati; Kim F.,83,0,100,17
1713332059529,CHEM 40B,A01,488920,Weizman; Haim,43,0,50,7
1713332059529,CHEM 40B,A02,488938,Weizman; Haim,44,0,50,6
1713332060556,CHEM 41A,A01,489029,Klosterman; Jeremy K,57,0,60,3
1713332061585,CHEM 41C,A01,500436,Tor; Yitzhak,55,0,60,5
1713332062617,CHEM 43A,A01,500426,Weizman; Haim,0,0,24,24
1713332062617,CHEM 43A,A02,500430,Weizman; Haim,7,0,24,17
1713332062617,CHEM 43A,B01,514041,Klosterman; Jeremy K,16,0,24,8
1713332062617,CHEM 43A,B02,514047,Klosterman; Jeremy K,23,0,24,1
1713332063647,CHEM 108,A01,489140,Jennings; Patricia A.,9,0,24,15
1713332063647,CHEM 108,A02,489142,Jennings; Patricia A.,14,0,24,10
1713332064672,CHEM 114A,A01,489147,Stallings; Dontarie M,68,0,100,32
1713332065702,CHIN 169A,A00,489171,Wang; Xiao,19,0,20,1
1713332067752,COGS 3,A01,518827,Boyle; Mary E. T.,25,0,40,15
1713332068778,COGS 11,A01,489175,Staff,27,0,30,3
1713332069803,COGS 14A,A01,518829,Staff,51,0,60,9
1713332070833,COGS 14B,A01,489177,Hoffman; Drew Ellen,62,0,75,13
1713332071859,COGS 100,A01,489181,Allen; Michael Gordon,62,0,75,13
1713332072884,COGS 101A,A01,489183,Staff,46,0,60,14
1713332073909,COGS 101B,A01,489185,Allen; Michael Gordon,8,0,30,22
1713332074938,COGS 101C,A01,526786,Staff,23,0,30,7
1713332077040,COGS 107A,A01,489189,Boyle; Mary E. T.,17,0,35,18
1713332078066,COGS 107B,A01,627144,Mooshagian; Eric Frederick,60,0,60,0
1713332079091,COGS 118A,A01,489191,Staff,0,45,40,40
1713332081146,COGS 171GS,A01,489194,Pineda; Jaime A,19,0,28,9
1713332082172,COGS 172,A01,489196,Staff,2,0,30,28
1713332083199,COGS 174GS,A01,489264,Pineda; Jaime A,19,0,28,9
1713332084224,COGS 180,A01,627150,Staff,28,0,30,2
1713332085249,COGS 186,A01,489274,Staff,0,1,30,30
1713332086278,COMM 10,A01,489276,Staff,23,0,25,2
1713332086278,COMM 10,A02,489303,Staff,23,0,25,2
1713332087306,COMM 100A,A01,489312,Staff,14,0,25,11
1713332087306,COMM 100A,A02,489313,Staff,24,0,25,1
1713332088334,COMM 106T,A00,512540,Staff,33,0,35,2
1713332089360,COMM 107,A00,489347,Staff,27,0,35,8
1713332090387,COMM 109P,A00,489358,Staff,31,0,35,4
1713332091413,COMM 132,A00,489361,McKenna; Denise,27,0,30,3
1713332092441,COMM 146,A00,489362,Halm; Gavin Patrick,26,0,30,4
1713332093468,COMM 190,A00,489363,Abuelhiga; Soraya Jill,17,0,23,6
1713332094498,CSE 8A,A50,489366,Staff,21,0,25,4
1713332094498,CSE 8A,A51,489367,Staff,24,0,25,1
1713332095526,CSE 11,A01,489398,Cao; Yingjun,73,0,100,27
1713332096552,CSE 12,A01,489487,Staff,43,0,50,7
1713332097577,CSE 20,A01,489497,Staff,48,0,50,2
1713332098606,CSE 21,A01,489517,Braun; Oliver,42,0,50,8
1713332099631,CSE 101,A01,489524,Braun; Oliver,0,32,50,50
1713332100675,CSE 105,A01,512594,Jones; Miles E,72,0,100,28
1713332100675,CSE 105,B01,512598,Jones; Miles E,52,0,100,48
1713332101701,CSE 140,A01,489538,Staff,41,0,50,9
1713332102726,CSE 141,A01,489550,Eldon; John,67,0,100,33
1713332103752,CSE 141L,A01,489571,Eldon; John,65,0,100,35
1713332104782,CSE 151A,A01,489583,Solares; Edwin A,141,0,200,59
1713332105807,CSE 175,A01,510886,Kumar; Rakesh,30,0,30,0
1713332106833,CSE 190,A00,516828,Dubnov; Shlomo,38,0,49,11
1713332107862,DOC 100D,A00,489667,Pass; Natalye Joann,19,0,25,6
1713332108887,DSC 10,A01,624268,Staff,72,0,75,3
1713332109915,DSC 20,A01,624476,Staff,50,0,50,0
1713332110942,DSC 40A,A01,624608,Staff,39,0,40,1
1713332111972,DSGN 1,A01,489179,Rill; Bryan,32,0,50,18
1713332112998,ECE 17,A01,490489,Sahay; Rajeev,18,0,30,12
1713332114023,ECE 65,A50,490492,Staff,11,0,20,9
1713332114023,ECE 65,A51,490493,Staff,18,0,20,2
1713332115050,ECON 1,A01,489715,Famulari; Melissa,67,0,70,3
1713332116074,ECON 2,A01,489717,Levkoff; Steven B.,68,0,70,2
1713332117100,ECON 3,A01,489948,Staff,70,0,70,0
1713332119155,ECON 5,A01,490103,Staff,27,0,30,3
1713332119155,ECON 5,B01,626281,Dai; Yinlin,45,0,45,0
1713332120181,ECON 100A,A01,490127,Famulari; Melissa,65,0,70,5
1713332121211,ECON 100B,A01,490129,Staff,64,0,70,6
1713332122238,ECON 109,A01,490187,Shishkin; Denis,27,0,35,8
1713332123267,ECON 110A,A01,490190,Levkoff; Steven B.,60,0,70,10
1713332124291,ECON 120A,A01,490245,Dai; Yinlin,61,0,70,9
1713332125317,ECON 120B,A01,490247,Nieto-Barthaburu; Augusto,40,0,70,30
1713332126344,ECON 120C,A01,490253,Sun; Yixiao,30,0,35,5
1713332126344,ECON 120C,B01,490255,Sun; Yixiao,34,0,35,1
1713332127375,ECON 129,A00,490256,Eckert; Fabian Paul,23,0,35,12
1713332128404,ECON 131,A00,490257,Nieto-Barthaburu; Augusto,0,6,35,35
1713332129437,ECON 138,A00,490258,Bharadwaj; Prashant,13,0,35,22
1713332129437,ECON 138,B00,490259,Bharadwaj; Prashant,15,0,35,20
1713332130467,ECON 159,A00,490260,Hendrickson; Gerald M.,0,9,0,0
1713332131497,ECON 178,A01,553995,Zhu; Ying,24,0,35,11
1713332132524,EDS 40,A01,512576,Black; Alison Michelle,20,0,20,0
1713332133549,EDS 107,A01,515848,Staff,30,0,30,0
1713332134573,EDS 110R,A01,490262,Staff,26,0,30,4
1713332135599,EDS 112,A01,490264,Chapman; Thandeka K,40,0,50,10
1713332136623,EDS 113,A00,490266,Staff,26,0,30,4
1713332137651,EDS 118,A00,490267,Warstadt; Melissa Fawn,20,0,30,10
1713332138680,EDS 124BR,A00,490268,Eguchi; Emi,4,0,25,21
1713332138680,EDS 124BR,B00,490269,Eguchi; Emi,23,0,25,2
1713332139705,EDS 126,A01,490271,Jones; Makeba,43,0,50,7
1713332140729,EDS 135,A01,490316,Staff,19,0,20,1
1713332141754,ENVR 142GS,A00,519514,Chang; Edmond Yi-Teh,26,0,28,2
1713332142781,ETHN 103,A00,490504,Staff,25,0,36,11
1713332143809,ETHN 103A,A00,490505,Man; Simeon S,4,0,9,5
1713332144835,ETHN 109,A00,490506,Staff,28,0,30,2
1713332145863,ETHN 118,A00,490507,Staff,35,0,36,1
1713332146892,ETHN 119,A00,490508,Staff,33,0,36,3
1713332147918,ETHN 121R,A00,490518,Choi; Esther Min,21,0,36,15
1713332148948,ETHN 127,A00,490528,Staff,14,0,15,1
1713332149974,ETHN 139,A00,490573,Staff,10,0,10,0
1713332150999,ETHN 150,A00,490575,Staff,15,0,15,0
1713332152027,GLBH 20,A00,491705,Elwardani; Nile Regina,38,0,40,2
1713332153055,GLBH 101,A00,491706,Staff,20,0,20,0
1713332154082,GLBH 111,A01,491708,Burgos; Jose L.,15,0,15,0
1713332155106,GLBH 146,A00,491709,Staff,9,0,20,11
1713332156135,GLBH 148,A00,491710,Olivas Hernandez; Olga Lid,11,0,20,9
1713332157162,GLBH 150,A00,491711,Sloane; Julia Kathryn,19,0,20,1
1713332158187,HIEA 131,A00,491760,Staff,28,0,32,4
1713332159215,HIEA 153,A00,491762,Staff,28,0,30,2
1713332160244,HIEU 124,A00,491811,Staff,26,0,32,6
1713332161268,HIEU 124GS,A00,491812,Markman; Kristina,27,0,28,1
1713332162294,HIEU 147,A00,491813,Staff,30,0,32,2
1713332163320,HIEU 149GS,A00,491816,Caldwell; Michael Alan,28,0,28,0
1713332164345,HILD 2C,A01,491713,Hendrickson; Gerald M.,26,0,30,4
1713332165370,HILD 7B,A01,491715,Kwak; Nancy,0,2,30,30
1713332166393,HILD 10,A01,491717,Staff,11,0,20,9
1713332167425,HILD 30GS,A00,491719,Edington; Claire Ellen,24,0,28,4
1713332168451,HINE 109,A00,491818,Shafir; Nir,27,0,32,5
1713332169473,HINE 128,A00,491821,Shafir; Nir,31,0,32,1
1713332170499,HISC 117,A00,491830,Staff,27,0,32,5
1713332171531,HIUS 103,A00,491834,Man; Simeon S,14,0,23,9
1713332172557,HIUS 108B,A00,491835,Staff,27,0,30,3
1713332173582,HIUS 141,A00,491836,Hendrickson; Gerald M.,28,0,32,4
1713332174608,HIUS 149,A00,491839,Staff,24,0,32,8
1713332175639,HUM 3,A01,512617,Crum; Matthew Stephen,42,0,50,8
1713332175639,HUM 3,A02,512618,Crum; Matthew Stephen,48,0,50,2
1713332176662,HUM 3GS,A00,512663,Markman; Kristina,0,0,0,1
1713332176662,HUM 3GS,B00,512664,Staff,0,0,0,0
1713332177693,HUM 4,A01,512620,West; Geoffrey Scott,25,0,50,25
1713332178717,HUM 4GS,A00,512666,Lyon; Antony J.,0,0,0,5
1713332179801,HUM 4R,A01,512625,Watkins; Eric,49,0,50,1
1713332180827,HUM 5,A01,512649,Zavodny; Tatiana Sophia,23,0,50,27
1713332180827,HUM 5,B01,512661,Zroka; Ryan Edward,48,0,50,2
1713332181855,INTL 190,A00,490577,Segui; Alan S,0,0,0,5
1713332182884,JAPN 20AR,A01,491267,Ross; Kayoko F,7,0,20,13
1713332183916,JAPN 180,A00,491285,Berman; Michael David,33,0,40,7
1713332184946,LATI 50,A01,502536,Kokinis; Troy Andreas,16,0,22,6
1713332184946,LATI 50,A02,502551,Kokinis; Troy Andreas,22,0,22,0
1713332184946,LATI 50,A03,502650,Kokinis; Troy Andreas,22,0,22,0
1713332184946,LATI 50,A04,502909,Kokinis; Troy Andreas,21,0,22,1
1713332185975,LATI 160,A01,502920,Kokinis; Troy Andreas,30,0,30,0
1713332187003,LIFR 1A,A00,490494,Van Moer; Vinciane G,17,0,20,3
1713332188029,LIFR 1AX,A00,490495,Van Moer; Vinciane G,17,0,20,3
1713332189054,LIFR 1B,A00,490496,Van Moer; Vinciane G,17,0,20,3
1713332190085,LIFR 1BX,A00,490497,Van Moer; Vinciane G,17,0,20,3
1713332191112,LIGN 8,A00,505198,McIntosh; Justin Daniel,134,0,150,16
1713332192138,LIGN 9GS,A00,491239,Lott; Margaret S.,18,0,20,2
1713332193167,LIGN 101,A01,505200,McIntosh; Justin Daniel,22,0,30,8
1713332194197,LIGN 120,A01,491244,Staff,22,0,30,8
1713332195222,LIGN 149GS,A00,491245,Lott; Margaret S.,18,0,20,2
1713332196246,LIGN 170,A00,491247,Staff,22,0,30,8
1713332197273,LISP 1D,A00,490498,Munoz Sanchez; Alicia,8,0,14,6
1713332197273,LISP 1D,B00,490499,Munoz Sanchez; Alicia,6,0,14,8
1713332197273,LISP 1D,C00,490500,Munoz Sanchez; Alicia,7,0,14,7
1713332197273,LISP 1D,D00,490501,Munoz Sanchez; Alicia,10,0,14,4
1713332198298,LISP 1DX,A00,490502,Munoz Sanchez; Alicia,13,0,28,15
1713332198298,LISP 1DX,B00,490503,Munoz Sanchez; Alicia,16,0,28,12
1713332200355,LTAM 110,A00,491847,Staff,22,0,25,3
1713332201383,LTCS 119,A00,491848,Staff,11,0,15,4
1713332202412,LTCS 130,A00,491849,Staff,24,0,25,1
1713332204469,LTEA 120C,A00,491852,Staff,32,0,40,8
1713332205495,LTEN 130GS,A00,491853,Lyon; Antony J.,23,0,28,5
1713332206523,LTEN 148,A00,491855,Staff,23,0,25,2
1713332207551,LTEN 159,A00,491856,Staff,20,0,25,5
1713332208607,LTEN 180,A00,491857,Staff,8,0,15,7
1713332210658,LTSP 123GS,A00,505928,Bessett; Ryan Matthew,24,0,28,4
1713332211682,LTSP 174GS,A00,506037,Bessett; Ryan Matthew,24,0,28,4
1713332213735,LTWR 102,A00,491861,Staff,9,0,15,6
1713332214759,LTWR 106,A00,491862,Staff,8,0,15,7
1713332215786,MAE 11,A00,490930,Bahadori; Mohammad Yousef,95,0,100,5
1713332216812,MAE 30A,A00,490931,Qi; Huihui,37,0,40,3
1713332217837,MAE 101A,A00,491036,Sadeghizadeh; Zahra,92,0,100,8
1713332218864,MAE 101C,A00,491037,Seshadri; Kalyanasundaram,66,0,100,34
1713332219892,MAE 113,A00,491040,Seshadri; Kalyanasundaram,65,0,80,15
1713332220921,MAE 131A,A00,491041,Ghazinejad; Maziar,37,0,40,3
1713332221949,MAE 142,A00,491053,Staff,39,0,40,1
1713332222974,MAE 143A,A00,491054,Staff,31,0,50,19
1713332224000,MAE 150,A00,491092,Truong; Phuong Thi Ngoc,24,0,35,11
1713332225030,MATH 3C,A01,494031,Pardo Guerra; Sebastian,30,0,30,0
1713332225030,MATH 3C,A02,494032,Pardo Guerra; Sebastian,29,0,30,1
1713332226055,MATH 10A,A01,494034,Staff,27,0,30,3
1713332226055,MATH 10A,A02,494035,Staff,28,0,30,2
1713332226055,MATH 10A,B01,494037,Staff,27,0,30,3
1713332226055,MATH 10A,B02,494038,Staff,29,0,30,1
1713332227092,MATH 10B,A01,494040,Habib; Yousaf,22,0,30,8
1713332227092,MATH 10B,A02,494041,Habib; Yousaf,28,0,30,2
1713332227092,MATH 10B,A03,494042,Habib; Yousaf,29,0,30,1
1713332227092,MATH 10B,A04,494043,Habib; Yousaf,30,0,30,0
1713332227092,MATH 10B,B01,494045,Habib; Yousaf,25,0,30,5
1713332227092,MATH 10B,B02,494046,Habib; Yousaf,30,0,30,0
1713332227092,MATH 10B,B03,494047,Habib; Yousaf,30,0,30,0
1713332227092,MATH 10B,B04,494048,Habib; Yousaf,30,0,30,0
1713332228122,MATH 18,A01,494050,Kemp; Todd Aahron,25,0,30,5
1713332228122,MATH 18,A02,494051,Kemp; Todd Aahron,29,0,30,1
1713332228122,MATH 18,B01,494054,Kemp; Todd Aahron,26,0,30,4
1713332228122,MATH 18,B02,494055,Kemp; Todd Aahron,29,0,30,1
1713332229146,MATH 20A,A01,494059,Suk; Andrew Hoon,30,0,30,0
1713332230173,MATH 20B,A01,494061,Briones; Jor-el Thomas Caparas,33,0,35,2
1713332230173,MATH 20B,B01,494063,Bach; Quang Tran,34,0,35,1
1713332231208,MATH 20C,A01,494065,Staff,28,0,30,2
1713332231208,MATH 20C,A02,494066,Staff,30,0,30,0
1713332231208,MATH 20C,A03,494067,Staff,30,0,30,0
1713332231208,MATH 20C,A04,494068,Staff,30,0,30,0
1713332231208,MATH 20C,B01,494070,Zhang; Ming,25,0,30,5
1713332231208,MATH 20C,B02,494071,Zhang; Ming,27,0,30,3
1713332231208,MATH 20C,B03,494072,Zhang; Ming,29,0,30,1
1713332231208,MATH 20C,B04,494073,Zhang; Ming,29,0,30,1
1713332232238,MATH 20D,A01,494075,Staff,22,0,30,8
1713332232238,MATH 20D,A02,494076,Staff,29,0,30,1
1713332233263,MATH 20E,A01,494079,Staff,24,0,30,6
1713332233263,MATH 20E,A02,494080,Staff,26,0,30,4
1713332233263,MATH 20E,B01,494082,Staff,25,0,30,5
1713332233263,MATH 20E,B02,494083,Staff,25,0,30,5
1713332234290,MATH 103A,A01,494085,Aliabadi Sr.; Mohsen,13,0,30,17
1713332234290,MATH 103A,A02,494086,Aliabadi Sr.; Mohsen,28,0,30,2
1713332234290,MATH 103A,B01,494088,Aliabadi Sr.; Mohsen,21,0,30,9
1713332234290,MATH 103A,B02,494089,Aliabadi Sr.; Mohsen,27,0,30,3
1713332235315,MATH 109,A01,494091,Staff,30,0,30,0
1713332235315,MATH 109,A02,494092,Staff,29,0,30,1
1713332235315,MATH 109,B01,494094,Staff,27,0,30,3
1713332235315,MATH 109,B02,494095,Staff,29,0,30,1
1713332236345,MATH 142A,A01,494097,Chow; Bennett,15,0,30,15
1713332236345,MATH 142A,A02,494098,Chow; Bennett,23,0,30,7
1713332236345,MATH 142A,B01,494100,Chow; Bennett,19,0,30,11
1713332236345,MATH 142A,B02,494101,Chow; Bennett,29,0,30,1
1713332238402,MATH 168A,A01,516677,Dumitriu; Ioana,16,0,35,19
1713332239428,MATH 170A,A01,516679,Dumitriu; Ioana,18,0,30,12
1713332239428,MATH 170A,A02,516680,Dumitriu; Ioana,28,0,30,2
1713332240457,MATH 193A,A01,494107,Staff,13,0,30,17
1713332240457,MATH 193A,A02,494108,Staff,19,0,30,11
1713332240457,MATH 193A,A03,494109,Staff,29,0,30,1
1713332240457,MATH 193A,A04,494110,Staff,22,0,30,8
1713332243540,MGT 16,A00,491930,McKay; Michael J,92,0,98,6
1713332244566,MGT 18,A00,491992,McKay; Michael J,96,0,98,2
1713332245594,MGT 71,A00,492003,Staff,63,0,98,35
1713332246618,MGT 103,A00,505209,Eberhard; Craig A,81,0,98,17
1713332247644,MGT 131A,A00,505210,Anderson; John Charles,89,0,98,9
1713332249701,MGT 153,A00,492077,Perols; Johan Lars,18,0,90,72
1713332252775,MGT 164,A00,492222,McKay; Mary A,91,0,98,7
1713332253805,MGT 172,A00,492245,Staff,59,0,60,1
1713332253805,MGT 172,B00,505526,Hedges; Kathleen,65,0,98,33
1713332254830,MGT 181,A00,505669,Dunn; Louis Jean,80,0,98,18
1713332255863,MMW 14,A01,494399,Staff,15,0,28,13
1713332255863,MMW 14,A02,494400,Staff,25,0,28,3
1713332255863,MMW 14,A03,494401,Staff,28,0,28,0
1713332255863,MMW 14,A04,494402,Staff,28,0,28,0
1713332255863,MMW 14,B01,494404,Carreras; Maria Victoria,8,0,28,20
1713332255863,MMW 14,B02,494405,Carreras; Maria Victoria,25,0,28,3
1713332255863,MMW 14,B03,494406,Carreras; Maria Victoria,27,0,28,1
1713332255863,MMW 14,B04,494407,Carreras; Maria Victoria,28,0,28,0
1713332256889,MMW 14GS,A00,506250,Chang; Edmond Yi-Teh,0,0,0,0
1713332257918,MMW 121R,A01,494415,Adamiak; Patrick John,10,0,28,18
1713332257918,MMW 121R,A02,494416,Adamiak; Patrick John,24,0,28,4
1713332258948,MUS 1A,A01,494113,Staff,12,0,25,13
1713332258948,MUS 1A,A02,494114,Staff,24,0,25,1
1713332259979,MUS 4,A01,494116,Staff,23,0,25,2
1713332259979,MUS 4,A02,494117,Staff,22,0,25,3
1713332261004,MUS 5R,A01,494236,Dubnov; Shlomo,6,0,25,19
1713332261004,MUS 5R,A02,494237,Dubnov; Shlomo,25,0,25,0
1713332262029,MUS 6,A01,494122,Staff,10,0,25,15
1713332262029,MUS 6,A02,494123,Staff,23,0,25,2
1713332263057,MUS 7,A01,494125,Staff,16,0,25,9
1713332263057,MUS 7,A02,494126,Staff,24,0,25,1
1713332264086,MUS 11,A01,494128,Staff,23,0,25,2
1713332264086,MUS 11,A02,494129,Staff,24,0,25,1
1713332265112,MUS 13,A01,494131,Staff,25,0,25,0
1713332265112,MUS 13,A02,494132,Staff,25,0,25,0
1713332266142,MUS 15,A01,494134,Staff,16,0,25,9
1713332266142,MUS 15,A02,494135,Staff,25,0,25,0
1713332266142,MUS 15,B01,494137,Staff,24,0,25,1
1713332267168,MUS 80,A00,494232,Staff,24,0,25,1
1713332267168,MUS 80,B00,494233,Staff,25,0,25,0
1713332267168,MUS 80,C00,494234,Staff,23,0,25,2
1713332268196,MUS 95C,A00,494141,Staff,70,0,75,5
1713332269224,MUS 114,A00,494142,Staff,40,0,50,10
1713332270250,NANO 15,A01,490636,Drews; Aaron,7,0,7,0
1713332271277,PHIL 1,A00,490578,Grush; Rick Scott,49,0,50,1
1713332272304,PHIL 10,A01,490580,Grush; Rick Scott,33,0,35,2
1713332272304,PHIL 10,A02,490586,Grush; Rick Scott,32,0,35,3
1713332273334,PHIL 27,A01,490591,Staff,22,0,25,3
1713332273334,PHIL 27,A02,490592,Staff,25,0,25,0
1713332273334,PHIL 27,A03,490593,Staff,25,0,25,0
1713332273334,PHIL 27,A04,490598,Staff,25,0,25,0
1713332274357,PHIL 32,A01,490611,Staff,20,0,20,0
1713332274357,PHIL 32,A02,490618,Staff,20,0,20,0
1713332275382,PHIL 90,A00,490624,Staff,40,0,40,0
1713332276411,PHIL 136,A00,490627,Cohen; Jonathan David,37,0,40,3
1713332277436,PHIL 155,A00,490634,Staff,62,0,70,8
1713332278465,PHYS 1A,A00,491610,Staff,245,0,250,5
1713332279489,PHYS 1AL,001,491616,Tsai; Philbert S,27,0,30,3
1713332279489,PHYS 1AL,002,491618,Tsai; Philbert S,30,0,30,0
1713332280513,PHYS 1B,A00,491623,Staff,236,0,250,14
1713332281539,PHYS 1BL,001,491626,Tsai; Philbert S,22,0,30,8
1713332281539,PHYS 1BL,002,491628,Tsai; Philbert S,26,0,30,4
1713332282564,PHYS 1C,A00,491632,Staff,213,0,245,32
1713332283646,PHYS 1CL,001,491635,Tsai; Philbert S,2,0,30,28
1713332283646,PHYS 1CL,002,491643,Tsai; Philbert S,22,0,30,8
1713332284673,PHYS 2AR,A01,491651,Meyertholen; Andrew D.,44,0,50,6
1713332285701,PHYS 2B,A01,491659,Staff,106,0,115,9
1713332286727,PHYS 2BL,A01,491685,Staff,21,0,24,3
1713332286727,PHYS 2BL,A02,491700,Staff,21,0,24,3
1713332287754,PHYS 2C,A01,505161,Staff,101,0,115,14
1713332288784,PHYS 4A,A01,491704,Grinstein; Benjamin,99,0,100,1
1713332289816,POLI 5D,A01,494144,Staff,3,0,5,2
1713332289816,POLI 5D,B01,626283,Dai; Yinlin,5,0,5,0
1713332290842,POLI 12,A00,494145,Staff,43,0,45,2
1713332291870,POLI 13R,A00,494146,Forman; Fonna,45,0,50,5
1713332292898,POLI 27,A01,494148,Staff,54,0,60,6
1713332293928,POLI 30,A00,494149,Staff,49,0,50,1
1713332294957,POLI 100DA,A00,494150,Staff,21,0,25,4
1713332297008,POLI 100I,A00,494152,Staff,27,0,30,3
1713332298033,POLI 104B,A00,494153,Smith; Glenn Chatmas,53,0,55,2
1713332299057,POLI 104F,A00,494154,Staff,28,0,30,2
1713332300084,POLI 104I,A00,494155,Smith; Glenn Chatmas,29,0,30,1
1713332301114,POLI 110C,A00,494156,Ingham; Sean,23,0,25,2
1713332302140,POLI 117R,A00,494157,Forman; Fonna,6,0,20,14
1713332303169,POLI 118,A00,494158,Ingham; Sean,21,0,25,4
1713332304194,POLI 120H,A00,494159,Fisk; David Lee,39,0,45,6
1713332305220,POLI 131CR,A00,494160,Hoston; Germaine,35,0,45,10
1713332306245,POLI 133J,A00,494161,Staff,32,0,35,3
1713332307270,POLI 135,A00,494162,Fisk; David Lee,33,0,35,2
1713332308298,POLI 140A,A00,494164,Staff,19,0,30,11
1713332309323,POLI 142I,A00,494165,Staff,30,0,30,0
1713332310352,POLI 144D,A00,494166,Staff,23,0,25,2
1713332311376,POLI 151,A00,494167,Staff,30,0,30,0
1713332312401,POLI 153,A00,494168,Staff,33,0,35,2
1713332313426,POLI 160AA,A00,494169,Staff,34,0,40,6
1713332314451,POLI 162,A00,494170,Mignozzetti; Umberto,18,0,25,7
1713332315476,POLI 171,A00,494171,Mignozzetti; Umberto,18,0,25,7
1713332316500,PSYC 1,A00,494172,Staff,95,0,100,5
1713332317526,PSYC 2,A00,494173,Moranton; Nirelia Melbina-,34,0,50,16
1713332318551,PSYC 3,A00,494174,Staff,29,0,30,1
1713332319577,PSYC 6,A00,494175,Staff,17,0,20,3
1713332320603,PSYC 60,A01,494177,Staff,37,0,45,8
1713332321634,PSYC 70,A01,505724,Geller; Emma Harlan,42,0,45,3
1713332322663,PSYC 101,A00,494180,Heyman; Gail D.,84,0,100,16
1713332323689,PSYC 105,A00,494181,Geller; Emma Harlan,51,0,90,39
1713332324716,PSYC 106,A00,494182,Dobkins; Karen R.,27,0,45,18
1713332325741,PSYC 108,A00,494183,Adrian; Julia Anna,89,0,100,11
1713332326771,PSYC 114,A01,494185,Winkielman; Piotr,0,3,30,30
1713332327802,PSYC 122,A00,494186,Moranton; Nirelia Melbina-,27,0,50,23
1713332328832,PSYC 124,A00,494187,Chapman; Eddie Nathaniel,70,0,80,10
1713332329857,PSYC 131,A00,494188,Anagnostaras; Stephan,41,0,80,39
1713332330885,PSYC 144,A00,494189,Staff,3,0,50,47
1713332331911,PSYC 154,A00,494190,Lacefield; Katharine I,107,0,180,73
1713332332938,PSYC 162,A00,494191,Wixted; John T,71,0,100,29
1713332333964,PSYC 172,A00,494192,Gorman; Michael R.,36,0,45,9
1713332334992,PSYC 178,A00,494193,Glaser; Dale,34,0,45,11
1713332336020,PSYC 193,A00,505725,Chapman; Eddie Nathaniel,20,0,20,0
1713332337045,RELI 145GS,A00,519817,Rahimi; Babak,18,0,20,2
1713332338075,SE 101A,A01,490862,Chadha; Mayank,23,0,25,2
1713332339103,SE 101C,A01,490924,Krysl; Petr,15,0,20,5
1713332340129,SE 110A,A01,490928,Staff,19,0,20,1
1713332341155,SE 130A,A00,490929,Morrison; Machel Leigh,55,0,70,15
1713332342182,SIO 1,A01,519325,Staff,39,0,40,1
1713332343207,SIO 30,A01,519327,Staff,38,0,40,2
1713332344313,SIO 40,A00,519328,Staff,39,0,40,1
1713332345342,SIO 46GS,A00,519819,Cook; Geoffrey W,17,0,25,8
1713332346367,SIO 109R,A00,494197,Forman; Fonna,0,3,20,20
1713332347395,SIO 121GS,A00,519827,Cook; Geoffrey W,17,0,25,8
1713332348427,SIO 132,A01,519330,Staff,38,0,40,2
1713332349453,SIO 133,A01,519397,Staff,37,0,40,3
1713332350483,SIO 139,A00,519396,Kacev; David,29,0,40,11
1713332351510,SOCI 1,A01,494199,Thorpe; Charles Robert,21,0,30,9
1713332351510,SOCI 1,A02,494200,Thorpe; Charles Robert,30,0,30,0
1713332351510,SOCI 1,A03,494201,Thorpe; Charles Robert,29,0,30,1
1713332351510,SOCI 1,A04,494202,Thorpe; Charles Robert,29,0,30,1
1713332351510,SOCI 1,A05,494203,Thorpe; Charles Robert,29,0,30,1
1713332351510,SOCI 1,A06,494204,Thorpe; Charles Robert,30,0,30,0
1713332351510,SOCI 1,A07,494205,Thorpe; Charles Robert,28,0,30,2
1713332352536,SOCI 60,A01,494207,Staff,34,0,40,6
1713332352536,SOCI 60,A02,494208,Staff,39,0,40,1
1713332353564,SOCI 100,A01,494210,Payne; Christine Anna,25,0,30,5
1713332353564,SOCI 100,A02,494211,Payne; Christine Anna,26,0,30,4
1713332354593,SOCI 109M,A00,494212,Staff,20,0,20,0
1713332355619,SOCI 110,A00,494213,Staff,34,0,40,6
1713332357673,SOCI 118E,A00,494215,Ng; Kwai,37,0,40,3
1713332358717,SOCI 125,A00,494216,Calderon-Zaks; Michael Aar,40,0,45,5
1713332359743,SOCI 126,A01,494218,Jones; Makeba,3,0,5,2
1713332360772,SOCI 131,A00,494219,Thorpe; Charles Robert,26,0,30,4
1713332362829,SOCI 135,A00,494221,Payne; Christine Anna,28,0,50,22
1713332363872,SOCI 136E,A00,626690,Ruiz; Jonathan Joseph,24,0,25,1
1713332364901,SOCI 138GS,A00,494222,Navon; Daniel,24,0,28,4
1713332366954,SOCI 145,A00,494224,Staff,40,0,45,5
1713332367982,SOCI 153,A00,494225,Staff,28,0,30,2
1713332369008,SOCI 160E,A00,494226,Ng; Kwai,29,0,40,11
1713332370035,SOCI 180,A00,494227,Staff,29,0,30,1
1713332371064,SOCI 189GS,A00,494228,Ribas Norris; Janet Vanesa,11,0,11,0
1713332372089,SOCI 190GS,A00,553232,Ribas Norris; Janet Vanesa,11,0,11,0
1713332373115,SOMI 220,A00,627178,Schneid; Stephen David,30,0,30,0
1713332374140,SYN 2,001,490768,Staff,13,0,15,2
1713332374140,SYN 2,002,490769,Staff,14,0,15,1
1713332374140,SYN 2,004,490775,Staff,0,0,0,0
1713332374140,SYN 2,003,490774,Staff,0,0,0,0
1713332374140,SYN 2,005,490776,Staff,0,0,0,0
1713332375169,SYN 2R,001,490779,Staff,11,0,15,4
1713332375169,SYN 2R,002,514635,Staff,14,0,15,1
1713332376199,SYN 100,A01,490783,Staff,9,0,20,11
1713332376199,SYN 100,B01,490787,Staff,9,0,20,11
1713332376199,SYN 100,C01,490789,Staff,10,0,20,10
1713332377224,SYN 150,A00,490817,Staff,14,0,15,1
1713332377224,SYN 150,B00,514610,Staff,15,0,15,0
1713332378254,TDAC 1,A00,492753,Walsh; Kim C.,19,0,20,1
1713332378254,TDAC 1,B00,492754,Harting; Carla Kelso,19,0,20,1
1713332378254,TDAC 1,C00,513995,Salovey; Todd,15,0,20,5
1713332379280,TDAC 101,A00,492766,Harting; Carla Kelso,17,0,20,3
1713332380305,TDAC 102,A00,492768,Basso; Beatrice,19,0,20,1
1713332381332,TDDE 111,A00,492769,Staff,25,0,25,0
1713332382361,TDDE 131,A00,492770,Staff,15,0,15,0
1713332382361,TDDE 131,B00,492771,Staff,15,0,15,0
1713332383387,TDDE 131GS,A00,523716,Guirguis; Mark C,23,0,28,5
1713332384418,TDGE 1,A01,492756,Salovey; Todd,56,0,60,4
1713332385447,TDGE 5,A01,492758,Staff,23,0,25,2
1713332386476,TDGE 10,A00,492759,Fulton; Julia,203,0,220,17
1713332387558,TDGE 11,A00,492760,Castro; Robert Jess,198,0,200,2
1713332389610,TDGE 124,A00,492772,Fulton; Julia,184,0,220,36
1713332390641,TDGE 125,A00,492773,Meyer; Ursula,38,0,50,12
1713332390641,TDGE 125,B00,492774,Staff,49,0,50,1
1713332390641,TDGE 125,C00,523565,Staff,48,0,50,2
1713332391666,TDGE 125GS,A00,523580,Guirguis; Mark C,23,0,28,5
1713332392691,TDGE 127,A00,492775,Havis; Allan,33,0,50,17
1713332393717,TDHT 101,A00,492776,Staff,34,0,35,1
1713332394749,TDMV 1,A00,492762,Caligagan; Maria T.,29,0,30,1
1713332394749,TDMV 1,B00,492763,Arcidiacono; Kristin,26,0,30,4
1713332395913,TDMV 2,A00,492764,Weinberg; Sadie,28,0,30,2
1713332396939,TDMV 3,A00,492765,Mack; Kara Shanai',37,0,40,3
1713332397968,TDMV 138,A00,492777,Mack; Kara Shanai',34,0,40,6
1713332398996,TDMV 140,A00,492778,Lima; Paulo Henrique,40,0,40,0
1713332400023,TDMV 142,A00,492779,Caligagan; Maria T.,33,0,40,7
1713332400023,TDMV 142,B00,492780,Caligagan; Tony,37,0,40,3
1713332401048,TDMV 143,A00,492781,Fyall; Daunte Edward,39,0,40,1
1713332402075,USP 1,A01,492401,Kwak; Nancy,27,0,35,8
1713332403101,USP 2,A01,492453,Hinds; Juli Beth,35,0,35,0
1713332404127,USP 3,A01,492516,Staff,28,0,35,7
1713332405152,USP 4,A00,492522,McTague; Sarah,16,0,25,9
1713332406178,USP 100,A00,492523,Staff,32,0,35,3
1713332407205,USP 101,A00,492524,Staff,13,0,15,2
1713332408232,USP 105,A00,492525,Staff,21,0,25,4
1713332409258,USP 151,A00,492526,Shenkman; Michael Thomas,32,0,35,3
1713332410288,USP 170,A00,492545,Hinds; Juli Beth,33,0,35,2
1713332411312,USP 171GS,A00,492608,Bussell; Mirle Rabinowitz,24,0,28,4
1713332412338,USP 183GS,A00,492613,Peerson; Susan,24,0,28,4
1713332413365,VIS 30,A01,490693,Yoldas; Pinar,19,0,22,3
1713332413365,VIS 30,A02,490694,Yoldas; Pinar,18,0,22,4
1713332414395,VIS 83,A00,490695,Kester; Grant,63,0,75,12
1713332415424,VIS 105D,A00,490696,Staff,22,0,25,3
1713332416450,VIS 124CN,A00,490699,Rose; Jordan M,65,0,75,10
1713332417475,VIS 125GS,A00,511221,Williams; Alena J,21,0,22,1
1713332418502,VIS 128D,A00,490700,Staff,73,0,75,2
1713332419529,VIS 151,A01,490717,Staff,33,0,34,1
1713332419529,VIS 151,A02,490766,Staff,33,0,34,1
1713332420558,VIS 154GS,A00,511972,Williams; Alena J,21,0,22,1
1713332421586,VIS 160A,A00,490767,Stone; Patricia,7,0,10,3
1713332422611,WCWP 10A,A00,490638,Staff,14,0,15,1
1713332422611,WCWP 10A,B00,490640,Staff,15,0,15,0
1713332423638,WCWP 10B,A00,490641,Staff,0,0,0,0
1713332423638,WCWP 10B,B00,490642,Staff,14,0,15,1
1713332423638,WCWP 10B,C00,490644,Staff,13,0,15,2
1713332423638,WCWP 10B,D00,490647,Staff,0,0,0,0
1713332424664,WCWP 100,A00,490655,Staff,0,0,0,0
1713332424664,WCWP 100,B00,490687,Staff,10,0,15,5
1713332426762,ANAR 153,A00,487222,Braswell; Geoffrey E.,53,0,60,7
1713332427790,ANBI 134,A00,487223,Staff,5,0,20,15
1713332428814,ANBI 143GS,A00,487224,Noel; Geoffroy Pierre Jean,18,0,24,6
1713332429839,ANBI 144GS,A00,519548,Noel; Geoffroy Pierre Jean,18,0,24,6
1713332430867,ANSC 101,A00,487225,Staff,18,0,20,2
1713332431894,ANSC 125,A00,487227,Brenner; Suzanne A,38,0,40,2
1713332433947,ANSC 146,A00,487229,Staff,35,0,40,5
1713332434978,ANSC 148,A00,487230,Olivas Hernandez; Olga Lid,39,0,40,1
1713332436007,ANSC 150,A00,504165,Sloane; Julia Kathryn,18,0,20,2
1713332437032,ANSC 180,A00,487232,Staff,14,0,15,1
1713332438061,ANSC 188,A00,627155,Staff,38,0,40,2
1713332439086,ANTH 5,A00,519529,Semendeferi; Ekaterini,15,0,15,0
1713332440112,ANTH 10,A00,487219,Staff,58,0,60,2
1713332441141,ANTH 23,A01,487221,Staff,17,0,20,3
1713332442166,ANTH 102,A00,487233,Wilder; Linnea Lorene,51,0,60,9
1713332443195,ANTH 103,A00,487234,Varma; Saiba,55,0,60,5
1713332444225,ANTH 105,A00,487235,Stewart; Alexander B,54,0,60,6
1713332445250,BENG 100,A01,516685,Taylor Amos; Alyssa C,26,0,30,4
1713332446281,BIBC 102,A01,491316,Flagg; Matthew Paul,10,0,88,78
1713332446281,BIBC 102,A02,491366,Flagg; Matthew Paul,78,0,88,10
1713332447311,BIBC 103,A01,491486,Boumechache; Miyyada,16,0,24,8
1713332447311,BIBC 103,A02,491487,Boumechache; Miyyada,24,0,24,0
1713332448335,BICD 100,A01,516882,Staff,73,0,75,2
1713332448335,BICD 100,A02,516890,Staff,69,0,75,6
1713332449362,BICD 102GS,A00,491488,Lo; Stanley M.,26,0,28,2
1713332450387,BIEB 136GS,A00,516940,Holway; David A. & Shurin; Jonathan,18,0,24,6
1713332451411,BIEB 137GS,A01,517034,Holway; David A. & Shurin; Jonathan,18,0,24,6
1713332452440,BIEB 138GS,A01,491492,Pirino; Giorgia,21,0,28,7
1713332453466,BILD 1,A01,491296,Staff,60,0,63,3
1713332453466,BILD 1,A02,491297,Staff,63,0,63,0
1713332454497,BILD 4,A01,517099,Gonzalez Gamboa; Ivonne,22,0,24,2
1713332454497,BILD 4,A02,517100,Gonzalez Gamboa; Ivonne,24,0,24,0
1713332455525,BILD 60GS,A00,491309,Lo; Stanley M.,26,0,28,2
1713332456555,BIMM 100,A01,517136,Staff,83,0,100,17
1713332457581,BIMM 110,A01,517182,Staff,54,0,100,46
1713332458616,BIMM 120,A01,517228,Pickett; Brooke Elizabeth,28,0,63,35
1713332458616,BIMM 120,A02,517240,Pickett; Brooke Elizabeth,44,0,63,19
1713332459642,BIMM 132GS,A01,491498,Pirino; Giorgia,21,0,28,7
1713332460668,BIMM 143,A01,491589,Bozinovic; Goran,12,0,40,28
1713332461696,BIPN 100,A01,491594,Armour; Jon Christopher,83,0,100,17
1713332462722,BIPN 140,A01,491602,Marino; Marc J,25,0,50,25
1713332464777,CAT 125,A00,515973,Staff,18,0,20,2
1713332465807,CAT 125GS,A00,515974,Rahimi; Babak,17,0,20,3
1713332466832,CAT 125R,A00,515980,Staff,12,0,20,8
1713332466832,CAT 125R,B00,515981,Tosun; Adriana,19,0,20,1
1713332466832,CAT 125R,C00,515987,Hyland; Tina Mae,0,3,20,20
1713332466832,CAT 125R,D00,515988,Bronstein; Phoebe Malan,16,0,20,4
1713332467860,CENG 15,A01,488699,Drews; Aaron,25,0,25,0
1713332468886,CENG 100,A00,505196,Opatkiewicz; Justin Paul,25,0,25,0
1713332469912,CGS 2A,A01,489598,Staff,33,0,35,2
1713332470941,CGS 112,A00,489599,Staff,15,0,15,0
1713332471964,CGS 119,A00,489603,Staff,10,0,10,0
1713332472994,CGS 120,A00,489604,Staff,14,0,15,1
1713332474019,CGS 150,A00,489607,Staff,15,0,15,0
1713332475050,CHEM 6A,A01,488715,Staff,97,0,100,3
1713332476079,CHEM 6B,A01,488719,Piercy; Marc Anthony,99,0,100,1
1713332477105,CHEM 6C,A01,488723,Albizati; Kim F.,93,0,100,7
1713332478133,CHEM 7L,A01,488728,Schurmeier; Kimberly,18,0,24,6
1713332478133,CHEM 7L,A02,488730,Schurmeier; Kimberly,23,0,24,1
1713332478133,CHEM 7L,A03,488734,Schurmeier; Kimberly,20,0,24,4
1713332478133,CHEM 7L,A04,488763,Schurmeier; Kimberly,23,0,24,1
1713332478133,CHEM 7L,B01,488798,Schurmeier; Kimberly,17,0,24,7
1713332478133,CHEM 7L,B02,488801,Schurmeier; Kimberly,22,0,24,2
1713332478133,CHEM 7L,B03,488808,Schurmeier; Kimberly,22,0,24,2
1713332478133,CHEM 7L,B04,488811,Schurmeier; Kimberly,24,0,24,0
1713332479159,CHEM 11,A01,488897,Stallings; Dontarie M,95,0,100,5
1713332480185,CHEM 40A,A01,488913,Albizati; Kim F.,83,0,100,17
1713332481210,CHEM 40B,A01,488920,Weizman; Haim,43,0,50,7
1713332481210,CHEM 40B,A02,488938,Weizman; Haim,44,0,50,6
1713332482235,CHEM 41A,A01,489029,Klosterman; Jeremy K,57,0,60,3
1713332483266,CHEM 41C,A01,500436,Tor; Yitzhak,55,0,60,5
1713332484305,CHEM 43A,A01,500426,Weizman; Haim,0,0,24,24
1713332484305,CHEM 43A,A02,500430,Weizman; Haim,7,0,24,17
1713332484305,CHEM 43A,B01,514041,Klosterman; Jeremy K,16,0,24,8
1713332484305,CHEM 43A,B02,514047,Klosterman; Jeremy K,23,0,24,1
1713332485329,CHEM 108,A01,489140,Jennings; Patricia A.,8,0,24,16
1713332485329,CHEM 108,A02,489142,Jennings; Patricia A.,14,0,24,10
1713332486358,CHEM 114A,A01,489147,Stallings; Dontarie M,68,0,100,32
1713332487383,CHIN 169A,A00,489171,Wang; Xiao,19,0,20,1
1713332489436,COGS 3,A01,518827,Boyle; Mary E. T.,25,0,40,15
1713332490460,COGS 11,A01,489175,Staff,27,0,30,3
1713332491545,COGS 14A,A01,518829,Staff,51,0,60,9
1713332492575,COGS 14B,A01,489177,Hoffman; Drew Ellen,62,0,75,13
1713332493605,COGS 100,A01,489181,Allen; Michael Gordon,62,0,75,13
1713332494631,COGS 101A,A01,489183,Staff,45,0,60,15
1713332495658,COGS 101B,A01,489185,Allen; Michael Gordon,8,0,30,22
1713332496687,COGS 101C,A01,526786,Staff,23,0,30,7
1713332498756,COGS 107A,A01,489189,Boyle; Mary E. T.,17,0,35,18
1713332499782,COGS 107B,A01,627144,Mooshagian; Eric Frederick,60,0,60,0
1713332500812,COGS 118A,A01,489191,Staff,0,45,40,40
1713332502865,COGS 171GS,A01,489194,Pineda; Jaime A,19,0,28,9
1713332503895,COGS 172,A01,489196,Staff,2,0,30,28
1713332504918,COGS 174GS,A01,489264,Pineda; Jaime A,19,0,28,9
1713332505946,COGS 180,A01,627150,Staff,28,0,30,2
1713332506972,COGS 186,A01,489274,Staff,0,1,30,30
1713332507996,COMM 10,A01,489276,Staff,23,0,25,2
1713332507996,COMM 10,A02,489303,Staff,23,0,25,2
1713332509027,COMM 100A,A01,489312,Staff,14,0,25,11
1713332509027,COMM 100A,A02,489313,Staff,24,0,25,1
1713332510056,COMM 106T,A00,512540,Staff,33,0,35,2
1713332511085,COMM 107,A00,489347,Staff,27,0,35,8
1713332512111,COMM 109P,A00,489358,Staff,31,0,35,4
1713332513135,COMM 132,A00,489361,McKenna; Denise,27,0,30,3
1713332514161,COMM 146,A00,489362,Halm; Gavin Patrick,26,0,30,4
1713332515186,COMM 190,A00,489363,Abuelhiga; Soraya Jill,17,0,23,6
1713332516218,CSE 8A,A50,489366,Staff,21,0,25,4
1713332516218,CSE 8A,A51,489367,Staff,24,0,25,1
1713332517243,CSE 11,A01,489398,Cao; Yingjun,73,0,100,27
1713332518270,CSE 12,A01,489487,Staff,43,0,50,7
1713332519302,CSE 20,A01,489497,Staff,48,0,50,2
1713332520330,CSE 21,A01,489517,Braun; Oliver,42,0,50,8
1713332521356,CSE 101,A01,489524,Braun; Oliver,0,32,50,50
1713332522383,CSE 105,A01,512594,Jones; Miles E,72,0,100,28
1713332522383,CSE 105,B01,512598,Jones; Miles E,52,0,100,48
1713332523416,CSE 140,A01,489538,Staff,41,0,50,9
1713332524442,CSE 141,A01,489550,Eldon; John,67,0,100,33
1713332525468,CSE 141L,A01,489571,Eldon; John,65,0,100,35
1713332526500,CSE 151A,A01,489583,Solares; Edwin A,141,0,200,59
1713332527525,CSE 175,A01,510886,Kumar; Rakesh,30,0,30,0
1713332528549,CSE 190,A00,516828,Dubnov; Shlomo,38,0,49,11
1713332529574,DOC 100D,A00,489667,Pass; Natalye Joann,19,0,25,6
1713332530600,DSC 10,A01,624268,Staff,72,0,75,3
1713332531625,DSC 20,A01,624476,Staff,50,0,50,0
1713332532649,DSC 40A,A01,624608,Staff,39,0,40,1
1713332533676,DSGN 1,A01,489179,Rill; Bryan,32,0,50,18
1713332534701,ECE 17,A01,490489,Sahay; Rajeev,18,0,30,12
1713332535727,ECE 65,A50,490492,Staff,11,0,20,9
1713332535727,ECE 65,A51,490493,Staff,18,0,20,2
1713332536752,ECON 1,A01,489715,Famulari; Melissa,67,0,70,3
1713332537776,ECON 2,A01,489717,Levkoff; Steven B.,68,0,70,2
1713332538803,ECON 3,A01,489948,Staff,70,0,70,0
1713332540858,ECON 5,A01,490103,Staff,27,0,30,3
1713332540858,ECON 5,B01,626281,Dai; Yinlin,45,0,45,0
1713332541887,ECON 100A,A01,490127,Famulari; Melissa,65,0,70,5
1713332542915,ECON 100B,A01,490129,Staff,64,0,70,6
1713332543944,ECON 109,A01,490187,Shishkin; Denis,27,0,35,8
1713332544970,ECON 110A,A01,490190,Levkoff; Steven B.,60,0,70,10
1713332545994,ECON 120A,A01,490245,Dai; Yinlin,61,0,70,9
1713332547021,ECON 120B,A01,490247,Nieto-Barthaburu; Augusto,40,0,70,30
1713332548053,ECON 120C,A01,490253,Sun; Yixiao,30,0,35,5
1713332548053,ECON 120C,B01,490255,Sun; Yixiao,34,0,35,1
1713332549083,ECON 129,A00,490256,Eckert; Fabian Paul,22,0,35,13
1713332550108,ECON 131,A00,490257,Nieto-Barthaburu; Augusto,0,6,35,35
1713332551135,ECON 138,A00,490258,Bharadwaj; Prashant,13,0,35,22
1713332551135,ECON 138,B00,490259,Bharadwaj; Prashant,15,0,35,20
1713332552161,ECON 159,A00,490260,Hendrickson; Gerald M.,0,9,0,0
1713332553186,ECON 178,A01,553995,Zhu; Ying,24,0,35,11
1713332554213,EDS 40,A01,512576,Black; Alison Michelle,20,0,20,0
1713332555241,EDS 107,A01,515848,Staff,30,0,30,0
1713332556265,EDS 110R,A01,490262,Staff,26,0,30,4
1713332557296,EDS 112,A01,490264,Chapman; Thandeka K,40,0,50,10
1713332558322,EDS 113,A00,490266,Staff,26,0,30,4
1713332559349,EDS 118,A00,490267,Warstadt; Melissa Fawn,20,0,30,10
1713332560375,EDS 124BR,A00,490268,Eguchi; Emi,4,0,25,21
1713332560375,EDS 124BR,B00,490269,Eguchi; Emi,23,0,25,2
1713332561401,EDS 126,A01,490271,Jones; Makeba,43,0,50,7
1713332562426,EDS 135,A01,490316,Staff,19,0,20,1
1713332563451,ENVR 142GS,A00,519514,Chang; Edmond Yi-Teh,26,0,28,2
1713332564480,ETHN 103,A00,490504,Staff,25,0,36,11
1713332565507,ETHN 103A,A00,490505,Man; Simeon S,4,0,9,5
1713332566537,ETHN 109,A00,490506,Staff,28,0,30,2
1713332567565,ETHN 118,A00,490507,Staff,35,0,36,1
1713332568593,ETHN 119,A00,490508,Staff,33,0,36,3
1713332569620,ETHN 121R,A00,490518,Choi; Esther Min,21,0,36,15
1713332570645,ETHN 127,A00,490528,Staff,14,0,15,1
1713332571670,ETHN 139,A00,490573,Staff,10,0,10,0
1713332572695,ETHN 150,A00,490575,Staff,15,0,15,0
1713332573723,GLBH 20,A00,491705,Elwardani; Nile Regina,38,0,40,2
1713332574748,GLBH 101,A00,491706,Staff,20,0,20,0
1713332575776,GLBH 111,A01,491708,Burgos; Jose L.,15,0,15,0
1713332576805,GLBH 146,A00,491709,Staff,9,0,20,11
1713332577831,GLBH 148,A00,491710,Olivas Hernandez; Olga Lid,11,0,20,9
1713332578856,GLBH 150,A00,491711,Sloane; Julia Kathryn,19,0,20,1
1713332579885,HIEA 131,A00,491760,Staff,28,0,32,4
1713332580908,HIEA 153,A00,491762,Staff,28,0,30,2
1713332581936,HIEU 124,A00,491811,Staff,26,0,32,6
1713332582968,HIEU 124GS,A00,491812,Markman; Kristina,27,0,28,1
1713332583997,HIEU 147,A00,491813,Staff,30,0,32,2
1713332585023,HIEU 149GS,A00,491816,Caldwell; Michael Alan,28,0,28,0
1713332586054,HILD 2C,A01,491713,Hendrickson; Gerald M.,26,0,30,4
1713332587079,HILD 7B,A01,491715,Kwak; Nancy,0,2,30,30
1713332588108,HILD 10,A01,491717,Staff,11,0,20,9
1713332589133,HILD 30GS,A00,491719,Edington; Claire Ellen,24,0,28,4
1713332590157,HINE 109,A00,491818,Shafir; Nir,27,0,32,5
1713332591187,HINE 128,A00,491821,Shafir; Nir,31,0,32,1
1713332592213,HISC 117,A00,491830,Staff,27,0,32,5
1713332593241,HIUS 103,A00,491834,Man; Simeon S,14,0,23,9
1713332594266,HIUS 108B,A00,491835,Staff,27,0,30,3
1713332595346,HIUS 141,A00,491836,Hendrickson; Gerald M.,28,0,32,4
1713332596372,HIUS 149,A00,491839,Staff,24,0,32,8
1713332597402,HUM 3,A01,512617,Crum; Matthew Stephen,42,0,50,8
1713332597402,HUM 3,A02,512618,Crum; Matthew Stephen,48,0,50,2
1713332598432,HUM 3GS,A00,512663,Markman; Kristina,0,0,0,1
1713332598432,HUM 3GS,B00,512664,Staff,0,0,0,0
1713332599456,HUM 4,A01,512620,West; Geoffrey Scott,25,0,50,25
1713332600481,HUM 4GS,A00,512666,Lyon; Antony J.,0,0,0,5
1713332601508,HUM 4R,A01,512625,Watkins; Eric,49,0,50,1
1713332602535,HUM 5,A01,512649,Zavodny; Tatiana Sophia,23,0,50,27
1713332602535,HUM 5,B01,512661,Zroka; Ryan Edward,48,0,50,2
1713332603565,INTL 190,A00,490577,Segui; Alan S,0,0,0,5
1713332604591,JAPN 20AR,A01,491267,Ross; Kayoko F,7,0,20,13
1713332605617,JAPN 180,A00,491285,Berman; Michael David,33,0,40,7
1713332606645,LATI 50,A01,502536,Kokinis; Troy Andreas,16,0,22,6
1713332606645,LATI 50,A02,502551,Kokinis; Troy Andreas,22,0,22,0
1713332606645,LATI 50,A03,502650,Kokinis; Troy Andreas,22,0,22,0
1713332606645,LATI 50,A04,502909,Kokinis; Troy Andreas,21,0,22,1
1713332607673,LATI 160,A01,502920,Kokinis; Troy Andreas,30,0,30,0
1713332608702,LIFR 1A,A00,490494,Van Moer; Vinciane G,17,0,20,3
1713332609726,LIFR 1AX,A00,490495,Van Moer; Vinciane G,17,0,20,3
1713332610755,LIFR 1B,A00,490496,Van Moer; Vinciane G,17,0,20,3
1713332611779,LIFR 1BX,A00,490497,Van Moer; Vinciane G,17,0,20,3
1713332612805,LIGN 8,A00,505198,McIntosh; Justin Daniel,134,0,150,16
1713332613828,LIGN 9GS,A00,491239,Lott; Margaret S.,18,0,20,2
1713332614859,LIGN 101,A01,505200,McIntosh; Justin Daniel,22,0,30,8
1713332615882,LIGN 120,A01,491244,Staff,22,0,30,8
1713332616908,LIGN 149GS,A00,491245,Lott; Margaret S.,18,0,20,2
1713332617933,LIGN 170,A00,491247,Staff,22,0,30,8
1713332618961,LISP 1D,A00,490498,Munoz Sanchez; Alicia,8,0,14,6
1713332618961,LISP 1D,B00,490499,Munoz Sanchez; Alicia,6,0,14,8
1713332618961,LISP 1D,C00,490500,Munoz Sanchez; Alicia,7,0,14,7
1713332618961,LISP 1D,D00,490501,Munoz Sanchez; Alicia,10,0,14,4
1713332619986,LISP 1DX,A00,490502,Munoz Sanchez; Alicia,13,0,28,15
1713332619986,LISP 1DX,B00,490503,Munoz Sanchez; Alicia,16,0,28,12
1713332622040,LTAM 110,A00,491847,Staff,22,0,25,3
1713332623065,LTCS 119,A00,491848,Staff,11,0,15,4
1713332624091,LTCS 130,A00,491849,Staff,24,0,25,1
1713332626141,LTEA 120C,A00,491852,Staff,32,0,40,8
1713332627168,LTEN 130GS,A00,491853,Lyon; Antony J.,23,0,28,5
1713332628195,LTEN 148,A00,491855,Staff,23,0,25,2
1713332629223,LTEN 159,A00,491856,Staff,20,0,25,5
1713332630251,LTEN 180,A00,491857,Staff,8,0,15,7
1713332632301,LTSP 123GS,A00,505928,Bessett; Ryan Matthew,24,0,28,4
1713332633330,LTSP 174GS,A00,506037,Bessett; Ryan Matthew,24,0,28,4
1713332635383,LTWR 102,A00,491861,Staff,9,0,15,6
1713332636409,LTWR 106,A00,491862,Staff,8,0,15,7
1713332637434,MAE 11,A00,490930,Bahadori; Mohammad Yousef,95,0,100,5
1713332638466,MAE 30A,A00,490931,Qi; Huihui,37,0,40,3
1713332639494,MAE 101A,A00,491036,Sadeghizadeh; Zahra,92,0,100,8
1713332640523,MAE 101C,A00,491037,Seshadri; Kalyanasundaram,66,0,100,34
1713332641548,MAE 113,A00,491040,Seshadri; Kalyanasundaram,65,0,80,15
1713332642573,MAE 131A,A00,491041,Ghazinejad; Maziar,37,0,40,3
1713332643603,MAE 142,A00,491053,Staff,39,0,40,1
1713332644628,MAE 143A,A00,491054,Staff,31,0,50,19
1713332645653,MAE 150,A00,491092,Truong; Phuong Thi Ngoc,24,0,35,11
1713332646678,MATH 3C,A01,494031,Pardo Guerra; Sebastian,30,0,30,0
1713332646678,MATH 3C,A02,494032,Pardo Guerra; Sebastian,29,0,30,1
1713332647707,MATH 10A,A01,494034,Staff,27,0,30,3
1713332647707,MATH 10A,A02,494035,Staff,28,0,30,2
1713332647707,MATH 10A,B01,494037,Staff,27,0,30,3
1713332647707,MATH 10A,B02,494038,Staff,29,0,30,1
1713332648745,MATH 10B,A01,494040,Habib; Yousaf,22,0,30,8
1713332648745,MATH 10B,A02,494041,Habib; Yousaf,28,0,30,2
1713332648745,MATH 10B,A03,494042,Habib; Yousaf,29,0,30,1
1713332648745,MATH 10B,A04,494043,Habib; Yousaf,30,0,30,0
1713332648745,MATH 10B,B01,494045,Habib; Yousaf,25,0,30,5
1713332648745,MATH 10B,B02,494046,Habib; Yousaf,30,0,30,0
1713332648745,MATH 10B,B03,494047,Habib; Yousaf,30,0,30,0
1713332648745,MATH 10B,B04,494048,Habib; Yousaf,30,0,30,0
1713332649773,MATH 18,A01,494050,Kemp; Todd Aahron,25,0,30,5
1713332649773,MATH 18,A02,494051,Kemp; Todd Aahron,29,0,30,1
1713332649773,MATH 18,B01,494054,Kemp; Todd Aahron,26,0,30,4
1713332649773,MATH 18,B02,494055,Kemp; Todd Aahron,29,0,30,1
1713332650798,MATH 20A,A01,494059,Suk; Andrew Hoon,30,0,30,0
1713332651830,MATH 20B,A01,494061,Briones; Jor-el Thomas Caparas,33,0,35,2
1713332651830,MATH 20B,B01,494063,Bach; Quang Tran,34,0,35,1
1713332652856,MATH 20C,A01,494065,Staff,28,0,30,2
1713332652856,MATH 20C,A02,494066,Staff,30,0,30,0
1713332652856,MATH 20C,A03,494067,Staff,30,0,30,0
1713332652856,MATH 20C,A04,494068,Staff,30,0,30,0
1713332652856,MATH 20C,B01,494070,Zhang; Ming,25,0,30,5
1713332652856,MATH 20C,B02,494071,Zhang; Ming,27,0,30,3
1713332652856,MATH 20C,B03,494072,Zhang; Ming,29,0,30,1
1713332652856,MATH 20C,B04,494073,Zhang; Ming,29,0,30,1
1713332653892,MATH 20D,A01,494075,Staff,22,0,30,8
1713332653892,MATH 20D,A02,494076,Staff,29,0,30,1
1713332654922,MATH 20E,A01,494079,Staff,24,0,30,6
1713332654922,MATH 20E,A02,494080,Staff,26,0,30,4
1713332654922,MATH 20E,B01,494082,Staff,25,0,30,5
1713332654922,MATH 20E,B02,494083,Staff,25,0,30,5
1713332655947,MATH 103A,A01,494085,Aliabadi Sr.; Mohsen,13,0,30,17
1713332655947,MATH 103A,A02,494086,Aliabadi Sr.; Mohsen,28,0,30,2
1713332655947,MATH 103A,B01,494088,Aliabadi Sr.; Mohsen,21,0,30,9
1713332655947,MATH 103A,B02,494089,Aliabadi Sr.; Mohsen,27,0,30,3
1713332656974,MATH 109,A01,494091,Staff,30,0,30,0
1713332656974,MATH 109,A02,494092,Staff,29,0,30,1
1713332656974,MATH 109,B01,494094,Staff,27,0,30,3
1713332656974,MATH 109,B02,494095,Staff,29,0,30,1
1713332658006,MATH 142A,A01,494097,Chow; Bennett,15,0,30,15
1713332658006,MATH 142A,A02,494098,Chow; Bennett,23,0,30,7
1713332658006,MATH 142A,B01,494100,Chow; Bennett,19,0,30,11
1713332658006,MATH 142A,B02,494101,Chow; Bennett,29,0,30,1
1713332660064,MATH 168A,A01,516677,Dumitriu; Ioana,16,0,35,19
1713332661093,MATH 170A,A01,516679,Dumitriu; Ioana,18,0,30,12
1713332661093,MATH 170A,A02,516680,Dumitriu; Ioana,28,0,30,2
1713332662120,MATH 193A,A01,494107,Staff,13,0,30,17
1713332662120,MATH 193A,A02,494108,Staff,19,0,30,11
1713332662120,MATH 193A,A03,494109,Staff,29,0,30,1
1713332662120,MATH 193A,A04,494110,Staff,22,0,30,8
1713332665197,MGT 16,A00,491930,McKay; Michael J,92,0,98,6
1713332666222,MGT 18,A00,491992,McKay; Michael J,96,0,98,2
1713332667245,MGT 71,A00,492003,Staff,63,0,98,35
1713332668274,MGT 103,A00,505209,Eberhard; Craig A,81,0,98,17
1713332669301,MGT 131A,A00,505210,Anderson; John Charles,89,0,98,9
1713332671354,MGT 153,A00,492077,Perols; Johan Lars,18,0,90,72
1713332674431,MGT 164,A00,492222,McKay; Mary A,91,0,98,7
1713332675458,MGT 172,A00,492245,Staff,59,0,60,1
1713332675458,MGT 172,B00,505526,Hedges; Kathleen,65,0,98,33
1713332676483,MGT 181,A00,505669,Dunn; Louis Jean,80,0,98,18
1713332677510,MMW 14,A01,494399,Staff,15,0,28,13
1713332677510,MMW 14,A02,494400,Staff,25,0,28,3
1713332677510,MMW 14,A03,494401,Staff,28,0,28,0
1713332677510,MMW 14,A04,494402,Staff,28,0,28,0
1713332677510,MMW 14,B01,494404,Carreras; Maria Victoria,8,0,28,20
1713332677510,MMW 14,B02,494405,Carreras; Maria Victoria,25,0,28,3
1713332677510,MMW 14,B03,494406,Carreras; Maria Victoria,27,0,28,1
1713332677510,MMW 14,B04,494407,Carreras; Maria Victoria,28,0,28,0
1713332678535,MMW 14GS,A00,506250,Chang; Edmond Yi-Teh,0,0,0,0
1713332679560,MMW 121R,A01,494415,Adamiak; Patrick John,10,0,28,18
1713332679560,MMW 121R,A02,494416,Adamiak; Patrick John,24,0,28,4
1713332680587,MUS 1A,A01,494113,Staff,12,0,25,13
1713332680587,MUS 1A,A02,494114,Staff,24,0,25,1
1713332681613,MUS 4,A01,494116,Staff,23,0,25,2
1713332681613,MUS 4,A02,494117,Staff,22,0,25,3
1713332682644,MUS 5R,A01,494236,Dubnov; Shlomo,6,0,25,19
1713332682644,MUS 5R,A02,494237,Dubnov; Shlomo,25,0,25,0
1713332683674,MUS 6,A01,494122,Staff,10,0,25,15
1713332683674,MUS 6,A02,494123,Staff,23,0,25,2
1713332684699,MUS 7,A01,494125,Staff,16,0,25,9
1713332684699,MUS 7,A02,494126,Staff,24,0,25,1
1713332685726,MUS 11,A01,494128,Staff,23,0,25,2
1713332685726,MUS 11,A02,494129,Staff,24,0,25,1
1713332686757,MUS 13,A01,494131,Staff,25,0,25,0
1713332686757,MUS 13,A02,494132,Staff,25,0,25,0
1713332687780,MUS 15,A01,494134,Staff,16,0,25,9
1713332687780,MUS 15,A02,494135,Staff,25,0,25,0
1713332687780,MUS 15,B01,494137,Staff,24,0,25,1
1713332688806,MUS 80,A00,494232,Staff,24,0,25,1
1713332688806,MUS 80,B00,494233,Staff,25,0,25,0
1713332688806,MUS 80,C00,494234,Staff,23,0,25,2
1713332689832,MUS 95C,A00,494141,Staff,70,0,75,5
1713332690859,MUS 114,A00,494142,Staff,40,0,50,10
1713332691886,NANO 15,A01,490636,Drews; Aaron,7,0,7,0
1713332692917,PHIL 1,A00,490578,Grush; Rick Scott,49,0,50,1
1713332693943,PHIL 10,A01,490580,Grush; Rick Scott,33,0,35,2
1713332693943,PHIL 10,A02,490586,Grush; Rick Scott,32,0,35,3
1713332694968,PHIL 27,A01,490591,Staff,22,0,25,3
1713332694968,PHIL 27,A02,490592,Staff,25,0,25,0
1713332694968,PHIL 27,A03,490593,Staff,25,0,25,0
1713332694968,PHIL 27,A04,490598,Staff,25,0,25,0
1713332695996,PHIL 32,A01,490611,Staff,20,0,20,0
1713332695996,PHIL 32,A02,490618,Staff,20,0,20,0
1713332697020,PHIL 90,A00,490624,Staff,40,0,40,0
1713332698046,PHIL 136,A00,490627,Cohen; Jonathan David,37,0,40,3
1713332699130,PHIL 155,A00,490634,Staff,62,0,70,8
1713332700166,PHYS 1A,A00,491610,Staff,245,0,250,5
1713332701191,PHYS 1AL,001,491616,Tsai; Philbert S,27,0,30,3
1713332701191,PHYS 1AL,002,491618,Tsai; Philbert S,30,0,30,0
1713332702219,PHYS 1B,A00,491623,Staff,236,0,250,14
1713332703242,PHYS 1BL,001,491626,Tsai; Philbert S,22,0,30,8
1713332703242,PHYS 1BL,002,491628,Tsai; Philbert S,26,0,30,4
1713332704267,PHYS 1C,A00,491632,Staff,213,0,245,32
1713332705291,PHYS 1CL,001,491635,Tsai; Philbert S,2,0,30,28
1713332705291,PHYS 1CL,002,491643,Tsai; Philbert S,22,0,30,8
1713332706322,PHYS 2AR,A01,491651,Meyertholen; Andrew D.,44,0,50,6
1713332707347,PHYS 2B,A01,491659,Staff,106,0,115,9
1713332708376,PHYS 2BL,A01,491685,Staff,21,0,24,3
1713332708376,PHYS 2BL,A02,491700,Staff,21,0,24,3
1713332709403,PHYS 2C,A01,505161,Staff,101,0,115,14
1713332710430,PHYS 4A,A01,491704,Grinstein; Benjamin,99,0,100,1
1713332711461,POLI 5D,A01,494144,Staff,3,0,5,2
1713332711461,POLI 5D,B01,626283,Dai; Yinlin,5,0,5,0
1713332712490,POLI 12,A00,494145,Staff,43,0,45,2
1713332713515,POLI 13R,A00,494146,Forman; Fonna,45,0,50,5
1713332714543,POLI 27,A01,494148,Staff,54,0,60,6
1713332715571,POLI 30,A00,494149,Staff,49,0,50,1
1713332716598,POLI 100DA,A00,494150,Staff,21,0,25,4
1713332718649,POLI 100I,A00,494152,Staff,27,0,30,3
1713332719675,POLI 104B,A00,494153,Smith; Glenn Chatmas,53,0,55,2
1713332720703,POLI 104F,A00,494154,Staff,28,0,30,2
1713332721731,POLI 104I,A00,494155,Smith; Glenn Chatmas,29,0,30,1
1713332722755,POLI 110C,A00,494156,Ingham; Sean,23,0,25,2
1713332723784,POLI 117R,A00,494157,Forman; Fonna,6,0,20,14
1713332724809,POLI 118,A00,494158,Ingham; Sean,21,0,25,4
1713332725838,POLI 120H,A00,494159,Fisk; David Lee,39,0,45,6
1713332726862,POLI 131CR,A00,494160,Hoston; Germaine,35,0,45,10
1713332727890,POLI 133J,A00,494161,Staff,32,0,35,3
1713332728916,POLI 135,A00,494162,Fisk; David Lee,33,0,35,2
1713332729941,POLI 140A,A00,494164,Staff,19,0,30,11
1713332730966,POLI 142I,A00,494165,Staff,30,0,30,0
1713332731991,POLI 144D,A00,494166,Staff,23,0,25,2
1713332733023,POLI 151,A00,494167,Staff,30,0,30,0
1713332734048,POLI 153,A00,494168,Staff,33,0,35,2
1713332735077,POLI 160AA,A00,494169,Staff,34,0,40,6
1713332736103,POLI 162,A00,494170,Mignozzetti; Umberto,18,0,25,7
1713332737132,POLI 171,A00,494171,Mignozzetti; Umberto,18,0,25,7
1713332738157,PSYC 1,A00,494172,Staff,95,0,100,5
1713332739183,PSYC 2,A00,494173,Moranton; Nirelia Melbina-,34,0,50,16
1713332740208,PSYC 3,A00,494174,Staff,29,0,30,1
1713332741234,PSYC 6,A00,494175,Staff,17,0,20,3
1713332742258,PSYC 60,A01,494177,Staff,37,0,45,8
1713332743283,PSYC 70,A01,505724,Geller; Emma Harlan,42,0,45,3
1713332744311,PSYC 101,A00,494180,Heyman; Gail D.,84,0,100,16
1713332745336,PSYC 105,A00,494181,Geller; Emma Harlan,51,0,90,39
1713332746362,PSYC 106,A00,494182,Dobkins; Karen R.,27,0,45,18
1713332747393,PSYC 108,A00,494183,Adrian; Julia Anna,89,0,100,11
1713332748418,PSYC 114,A01,494185,Winkielman; Piotr,0,3,30,30
1713332749442,PSYC 122,A00,494186,Moranton; Nirelia Melbina-,27,0,50,23
1713332750471,PSYC 124,A00,494187,Chapman; Eddie Nathaniel,70,0,80,10
1713332751495,PSYC 131,A00,494188,Anagnostaras; Stephan,41,0,80,39
1713332752521,PSYC 144,A00,494189,Staff,3,0,50,47
1713332753547,PSYC 154,A00,494190,Lacefield; Katharine I,107,0,180,73
1713332754571,PSYC 162,A00,494191,Wixted; John T,71,0,100,29
1713332755600,PSYC 172,A00,494192,Gorman; Michael R.,36,0,45,9
1713332756630,PSYC 178,A00,494193,Glaser; Dale,34,0,45,11
1713332757654,PSYC 193,A00,505725,Chapman; Eddie Nathaniel,20,0,20,0
1713332758682,RELI 145GS,A00,519817,Rahimi; Babak,18,0,20,2
1713332759709,SE 101A,A01,490862,Chadha; Mayank,23,0,25,2
1713332760734,SE 101C,A01,490924,Krysl; Petr,15,0,20,5
1713332761758,SE 110A,A01,490928,Staff,19,0,20,1
1713332762783,SE 130A,A00,490929,Morrison; Machel Leigh,54,0,70,16
1713332763813,SIO 1,A01,519325,Staff,39,0,40,1
1713332764842,SIO 30,A01,519327,Staff,38,0,40,2
1713332765866,SIO 40,A00,519328,Staff,39,0,40,1
1713332766895,SIO 46GS,A00,519819,Cook; Geoffrey W,17,0,25,8
1713332767924,SIO 109R,A00,494197,Forman; Fonna,0,3,20,20
1713332768951,SIO 121GS,A00,519827,Cook; Geoffrey W,17,0,25,8
1713332769976,SIO 132,A01,519330,Staff,38,0,40,2
1713332771001,SIO 133,A01,519397,Staff,37,0,40,3
1713332772029,SIO 139,A00,519396,Kacev; David,29,0,40,11
1713332773059,SOCI 1,A01,494199,Thorpe; Charles Robert,21,0,30,9
1713332773059,SOCI 1,A02,494200,Thorpe; Charles Robert,30,0,30,0
1713332773059,SOCI 1,A03,494201,Thorpe; Charles Robert,29,0,30,1
1713332773059,SOCI 1,A04,494202,Thorpe; Charles Robert,29,0,30,1
1713332773059,SOCI 1,A05,494203,Thorpe; Charles Robert,29,0,30,1
1713332773059,SOCI 1,A06,494204,Thorpe; Charles Robert,30,0,30,0
1713332773059,SOCI 1,A07,494205,Thorpe; Charles Robert,28,0,30,2
1713332774086,SOCI 60,A01,494207,Staff,34,0,40,6
1713332774086,SOCI 60,A02,494208,Staff,39,0,40,1
1713332775112,SOCI 100,A01,494210,Payne; Christine Anna,25,0,30,5
1713332775112,SOCI 100,A02,494211,Payne; Christine Anna,26,0,30,4
1713332776141,SOCI 109M,A00,494212,Staff,20,0,20,0
1713332777167,SOCI 110,A00,494213,Staff,34,0,40,6
1713332779222,SOCI 118E,A00,494215,Ng; Kwai,37,0,40,3
1713332780249,SOCI 125,A00,494216,Calderon-Zaks; Michael Aar,40,0,45,5
1713332781275,SOCI 126,A01,494218,Jones; Makeba,3,0,5,2
1713332782305,SOCI 131,A00,494219,Thorpe; Charles Robert,26,0,30,4
1713332784355,SOCI 135,A00,494221,Payne; Christine Anna,28,0,50,22
1713332785381,SOCI 136E,A00,626690,Ruiz; Jonathan Joseph,24,0,25,1
1713332786405,SOCI 138GS,A00,494222,Navon; Daniel,24,0,28,4
1713332788455,SOCI 145,A00,494224,Staff,40,0,45,5
1713332789480,SOCI 153,A00,494225,Staff,28,0,30,2
1713332790505,SOCI 160E,A00,494226,Ng; Kwai,29,0,40,11
1713332791535,SOCI 180,A00,494227,Staff,29,0,30,1
1713332792559,SOCI 189GS,A00,494228,Ribas Norris; Janet Vanesa,11,0,11,0
1713332793587,SOCI 190GS,A00,553232,Ribas Norris; Janet Vanesa,11,0,11,0
1713332794618,SOMI 220,A00,627178,Schneid; Stephen David,30,0,30,0
1713332795936,SYN 2,001,490768,Staff,13,0,15,2
1713332795936,SYN 2,002,490769,Staff,14,0,15,1
1713332795936,SYN 2,004,490775,Staff,0,0,0,0
1713332795936,SYN 2,003,490774,Staff,0,0,0,0
1713332795936,SYN 2,005,490776,Staff,0,0,0,0
1713332796967,SYN 2R,001,490779,Staff,11,0,15,4
1713332796967,SYN 2R,002,514635,Staff,14,0,15,1
1713332797993,SYN 100,A01,490783,Staff,9,0,20,11
1713332797993,SYN 100,B01,490787,Staff,9,0,20,11
1713332797993,SYN 100,C01,490789,Staff,10,0,20,10
1713332799021,SYN 150,A00,490817,Staff,14,0,15,1
1713332799021,SYN 150,B00,514610,Staff,15,0,15,0
1713332800050,TDAC 1,A00,492753,Walsh; Kim C.,19,0,20,1
1713332800050,TDAC 1,B00,492754,Harting; Carla Kelso,19,0,20,1
1713332800050,TDAC 1,C00,513995,Salovey; Todd,15,0,20,5
1713332801084,TDAC 101,A00,492766,Harting; Carla Kelso,17,0,20,3
1713332802110,TDAC 102,A00,492768,Basso; Beatrice,19,0,20,1
1713332803190,TDDE 111,A00,492769,Staff,25,0,25,0
1713332804218,TDDE 131,A00,492770,Staff,15,0,15,0
1713332804218,TDDE 131,B00,492771,Staff,15,0,15,0
1713332805247,TDDE 131GS,A00,523716,Guirguis; Mark C,23,0,28,5
1713332806274,TDGE 1,A01,492756,Salovey; Todd,56,0,60,4
1713332807301,TDGE 5,A01,492758,Staff,23,0,25,2
1713332808327,TDGE 10,A00,492759,Fulton; Julia,203,0,220,17
1713332809352,TDGE 11,A00,492760,Castro; Robert Jess,198,0,200,2
1713332811406,TDGE 124,A00,492772,Fulton; Julia,184,0,220,36
1713332812432,TDGE 125,A00,492773,Meyer; Ursula,38,0,50,12
1713332812432,TDGE 125,B00,492774,Staff,49,0,50,1
1713332812432,TDGE 125,C00,523565,Staff,48,0,50,2
1713332813456,TDGE 125GS,A00,523580,Guirguis; Mark C,23,0,28,5
1713332814482,TDGE 127,A00,492775,Havis; Allan,33,0,50,17
1713332815507,TDHT 101,A00,492776,Staff,34,0,35,1
1713332816533,TDMV 1,A00,492762,Caligagan; Maria T.,29,0,30,1
1713332816533,TDMV 1,B00,492763,Arcidiacono; Kristin,26,0,30,4
1713332817561,TDMV 2,A00,492764,Weinberg; Sadie,28,0,30,2
1713332818590,TDMV 3,A00,492765,Mack; Kara Shanai',37,0,40,3
1713332819620,TDMV 138,A00,492777,Mack; Kara Shanai',34,0,40,6
1713332820648,TDMV 140,A00,492778,Lima; Paulo Henrique,40,0,40,0
1713332821674,TDMV 142,A00,492779,Caligagan; Maria T.,33,0,40,7
1713332821674,TDMV 142,B00,492780,Caligagan; Tony,37,0,40,3
1713332822699,TDMV 143,A00,492781,Fyall; Daunte Edward,39,0,40,1
1713332823726,USP 1,A01,492401,Kwak; Nancy,27,0,35,8
1713332824750,USP 2,A01,492453,Hinds; Juli Beth,35,0,35,0
1713332825775,USP 3,A01,492516,Staff,28,0,35,7
1713332826800,USP 4,A00,492522,McTague; Sarah,16,0,25,9
1713332827827,USP 100,A00,492523,Staff,32,0,35,3
1713332828853,USP 101,A00,492524,Staff,13,0,15,2
1713332829877,USP 105,A00,492525,Staff,21,0,25,4
1713332830904,USP 151,A00,492526,Shenkman; Michael Thomas,32,0,35,3
1713332831930,USP 170,A00,492545,Hinds; Juli Beth,33,0,35,2
1713332832957,USP 171GS,A00,492608,Bussell; Mirle Rabinowitz,24,0,28,4
1713332833983,USP 183GS,A00,492613,Peerson; Susan,24,0,28,4
1713332835019,VIS 30,A01,490693,Yoldas; Pinar,19,0,22,3
1713332835019,VIS 30,A02,490694,Yoldas; Pinar,18,0,22,4
1713332836052,VIS 83,A00,490695,Kester; Grant,63,0,75,12
1713332837080,VIS 105D,A00,490696,Staff,22,0,25,3
1713332838108,VIS 124CN,A00,490699,Rose; Jordan M,65,0,75,10
1713332839132,VIS 125GS,A00,511221,Williams; Alena J,21,0,22,1
1713332840160,VIS 128D,A00,490700,Staff,73,0,75,2
1713332841185,VIS 151,A01,490717,Staff,33,0,34,1
1713332841185,VIS 151,A02,490766,Staff,33,0,34,1
1713332842211,VIS 154GS,A00,511972,Williams; Alena J,21,0,22,1
1713332843242,VIS 160A,A00,490767,Stone; Patricia,7,0,10,3
1713332844269,WCWP 10A,A00,490638,Staff,14,0,15,1
1713332844269,WCWP 10A,B00,490640,Staff,15,0,15,0
1713332845297,WCWP 10B,A00,490641,Staff,0,0,0,0
1713332845297,WCWP 10B,B00,490642,Staff,14,0,15,1
1713332845297,WCWP 10B,C00,490644,Staff,13,0,15,2
1713332845297,WCWP 10B,D00,490647,Staff,0,0,0,0
1713332846324,WCWP 100,A00,490655,Staff,0,0,0,0
1713332846324,WCWP 100,B00,490687,Staff,10,0,15,5
1713332848423,ANAR 153,A00,487222,Braswell; Geoffrey E.,53,0,60,7
1713332849453,ANBI 134,A00,487223,Staff,5,0,20,15
1713332850478,ANBI 143GS,A00,487224,Noel; Geoffroy Pierre Jean,18,0,24,6
1713332851507,ANBI 144GS,A00,519548,Noel; Geoffroy Pierre Jean,18,0,24,6
1713332852535,ANSC 101,A00,487225,Staff,18,0,20,2
1713332853562,ANSC 125,A00,487227,Brenner; Suzanne A,38,0,40,2
1713332855612,ANSC 146,A00,487229,Staff,35,0,40,5
1713332856636,ANSC 148,A00,487230,Olivas Hernandez; Olga Lid,39,0,40,1
1713332857664,ANSC 150,A00,504165,Sloane; Julia Kathryn,18,0,20,2
1713332858690,ANSC 180,A00,487232,Staff,14,0,15,1
1713332859716,ANSC 188,A00,627155,Staff,38,0,40,2
1713332860747,ANTH 5,A00,519529,Semendeferi; Ekaterini,15,0,15,0
1713332861775,ANTH 10,A00,487219,Staff,58,0,60,2
1713332862804,ANTH 23,A01,487221,Staff,17,0,20,3
1713332863829,ANTH 102,A00,487233,Wilder; Linnea Lorene,51,0,60,9
1713332864860,ANTH 103,A00,487234,Varma; Saiba,55,0,60,5
1713332865888,ANTH 105,A00,487235,Stewart; Alexander B,54,0,60,6
1713332866918,BENG 100,A01,516685,Taylor Amos; Alyssa C,26,0,30,4
1713332867945,BIBC 102,A01,491316,Flagg; Matthew Paul,10,0,88,78
1713332867945,BIBC 102,A02,491366,Flagg; Matthew Paul,78,0,88,10
1713332868972,BIBC 103,A01,491486,Boumechache; Miyyada,16,0,24,8
1713332868972,BIBC 103,A02,491487,Boumechache; Miyyada,24,0,24,0
1713332869999,BICD 100,A01,516882,Staff,73,0,75,2
1713332869999,BICD 100,A02,516890,Staff,69,0,75,6
1713332871024,BICD 102GS,A00,491488,Lo; Stanley M.,26,0,28,2
1713332872051,BIEB 136GS,A00,516940,Holway; David A. & Shurin; Jonathan,18,0,24,6
1713332873075,BIEB 137GS,A01,517034,Holway; David A. & Shurin; Jonathan,18,0,24,6
1713332874102,BIEB 138GS,A01,491492,Pirino; Giorgia,21,0,28,7
1713332875128,BILD 1,A01,491296,Staff,60,0,63,3
1713332875128,BILD 1,A02,491297,Staff,63,0,63,0
1713332876154,BILD 4,A01,517099,Gonzalez Gamboa; Ivonne,22,0,24,2
1713332876154,BILD 4,A02,517100,Gonzalez Gamboa; Ivonne,24,0,24,0
1713332877178,BILD 60GS,A00,491309,Lo; Stanley M.,26,0,28,2
1713332878204,BIMM 100,A01,517136,Staff,83,0,100,17
1713332879230,BIMM 110,A01,517182,Staff,54,0,100,46
1713332880261,BIMM 120,A01,517228,Pickett; Brooke Elizabeth,28,0,63,35
1713332880261,BIMM 120,A02,517240,Pickett; Brooke Elizabeth,44,0,63,19
1713332881292,BIMM 132GS,A01,491498,Pirino; Giorgia,21,0,28,7
1713332882319,BIMM 143,A01,491589,Bozinovic; Goran,12,0,40,28
1713332883348,BIPN 100,A01,491594,Armour; Jon Christopher,83,0,100,17
1713332884384,BIPN 140,A01,491602,Marino; Marc J,25,0,50,25
1713332886434,CAT 125,A00,515973,Staff,18,0,20,2
1713332887462,CAT 125GS,A00,515974,Rahimi; Babak,17,0,20,3
1713332888490,CAT 125R,A00,515980,Staff,12,0,20,8
1713332888490,CAT 125R,B00,515981,Tosun; Adriana,19,0,20,1
1713332888490,CAT 125R,C00,515987,Hyland; Tina Mae,0,3,20,20
1713332888490,CAT 125R,D00,515988,Bronstein; Phoebe Malan,16,0,20,4
1713332889514,CENG 15,A01,488699,Drews; Aaron,25,0,25,0
1713332890538,CENG 100,A00,505196,Opatkiewicz; Justin Paul,25,0,25,0
1713332891563,CGS 2A,A01,489598,Staff,33,0,35,2
1713332892588,CGS 112,A00,489599,Staff,15,0,15,0
1713332893615,CGS 119,A00,489603,Staff,10,0,10,0
1713332894641,CGS 120,A00,489604,Staff,14,0,15,1
1713332895666,CGS 150,A00,489607,Staff,15,0,15,0
1713332896696,CHEM 6A,A01,488715,Staff,97,0,100,3
1713332897723,CHEM 6B,A01,488719,Piercy; Marc Anthony,99,0,100,1
1713332898749,CHEM 6C,A01,488723,Albizati; Kim F.,93,0,100,7
1713332899778,CHEM 7L,A01,488728,Schurmeier; Kimberly,18,0,24,6
1713332899778,CHEM 7L,A02,488730,Schurmeier; Kimberly,23,0,24,1
1713332899778,CHEM 7L,A03,488734,Schurmeier; Kimberly,20,0,24,4
1713332899778,CHEM 7L,A04,488763,Schurmeier; Kimberly,23,0,24,1
1713332899778,CHEM 7L,B01,488798,Schurmeier; Kimberly,17,0,24,7
1713332899778,CHEM 7L,B02,488801,Schurmeier; Kimberly,22,0,24,2
1713332899778,CHEM 7L,B03,488808,Schurmeier; Kimberly,22,0,24,2
1713332899778,CHEM 7L,B04,488811,Schurmeier; Kimberly,24,0,24,0
1713332900803,CHEM 11,A01,488897,Stallings; Dontarie M,95,0,100,5
1713332901834,CHEM 40A,A01,488913,Albizati; Kim F.,83,0,100,17
1713332902862,CHEM 40B,A01,488920,Weizman; Haim,43,0,50,7
1713332902862,CHEM 40B,A02,488938,Weizman; Haim,44,0,50,6
1713332903891,CHEM 41A,A01,489029,Klosterman; Jeremy K,57,0,60,3
1713332904918,CHEM 41C,A01,500436,Tor; Yitzhak,55,0,60,5
1713332905945,CHEM 43A,A01,500426,Weizman; Haim,0,0,24,24
1713332905945,CHEM 43A,A02,500430,Weizman; Haim,7,0,24,17
1713332905945,CHEM 43A,B01,514041,Klosterman; Jeremy K,16,0,24,8
1713332905945,CHEM 43A,B02,514047,Klosterman; Jeremy K,23,0,24,1
1713332907050,CHEM 108,A01,489140,Jennings; Patricia A.,8,0,24,16
1713332907050,CHEM 108,A02,489142,Jennings; Patricia A.,14,0,24,10
1713332908075,CHEM 114A,A01,489147,Stallings; Dontarie M,68,0,100,32
1713332909102,CHIN 169A,A00,489171,Wang; Xiao,19,0,20,1
1713332911154,COGS 3,A01,518827,Boyle; Mary E. T.,25,0,40,15
1713332912184,COGS 11,A01,489175,Staff,27,0,30,3
1713332913209,COGS 14A,A01,518829,Staff,51,0,60,9
1713332914241,COGS 14B,A01,489177,Hoffman; Drew Ellen,62,0,75,13
1713332915268,COGS 100,A01,489181,Allen; Michael Gordon,62,0,75,13
1713332916295,COGS 101A,A01,489183,Staff,45,0,60,15
1713332917324,COGS 101B,A01,489185,Allen; Michael Gordon,8,0,30,22
1713332918355,COGS 101C,A01,526786,Staff,23,0,30,7
1713332920406,COGS 107A,A01,489189,Boyle; Mary E. T.,17,0,35,18
1713332921432,COGS 107B,A01,627144,Mooshagian; Eric Frederick,60,0,60,0
1713332922458,COGS 118A,A01,489191,Staff,0,45,40,40
1713332924514,COGS 171GS,A01,489194,Pineda; Jaime A,19,0,28,9
1713332925543,COGS 172,A01,489196,Staff,2,0,30,28
1713332926568,COGS 174GS,A01,489264,Pineda; Jaime A,19,0,28,9
1713332927597,COGS 180,A01,627150,Staff,28,0,30,2
1713332928623,COGS 186,A01,489274,Staff,0,1,30,30
1713332929650,COMM 10,A01,489276,Staff,23,0,25,2
1713332929650,COMM 10,A02,489303,Staff,23,0,25,2
1713332930676,COMM 100A,A01,489312,Staff,14,0,25,11
1713332930676,COMM 100A,A02,489313,Staff,24,0,25,1
1713332931703,COMM 106T,A00,512540,Staff,33,0,35,2
1713332932727,COMM 107,A00,489347,Staff,27,0,35,8
1713332933756,COMM 109P,A00,489358,Staff,31,0,35,4
1713332934783,COMM 132,A00,489361,McKenna; Denise,27,0,30,3
1713332935809,COMM 146,A00,489362,Halm; Gavin Patrick,26,0,30,4
1713332936834,COMM 190,A00,489363,Abuelhiga; Soraya Jill,17,0,23,6
1713332937861,CSE 8A,A50,489366,Staff,21,0,25,4
1713332937861,CSE 8A,A51,489367,Staff,24,0,25,1
1713332938886,CSE 11,A01,489398,Cao; Yingjun,73,0,100,27
1713332939912,CSE 12,A01,489487,Staff,43,0,50,7
1713332940941,CSE 20,A01,489497,Staff,48,0,50,2
1713332941972,CSE 21,A01,489517,Braun; Oliver,42,0,50,8
1713332942997,CSE 101,A01,489524,Braun; Oliver,0,32,50,50
1713332944031,CSE 105,A01,512594,Jones; Miles E,72,0,100,28
1713332944031,CSE 105,B01,512598,Jones; Miles E,52,0,100,48
1713332945058,CSE 140,A01,489538,Staff,41,0,50,9
1713332946083,CSE 141,A01,489550,Eldon; John,67,0,100,33
1713332947112,CSE 141L,A01,489571,Eldon; John,65,0,100,35
1713332948138,CSE 151A,A01,489583,Solares; Edwin A,141,0,200,59
1713332949163,CSE 175,A01,510886,Kumar; Rakesh,30,0,30,0
1713332950189,CSE 190,A00,516828,Dubnov; Shlomo,38,0,49,11
1713332951216,DOC 100D,A00,489667,Pass; Natalye Joann,19,0,25,6
1713332952245,DSC 10,A01,624268,Staff,72,0,75,3
1713332953273,DSC 20,A01,624476,Staff,50,0,50,0
1713332954297,DSC 40A,A01,624608,Staff,39,0,40,1
1713332955328,DSGN 1,A01,489179,Rill; Bryan,32,0,50,18
1713332956359,ECE 17,A01,490489,Sahay; Rajeev,18,0,30,12
1713332957388,ECE 65,A50,490492,Staff,11,0,20,9
1713332957388,ECE 65,A51,490493,Staff,18,0,20,2
1713332958417,ECON 1,A01,489715,Famulari; Melissa,67,0,70,3
1713332959443,ECON 2,A01,489717,Levkoff; Steven B.,68,0,70,2
1713332960471,ECON 3,A01,489948,Staff,70,0,70,0
1713332962522,ECON 5,A01,490103,Staff,27,0,30,3
1713332962522,ECON 5,B01,626281,Dai; Yinlin,45,0,45,0
1713332963554,ECON 100A,A01,490127,Famulari; Melissa,65,0,70,5
1713332964583,ECON 100B,A01,490129,Staff,64,0,70,6
1713332965610,ECON 109,A01,490187,Shishkin; Denis,27,0,35,8
1713332966636,ECON 110A,A01,490190,Levkoff; Steven B.,60,0,70,10
1713332967665,ECON 120A,A01,490245,Dai; Yinlin,61,0,70,9
1713332968688,ECON 120B,A01,490247,Nieto-Barthaburu; Augusto,40,0,70,30
1713332969720,ECON 120C,A01,490253,Sun; Yixiao,30,0,35,5
1713332969720,ECON 120C,B01,490255,Sun; Yixiao,34,0,35,1
1713332970746,ECON 129,A00,490256,Eckert; Fabian Paul,22,0,35,13
1713332971772,ECON 131,A00,490257,Nieto-Barthaburu; Augusto,0,6,35,35
1713332972799,ECON 138,A00,490258,Bharadwaj; Prashant,13,0,35,22
1713332972799,ECON 138,B00,490259,Bharadwaj; Prashant,15,0,35,20
1713332973825,ECON 159,A00,490260,Hendrickson; Gerald M.,0,9,0,0
1713332974853,ECON 178,A01,553995,Zhu; Ying,24,0,35,11
1713332975881,EDS 40,A01,512576,Black; Alison Michelle,20,0,20,0
1713332976906,EDS 107,A01,515848,Staff,30,0,30,0
1713332977935,EDS 110R,A01,490262,Staff,26,0,30,4
1713332978961,EDS 112,A01,490264,Chapman; Thandeka K,40,0,50,10
1713332979990,EDS 113,A00,490266,Staff,26,0,30,4
1713332981020,EDS 118,A00,490267,Warstadt; Melissa Fawn,20,0,30,10
1713332982046,EDS 124BR,A00,490268,Eguchi; Emi,4,0,25,21
1713332982046,EDS 124BR,B00,490269,Eguchi; Emi,23,0,25,2
1713332983071,EDS 126,A01,490271,Jones; Makeba,43,0,50,7
1713332984098,EDS 135,A01,490316,Staff,19,0,20,1
1713332985122,ENVR 142GS,A00,519514,Chang; Edmond Yi-Teh,26,0,28,2
1713332986151,ETHN 103,A00,490504,Staff,25,0,36,11
1713332987178,ETHN 103A,A00,490505,Man; Simeon S,4,0,9,5
1713332988204,ETHN 109,A00,490506,Staff,28,0,30,2
1713332989232,ETHN 118,A00,490507,Staff,35,0,36,1
1713332990260,ETHN 119,A00,490508,Staff,33,0,36,3
1713332991285,ETHN 121R,A00,490518,Choi; Esther Min,21,0,36,15
1713332992309,ETHN 127,A00,490528,Staff,14,0,15,1
1713332993337,ETHN 139,A00,490573,Staff,10,0,10,0
1713332994362,ETHN 150,A00,490575,Staff,15,0,15,0
1713332995392,GLBH 20,A00,491705,Elwardani; Nile Regina,38,0,40,2
1713332996417,GLBH 101,A00,491706,Staff,20,0,20,0
1713332997443,GLBH 111,A01,491708,Burgos; Jose L.,15,0,15,0
1713332998469,GLBH 146,A00,491709,Staff,9,0,20,11
1713332999494,GLBH 148,A00,491710,Olivas Hernandez; Olga Lid,11,0,20,9
1713333000523,GLBH 150,A00,491711,Sloane; Julia Kathryn,19,0,20,1
1713333001548,HIEA 131,A00,491760,Staff,28,0,32,4
1713333002573,HIEA 153,A00,491762,Staff,28,0,30,2
1713333003598,HIEU 124,A00,491811,Staff,26,0,32,6
1713333004628,HIEU 124GS,A00,491812,Markman; Kristina,27,0,28,1
1713333005656,HIEU 147,A00,491813,Staff,30,0,32,2
1713333006684,HIEU 149GS,A00,491816,Caldwell; Michael Alan,28,0,28,0
1713333007715,HILD 2C,A01,491713,Hendrickson; Gerald M.,26,0,30,4
1713333008744,HILD 7B,A01,491715,Kwak; Nancy,0,2,30,30
1713333009770,HILD 10,A01,491717,Staff,11,0,20,9
1713333010852,HILD 30GS,A00,491719,Edington; Claire Ellen,24,0,28,4
1713333011882,HINE 109,A00,491818,Shafir; Nir,27,0,32,5
1713333012906,HINE 128,A00,491821,Shafir; Nir,31,0,32,1
1713333013931,HISC 117,A00,491830,Staff,27,0,32,5
1713333014958,HIUS 103,A00,491834,Man; Simeon S,14,0,23,9
1713333015987,HIUS 108B,A00,491835,Staff,27,0,30,3
1713333017013,HIUS 141,A00,491836,Hendrickson; Gerald M.,28,0,32,4
1713333018038,HIUS 149,A00,491839,Staff,24,0,32,8
1713333019070,HUM 3,A01,512617,Crum; Matthew Stephen,42,0,50,8
1713333019070,HUM 3,A02,512618,Crum; Matthew Stephen,48,0,50,2
1713333020100,HUM 3GS,A00,512663,Markman; Kristina,0,0,0,1
1713333020100,HUM 3GS,B00,512664,Staff,0,0,0,0
1713333021125,HUM 4,A01,512620,West; Geoffrey Scott,25,0,50,25
1713333022147,HUM 4GS,A00,512666,Lyon; Antony J.,0,0,0,5
1713333023173,HUM 4R,A01,512625,Watkins; Eric,49,0,50,1
1713333024202,HUM 5,A01,512649,Zavodny; Tatiana Sophia,23,0,50,27
1713333024202,HUM 5,B01,512661,Zroka; Ryan Edward,48,0,50,2
1713333025229,INTL 190,A00,490577,Segui; Alan S,0,0,0,5
1713333026256,JAPN 20AR,A01,491267,Ross; Kayoko F,7,0,20,13
1713333027285,JAPN 180,A00,491285,Berman; Michael David,33,0,40,7
1713333028312,LATI 50,A01,502536,Kokinis; Troy Andreas,16,0,22,6
1713333028312,LATI 50,A02,502551,Kokinis; Troy Andreas,22,0,22,0
1713333028312,LATI 50,A03,502650,Kokinis; Troy Andreas,22,0,22,0
1713333028312,LATI 50,A04,502909,Kokinis; Troy Andreas,21,0,22,1
1713333029335,LATI 160,A01,502920,Kokinis; Troy Andreas,30,0,30,0
1713333030361,LIFR 1A,A00,490494,Van Moer; Vinciane G,17,0,20,3
1713333031391,LIFR 1AX,A00,490495,Van Moer; Vinciane G,17,0,20,3
1713333032421,LIFR 1B,A00,490496,Van Moer; Vinciane G,17,0,20,3
1713333033446,LIFR 1BX,A00,490497,Van Moer; Vinciane G,17,0,20,3
1713333034471,LIGN 8,A00,505198,McIntosh; Justin Daniel,134,0,150,16
1713333035497,LIGN 9GS,A00,491239,Lott; Margaret S.,18,0,20,2
1713333036521,LIGN 101,A01,505200,McIntosh; Justin Daniel,22,0,30,8
1713333037550,LIGN 120,A01,491244,Staff,22,0,30,8
1713333038575,LIGN 149GS,A00,491245,Lott; Margaret S.,18,0,20,2
1713333039601,LIGN 170,A00,491247,Staff,22,0,30,8
1713333040627,LISP 1D,A00,490498,Munoz Sanchez; Alicia,8,0,14,6
1713333040627,LISP 1D,B00,490499,Munoz Sanchez; Alicia,6,0,14,8
1713333040627,LISP 1D,C00,490500,Munoz Sanchez; Alicia,7,0,14,7
1713333040627,LISP 1D,D00,490501,Munoz Sanchez; Alicia,10,0,14,4
1713333041653,LISP 1DX,A00,490502,Munoz Sanchez; Alicia,13,0,28,15
1713333041653,LISP 1DX,B00,490503,Munoz Sanchez; Alicia,16,0,28,12
1713333043713,LTAM 110,A00,491847,Staff,22,0,25,3
1713333044741,LTCS 119,A00,491848,Staff,11,0,15,4
1713333045772,LTCS 130,A00,491849,Staff,24,0,25,1
1713333047824,LTEA 120C,A00,491852,Staff,32,0,40,8
1713333048850,LTEN 130GS,A00,491853,Lyon; Antony J.,23,0,28,5
1713333049873,LTEN 148,A00,491855,Staff,23,0,25,2
1713333050902,LTEN 159,A00,491856,Staff,20,0,25,5
1713333051930,LTEN 180,A00,491857,Staff,8,0,15,7
1713333053988,LTSP 123GS,A00,505928,Bessett; Ryan Matthew,24,0,28,4
1713333055013,LTSP 174GS,A00,506037,Bessett; Ryan Matthew,24,0,28,4
1713333057066,LTWR 102,A00,491861,Staff,9,0,15,6
1713333058096,LTWR 106,A00,491862,Staff,8,0,15,7
1713333059126,MAE 11,A00,490930,Bahadori; Mohammad Yousef,95,0,100,5
1713333060151,MAE 30A,A00,490931,Qi; Huihui,37,0,40,3
1713333061178,MAE 101A,A00,491036,Sadeghizadeh; Zahra,92,0,100,8
1713333062209,MAE 101C,A00,491037,Seshadri; Kalyanasundaram,65,0,100,35
1713333063234,MAE 113,A00,491040,Seshadri; Kalyanasundaram,65,0,80,15
1713333064260,MAE 131A,A00,491041,Ghazinejad; Maziar,37,0,40,3
1713333065285,MAE 142,A00,491053,Staff,39,0,40,1
1713333066312,MAE 143A,A00,491054,Staff,31,0,50,19
1713333067339,MAE 150,A00,491092,Truong; Phuong Thi Ngoc,23,0,35,12
1713333068365,MATH 3C,A01,494031,Pardo Guerra; Sebastian,30,0,30,0
1713333068365,MATH 3C,A02,494032,Pardo Guerra; Sebastian,29,0,30,1
1713333069395,MATH 10A,A01,494034,Staff,27,0,30,3
1713333069395,MATH 10A,A02,494035,Staff,28,0,30,2
1713333069395,MATH 10A,B01,494037,Staff,27,0,30,3
1713333069395,MATH 10A,B02,494038,Staff,29,0,30,1
1713333070498,MATH 10B,A01,494040,Habib; Yousaf,22,0,30,8
1713333070498,MATH 10B,A02,494041,Habib; Yousaf,28,0,30,2
1713333070498,MATH 10B,A03,494042,Habib; Yousaf,29,0,30,1
1713333070498,MATH 10B,A04,494043,Habib; Yousaf,30,0,30,0
1713333070498,MATH 10B,B01,494045,Habib; Yousaf,25,0,30,5
1713333070498,MATH 10B,B02,494046,Habib; Yousaf,30,0,30,0
1713333070498,MATH 10B,B03,494047,Habib; Yousaf,30,0,30,0
1713333070498,MATH 10B,B04,494048,Habib; Yousaf,30,0,30,0
1713333071576,MATH 18,A01,494050,Kemp; Todd Aahron,25,0,30,5
1713333071576,MATH 18,A02,494051,Kemp; Todd Aahron,29,0,30,1
1713333071576,MATH 18,B01,494054,Kemp; Todd Aahron,26,0,30,4
1713333071576,MATH 18,B02,494055,Kemp; Todd Aahron,29,0,30,1
1713333072604,MATH 20A,A01,494059,Suk; Andrew Hoon,30,0,30,0
1713333073638,MATH 20B,A01,494061,Briones; Jor-el Thomas Caparas,33,0,35,2
1713333073638,MATH 20B,B01,494063,Bach; Quang Tran,34,0,35,1
1713333074673,MATH 20C,A01,494065,Staff,28,0,30,2
1713333074673,MATH 20C,A02,494066,Staff,30,0,30,0
1713333074673,MATH 20C,A03,494067,Staff,30,0,30,0
1713333074673,MATH 20C,A04,494068,Staff,30,0,30,0
1713333074673,MATH 20C,B01,494070,Zhang; Ming,25,0,30,5
1713333074673,MATH 20C,B02,494071,Zhang; Ming,27,0,30,3
1713333074673,MATH 20C,B03,494072,Zhang; Ming,29,0,30,1
1713333074673,MATH 20C,B04,494073,Zhang; Ming,29,0,30,1
1713333075698,MATH 20D,A01,494075,Staff,22,0,30,8
1713333075698,MATH 20D,A02,494076,Staff,29,0,30,1
1713333076726,MATH 20E,A01,494079,Staff,24,0,30,6
1713333076726,MATH 20E,A02,494080,Staff,26,0,30,4
1713333076726,MATH 20E,B01,494082,Staff,25,0,30,5
1713333076726,MATH 20E,B02,494083,Staff,25,0,30,5
1713333077757,MATH 103A,A01,494085,Aliabadi Sr.; Mohsen,13,0,30,17
1713333077757,MATH 103A,A02,494086,Aliabadi Sr.; Mohsen,28,0,30,2
1713333077757,MATH 103A,B01,494088,Aliabadi Sr.; Mohsen,21,0,30,9
1713333077757,MATH 103A,B02,494089,Aliabadi Sr.; Mohsen,27,0,30,3
1713333078818,MATH 109,A01,494091,Staff,30,0,30,0
1713333078818,MATH 109,A02,494092,Staff,29,0,30,1
1713333078818,MATH 109,B01,494094,Staff,27,0,30,3
1713333078818,MATH 109,B02,494095,Staff,29,0,30,1
1713333079845,MATH 142A,A01,494097,Chow; Bennett,14,0,30,16
1713333079845,MATH 142A,A02,494098,Chow; Bennett,23,0,30,7
1713333079845,MATH 142A,B01,494100,Chow; Bennett,19,0,30,11
1713333079845,MATH 142A,B02,494101,Chow; Bennett,29,0,30,1
1713333081899,MATH 168A,A01,516677,Dumitriu; Ioana,16,0,35,19
1713333082928,MATH 170A,A01,516679,Dumitriu; Ioana,18,0,30,12
1713333082928,MATH 170A,A02,516680,Dumitriu; Ioana,28,0,30,2
1713333083954,MATH 193A,A01,494107,Staff,13,0,30,17
1713333083954,MATH 193A,A02,494108,Staff,19,0,30,11
1713333083954,MATH 193A,A03,494109,Staff,29,0,30,1
1713333083954,MATH 193A,A04,494110,Staff,22,0,30,8
1713333087033,MGT 16,A00,491930,McKay; Michael J,92,0,98,6
1713333088059,MGT 18,A00,491992,McKay; Michael J,96,0,98,2
1713333089087,MGT 71,A00,492003,Staff,63,0,98,35
1713333090117,MGT 103,A00,505209,Eberhard; Craig A,81,0,98,17
1713333091141,MGT 131A,A00,505210,Anderson; John Charles,89,0,98,9
1713333093198,MGT 153,A00,492077,Perols; Johan Lars,18,0,90,72
1713333096277,MGT 164,A00,492222,McKay; Mary A,91,0,98,7
1713333097302,MGT 172,A00,492245,Staff,59,0,60,1
1713333097302,MGT 172,B00,505526,Hedges; Kathleen,65,0,98,33
1713333098328,MGT 181,A00,505669,Dunn; Louis Jean,80,0,98,18
1713333099352,MMW 14,A01,494399,Staff,15,0,28,13
1713333099352,MMW 14,A02,494400,Staff,25,0,28,3
1713333099352,MMW 14,A03,494401,Staff,28,0,28,0
1713333099352,MMW 14,A04,494402,Staff,28,0,28,0
1713333099352,MMW 14,B01,494404,Carreras; Maria Victoria,8,0,28,20
1713333099352,MMW 14,B02,494405,Carreras; Maria Victoria,25,0,28,3
1713333099352,MMW 14,B03,494406,Carreras; Maria Victoria,27,0,28,1
1713333099352,MMW 14,B04,494407,Carreras; Maria Victoria,28,0,28,0
1713333100381,MMW 14GS,A00,506250,Chang; Edmond Yi-Teh,0,0,0,0
1713333101409,MMW 121R,A01,494415,Adamiak; Patrick John,10,0,28,18
1713333101409,MMW 121R,A02,494416,Adamiak; Patrick John,24,0,28,4
1713333102436,MUS 1A,A01,494113,Staff,12,0,25,13
1713333102436,MUS 1A,A02,494114,Staff,24,0,25,1
1713333103464,MUS 4,A01,494116,Staff,23,0,25,2
1713333103464,MUS 4,A02,494117,Staff,22,0,25,3
1713333104493,MUS 5R,A01,494236,Dubnov; Shlomo,6,0,25,19
1713333104493,MUS 5R,A02,494237,Dubnov; Shlomo,25,0,25,0
1713333105517,MUS 6,A01,494122,Staff,10,0,25,15
1713333105517,MUS 6,A02,494123,Staff,23,0,25,2
1713333106542,MUS 7,A01,494125,Staff,16,0,25,9
1713333106542,MUS 7,A02,494126,Staff,24,0,25,1
1713333107572,MUS 11,A01,494128,Staff,23,0,25,2
1713333107572,MUS 11,A02,494129,Staff,24,0,25,1
1713333108598,MUS 13,A01,494131,Staff,25,0,25,0
1713333108598,MUS 13,A02,494132,Staff,25,0,25,0
1713333109624,MUS 15,A01,494134,Staff,16,0,25,9
1713333109624,MUS 15,A02,494135,Staff,25,0,25,0
1713333109624,MUS 15,B01,494137,Staff,24,0,25,1
1713333110654,MUS 80,A00,494232,Staff,24,0,25,1
1713333110654,MUS 80,B00,494233,Staff,25,0,25,0
1713333110654,MUS 80,C00,494234,Staff,23,0,25,2
1713333111680,MUS 95C,A00,494141,Staff,70,0,75,5
1713333112705,MUS 114,A00,494142,Staff,40,0,50,10
1713333113732,NANO 15,A01,490636,Drews; Aaron,7,0,7,0
1713333114811,PHIL 1,A00,490578,Grush; Rick Scott,49,0,50,1
1713333115837,PHIL 10,A01,490580,Grush; Rick Scott,33,0,35,2
1713333115837,PHIL 10,A02,490586,Grush; Rick Scott,32,0,35,3
1713333116863,PHIL 27,A01,490591,Staff,22,0,25,3
1713333116863,PHIL 27,A02,490592,Staff,25,0,25,0
1713333116863,PHIL 27,A03,490593,Staff,25,0,25,0
1713333116863,PHIL 27,A04,490598,Staff,25,0,25,0
1713333117888,PHIL 32,A01,490611,Staff,20,0,20,0
1713333117888,PHIL 32,A02,490618,Staff,20,0,20,0
1713333118913,PHIL 90,A00,490624,Staff,40,0,40,0
1713333119939,PHIL 136,A00,490627,Cohen; Jonathan David,37,0,40,3
1713333120964,PHIL 155,A00,490634,Staff,62,0,70,8
1713333121991,PHYS 1A,A00,491610,Staff,245,0,250,5
1713333123017,PHYS 1AL,001,491616,Tsai; Philbert S,27,0,30,3
1713333123017,PHYS 1AL,002,491618,Tsai; Philbert S,30,0,30,0
1713333124043,PHYS 1B,A00,491623,Staff,236,0,250,14
1713333125068,PHYS 1BL,001,491626,Tsai; Philbert S,22,0,30,8
1713333125068,PHYS 1BL,002,491628,Tsai; Philbert S,26,0,30,4
1713333126093,PHYS 1C,A00,491632,Staff,213,0,245,32
1713333127118,PHYS 1CL,001,491635,Tsai; Philbert S,2,0,30,28
1713333127118,PHYS 1CL,002,491643,Tsai; Philbert S,22,0,30,8
1713333128148,PHYS 2AR,A01,491651,Meyertholen; Andrew D.,44,0,50,6
1713333129175,PHYS 2B,A01,491659,Staff,106,0,115,9
1713333130199,PHYS 2BL,A01,491685,Staff,21,0,24,3
1713333130199,PHYS 2BL,A02,491700,Staff,21,0,24,3
1713333131229,PHYS 2C,A01,505161,Staff,101,0,115,14
1713333132259,PHYS 4A,A01,491704,Grinstein; Benjamin,99,0,100,1
1713333133286,POLI 5D,A01,494144,Staff,3,0,5,2
1713333133286,POLI 5D,B01,626283,Dai; Yinlin,5,0,5,0
1713333134312,POLI 12,A00,494145,Staff,43,0,45,2
1713333135337,POLI 13R,A00,494146,Forman; Fonna,45,0,50,5
1713333136361,POLI 27,A01,494148,Staff,54,0,60,6
1713333137385,POLI 30,A00,494149,Staff,49,0,50,1
1713333138410,POLI 100DA,A00,494150,Staff,21,0,25,4
1713333140460,POLI 100I,A00,494152,Staff,27,0,30,3
1713333141490,POLI 104B,A00,494153,Smith; Glenn Chatmas,53,0,55,2
1713333142515,POLI 104F,A00,494154,Staff,28,0,30,2
1713333143543,POLI 104I,A00,494155,Smith; Glenn Chatmas,29,0,30,1
1713333144573,POLI 110C,A00,494156,Ingham; Sean,23,0,25,2
1713333145599,POLI 117R,A00,494157,Forman; Fonna,5,0,20,15
1713333146624,POLI 118,A00,494158,Ingham; Sean,21,0,25,4
1713333147654,POLI 120H,A00,494159,Fisk; David Lee,39,0,45,6
1713333148682,POLI 131CR,A00,494160,Hoston; Germaine,35,0,45,10
1713333149709,POLI 133J,A00,494161,Staff,31,0,35,4
1713333150734,POLI 135,A00,494162,Fisk; David Lee,33,0,35,2
1713333151759,POLI 140A,A00,494164,Staff,19,0,30,11
1713333152785,POLI 142I,A00,494165,Staff,30,0,30,0
1713333153810,POLI 144D,A00,494166,Staff,23,0,25,2
1713333154839,POLI 151,A00,494167,Staff,30,0,30,0
1713333155863,POLI 153,A00,494168,Staff,33,0,35,2
1713333156892,POLI 160AA,A00,494169,Staff,34,0,40,6
1713333157922,POLI 162,A00,494170,Mignozzetti; Umberto,18,0,25,7
1713333158946,POLI 171,A00,494171,Mignozzetti; Umberto,18,0,25,7
1713333159973,PSYC 1,A00,494172,Staff,95,0,100,5
1713333160997,PSYC 2,A00,494173,Moranton; Nirelia Melbina-,34,0,50,16
1713333162023,PSYC 3,A00,494174,Staff,29,0,30,1
1713333163049,PSYC 6,A00,494175,Staff,17,0,20,3
1713333164082,PSYC 60,A01,494177,Staff,37,0,45,8
1713333165108,PSYC 70,A01,505724,Geller; Emma Harlan,42,0,45,3
1713333166133,PSYC 101,A00,494180,Heyman; Gail D.,84,0,100,16
1713333167162,PSYC 105,A00,494181,Geller; Emma Harlan,51,0,90,39
1713333168188,PSYC 106,A00,494182,Dobkins; Karen R.,27,0,45,18
1713333169212,PSYC 108,A00,494183,Adrian; Julia Anna,89,0,100,11
1713333170238,PSYC 114,A01,494185,Winkielman; Piotr,0,3,30,30
1713333171264,PSYC 122,A00,494186,Moranton; Nirelia Melbina-,27,0,50,23
1713333172292,PSYC 124,A00,494187,Chapman; Eddie Nathaniel,70,0,80,10
1713333173320,PSYC 131,A00,494188,Anagnostaras; Stephan,41,0,80,39
1713333174348,PSYC 144,A00,494189,Staff,3,0,50,47
1713333175374,PSYC 154,A00,494190,Lacefield; Katharine I,107,0,180,73
1713333176403,PSYC 162,A00,494191,Wixted; John T,71,0,100,29
1713333177429,PSYC 172,A00,494192,Gorman; Michael R.,36,0,45,9
1713333178455,PSYC 178,A00,494193,Glaser; Dale,34,0,45,11
1713333179479,PSYC 193,A00,505725,Chapman; Eddie Nathaniel,20,0,20,0
1713333180509,RELI 145GS,A00,519817,Rahimi; Babak,18,0,20,2
1713333181532,SE 101A,A01,490862,Chadha; Mayank,23,0,25,2
1713333182560,SE 101C,A01,490924,Krysl; Petr,15,0,20,5
1713333183586,SE 110A,A01,490928,Staff,19,0,20,1
1713333184613,SE 130A,A00,490929,Morrison; Machel Leigh,54,0,70,16
1713333185638,SIO 1,A01,519325,Staff,39,0,40,1
1713333186666,SIO 30,A01,519327,Staff,38,0,40,2
1713333187690,SIO 40,A00,519328,Staff,39,0,40,1
1713333188715,SIO 46GS,A00,519819,Cook; Geoffrey W,17,0,25,8
1713333189740,SIO 109R,A00,494197,Forman; Fonna,0,3,20,20
1713333190763,SIO 121GS,A00,519827,Cook; Geoffrey W,17,0,25,8
1713333191787,SIO 132,A01,519330,Staff,38,0,40,2
1713333192811,SIO 133,A01,519397,Staff,37,0,40,3
1713333193837,SIO 139,A00,519396,Kacev; David,29,0,40,11
1713333194865,SOCI 1,A01,494199,Thorpe; Charles Robert,21,0,30,9
1713333194865,SOCI 1,A02,494200,Thorpe; Charles Robert,30,0,30,0
1713333194865,SOCI 1,A03,494201,Thorpe; Charles Robert,29,0,30,1
1713333194865,SOCI 1,A04,494202,Thorpe; Charles Robert,29,0,30,1
1713333194865,SOCI 1,A05,494203,Thorpe; Charles Robert,29,0,30,1
1713333194865,SOCI 1,A06,494204,Thorpe; Charles Robert,30,0,30,0
1713333194865,SOCI 1,A07,494205,Thorpe; Charles Robert,28,0,30,2
1713333195892,SOCI 60,A01,494207,Staff,34,0,40,6
1713333195892,SOCI 60,A02,494208,Staff,39,0,40,1
1713333196917,SOCI 100,A01,494210,Payne; Christine Anna,25,0,30,5
1713333196917,SOCI 100,A02,494211,Payne; Christine Anna,26,0,30,4
1713333197944,SOCI 109M,A00,494212,Staff,20,0,20,0
1713333198969,SOCI 110,A00,494213,Staff,34,0,40,6
1713333201024,SOCI 118E,A00,494215,Ng; Kwai,37,0,40,3
1713333202051,SOCI 125,A00,494216,Calderon-Zaks; Michael Aar,40,0,45,5
1713333203077,SOCI 126,A01,494218,Jones; Makeba,3,0,5,2
1713333204103,SOCI 131,A00,494219,Thorpe; Charles Robert,26,0,30,4
1713333206154,SOCI 135,A00,494221,Payne; Christine Anna,28,0,50,22
1713333207180,SOCI 136E,A00,626690,Ruiz; Jonathan Joseph,24,0,25,1
1713333208205,SOCI 138GS,A00,494222,Navon; Daniel,24,0,28,4
1713333210257,SOCI 145,A00,494224,Staff,40,0,45,5
1713333211283,SOCI 153,A00,494225,Staff,28,0,30,2
1713333212309,SOCI 160E,A00,494226,Ng; Kwai,29,0,40,11
1713333213337,SOCI 180,A00,494227,Staff,29,0,30,1
1713333214369,SOCI 189GS,A00,494228,Ribas Norris; Janet Vanesa,11,0,11,0
1713333215393,SOCI 190GS,A00,553232,Ribas Norris; Janet Vanesa,11,0,11,0
1713333216419,SOMI 220,A00,627178,Schneid; Stephen David,30,0,30,0
1713333217448,SYN 2,001,490768,Staff,13,0,15,2
1713333217448,SYN 2,002,490769,Staff,14,0,15,1
1713333217448,SYN 2,004,490775,Staff,0,0,0,0
1713333217448,SYN 2,003,490774,Staff,0,0,0,0
1713333217448,SYN 2,005,490776,Staff,0,0,0,0
1713333218527,SYN 2R,001,490779,Staff,11,0,15,4
1713333218527,SYN 2R,002,514635,Staff,14,0,15,1
1713333219556,SYN 100,A01,490783,Staff,9,0,20,11
1713333219556,SYN 100,B01,490787,Staff,9,0,20,11
1713333219556,SYN 100,C01,490789,Staff,10,0,20,10
1713333220582,SYN 150,A00,490817,Staff,14,0,15,1
1713333220582,SYN 150,B00,514610,Staff,15,0,15,0
1713333221612,TDAC 1,A00,492753,Walsh; Kim C.,19,0,20,1
1713333221612,TDAC 1,B00,492754,Harting; Carla Kelso,19,0,20,1
1713333221612,TDAC 1,C00,513995,Salovey; Todd,15,0,20,5
1713333222638,TDAC 101,A00,492766,Harting; Carla Kelso,17,0,20,3
1713333223664,TDAC 102,A00,492768,Basso; Beatrice,19,0,20,1
1713333224688,TDDE 111,A00,492769,Staff,25,0,25,0
1713333225714,TDDE 131,A00,492770,Staff,15,0,15,0
1713333225714,TDDE 131,B00,492771,Staff,15,0,15,0
1713333226742,TDDE 131GS,A00,523716,Guirguis; Mark C,23,0,28,5
1713333227770,TDGE 1,A01,492756,Salovey; Todd,56,0,60,4
1713333228798,TDGE 5,A01,492758,Staff,23,0,25,2
1713333229825,TDGE 10,A00,492759,Fulton; Julia,203,0,220,17
1713333230858,TDGE 11,A00,492760,Castro; Robert Jess,198,0,200,2
1713333232915,TDGE 124,A00,492772,Fulton; Julia,184,0,220,36
1713333233940,TDGE 125,A00,492773,Meyer; Ursula,38,0,50,12
1713333233940,TDGE 125,B00,492774,Staff,49,0,50,1
1713333233940,TDGE 125,C00,523565,Staff,48,0,50,2
1713333234966,TDGE 125GS,A00,523580,Guirguis; Mark C,23,0,28,5
1713333235996,TDGE 127,A00,492775,Havis; Allan,33,0,50,17
1713333237020,TDHT 101,A00,492776,Staff,34,0,35,1
1713333238046,TDMV 1,A00,492762,Caligagan; Maria T.,29,0,30,1
1713333238046,TDMV 1,B00,492763,Arcidiacono; Kristin,26,0,30,4
1713333239074,TDMV 2,A00,492764,Weinberg; Sadie,28,0,30,2
1713333240100,TDMV 3,A00,492765,Mack; Kara Shanai',37,0,40,3
1713333241125,TDMV 138,A00,492777,Mack; Kara Shanai',34,0,40,6
1713333242152,TDMV 140,A00,492778,Lima; Paulo Henrique,40,0,40,0
1713333243175,TDMV 142,A00,492779,Caligagan; Maria T.,33,0,40,7
1713333243175,TDMV 142,B00,492780,Caligagan; Tony,37,0,40,3
1713333244202,TDMV 143,A00,492781,Fyall; Daunte Edward,39,0,40,1
1713333245225,USP 1,A01,492401,Kwak; Nancy,27,0,35,8
1713333246249,USP 2,A01,492453,Hinds; Juli Beth,35,0,35,0
1713333247279,USP 3,A01,492516,Staff,28,0,35,7
1713333248304,USP 4,A00,492522,McTague; Sarah,16,0,25,9
1713333249330,USP 100,A00,492523,Staff,32,0,35,3
1713333250355,USP 101,A00,492524,Staff,13,0,15,2
1713333251381,USP 105,A00,492525,Staff,21,0,25,4
1713333252406,USP 151,A00,492526,Shenkman; Michael Thomas,32,0,35,3
1713333253431,USP 170,A00,492545,Hinds; Juli Beth,33,0,35,2
1713333254456,USP 171GS,A00,492608,Bussell; Mirle Rabinowitz,24,0,28,4
1713333255481,USP 183GS,A00,492613,Peerson; Susan,24,0,28,4
1713333256510,VIS 30,A01,490693,Yoldas; Pinar,19,0,22,3
1713333256510,VIS 30,A02,490694,Yoldas; Pinar,18,0,22,4
1713333257535,VIS 83,A00,490695,Kester; Grant,63,0,75,12
1713333258558,VIS 105D,A00,490696,Staff,22,0,25,3
1713333259583,VIS 124CN,A00,490699,Rose; Jordan M,65,0,75,10
1713333260611,VIS 125GS,A00,511221,Williams; Alena J,21,0,22,1
1713333261636,VIS 128D,A00,490700,Staff,73,0,75,2
1713333262661,VIS 151,A01,490717,Staff,33,0,34,1
1713333262661,VIS 151,A02,490766,Staff,33,0,34,1
1713333263685,VIS 154GS,A00,511972,Williams; Alena J,21,0,22,1
1713333264711,VIS 160A,A00,490767,Stone; Patricia,7,0,10,3
1713333265736,WCWP 10A,A00,490638,Staff,14,0,15,1
1713333265736,WCWP 10A,B00,490640,Staff,15,0,15,0
1713333266760,WCWP 10B,A00,490641,Staff,0,0,0,0
1713333266760,WCWP 10B,B00,490642,Staff,14,0,15,1
1713333266760,WCWP 10B,C00,490644,Staff,13,0,15,2
1713333266760,WCWP 10B,D00,490647,Staff,0,0,0,0
1713333267788,WCWP 100,A00,490655,Staff,0,0,0,0
1713333267788,WCWP 100,B00,490687,Staff,10,0,15,5
1713333269899,ANAR 153,A00,487222,Braswell; Geoffrey E.,53,0,60,7
1713333270922,ANBI 134,A00,487223,Staff,5,0,20,15
1713333271950,ANBI 143GS,A00,487224,Noel; Geoffroy Pierre Jean,18,0,24,6
1713333272977,ANBI 144GS,A00,519548,Noel; Geoffroy Pierre Jean,18,0,24,6
1713333274001,ANSC 101,A00,487225,Staff,18,0,20,2
1713333275026,ANSC 125,A00,487227,Brenner; Suzanne A,38,0,40,2
1713333277079,ANSC 146,A00,487229,Staff,35,0,40,5
1713333278106,ANSC 148,A00,487230,Olivas Hernandez; Olga Lid,39,0,40,1
1713333279136,ANSC 150,A00,504165,Sloane; Julia Kathryn,18,0,20,2
1713333280166,ANSC 180,A00,487232,Staff,14,0,15,1
1713333281190,ANSC 188,A00,627155,Staff,38,0,40,2
1713333282220,ANTH 5,A00,519529,Semendeferi; Ekaterini,15,0,15,0
1713333283248,ANTH 10,A00,487219,Staff,58,0,60,2
1713333284277,ANTH 23,A01,487221,Staff,17,0,20,3
1713333285303,ANTH 102,A00,487233,Wilder; Linnea Lorene,51,0,60,9
1713333286334,ANTH 103,A00,487234,Varma; Saiba,55,0,60,5
1713333287360,ANTH 105,A00,487235,Stewart; Alexander B,54,0,60,6
1713333288391,BENG 100,A01,516685,Taylor Amos; Alyssa C,26,0,30,4
1713333289425,BIBC 102,A01,491316,Flagg; Matthew Paul,9,0,88,79
1713333289425,BIBC 102,A02,491366,Flagg; Matthew Paul,78,0,88,10
1713333290451,BIBC 103,A01,491486,Boumechache; Miyyada,16,0,24,8
1713333290451,BIBC 103,A02,491487,Boumechache; Miyyada,24,0,24,0
1713333291476,BICD 100,A01,516882,Staff,73,0,75,2
1713333291476,BICD 100,A02,516890,Staff,69,0,75,6
1713333292504,BICD 102GS,A00,491488,Lo; Stanley M.,26,0,28,2
1713333293531,BIEB 136GS,A00,516940,Holway; David A. & Shurin; Jonathan,18,0,24,6
1713333294558,BIEB 137GS,A01,517034,Holway; David A. & Shurin; Jonathan,18,0,24,6
1713333295583,BIEB 138GS,A01,491492,Pirino; Giorgia,21,0,28,7
1713333296613,BILD 1,A01,491296,Staff,60,0,63,3
1713333296613,BILD 1,A02,491297,Staff,63,0,63,0
1713333297640,BILD 4,A01,517099,Gonzalez Gamboa; Ivonne,22,0,24,2
1713333297640,BILD 4,A02,517100,Gonzalez Gamboa; Ivonne,24,0,24,0
1713333298665,BILD 60GS,A00,491309,Lo; Stanley M.,26,0,28,2
1713333299691,BIMM 100,A01,517136,Staff,83,0,100,17
1713333300717,BIMM 110,A01,517182,Staff,54,0,100,46
1713333301747,BIMM 120,A01,517228,Pickett; Brooke Elizabeth,28,0,63,35
1713333301747,BIMM 120,A02,517240,Pickett; Brooke Elizabeth,44,0,63,19
1713333302774,BIMM 132GS,A01,491498,Pirino; Giorgia,21,0,28,7
1713333303798,BIMM 143,A01,491589,Bozinovic; Goran,12,0,40,28
1713333304826,BIPN 100,A01,491594,Armour; Jon Christopher,83,0,100,17
1713333305853,BIPN 140,A01,491602,Marino; Marc J,25,0,50,25
1713333307905,CAT 125,A00,515973,Staff,18,0,20,2
1713333308931,CAT 125GS,A00,515974,Rahimi; Babak,17,0,20,3
1713333309957,CAT 125R,A00,515980,Staff,12,0,20,8
1713333309957,CAT 125R,B00,515981,Tosun; Adriana,19,0,20,1
1713333309957,CAT 125R,C00,515987,Hyland; Tina Mae,0,3,20,20
1713333309957,CAT 125R,D00,515988,Bronstein; Phoebe Malan,16,0,20,4
1713333310983,CENG 15,A01,488699,Drews; Aaron,25,0,25,0
1713333312015,CENG 100,A00,505196,Opatkiewicz; Justin Paul,25,0,25,0
1713333313043,CGS 2A,A01,489598,Staff,33,0,35,2
1713333314068,CGS 112,A00,489599,Staff,15,0,15,0
1713333315096,CGS 119,A00,489603,Staff,10,0,10,0
1713333316120,CGS 120,A00,489604,Staff,14,0,15,1
1713333317147,CGS 150,A00,489607,Staff,15,0,15,0
1713333318179,CHEM 6A,A01,488715,Staff,97,0,100,3
1713333319208,CHEM 6B,A01,488719,Piercy; Marc Anthony,99,0,100,1
1713333320233,CHEM 6C,A01,488723,Albizati; Kim F.,93,0,100,7
1713333321268,CHEM 7L,A01,488728,Schurmeier; Kimberly,18,0,24,6
1713333321268,CHEM 7L,A02,488730,Schurmeier; Kimberly,23,0,24,1
1713333321268,CHEM 7L,A03,488734,Schurmeier; Kimberly,20,0,24,4
1713333321268,CHEM 7L,A04,488763,Schurmeier; Kimberly,23,0,24,1
1713333321268,CHEM 7L,B01,488798,Schurmeier; Kimberly,17,0,24,7
1713333321268,CHEM 7L,B02,488801,Schurmeier; Kimberly,22,0,24,2
1713333321268,CHEM 7L,B03,488808,Schurmeier; Kimberly,22,0,24,2
1713333321268,CHEM 7L,B04,488811,Schurmeier; Kimberly,24,0,24,0
1713333322369,CHEM 11,A01,488897,Stallings; Dontarie M,95,0,100,5
1713333323402,CHEM 40A,A01,488913,Albizati; Kim F.,83,0,100,17
1713333324431,CHEM 40B,A01,488920,Weizman; Haim,43,0,50,7
1713333324431,CHEM 40B,A02,488938,Weizman; Haim,44,0,50,6
1713333325460,CHEM 41A,A01,489029,Klosterman; Jeremy K,57,0,60,3
1713333326486,CHEM 41C,A01,500436,Tor; Yitzhak,55,0,60,5
1713333327519,CHEM 43A,A01,500426,Weizman; Haim,0,1,24,24
1713333327519,CHEM 43A,A02,500430,Weizman; Haim,7,0,24,17
1713333327519,CHEM 43A,B01,514041,Klosterman; Jeremy K,16,0,24,8
1713333327519,CHEM 43A,B02,514047,Klosterman; Jeremy K,23,0,24,1
1713333328545,CHEM 108,A01,489140,Jennings; Patricia A.,8,0,24,16
1713333328545,CHEM 108,A02,489142,Jennings; Patricia A.,14,0,24,10
1713333329575,CHEM 114A,A01,489147,Stallings; Dontarie M,68,0,100,32
1713333330603,CHIN 169A,A00,489171,Wang; Xiao,19,0,20,1
1713333332657,COGS 3,A01,518827,Boyle; Mary E. T.,25,0,40,15
1713333333685,COGS 11,A01,489175,Staff,27,0,30,3
1713333334711,COGS 14A,A01,518829,Staff,51,0,60,9
1713333335742,COGS 14B,A01,489177,Hoffman; Drew Ellen,62,0,75,13
1713333336766,COGS 100,A01,489181,Allen; Michael Gordon,62,0,75,13
1713333337793,COGS 101A,A01,489183,Staff,45,0,60,15
1713333338817,COGS 101B,A01,489185,Allen; Michael Gordon,8,0,30,22
1713333339847,COGS 101C,A01,526786,Staff,23,0,30,7
1713333341904,COGS 107A,A01,489189,Boyle; Mary E. T.,17,0,35,18
1713333342934,COGS 107B,A01,627144,Mooshagian; Eric Frederick,60,0,60,0
1713333343962,COGS 118A,A01,489191,Staff,0,45,40,40
1713333346015,COGS 171GS,A01,489194,Pineda; Jaime A,19,0,28,9
1713333347041,COGS 172,A01,489196,Staff,2,0,30,28
1713333348072,COGS 174GS,A01,489264,Pineda; Jaime A,19,0,28,9
1713333349100,COGS 180,A01,627150,Staff,28,0,30,2
1713333350124,COGS 186,A01,489274,Staff,0,1,30,30
1713333351153,COMM 10,A01,489276,Staff,23,0,25,2
1713333351153,COMM 10,A02,489303,Staff,23,0,25,2
1713333352182,COMM 100A,A01,489312,Staff,14,0,25,11
1713333352182,COMM 100A,A02,489313,Staff,24,0,25,1
1713333353210,COMM 106T,A00,512540,Staff,33,0,35,2
1713333354234,COMM 107,A00,489347,Staff,27,0,35,8
1713333355265,COMM 109P,A00,489358,Staff,31,0,35,4
1713333356297,COMM 132,A00,489361,McKenna; Denise,27,0,30,3
1713333357323,COMM 146,A00,489362,Halm; Gavin Patrick,26,0,30,4
1713333358354,COMM 190,A00,489363,Abuelhiga; Soraya Jill,17,0,23,6
1713333359389,CSE 8A,A50,489366,Staff,21,0,25,4
1713333359389,CSE 8A,A51,489367,Staff,24,0,25,1
1713333360415,CSE 11,A01,489398,Cao; Yingjun,73,0,100,27
1713333361443,CSE 12,A01,489487,Staff,43,0,50,7
1713333362468,CSE 20,A01,489497,Staff,48,0,50,2
1713333363496,CSE 21,A01,489517,Braun; Oliver,42,0,50,8
1713333364522,CSE 101,A01,489524,Braun; Oliver,0,32,50,50
1713333365550,CSE 105,A01,512594,Jones; Miles E,72,0,100,28
1713333365550,CSE 105,B01,512598,Jones; Miles E,52,0,100,48
1713333366578,CSE 140,A01,489538,Staff,41,0,50,9
1713333367612,CSE 141,A01,489550,Eldon; John,67,0,100,33
1713333368641,CSE 141L,A01,489571,Eldon; John,65,0,100,35
1713333369672,CSE 151A,A01,489583,Solares; Edwin A,141,0,200,59
1713333370706,CSE 175,A01,510886,Kumar; Rakesh,30,0,30,0
1713333371736,CSE 190,A00,516828,Dubnov; Shlomo,38,0,49,11
1713333372765,DOC 100D,A00,489667,Pass; Natalye Joann,19,0,25,6
1713333373792,DSC 10,A01,624268,Staff,72,0,75,3
1713333374816,DSC 20,A01,624476,Staff,50,0,50,0
1713333375846,DSC 40A,A01,624608,Staff,39,0,40,1
1713333376874,DSGN 1,A01,489179,Rill; Bryan,32,0,50,18
1713333377904,ECE 17,A01,490489,Sahay; Rajeev,18,0,30,12
1713333378934,ECE 65,A50,490492,Staff,11,0,20,9
1713333378934,ECE 65,A51,490493,Staff,18,0,20,2
1713333379963,ECON 1,A01,489715,Famulari; Melissa,67,0,70,3
1713333380992,ECON 2,A01,489717,Levkoff; Steven B.,67,0,70,3
1713333382017,ECON 3,A01,489948,Staff,70,0,70,0
1713333384079,ECON 5,A01,490103,Staff,27,0,30,3
1713333384079,ECON 5,B01,626281,Dai; Yinlin,45,0,45,0
1713333385106,ECON 100A,A01,490127,Famulari; Melissa,65,0,70,5
1713333386132,ECON 100B,A01,490129,Staff,64,0,70,6
1713333387162,ECON 109,A01,490187,Shishkin; Denis,27,0,35,8
1713333388192,ECON 110A,A01,490190,Levkoff; Steven B.,60,0,70,10
1713333389218,ECON 120A,A01,490245,Dai; Yinlin,61,0,70,9
1713333390244,ECON 120B,A01,490247,Nieto-Barthaburu; Augusto,40,0,70,30
1713333391270,ECON 120C,A01,490253,Sun; Yixiao,30,0,35,5
1713333391270,ECON 120C,B01,490255,Sun; Yixiao,34,0,35,1
1713333392302,ECON 129,A00,490256,Eckert; Fabian Paul,22,0,35,13
1713333393328,ECON 131,A00,490257,Nieto-Barthaburu; Augusto,0,6,35,35
1713333394355,ECON 138,A00,490258,Bharadwaj; Prashant,13,0,35,22
1713333394355,ECON 138,B00,490259,Bharadwaj; Prashant,15,0,35,20
1713333395386,ECON 159,A00,490260,Hendrickson; Gerald M.,0,9,0,0
1713333396419,ECON 178,A01,553995,Zhu; Ying,24,0,35,11
1713333397445,EDS 40,A01,512576,Black; Alison Michelle,20,0,20,0
1713333398471,EDS 107,A01,515848,Staff,30,0,30,0
1713333399499,EDS 110R,A01,490262,Staff,26,0,30,4
1713333400526,EDS 112,A01,490264,Chapman; Thandeka K,40,0,50,10
1713333401553,EDS 113,A00,490266,Staff,26,0,30,4
1713333402578,EDS 118,A00,490267,Warstadt; Melissa Fawn,20,0,30,10
1713333403607,EDS 124BR,A00,490268,Eguchi; Emi,4,0,25,21
1713333403607,EDS 124BR,B00,490269,Eguchi; Emi,23,0,25,2
1713333404636,EDS 126,A01,490271,Jones; Makeba,43,0,50,7
1713333405660,EDS 135,A01,490316,Staff,19,0,20,1
1713333406687,ENVR 142GS,A00,519514,Chang; Edmond Yi-Teh,26,0,28,2
1713333407717,ETHN 103,A00,490504,Staff,25,0,36,11
1713333408748,ETHN 103A,A00,490505,Man; Simeon S,4,0,9,5
1713333409773,ETHN 109,A00,490506,Staff,28,0,30,2
1713333410798,ETHN 118,A00,490507,Staff,35,0,36,1
1713333411823,ETHN 119,A00,490508,Staff,33,0,36,3
1713333412852,ETHN 121R,A00,490518,Choi; Esther Min,21,0,36,15
1713333413877,ETHN 127,A00,490528,Staff,14,0,15,1
1713333414905,ETHN 139,A00,490573,Staff,10,0,10,0
1713333415933,ETHN 150,A00,490575,Staff,15,0,15,0
1713333416962,GLBH 20,A00,491705,Elwardani; Nile Regina,38,0,40,2
1713333417989,GLBH 101,A00,491706,Staff,20,0,20,0
1713333419013,GLBH 111,A01,491708,Burgos; Jose L.,15,0,15,0
1713333420040,GLBH 146,A00,491709,Staff,9,0,20,11
1713333421066,GLBH 148,A00,491710,Olivas Hernandez; Olga Lid,11,0,20,9
1713333422092,GLBH 150,A00,491711,Sloane; Julia Kathryn,19,0,20,1
1713333423116,HIEA 131,A00,491760,Staff,28,0,32,4
1713333424140,HIEA 153,A00,491762,Staff,28,0,30,2
1713333425169,HIEU 124,A00,491811,Staff,26,0,32,6
1713333426250,HIEU 124GS,A00,491812,Markman; Kristina,27,0,28,1
1713333427279,HIEU 147,A00,491813,Staff,30,0,32,2
1713333428305,HIEU 149GS,A00,491816,Caldwell; Michael Alan,28,0,28,0
1713333429328,HILD 2C,A01,491713,Hendrickson; Gerald M.,26,0,30,4
1713333430359,HILD 7B,A01,491715,Kwak; Nancy,0,2,30,30
1713333431385,HILD 10,A01,491717,Staff,11,0,20,9
1713333432413,HILD 30GS,A00,491719,Edington; Claire Ellen,24,0,28,4
1713333433439,HINE 109,A00,491818,Shafir; Nir,27,0,32,5
1713333434464,HINE 128,A00,491821,Shafir; Nir,31,0,32,1
1713333435489,HISC 117,A00,491830,Staff,27,0,32,5
1713333436514,HIUS 103,A00,491834,Man; Simeon S,14,0,23,9
1713333437540,HIUS 108B,A00,491835,Staff,27,0,30,3
1713333438565,HIUS 141,A00,491836,Hendrickson; Gerald M.,28,0,32,4
1713333439594,HIUS 149,A00,491839,Staff,24,0,32,8
1713333440620,HUM 3,A01,512617,Crum; Matthew Stephen,42,0,50,8
1713333440620,HUM 3,A02,512618,Crum; Matthew Stephen,48,0,50,2
1713333441646,HUM 3GS,A00,512663,Markman; Kristina,0,0,0,1
1713333441646,HUM 3GS,B00,512664,Staff,0,0,0,0
1713333442675,HUM 4,A01,512620,West; Geoffrey Scott,25,0,50,25
1713333443702,HUM 4GS,A00,512666,Lyon; Antony J.,0,0,0,5
1713333444733,HUM 4R,A01,512625,Watkins; Eric,49,0,50,1
1713333445763,HUM 5,A01,512649,Zavodny; Tatiana Sophia,23,0,50,27
1713333445763,HUM 5,B01,512661,Zroka; Ryan Edward,48,0,50,2
1713333446790,INTL 190,A00,490577,Segui; Alan S,0,0,0,5
1713333447816,JAPN 20AR,A01,491267,Ross; Kayoko F,7,0,20,13
1713333448841,JAPN 180,A00,491285,Berman; Michael David,33,0,40,7
1713333449872,LATI 50,A01,502536,Kokinis; Troy Andreas,16,0,22,6
1713333449872,LATI 50,A02,502551,Kokinis; Troy Andreas,22,0,22,0
1713333449872,LATI 50,A03,502650,Kokinis; Troy Andreas,22,0,22,0
1713333449872,LATI 50,A04,502909,Kokinis; Troy Andreas,21,0,22,1
1713333450895,LATI 160,A01,502920,Kokinis; Troy Andreas,30,0,30,0
1713333451924,LIFR 1A,A00,490494,Van Moer; Vinciane G,17,0,20,3
1713333452950,LIFR 1AX,A00,490495,Van Moer; Vinciane G,17,0,20,3
1713333453979,LIFR 1B,A00,490496,Van Moer; Vinciane G,17,0,20,3
1713333455009,LIFR 1BX,A00,490497,Van Moer; Vinciane G,17,0,20,3
1713333456032,LIGN 8,A00,505198,McIntosh; Justin Daniel,134,0,150,16
1713333457058,LIGN 9GS,A00,491239,Lott; Margaret S.,18,0,20,2
1713333458083,LIGN 101,A01,505200,McIntosh; Justin Daniel,22,0,30,8
1713333459108,LIGN 120,A01,491244,Staff,22,0,30,8
1713333460133,LIGN 149GS,A00,491245,Lott; Margaret S.,18,0,20,2
1713333461161,LIGN 170,A00,491247,Staff,22,0,30,8
1713333462186,LISP 1D,A00,490498,Munoz Sanchez; Alicia,8,0,14,6
1713333462186,LISP 1D,B00,490499,Munoz Sanchez; Alicia,6,0,14,8
1713333462186,LISP 1D,C00,490500,Munoz Sanchez; Alicia,7,0,14,7
1713333462186,LISP 1D,D00,490501,Munoz Sanchez; Alicia,10,0,14,4
1713333463212,LISP 1DX,A00,490502,Munoz Sanchez; Alicia,13,0,28,15
1713333463212,LISP 1DX,B00,490503,Munoz Sanchez; Alicia,16,0,28,12
1713333465265,LTAM 110,A00,491847,Staff,22,0,25,3
1713333466291,LTCS 119,A00,491848,Staff,11,0,15,4
1713333467320,LTCS 130,A00,491849,Staff,24,0,25,1
1713333469369,LTEA 120C,A00,491852,Staff,32,0,40,8
1713333470398,LTEN 130GS,A00,491853,Lyon; Antony J.,23,0,28,5
1713333471423,LTEN 148,A00,491855,Staff,23,0,25,2
1713333472448,LTEN 159,A00,491856,Staff,20,0,25,5
1713333473472,LTEN 180,A00,491857,Staff,8,0,15,7
1713333475525,LTSP 123GS,A00,505928,Bessett; Ryan Matthew,24,0,28,4
1713333476553,LTSP 174GS,A00,506037,Bessett; Ryan Matthew,24,0,28,4
1713333478611,LTWR 102,A00,491861,Staff,9,0,15,6
1713333479638,LTWR 106,A00,491862,Staff,8,0,15,7
1713333480664,MAE 11,A00,490930,Bahadori; Mohammad Yousef,95,0,100,5
1713333481692,MAE 30A,A00,490931,Qi; Huihui,37,0,40,3
1713333482722,MAE 101A,A00,491036,Sadeghizadeh; Zahra,92,0,100,8
1713333483748,MAE 101C,A00,491037,Seshadri; Kalyanasundaram,64,0,100,36
1713333484773,MAE 113,A00,491040,Seshadri; Kalyanasundaram,65,0,80,15
1713333485803,MAE 131A,A00,491041,Ghazinejad; Maziar,37,0,40,3
1713333487049,MAE 142,A00,491053,Staff,39,0,40,1
1713333488075,MAE 143A,A00,491054,Staff,31,0,50,19
1713333489107,MAE 150,A00,491092,Truong; Phuong Thi Ngoc,23,0,35,12
1713333490134,MATH 3C,A01,494031,Pardo Guerra; Sebastian,30,0,30,0
1713333490134,MATH 3C,A02,494032,Pardo Guerra; Sebastian,29,0,30,1
1713333491164,MATH 10A,A01,494034,Staff,27,0,30,3
1713333491164,MATH 10A,A02,494035,Staff,28,0,30,2
1713333491164,MATH 10A,B01,494037,Staff,27,0,30,3
1713333491164,MATH 10A,B02,494038,Staff,29,0,30,1
1713333492200,MATH 10B,A01,494040,Habib; Yousaf,22,0,30,8
1713333492200,MATH 10B,A02,494041,Habib; Yousaf,28,0,30,2
1713333492200,MATH 10B,A03,494042,Habib; Yousaf,29,0,30,1
1713333492200,MATH 10B,A04,494043,Habib; Yousaf,30,0,30,0
1713333492200,MATH 10B,B01,494045,Habib; Yousaf,25,0,30,5
1713333492200,MATH 10B,B02,494046,Habib; Yousaf,30,0,30,0
1713333492200,MATH 10B,B03,494047,Habib; Yousaf,30,0,30,0
1713333492200,MATH 10B,B04,494048,Habib; Yousaf,30,0,30,0
1713333493228,MATH 18,A01,494050,Kemp; Todd Aahron,25,0,30,5
1713333493228,MATH 18,A02,494051,Kemp; Todd Aahron,29,0,30,1
1713333493228,MATH 18,B01,494054,Kemp; Todd Aahron,25,0,30,5
1713333493228,MATH 18,B02,494055,Kemp; Todd Aahron,29,0,30,1
1713333494253,MATH 20A,A01,494059,Suk; Andrew Hoon,30,0,30,0
1713333495284,MATH 20B,A01,494061,Briones; Jor-el Thomas Caparas,33,0,35,2
1713333495284,MATH 20B,B01,494063,Bach; Quang Tran,34,0,35,1
1713333496310,MATH 20C,A01,494065,Staff,28,0,30,2
1713333496310,MATH 20C,A02,494066,Staff,30,0,30,0
1713333496310,MATH 20C,A03,494067,Staff,30,0,30,0
1713333496310,MATH 20C,A04,494068,Staff,30,0,30,0
1713333496310,MATH 20C,B01,494070,Zhang; Ming,25,0,30,5
1713333496310,MATH 20C,B02,494071,Zhang; Ming,27,0,30,3
1713333496310,MATH 20C,B03,494072,Zhang; Ming,29,0,30,1
1713333496310,MATH 20C,B04,494073,Zhang; Ming,29,0,30,1
1713333497336,MATH 20D,A01,494075,Staff,22,0,30,8
1713333497336,MATH 20D,A02,494076,Staff,29,0,30,1
1713333498364,MATH 20E,A01,494079,Staff,24,0,30,6
1713333498364,MATH 20E,A02,494080,Staff,26,0,30,4
1713333498364,MATH 20E,B01,494082,Staff,25,0,30,5
1713333498364,MATH 20E,B02,494083,Staff,25,0,30,5
1713333499396,MATH 103A,A01,494085,Aliabadi Sr.; Mohsen,13,0,30,17
1713333499396,MATH 103A,A02,494086,Aliabadi Sr.; Mohsen,28,0,30,2
1713333499396,MATH 103A,B01,494088,Aliabadi Sr.; Mohsen,21,0,30,9
1713333499396,MATH 103A,B02,494089,Aliabadi Sr.; Mohsen,27,0,30,3
1713333500422,MATH 109,A01,494091,Staff,30,0,30,0
1713333500422,MATH 109,A02,494092,Staff,29,0,30,1
1713333500422,MATH 109,B01,494094,Staff,27,0,30,3
1713333500422,MATH 109,B02,494095,Staff,29,0,30,1
1713333501448,MATH 142A,A01,494097,Chow; Bennett,14,0,30,16
1713333501448,MATH 142A,A02,494098,Chow; Bennett,23,0,30,7
1713333501448,MATH 142A,B01,494100,Chow; Bennett,19,0,30,11
1713333501448,MATH 142A,B02,494101,Chow; Bennett,29,0,30,1
1713333503503,MATH 168A,A01,516677,Dumitriu; Ioana,16,0,35,19
1713333504533,MATH 170A,A01,516679,Dumitriu; Ioana,18,0,30,12
1713333504533,MATH 170A,A02,516680,Dumitriu; Ioana,28,0,30,2
1713333505558,MATH 193A,A01,494107,Staff,13,0,30,17
1713333505558,MATH 193A,A02,494108,Staff,19,0,30,11
1713333505558,MATH 193A,A03,494109,Staff,29,0,30,1
1713333505558,MATH 193A,A04,494110,Staff,22,0,30,8
1713333508640,MGT 16,A00,491930,McKay; Michael J,92,0,98,6
1713333509664,MGT 18,A00,491992,McKay; Michael J,96,0,98,2
1713333510689,MGT 71,A00,492003,Staff,63,0,98,35
1713333511721,MGT 103,A00,505209,Eberhard; Craig A,81,0,98,17
1713333512749,MGT 131A,A00,505210,Anderson; John Charles,89,0,98,9
1713333514801,MGT 153,A00,492077,Perols; Johan Lars,18,0,90,72
1713333517878,MGT 164,A00,492222,McKay; Mary A,91,0,98,7
1713333518908,MGT 172,A00,492245,Staff,59,0,60,1
1713333518908,MGT 172,B00,505526,Hedges; Kathleen,65,0,98,33
1713333519934,MGT 181,A00,505669,Dunn; Louis Jean,80,0,98,18
1713333520966,MMW 14,A01,494399,Staff,15,0,28,13
1713333520966,MMW 14,A02,494400,Staff,25,0,28,3
1713333520966,MMW 14,A03,494401,Staff,28,0,28,0
1713333520966,MMW 14,A04,494402,Staff,28,0,28,0
1713333520966,MMW 14,B01,494404,Carreras; Maria Victoria,8,0,28,20
1713333520966,MMW 14,B02,494405,Carreras; Maria Victoria,25,0,28,3
1713333520966,MMW 14,B03,494406,Carreras; Maria Victoria,27,0,28,1
1713333520966,MMW 14,B04,494407,Carreras; Maria Victoria,28,0,28,0
1713333521994,MMW 14GS,A00,506250,Chang; Edmond Yi-Teh,0,0,0,0
1713333523019,MMW 121R,A01,494415,Adamiak; Patrick John,10,0,28,18
1713333523019,MMW 121R,A02,494416,Adamiak; Patrick John,24,0,28,4
1713333524047,MUS 1A,A01,494113,Staff,12,0,25,13
1713333524047,MUS 1A,A02,494114,Staff,24,0,25,1
1713333525073,MUS 4,A01,494116,Staff,23,0,25,2
1713333525073,MUS 4,A02,494117,Staff,22,0,25,3
1713333526104,MUS 5R,A01,494236,Dubnov; Shlomo,6,0,25,19
1713333526104,MUS 5R,A02,494237,Dubnov; Shlomo,25,0,25,0
1713333527132,MUS 6,A01,494122,Staff,10,0,25,15
1713333527132,MUS 6,A02,494123,Staff,23,0,25,2
1713333528158,MUS 7,A01,494125,Staff,16,0,25,9
1713333528158,MUS 7,A02,494126,Staff,24,0,25,1
1713333529183,MUS 11,A01,494128,Staff,23,0,25,2
1713333529183,MUS 11,A02,494129,Staff,24,0,25,1
1713333530267,MUS 13,A01,494131,Staff,25,0,25,0
1713333530267,MUS 13,A02,494132,Staff,25,0,25,0
1713333531292,MUS 15,A01,494134,Staff,16,0,25,9
1713333531292,MUS 15,A02,494135,Staff,25,0,25,0
1713333531292,MUS 15,B01,494137,Staff,24,0,25,1
1713333532322,MUS 80,A00,494232,Staff,24,0,25,1
1713333532322,MUS 80,B00,494233,Staff,25,0,25,0
1713333532322,MUS 80,C00,494234,Staff,23,0,25,2
1713333533350,MUS 95C,A00,494141,Staff,70,0,75,5
1713333534374,MUS 114,A00,494142,Staff,40,0,50,10
1713333535403,NANO 15,A01,490636,Drews; Aaron,7,0,7,0
1713333536428,PHIL 1,A00,490578,Grush; Rick Scott,49,0,50,1
1713333537454,PHIL 10,A01,490580,Grush; Rick Scott,33,0,35,2
1713333537454,PHIL 10,A02,490586,Grush; Rick Scott,32,0,35,3
1713333538484,PHIL 27,A01,490591,Staff,22,0,25,3
1713333538484,PHIL 27,A02,490592,Staff,25,0,25,0
1713333538484,PHIL 27,A03,490593,Staff,25,0,25,0
1713333538484,PHIL 27,A04,490598,Staff,25,0,25,0
1713333539513,PHIL 32,A01,490611,Staff,20,0,20,0
1713333539513,PHIL 32,A02,490618,Staff,20,0,20,0
1713333540536,PHIL 90,A00,490624,Staff,40,0,40,0
1713333541562,PHIL 136,A00,490627,Cohen; Jonathan David,37,0,40,3
1713333542586,PHIL 155,A00,490634,Staff,62,0,70,8
1713333543612,PHYS 1A,A00,491610,Staff,245,0,250,5
1713333544638,PHYS 1AL,001,491616,Tsai; Philbert S,27,0,30,3
1713333544638,PHYS 1AL,002,491618,Tsai; Philbert S,30,0,30,0
1713333545664,PHYS 1B,A00,491623,Staff,236,0,250,14
1713333546692,PHYS 1BL,001,491626,Tsai; Philbert S,22,0,30,8
1713333546692,PHYS 1BL,002,491628,Tsai; Philbert S,26,0,30,4
1713333547720,PHYS 1C,A00,491632,Staff,213,0,245,32
1713333548743,PHYS 1CL,001,491635,Tsai; Philbert S,2,0,30,28
1713333548743,PHYS 1CL,002,491643,Tsai; Philbert S,22,0,30,8
1713333549770,PHYS 2AR,A01,491651,Meyertholen; Andrew D.,44,0,50,6
1713333550795,PHYS 2B,A01,491659,Staff,106,0,115,9
1713333551820,PHYS 2BL,A01,491685,Staff,21,0,24,3
1713333551820,PHYS 2BL,A02,491700,Staff,21,0,24,3
1713333552844,PHYS 2C,A01,505161,Staff,101,0,115,14
1713333553872,PHYS 4A,A01,491704,Grinstein; Benjamin,99,0,100,1
1713333554898,POLI 5D,A01,494144,Staff,3,0,5,2
1713333554898,POLI 5D,B01,626283,Dai; Yinlin,5,0,5,0
1713333555924,POLI 12,A00,494145,Staff,43,0,45,2
1713333556950,POLI 13R,A00,494146,Forman; Fonna,45,0,50,5
1713333557979,POLI 27,A01,494148,Staff,54,0,60,6
1713333559004,POLI 30,A00,494149,Staff,49,0,50,1
1713333560033,POLI 100DA,A00,494150,Staff,21,0,25,4
1713333562083,POLI 100I,A00,494152,Staff,27,0,30,3
1713333563111,POLI 104B,A00,494153,Smith; Glenn Chatmas,53,0,55,2
1713333564137,POLI 104F,A00,494154,Staff,28,0,30,2
1713333565161,POLI 104I,A00,494155,Smith; Glenn Chatmas,29,0,30,1
1713333566186,POLI 110C,A00,494156,Ingham; Sean,23,0,25,2
1713333567213,POLI 117R,A00,494157,Forman; Fonna,5,0,20,15
1713333568239,POLI 118,A00,494158,Ingham; Sean,21,0,25,4
1713333569265,POLI 120H,A00,494159,Fisk; David Lee,39,0,45,6
1713333570293,POLI 131CR,A00,494160,Hoston; Germaine,35,0,45,10
1713333571320,POLI 133J,A00,494161,Staff,31,0,35,4
1713333572344,POLI 135,A00,494162,Fisk; David Lee,33,0,35,2
1713333573369,POLI 140A,A00,494164,Staff,19,0,30,11
1713333574398,POLI 142I,A00,494165,Staff,30,0,30,0
1713333575423,POLI 144D,A00,494166,Staff,23,0,25,2
1713333576452,POLI 151,A00,494167,Staff,30,0,30,0
1713333577478,POLI 153,A00,494168,Staff,33,0,35,2
1713333578504,POLI 160AA,A00,494169,Staff,34,0,40,6
1713333579532,POLI 162,A00,494170,Mignozzetti; Umberto,18,0,25,7
1713333580556,POLI 171,A00,494171,Mignozzetti; Umberto,18,0,25,7
1713333581581,PSYC 1,A00,494172,Staff,95,0,100,5
1713333582608,PSYC 2,A00,494173,Moranton; Nirelia Melbina-,34,0,50,16
1713333583636,PSYC 3,A00,494174,Staff,29,0,30,1
1713333584662,PSYC 6,A00,494175,Staff,17,0,20,3
1713333585689,PSYC 60,A01,494177,Staff,37,0,45,8
1713333586714,PSYC 70,A01,505724,Geller; Emma Harlan,42,0,45,3
1713333587739,PSYC 101,A00,494180,Heyman; Gail D.,84,0,100,16
1713333588768,PSYC 105,A00,494181,Geller; Emma Harlan,51,0,90,39
1713333589797,PSYC 106,A00,494182,Dobkins; Karen R.,27,0,45,18
1713333590822,PSYC 108,A00,494183,Adrian; Julia Anna,89,0,100,11
1713333591849,PSYC 114,A01,494185,Winkielman; Piotr,0,3,30,30
1713333592874,PSYC 122,A00,494186,Moranton; Nirelia Melbina-,27,0,50,23
1713333593899,PSYC 124,A00,494187,Chapman; Eddie Nathaniel,70,0,80,10
1713333594928,PSYC 131,A00,494188,Anagnostaras; Stephan,41,0,80,39
1713333595953,PSYC 144,A00,494189,Staff,3,0,50,47
1713333596982,PSYC 154,A00,494190,Lacefield; Katharine I,107,0,180,73
1713333598010,PSYC 162,A00,494191,Wixted; John T,71,0,100,29
1713333599034,PSYC 172,A00,494192,Gorman; Michael R.,36,0,45,9
1713333600060,PSYC 178,A00,494193,Glaser; Dale,34,0,45,11
1713333601086,PSYC 193,A00,505725,Chapman; Eddie Nathaniel,20,0,20,0
1713333602111,RELI 145GS,A00,519817,Rahimi; Babak,18,0,20,2
1713333603145,SE 101A,A01,490862,Chadha; Mayank,23,0,25,2
1713333604174,SE 101C,A01,490924,Krysl; Petr,15,0,20,5
1713333605203,SE 110A,A01,490928,Staff,19,0,20,1
1713333606230,SE 130A,A00,490929,Morrison; Machel Leigh,54,0,70,16
1713333607255,SIO 1,A01,519325,Staff,39,0,40,1
1713333608278,SIO 30,A01,519327,Staff,38,0,40,2
1713333609307,SIO 40,A00,519328,Staff,39,0,40,1
1713333610334,SIO 46GS,A00,519819,Cook; Geoffrey W,17,0,25,8
1713333611359,SIO 109R,A00,494197,Forman; Fonna,0,3,20,20
1713333612384,SIO 121GS,A00,519827,Cook; Geoffrey W,17,0,25,8
1713333613409,SIO 132,A01,519330,Staff,38,0,40,2
1713333614436,SIO 133,A01,519397,Staff,37,0,40,3
1713333615464,SIO 139,A00,519396,Kacev; David,29,0,40,11
1713333616496,SOCI 1,A01,494199,Thorpe; Charles Robert,21,0,30,9
1713333616496,SOCI 1,A02,494200,Thorpe; Charles Robert,30,0,30,0
1713333616496,SOCI 1,A03,494201,Thorpe; Charles Robert,29,0,30,1
1713333616496,SOCI 1,A04,494202,Thorpe; Charles Robert,29,0,30,1
1713333616496,SOCI 1,A05,494203,Thorpe; Charles Robert,29,0,30,1
1713333616496,SOCI 1,A06,494204,Thorpe; Charles Robert,30,0,30,0
1713333616496,SOCI 1,A07,494205,Thorpe; Charles Robert,28,0,30,2
1713333617522,SOCI 60,A01,494207,Staff,34,0,40,6
1713333617522,SOCI 60,A02,494208,Staff,39,0,40,1
1713333618547,SOCI 100,A01,494210,Payne; Christine Anna,25,0,30,5
1713333618547,SOCI 100,A02,494211,Payne; Christine Anna,26,0,30,4
1713333619574,SOCI 109M,A00,494212,Staff,20,0,20,0
1713333620600,SOCI 110,A00,494213,Staff,34,0,40,6
1713333622651,SOCI 118E,A00,494215,Ng; Kwai,37,0,40,3
1713333623678,SOCI 125,A00,494216,Calderon-Zaks; Michael Aar,40,0,45,5
1713333624705,SOCI 126,A01,494218,Jones; Makeba,3,0,5,2
1713333625729,SOCI 131,A00,494219,Thorpe; Charles Robert,26,0,30,4
1713333627778,SOCI 135,A00,494221,Payne; Christine Anna,28,0,50,22
1713333628808,SOCI 136E,A00,626690,Ruiz; Jonathan Joseph,24,0,25,1
1713333629834,SOCI 138GS,A00,494222,Navon; Daniel,24,0,28,4
1713333631884,SOCI 145,A00,494224,Staff,40,0,45,5
1713333632913,SOCI 153,A00,494225,Staff,28,0,30,2
1713333633991,SOCI 160E,A00,494226,Ng; Kwai,29,0,40,11
1713333635016,SOCI 180,A00,494227,Staff,29,0,30,1
1713333636039,SOCI 189GS,A00,494228,Ribas Norris; Janet Vanesa,11,0,11,0
1713333637065,SOCI 190GS,A00,553232,Ribas Norris; Janet Vanesa,11,0,11,0
1713333638092,SOMI 220,A00,627178,Schneid; Stephen David,30,0,30,0
1713333639122,SYN 2,001,490768,Staff,13,0,15,2
1713333639122,SYN 2,002,490769,Staff,14,0,15,1
1713333639122,SYN 2,004,490775,Staff,0,0,0,0
1713333639122,SYN 2,003,490774,Staff,0,0,0,0
1713333639122,SYN 2,005,490776,Staff,0,0,0,0
1713333640148,SYN 2R,001,490779,Staff,11,0,15,4
1713333640148,SYN 2R,002,514635,Staff,14,0,15,1
1713333641178,SYN 100,A01,490783,Staff,9,0,20,11
1713333641178,SYN 100,B01,490787,Staff,9,0,20,11
1713333641178,SYN 100,C01,490789,Staff,10,0,20,10
1713333642206,SYN 150,A00,490817,Staff,14,0,15,1
1713333642206,SYN 150,B00,514610,Staff,15,0,15,0
1713333643235,TDAC 1,A00,492753,Walsh; Kim C.,19,0,20,1
1713333643235,TDAC 1,B00,492754,Harting; Carla Kelso,19,0,20,1
1713333643235,TDAC 1,C00,513995,Salovey; Todd,15,0,20,5
1713333644264,TDAC 101,A00,492766,Harting; Carla Kelso,17,0,20,3
1713333645293,TDAC 102,A00,492768,Basso; Beatrice,19,0,20,1
1713333646322,TDDE 111,A00,492769,Staff,25,0,25,0
1713333647352,TDDE 131,A00,492770,Staff,15,0,15,0
1713333647352,TDDE 131,B00,492771,Staff,15,0,15,0
1713333648380,TDDE 131GS,A00,523716,Guirguis; Mark C,23,0,28,5
1713333649407,TDGE 1,A01,492756,Salovey; Todd,56,0,60,4
1713333650435,TDGE 5,A01,492758,Staff,23,0,25,2
1713333651461,TDGE 10,A00,492759,Fulton; Julia,203,0,220,17
1713333652487,TDGE 11,A00,492760,Castro; Robert Jess,198,0,200,2
1713333654536,TDGE 124,A00,492772,Fulton; Julia,184,0,220,36
1713333655567,TDGE 125,A00,492773,Meyer; Ursula,38,0,50,12
1713333655567,TDGE 125,B00,492774,Staff,49,0,50,1
1713333655567,TDGE 125,C00,523565,Staff,48,0,50,2
1713333656595,TDGE 125GS,A00,523580,Guirguis; Mark C,23,0,28,5
1713333657625,TDGE 127,A00,492775,Havis; Allan,33,0,50,17
1713333658650,TDHT 101,A00,492776,Staff,34,0,35,1
1713333659679,TDMV 1,A00,492762,Caligagan; Maria T.,29,0,30,1
1713333659679,TDMV 1,B00,492763,Arcidiacono; Kristin,26,0,30,4
1713333660710,TDMV 2,A00,492764,Weinberg; Sadie,28,0,30,2
1713333661736,TDMV 3,A00,492765,Mack; Kara Shanai',37,0,40,3
1713333662831,TDMV 138,A00,492777,Mack; Kara Shanai',34,0,40,6
1713333663870,TDMV 140,A00,492778,Lima; Paulo Henrique,40,0,40,0
1713333664902,TDMV 142,A00,492779,Caligagan; Maria T.,33,0,40,7
1713333664902,TDMV 142,B00,492780,Caligagan; Tony,37,0,40,3
1713333665932,TDMV 143,A00,492781,Fyall; Daunte Edward,39,0,40,1
1713333666964,USP 1,A01,492401,Kwak; Nancy,27,0,35,8
1713333667992,USP 2,A01,492453,Hinds; Juli Beth,35,0,35,0
1713333669021,USP 3,A01,492516,Staff,28,0,35,7
1713333670049,USP 4,A00,492522,McTague; Sarah,16,0,25,9
1713333671074,USP 100,A00,492523,Staff,32,0,35,3
1713333672104,USP 101,A00,492524,Staff,13,0,15,2
1713333673131,USP 105,A00,492525,Staff,21,0,25,4
1713333674161,USP 151,A00,492526,Shenkman; Michael Thomas,32,0,35,3
1713333675188,USP 170,A00,492545,Hinds; Juli Beth,33,0,35,2
1713333676213,USP 171GS,A00,492608,Bussell; Mirle Rabinowitz,24,0,28,4
1713333677238,USP 183GS,A00,492613,Peerson; Susan,24,0,28,4
1713333678263,VIS 30,A01,490693,Yoldas; Pinar,19,0,22,3
1713333678263,VIS 30,A02,490694,Yoldas; Pinar,18,0,22,4
1713333679296,VIS 83,A00,490695,Kester; Grant,63,0,75,12
1713333680322,VIS 105D,A00,490696,Staff,22,0,25,3
1713333681349,VIS 124CN,A00,490699,Rose; Jordan M,65,0,75,10
1713333682382,VIS 125GS,A00,511221,Williams; Alena J,21,0,22,1
1713333683408,VIS 128D,A00,490700,Staff,73,0,75,2
1713333684437,VIS 151,A01,490717,Staff,33,0,34,1
1713333684437,VIS 151,A02,490766,Staff,33,0,34,1
1713333685465,VIS 154GS,A00,511972,Williams; Alena J,21,0,22,1
1713333686491,VIS 160A,A00,490767,Stone; Patricia,7,0,10,3
1713333687515,WCWP 10A,A00,490638,Staff,14,0,15,1
1713333687515,WCWP 10A,B00,490640,Staff,15,0,15,0
1713333688545,WCWP 10B,A00,490641,Staff,0,0,0,0
1713333688545,WCWP 10B,B00,490642,Staff,14,0,15,1
1713333688545,WCWP 10B,C00,490644,Staff,13,0,15,2
1713333688545,WCWP 10B,D00,490647,Staff,0,0,0,0
1713333689571,WCWP 100,A00,490655,Staff,0,0,0,0
1713333689571,WCWP 100,B00,490687,Staff,10,0,15,5
1713333691665,ANAR 153,A00,487222,Braswell; Geoffrey E.,53,0,60,7
1713333692694,ANBI 134,A00,487223,Staff,5,0,20,15
1713333693724,ANBI 143GS,A00,487224,Noel; Geoffroy Pierre Jean,18,0,24,6
1713333694750,ANBI 144GS,A00,519548,Noel; Geoffroy Pierre Jean,18,0,24,6
1713333695776,ANSC 101,A00,487225,Staff,18,0,20,2
1713333696806,ANSC 125,A00,487227,Brenner; Suzanne A,38,0,40,2
1713333698981,ANSC 146,A00,487229,Staff,35,0,40,5
1713333700007,ANSC 148,A00,487230,Olivas Hernandez; Olga Lid,39,0,40,1
1713333701034,ANSC 150,A00,504165,Sloane; Julia Kathryn,18,0,20,2
1713333702060,ANSC 180,A00,487232,Staff,14,0,15,1
1713333703084,ANSC 188,A00,627155,Staff,38,0,40,2
1713333704110,ANTH 5,A00,519529,Semendeferi; Ekaterini,15,0,15,0
1713333705135,ANTH 10,A00,487219,Staff,58,0,60,2
1713333706164,ANTH 23,A01,487221,Staff,17,0,20,3
1713333707191,ANTH 102,A00,487233,Wilder; Linnea Lorene,51,0,60,9
1713333708220,ANTH 103,A00,487234,Varma; Saiba,55,0,60,5
1713333709247,ANTH 105,A00,487235,Stewart; Alexander B,54,0,60,6
1713333710272,BENG 100,A01,516685,Taylor Amos; Alyssa C,26,0,30,4
1713333711301,BIBC 102,A01,491316,Flagg; Matthew Paul,8,0,88,80
1713333711301,BIBC 102,A02,491366,Flagg; Matthew Paul,78,0,88,10
1713333712330,BIBC 103,A01,491486,Boumechache; Miyyada,16,0,24,8
1713333712330,BIBC 103,A02,491487,Boumechache; Miyyada,24,0,24,0
1713333713361,BICD 100,A01,516882,Staff,73,0,75,2
1713333713361,BICD 100,A02,516890,Staff,69,0,75,6
1713333714388,BICD 102GS,A00,491488,Lo; Stanley M.,26,0,28,2
1713333715417,BIEB 136GS,A00,516940,Holway; David A. & Shurin; Jonathan,18,0,24,6
1713333716444,BIEB 137GS,A01,517034,Holway; David A. & Shurin; Jonathan,18,0,24,6
1713333717468,BIEB 138GS,A01,491492,Pirino; Giorgia,21,0,28,7
1713333718500,BILD 1,A01,491296,Staff,60,0,63,3
1713333718500,BILD 1,A02,491297,Staff,63,0,63,0
1713333719529,BILD 4,A01,517099,Gonzalez Gamboa; Ivonne,22,0,24,2
1713333719529,BILD 4,A02,517100,Gonzalez Gamboa; Ivonne,24,0,24,0
1713333720556,BILD 60GS,A00,491309,Lo; Stanley M.,26,0,28,2
1713333721582,BIMM 100,A01,517136,Staff,83,0,100,17
1713333722607,BIMM 110,A01,517182,Staff,54,0,100,46
1713333723642,BIMM 120,A01,517228,Pickett; Brooke Elizabeth,28,0,63,35
1713333723642,BIMM 120,A02,517240,Pickett; Brooke Elizabeth,44,0,63,19
1713333724671,BIMM 132GS,A01,491498,Pirino; Giorgia,21,0,28,7
1713333725697,BIMM 143,A01,491589,Bozinovic; Goran,12,0,40,28
1713333726729,BIPN 100,A01,491594,Armour; Jon Christopher,83,0,100,17
1713333727763,BIPN 140,A01,491602,Marino; Marc J,25,0,50,25
1713333729813,CAT 125,A00,515973,Staff,18,0,20,2
1713333730838,CAT 125GS,A00,515974,Rahimi; Babak,17,0,20,3
1713333731875,CAT 125R,A00,515980,Staff,12,0,20,8
1713333731875,CAT 125R,B00,515981,Tosun; Adriana,19,0,20,1
1713333731875,CAT 125R,C00,515987,Hyland; Tina Mae,0,3,20,20
1713333731875,CAT 125R,D00,515988,Bronstein; Phoebe Malan,16,0,20,4
1713333732905,CENG 15,A01,488699,Drews; Aaron,25,0,25,0
1713333733942,CENG 100,A00,505196,Opatkiewicz; Justin Paul,25,0,25,0
1713333734967,CGS 2A,A01,489598,Staff,33,0,35,2
1713333735998,CGS 112,A00,489599,Staff,15,0,15,0
1713333737023,CGS 119,A00,489603,Staff,10,0,10,0
1713333738103,CGS 120,A00,489604,Staff,14,0,15,1
1713333739129,CGS 150,A00,489607,Staff,15,0,15,0
1713333740155,CHEM 6A,A01,488715,Staff,97,0,100,3
1713333741181,CHEM 6B,A01,488719,Piercy; Marc Anthony,99,0,100,1
1713333742212,CHEM 6C,A01,488723,Albizati; Kim F.,93,0,100,7
1713333743241,CHEM 7L,A01,488728,Schurmeier; Kimberly,18,0,24,6
1713333743241,CHEM 7L,A02,488730,Schurmeier; Kimberly,23,0,24,1
1713333743241,CHEM 7L,A03,488734,Schurmeier; Kimberly,20,0,24,4
1713333743241,CHEM 7L,A04,488763,Schurmeier; Kimberly,23,0,24,1
1713333743241,CHEM 7L,B01,488798,Schurmeier; Kimberly,17,0,24,7
1713333743241,CHEM 7L,B02,488801,Schurmeier; Kimberly,22,0,24,2
1713333743241,CHEM 7L,B03,488808,Schurmeier; Kimberly,22,0,24,2
1713333743241,CHEM 7L,B04,488811,Schurmeier; Kimberly,24,0,24,0
1713333744269,CHEM 11,A01,488897,Stallings; Dontarie M,95,0,100,5
1713333745294,CHEM 40A,A01,488913,Albizati; Kim F.,83,0,100,17
1713333746322,CHEM 40B,A01,488920,Weizman; Haim,43,0,50,7
1713333746322,CHEM 40B,A02,488938,Weizman; Haim,44,0,50,6
1713333747347,CHEM 41A,A01,489029,Klosterman; Jeremy K,57,0,60,3
1713333748373,CHEM 41C,A01,500436,Tor; Yitzhak,55,0,60,5
1713333749398,CHEM 43A,A01,500426,Weizman; Haim,0,1,24,24
1713333749398,CHEM 43A,A02,500430,Weizman; Haim,7,0,24,17
1713333749398,CHEM 43A,B01,514041,Klosterman; Jeremy K,16,0,24,8
1713333749398,CHEM 43A,B02,514047,Klosterman; Jeremy K,23,0,24,1
1713333750436,CHEM 108,A01,489140,Jennings; Patricia A.,8,0,24,16
1713333750436,CHEM 108,A02,489142,Jennings; Patricia A.,14,0,24,10
1713333751461,CHEM 114A,A01,489147,Stallings; Dontarie M,68,0,100,32
1713333752491,CHIN 169A,A00,489171,Wang; Xiao,19,0,20,1
1713333754546,COGS 3,A01,518827,Boyle; Mary E. T.,25,0,40,15
1713333755573,COGS 11,A01,489175,Staff,27,0,30,3
1713333756601,COGS 14A,A01,518829,Staff,51,0,60,9
1713333757630,COGS 14B,A01,489177,Hoffman; Drew Ellen,62,0,75,13
1713333758666,COGS 100,A01,489181,Allen; Michael Gordon,62,0,75,13
1713333759692,COGS 101A,A01,489183,Staff,45,0,60,15
1713333760718,COGS 101B,A01,489185,Allen; Michael Gordon,8,0,30,22
1713333761743,COGS 101C,A01,526786,Staff,23,0,30,7
1713333763798,COGS 107A,A01,489189,Boyle; Mary E. T.,17,0,35,18
1713333764834,COGS 107B,A01,627144,Mooshagian; Eric Frederick,60,0,60,0
1713333765866,COGS 118A,A01,489191,Staff,0,46,40,40
1713333767926,COGS 171GS,A01,489194,Pineda; Jaime A,19,0,28,9
1713333768950,COGS 172,A01,489196,Staff,2,0,30,28
1713333769979,COGS 174GS,A01,489264,Pineda; Jaime A,19,0,28,9
1713333771004,COGS 180,A01,627150,Staff,28,0,30,2
1713333772030,COGS 186,A01,489274,Staff,0,1,30,30
1713333773060,COMM 10,A01,489276,Staff,23,0,25,2
1713333773060,COMM 10,A02,489303,Staff,23,0,25,2
1713333774087,COMM 100A,A01,489312,Staff,14,0,25,11
1713333774087,COMM 100A,A02,489313,Staff,24,0,25,1
1713333775113,COMM 106T,A00,512540,Staff,33,0,35,2
1713333776138,COMM 107,A00,489347,Staff,27,0,35,8
1713333777165,COMM 109P,A00,489358,Staff,31,0,35,4
1713333778194,COMM 132,A00,489361,McKenna; Denise,27,0,30,3
1713333779223,COMM 146,A00,489362,Halm; Gavin Patrick,26,0,30,4
1713333780249,COMM 190,A00,489363,Abuelhiga; Soraya Jill,17,0,23,6
1713333781276,CSE 8A,A50,489366,Staff,21,0,25,4
1713333781276,CSE 8A,A51,489367,Staff,24,0,25,1
1713333782307,CSE 11,A01,489398,Cao; Yingjun,73,0,100,27
1713333783338,CSE 12,A01,489487,Staff,43,0,50,7
1713333784368,CSE 20,A01,489497,Staff,48,0,50,2
1713333785394,CSE 21,A01,489517,Braun; Oliver,42,0,50,8
1713333786420,CSE 101,A01,489524,Braun; Oliver,0,32,50,50
1713333787447,CSE 105,A01,512594,Jones; Miles E,72,0,100,28
1713333787447,CSE 105,B01,512598,Jones; Miles E,52,0,100,48
1713333788474,CSE 140,A01,489538,Staff,41,0,50,9
1713333789513,CSE 141,A01,489550,Eldon; John,67,0,100,33
1713333790538,CSE 141L,A01,489571,Eldon; John,65,0,100,35
1713333791570,CSE 151A,A01,489583,Solares; Edwin A,141,0,200,59
1713333792596,CSE 175,A01,510886,Kumar; Rakesh,30,0,30,0
1713333793630,CSE 190,A00,516828,Dubnov; Shlomo,38,0,49,11
1713333794656,DOC 100D,A00,489667,Pass; Natalye Joann,19,0,25,6
1713333795681,DSC 10,A01,624268,Staff,72,0,75,3
1713333796708,DSC 20,A01,624476,Staff,50,0,50,0
1713333797733,DSC 40A,A01,624608,Staff,39,0,40,1
1713333798764,DSGN 1,A01,489179,Rill; Bryan,32,0,50,18
1713333799793,ECE 17,A01,490489,Sahay; Rajeev,18,0,30,12
1713333800820,ECE 65,A50,490492,Staff,11,0,20,9
1713333800820,ECE 65,A51,490493,Staff,18,0,20,2
1713333801929,ECON 1,A01,489715,Famulari; Melissa,67,0,70,3
1713333802959,ECON 2,A01,489717,Levkoff; Steven B.,67,0,70,3
1713333803986,ECON 3,A01,489948,Staff,70,0,70,0
1713333806046,ECON 5,A01,490103,Staff,27,0,30,3
1713333806046,ECON 5,B01,626281,Dai; Yinlin,45,0,45,0
1713333807071,ECON 100A,A01,490127,Famulari; Melissa,65,0,70,5
1713333808096,ECON 100B,A01,490129,Staff,64,0,70,6
1713333809125,ECON 109,A01,490187,Shishkin; Denis,27,0,35,8
1713333810151,ECON 110A,A01,490190,Levkoff; Steven B.,60,0,70,10
1713333811179,ECON 120A,A01,490245,Dai; Yinlin,61,0,70,9
1713333812206,ECON 120B,A01,490247,Nieto-Barthaburu; Augusto,40,0,70,30
1713333813236,ECON 120C,A01,490253,Sun; Yixiao,30,0,35,5
1713333813236,ECON 120C,B01,490255,Sun; Yixiao,34,0,35,1
1713333814263,ECON 129,A00,490256,Eckert; Fabian Paul,22,0,35,13
1713333815289,ECON 131,A00,490257,Nieto-Barthaburu; Augusto,0,6,35,35
1713333816318,ECON 138,A00,490258,Bharadwaj; Prashant,13,0,35,22
1713333816318,ECON 138,B00,490259,Bharadwaj; Prashant,15,0,35,20
1713333817345,ECON 159,A00,490260,Hendrickson; Gerald M.,0,9,0,0
1713333818373,ECON 178,A01,553995,Zhu; Ying,24,0,35,11
1713333819397,EDS 40,A01,512576,Black; Alison Michelle,20,0,20,0
1713333820423,EDS 107,A01,515848,Staff,30,0,30,0
1713333821451,EDS 110R,A01,490262,Staff,26,0,30,4
1713333822479,EDS 112,A01,490264,Chapman; Thandeka K,40,0,50,10
1713333823504,EDS 113,A00,490266,Staff,26,0,30,4
1713333824531,EDS 118,A00,490267,Warstadt; Melissa Fawn,20,0,30,10
1713333825560,EDS 124BR,A00,490268,Eguchi; Emi,4,0,25,21
1713333825560,EDS 124BR,B00,490269,Eguchi; Emi,23,0,25,2
1713333826587,EDS 126,A01,490271,Jones; Makeba,43,0,50,7
1713333827612,EDS 135,A01,490316,Staff,19,0,20,1
1713333828644,ENVR 142GS,A00,519514,Chang; Edmond Yi-Teh,26,0,28,2
1713333829679,ETHN 103,A00,490504,Staff,25,0,36,11
1713333830705,ETHN 103A,A00,490505,Man; Simeon S,4,0,9,5
1713333831733,ETHN 109,A00,490506,Staff,28,0,30,2
1713333832760,ETHN 118,A00,490507,Staff,35,0,36,1
1713333833791,ETHN 119,A00,490508,Staff,33,0,36,3
1713333834818,ETHN 121R,A00,490518,Choi; Esther Min,21,0,36,15
1713333835846,ETHN 127,A00,490528,Staff,14,0,15,1
1713333836876,ETHN 139,A00,490573,Staff,10,0,10,0
1713333837901,ETHN 150,A00,490575,Staff,15,0,15,0
1713333838926,GLBH 20,A00,491705,Elwardani; Nile Regina,38,0,40,2
1713333839951,GLBH 101,A00,491706,Staff,20,0,20,0
1713333840979,GLBH 111,A01,491708,Burgos; Jose L.,15,0,15,0
1713333842059,GLBH 146,A00,491709,Staff,9,0,20,11
1713333843088,GLBH 148,A00,491710,Olivas Hernandez; Olga Lid,11,0,20,9
1713333844118,GLBH 150,A00,491711,Sloane; Julia Kathryn,19,0,20,1
1713333845142,HIEA 131,A00,491760,Staff,28,0,32,4
1713333846167,HIEA 153,A00,491762,Staff,28,0,30,2
1713333847208,HIEU 124,A00,491811,Staff,26,0,32,6
1713333848253,HIEU 124GS,A00,491812,Markman; Kristina,27,0,28,1
1713333849282,HIEU 147,A00,491813,Staff,30,0,32,2
1713333850308,HIEU 149GS,A00,491816,Caldwell; Michael Alan,28,0,28,0
1713333851338,HILD 2C,A01,491713,Hendrickson; Gerald M.,26,0,30,4
1713333852365,HILD 7B,A01,491715,Kwak; Nancy,0,2,30,30
1713333853390,HILD 10,A01,491717,Staff,11,0,20,9
1713333854419,HILD 30GS,A00,491719,Edington; Claire Ellen,23,0,28,5
1713333855448,HINE 109,A00,491818,Shafir; Nir,27,0,32,5
1713333856473,HINE 128,A00,491821,Shafir; Nir,31,0,32,1
1713333857497,HISC 117,A00,491830,Staff,27,0,32,5
1713333858521,HIUS 103,A00,491834,Man; Simeon S,14,0,23,9
1713333859547,HIUS 108B,A00,491835,Staff,27,0,30,3
1713333860574,HIUS 141,A00,491836,Hendrickson; Gerald M.,28,0,32,4
1713333861601,HIUS 149,A00,491839,Staff,24,0,32,8
1713333862631,HUM 3,A01,512617,Crum; Matthew Stephen,42,0,50,8
1713333862631,HUM 3,A02,512618,Crum; Matthew Stephen,48,0,50,2
1713333863658,HUM 3GS,A00,512663,Markman; Kristina,0,0,0,1
1713333863658,HUM 3GS,B00,512664,Staff,0,0,0,0
1713333864688,HUM 4,A01,512620,West; Geoffrey Scott,25,0,50,25
1713333865716,HUM 4GS,A00,512666,Lyon; Antony J.,0,0,0,5
1713333866742,HUM 4R,A01,512625,Watkins; Eric,49,0,50,1
1713333867774,HUM 5,A01,512649,Zavodny; Tatiana Sophia,22,0,50,28
1713333867774,HUM 5,B01,512661,Zroka; Ryan Edward,48,0,50,2
1713333868800,INTL 190,A00,490577,Segui; Alan S,0,0,0,5
1713333869827,JAPN 20AR,A01,491267,Ross; Kayoko F,7,0,20,13
1713333870857,JAPN 180,A00,491285,Berman; Michael David,33,0,40,7
1713333871885,LATI 50,A01,502536,Kokinis; Troy Andreas,16,0,22,6
1713333871885,LATI 50,A02,502551,Kokinis; Troy Andreas,22,0,22,0
1713333871885,LATI 50,A03,502650,Kokinis; Troy Andreas,22,0,22,0
1713333871885,LATI 50,A04,502909,Kokinis; Troy Andreas,21,0,22,1
1713333872910,LATI 160,A01,502920,Kokinis; Troy Andreas,30,0,30,0
1713333873940,LIFR 1A,A00,490494,Van Moer; Vinciane G,17,0,20,3
1713333874964,LIFR 1AX,A00,490495,Van Moer; Vinciane G,17,0,20,3
1713333875990,LIFR 1B,A00,490496,Van Moer; Vinciane G,17,0,20,3
1713333877013,LIFR 1BX,A00,490497,Van Moer; Vinciane G,17,0,20,3
1713333878045,LIGN 8,A00,505198,McIntosh; Justin Daniel,134,0,150,16
1713333879071,LIGN 9GS,A00,491239,Lott; Margaret S.,18,0,20,2
1713333880097,LIGN 101,A01,505200,McIntosh; Justin Daniel,22,0,30,8
1713333881126,LIGN 120,A01,491244,Staff,22,0,30,8
1713333882151,LIGN 149GS,A00,491245,Lott; Margaret S.,18,0,20,2
1713333883180,LIGN 170,A00,491247,Staff,22,0,30,8
1713333884211,LISP 1D,A00,490498,Munoz Sanchez; Alicia,8,0,14,6
1713333884211,LISP 1D,B00,490499,Munoz Sanchez; Alicia,6,0,14,8
1713333884211,LISP 1D,C00,490500,Munoz Sanchez; Alicia,7,0,14,7
1713333884211,LISP 1D,D00,490501,Munoz Sanchez; Alicia,10,0,14,4
1713333885242,LISP 1DX,A00,490502,Munoz Sanchez; Alicia,13,0,28,15
1713333885242,LISP 1DX,B00,490503,Munoz Sanchez; Alicia,16,0,28,12
1713333887300,LTAM 110,A00,491847,Staff,22,0,25,3
1713333888327,LTCS 119,A00,491848,Staff,11,0,15,4
1713333889350,LTCS 130,A00,491849,Staff,24,0,25,1
1713333891405,LTEA 120C,A00,491852,Staff,32,0,40,8
1713333892432,LTEN 130GS,A00,491853,Lyon; Antony J.,23,0,28,5
1713333893458,LTEN 148,A00,491855,Staff,23,0,25,2
1713333894485,LTEN 159,A00,491856,Staff,20,0,25,5
1713333895511,LTEN 180,A00,491857,Staff,8,0,15,7
1713333897563,LTSP 123GS,A00,505928,Bessett; Ryan Matthew,24,0,28,4
1713333898589,LTSP 174GS,A00,506037,Bessett; Ryan Matthew,24,0,28,4
1713333900643,LTWR 102,A00,491861,Staff,9,0,15,6
1713333901669,LTWR 106,A00,491862,Staff,8,0,15,7
1713333902700,MAE 11,A00,490930,Bahadori; Mohammad Yousef,95,0,100,5
1713333903725,MAE 30A,A00,490931,Qi; Huihui,37,0,40,3
1713333904751,MAE 101A,A00,491036,Sadeghizadeh; Zahra,92,0,100,8
1713333905780,MAE 101C,A00,491037,Seshadri; Kalyanasundaram,64,0,100,36
1713333906806,MAE 113,A00,491040,Seshadri; Kalyanasundaram,65,0,80,15
1713333907834,MAE 131A,A00,491041,Ghazinejad; Maziar,37,0,40,3
1713333908861,MAE 142,A00,491053,Staff,39,0,40,1
1713333909888,MAE 143A,A00,491054,Staff,31,0,50,19
1713333910913,MAE 150,A00,491092,Truong; Phuong Thi Ngoc,23,0,35,12
1713333911938,MATH 3C,A01,494031,Pardo Guerra; Sebastian,30,0,30,0
1713333911938,MATH 3C,A02,494032,Pardo Guerra; Sebastian,29,0,30,1
1713333912968,MATH 10A,A01,494034,Staff,27,0,30,3
1713333912968,MATH 10A,A02,494035,Staff,28,0,30,2
1713333912968,MATH 10A,B01,494037,Staff,27,0,30,3
1713333912968,MATH 10A,B02,494038,Staff,29,0,30,1
1713333914014,MATH 10B,A01,494040,Habib; Yousaf,22,0,30,8
1713333914014,MATH 10B,A02,494041,Habib; Yousaf,28,0,30,2
1713333914014,MATH 10B,A03,494042,Habib; Yousaf,29,0,30,1
1713333914014,MATH 10B,A04,494043,Habib; Yousaf,30,0,30,0
1713333914014,MATH 10B,B01,494045,Habib; Yousaf,25,0,30,5
1713333914014,MATH 10B,B02,494046,Habib; Yousaf,30,0,30,0
1713333914014,MATH 10B,B03,494047,Habib; Yousaf,30,0,30,0
1713333914014,MATH 10B,B04,494048,Habib; Yousaf,30,0,30,0
1713333915045,MATH 18,A01,494050,Kemp; Todd Aahron,25,0,30,5
1713333915045,MATH 18,A02,494051,Kemp; Todd Aahron,29,0,30,1
1713333915045,MATH 18,B01,494054,Kemp; Todd Aahron,25,0,30,5
1713333915045,MATH 18,B02,494055,Kemp; Todd Aahron,29,0,30,1
1713333916077,MATH 20A,A01,494059,Suk; Andrew Hoon,30,0,30,0
1713333917103,MATH 20B,A01,494061,Briones; Jor-el Thomas Caparas,33,0,35,2
1713333917103,MATH 20B,B01,494063,Bach; Quang Tran,34,0,35,1
1713333918152,MATH 20C,A01,494065,Staff,28,0,30,2
1713333918152,MATH 20C,A02,494066,Staff,30,0,30,0
1713333918152,MATH 20C,A03,494067,Staff,30,0,30,0
1713333918152,MATH 20C,A04,494068,Staff,30,0,30,0
1713333918152,MATH 20C,B01,494070,Zhang; Ming,25,0,30,5
1713333918152,MATH 20C,B02,494071,Zhang; Ming,27,0,30,3
1713333918152,MATH 20C,B03,494072,Zhang; Ming,29,0,30,1
1713333918152,MATH 20C,B04,494073,Zhang; Ming,29,0,30,1
1713333919182,MATH 20D,A01,494075,Staff,22,0,30,8
1713333919182,MATH 20D,A02,494076,Staff,29,0,30,1
1713333920211,MATH 20E,A01,494079,Staff,24,0,30,6
1713333920211,MATH 20E,A02,494080,Staff,26,0,30,4
1713333920211,MATH 20E,B01,494082,Staff,25,0,30,5
1713333920211,MATH 20E,B02,494083,Staff,25,0,30,5
1713333921237,MATH 103A,A01,494085,Aliabadi Sr.; Mohsen,13,0,30,17
1713333921237,MATH 103A,A02,494086,Aliabadi Sr.; Mohsen,28,0,30,2
1713333921237,MATH 103A,B01,494088,Aliabadi Sr.; Mohsen,21,0,30,9
1713333921237,MATH 103A,B02,494089,Aliabadi Sr.; Mohsen,27,0,30,3
1713333922268,MATH 109,A01,494091,Staff,30,0,30,0
1713333922268,MATH 109,A02,494092,Staff,29,0,30,1
1713333922268,MATH 109,B01,494094,Staff,27,0,30,3
1713333922268,MATH 109,B02,494095,Staff,29,0,30,1
1713333923302,MATH 142A,A01,494097,Chow; Bennett,14,0,30,16
1713333923302,MATH 142A,A02,494098,Chow; Bennett,23,0,30,7
1713333923302,MATH 142A,B01,494100,Chow; Bennett,19,0,30,11
1713333923302,MATH 142A,B02,494101,Chow; Bennett,29,0,30,1
1713333925355,MATH 168A,A01,516677,Dumitriu; Ioana,16,0,35,19
1713333926385,MATH 170A,A01,516679,Dumitriu; Ioana,18,0,30,12
1713333926385,MATH 170A,A02,516680,Dumitriu; Ioana,28,0,30,2
1713333927411,MATH 193A,A01,494107,Staff,13,0,30,17
1713333927411,MATH 193A,A02,494108,Staff,19,0,30,11
1713333927411,MATH 193A,A03,494109,Staff,29,0,30,1
1713333927411,MATH 193A,A04,494110,Staff,22,0,30,8
1713333930491,MGT 16,A00,491930,McKay; Michael J,92,0,98,6
1713333931519,MGT 18,A00,491992,McKay; Michael J,96,0,98,2
1713333932544,MGT 71,A00,492003,Staff,63,0,98,35
1713333933573,MGT 103,A00,505209,Eberhard; Craig A,81,0,98,17
1713333934600,MGT 131A,A00,505210,Anderson; John Charles,89,0,98,9
1713333936661,MGT 153,A00,492077,Perols; Johan Lars,18,0,90,72
1713333939737,MGT 164,A00,492222,McKay; Mary A,91,0,98,7
1713333940762,MGT 172,A00,492245,Staff,59,0,60,1
1713333940762,MGT 172,B00,505526,Hedges; Kathleen,65,0,98,33
1713333941788,MGT 181,A00,505669,Dunn; Louis Jean,80,0,98,18
1713333942818,MMW 14,A01,494399,Staff,15,0,28,13
1713333942818,MMW 14,A02,494400,Staff,25,0,28,3
1713333942818,MMW 14,A03,494401,Staff,28,0,28,0
1713333942818,MMW 14,A04,494402,Staff,28,0,28,0
1713333942818,MMW 14,B01,494404,Carreras; Maria Victoria,8,0,28,20
1713333942818,MMW 14,B02,494405,Carreras; Maria Victoria,25,0,28,3
1713333942818,MMW 14,B03,494406,Carreras; Maria Victoria,27,0,28,1
1713333942818,MMW 14,B04,494407,Carreras; Maria Victoria,28,0,28,0
1713333943843,MMW 14GS,A00,506250,Chang; Edmond Yi-Teh,0,0,0,0
1713333944868,MMW 121R,A01,494415,Adamiak; Patrick John,10,0,28,18
1713333944868,MMW 121R,A02,494416,Adamiak; Patrick John,24,0,28,4
1713333945947,MUS 1A,A01,494113,Staff,12,0,25,13
1713333945947,MUS 1A,A02,494114,Staff,24,0,25,1
1713333946972,MUS 4,A01,494116,Staff,23,0,25,2
1713333946972,MUS 4,A02,494117,Staff,22,0,25,3
1713333948004,MUS 5R,A01,494236,Dubnov; Shlomo,6,0,25,19
1713333948004,MUS 5R,A02,494237,Dubnov; Shlomo,25,0,25,0
1713333949031,MUS 6,A01,494122,Staff,9,0,25,16
1713333949031,MUS 6,A02,494123,Staff,23,0,25,2
1713333950059,MUS 7,A01,494125,Staff,16,0,25,9
1713333950059,MUS 7,A02,494126,Staff,24,0,25,1
1713333951088,MUS 11,A01,494128,Staff,23,0,25,2
1713333951088,MUS 11,A02,494129,Staff,24,0,25,1
1713333952121,MUS 13,A01,494131,Staff,25,0,25,0
1713333952121,MUS 13,A02,494132,Staff,25,0,25,0
1713333953366,MUS 15,A01,494134,Staff,16,0,25,9
1713333953366,MUS 15,A02,494135,Staff,25,0,25,0
1713333953366,MUS 15,B01,494137,Staff,24,0,25,1
1713333954393,MUS 80,A00,494232,Staff,24,0,25,1
1713333954393,MUS 80,B00,494233,Staff,25,0,25,0
1713333954393,MUS 80,C00,494234,Staff,23,0,25,2
1713333955421,MUS 95C,A00,494141,Staff,70,0,75,5
1713333956447,MUS 114,A00,494142,Staff,40,0,50,10
1713333957480,NANO 15,A01,490636,Drews; Aaron,7,0,7,0
1713333958507,PHIL 1,A00,490578,Grush; Rick Scott,49,0,50,1
1713333959534,PHIL 10,A01,490580,Grush; Rick Scott,33,0,35,2
1713333959534,PHIL 10,A02,490586,Grush; Rick Scott,32,0,35,3
1713333960563,PHIL 27,A01,490591,Staff,22,0,25,3
1713333960563,PHIL 27,A02,490592,Staff,25,0,25,0
1713333960563,PHIL 27,A03,490593,Staff,25,0,25,0
1713333960563,PHIL 27,A04,490598,Staff,25,0,25,0
1713333961593,PHIL 32,A01,490611,Staff,20,0,20,0
1713333961593,PHIL 32,A02,490618,Staff,20,0,20,0
1713333962623,PHIL 90,A00,490624,Staff,40,0,40,0
1713333963652,PHIL 136,A00,490627,Cohen; Jonathan David,37,0,40,3
1713333964679,PHIL 155,A00,490634,Staff,62,0,70,8
1713333965704,PHYS 1A,A00,491610,Staff,245,0,250,5
1713333966727,PHYS 1AL,001,491616,Tsai; Philbert S,27,0,30,3
1713333966727,PHYS 1AL,002,491618,Tsai; Philbert S,30,0,30,0
1713333967752,PHYS 1B,A00,491623,Staff,236,0,250,14
1713333968780,PHYS 1BL,001,491626,Tsai; Philbert S,22,0,30,8
1713333968780,PHYS 1BL,002,491628,Tsai; Philbert S,26,0,30,4
1713333969807,PHYS 1C,A00,491632,Staff,213,0,245,32
1713333970833,PHYS 1CL,001,491635,Tsai; Philbert S,2,0,30,28
1713333970833,PHYS 1CL,002,491643,Tsai; Philbert S,22,0,30,8
1713333971859,PHYS 2AR,A01,491651,Meyertholen; Andrew D.,44,0,50,6
1713333972884,PHYS 2B,A01,491659,Staff,106,0,115,9
1713333973908,PHYS 2BL,A01,491685,Staff,21,0,24,3
1713333973908,PHYS 2BL,A02,491700,Staff,21,0,24,3
1713333974934,PHYS 2C,A01,505161,Staff,101,0,115,14
1713333975962,PHYS 4A,A01,491704,Grinstein; Benjamin,99,0,100,1
1713333976989,POLI 5D,A01,494144,Staff,3,0,5,2
1713333976989,POLI 5D,B01,626283,Dai; Yinlin,5,0,5,0
1713333978022,POLI 12,A00,494145,Staff,43,0,45,2
1713333979048,POLI 13R,A00,494146,Forman; Fonna,45,0,50,5
1713333980079,POLI 27,A01,494148,Staff,54,0,60,6
1713333981107,POLI 30,A00,494149,Staff,49,0,50,1
1713333982137,POLI 100DA,A00,494150,Staff,21,0,25,4
1713333984188,POLI 100I,A00,494152,Staff,27,0,30,3
1713333985215,POLI 104B,A00,494153,Smith; Glenn Chatmas,53,0,55,2
1713333986240,POLI 104F,A00,494154,Staff,28,0,30,2
1713333987265,POLI 104I,A00,494155,Smith; Glenn Chatmas,29,0,30,1
1713333988293,POLI 110C,A00,494156,Ingham; Sean,23,0,25,2
1713333989318,POLI 117R,A00,494157,Forman; Fonna,5,0,20,15
1713333990343,POLI 118,A00,494158,Ingham; Sean,21,0,25,4
1713333991371,POLI 120H,A00,494159,Fisk; David Lee,39,0,45,6
1713333992397,POLI 131CR,A00,494160,Hoston; Germaine,35,0,45,10
1713333993425,POLI 133J,A00,494161,Staff,31,0,35,4
1713333994451,POLI 135,A00,494162,Fisk; David Lee,33,0,35,2
1713333995481,POLI 140A,A00,494164,Staff,19,0,30,11
1713333996506,POLI 142I,A00,494165,Staff,30,0,30,0
1713333997530,POLI 144D,A00,494166,Staff,23,0,25,2
1713333998557,POLI 151,A00,494167,Staff,30,0,30,0
1713333999584,POLI 153,A00,494168,Staff,33,0,35,2
1713334000609,POLI 160AA,A00,494169,Staff,34,0,40,6
1713334001637,POLI 162,A00,494170,Mignozzetti; Umberto,18,0,25,7
1713334002660,POLI 171,A00,494171,Mignozzetti; Umberto,18,0,25,7
1713334003686,PSYC 1,A00,494172,Staff,95,0,100,5
1713334004714,PSYC 2,A00,494173,Moranton; Nirelia Melbina-,34,0,50,16
1713334005741,PSYC 3,A00,494174,Staff,29,0,30,1
1713334006766,PSYC 6,A00,494175,Staff,17,0,20,3
1713334007792,PSYC 60,A01,494177,Staff,37,0,45,8
1713334008825,PSYC 70,A01,505724,Geller; Emma Harlan,42,0,45,3
1713334009853,PSYC 101,A00,494180,Heyman; Gail D.,84,0,100,16
1713334010882,PSYC 105,A00,494181,Geller; Emma Harlan,51,0,90,39
1713334011907,PSYC 106,A00,494182,Dobkins; Karen R.,27,0,45,18
1713334012937,PSYC 108,A00,494183,Adrian; Julia Anna,89,0,100,11
1713334013964,PSYC 114,A01,494185,Winkielman; Piotr,0,3,30,30
1713334014993,PSYC 122,A00,494186,Moranton; Nirelia Melbina-,27,0,50,23
1713334016019,PSYC 124,A00,494187,Chapman; Eddie Nathaniel,70,0,80,10
1713334017044,PSYC 131,A00,494188,Anagnostaras; Stephan,41,0,80,39
1713334018068,PSYC 144,A00,494189,Staff,3,0,50,47
1713334019096,PSYC 154,A00,494190,Lacefield; Katharine I,107,0,180,73
1713334020126,PSYC 162,A00,494191,Wixted; John T,71,0,100,29
1713334021152,PSYC 172,A00,494192,Gorman; Michael R.,36,0,45,9
1713334022176,PSYC 178,A00,494193,Glaser; Dale,34,0,45,11
1713334023208,PSYC 193,A00,505725,Chapman; Eddie Nathaniel,20,0,20,0
1713334024234,RELI 145GS,A00,519817,Rahimi; Babak,18,0,20,2
1713334025264,SE 101A,A01,490862,Chadha; Mayank,23,0,25,2
1713334026288,SE 101C,A01,490924,Krysl; Petr,15,0,20,5
1713334027318,SE 110A,A01,490928,Staff,19,0,20,1
1713334028341,SE 130A,A00,490929,Morrison; Machel Leigh,54,0,70,16
1713334029366,SIO 1,A01,519325,Staff,39,0,40,1
1713334030391,SIO 30,A01,519327,Staff,38,0,40,2
1713334031415,SIO 40,A00,519328,Staff,39,0,40,1
1713334032439,SIO 46GS,A00,519819,Cook; Geoffrey W,17,0,25,8
1713334033464,SIO 109R,A00,494197,Forman; Fonna,0,3,20,20
1713334034493,SIO 121GS,A00,519827,Cook; Geoffrey W,17,0,25,8
1713334035517,SIO 132,A01,519330,Staff,38,0,40,2
1713334036544,SIO 133,A01,519397,Staff,37,0,40,3
1713334037574,SIO 139,A00,519396,Kacev; David,29,0,40,11
1713334038607,SOCI 1,A01,494199,Thorpe; Charles Robert,21,0,30,9
1713334038607,SOCI 1,A02,494200,Thorpe; Charles Robert,30,0,30,0
1713334038607,SOCI 1,A03,494201,Thorpe; Charles Robert,29,0,30,1
1713334038607,SOCI 1,A04,494202,Thorpe; Charles Robert,29,0,30,1
1713334038607,SOCI 1,A05,494203,Thorpe; Charles Robert,29,0,30,1
1713334038607,SOCI 1,A06,494204,Thorpe; Charles Robert,30,0,30,0
1713334038607,SOCI 1,A07,494205,Thorpe; Charles Robert,28,0,30,2
1713334039633,SOCI 60,A01,494207,Staff,34,0,40,6
1713334039633,SOCI 60,A02,494208,Staff,39,0,40,1
1713334040666,SOCI 100,A01,494210,Payne; Christine Anna,25,0,30,5
1713334040666,SOCI 100,A02,494211,Payne; Christine Anna,26,0,30,4
1713334041695,SOCI 109M,A00,494212,Staff,20,0,20,0
1713334042720,SOCI 110,A00,494213,Staff,34,0,40,6
1713334044774,SOCI 118E,A00,494215,Ng; Kwai,37,0,40,3
1713334045801,SOCI 125,A00,494216,Calderon-Zaks; Michael Aar,40,0,45,5
1713334046830,SOCI 126,A01,494218,Jones; Makeba,3,0,5,2
1713334047859,SOCI 131,A00,494219,Thorpe; Charles Robert,26,0,30,4
1713334049971,SOCI 135,A00,494221,Payne; Christine Anna,28,0,50,22
1713334050997,SOCI 136E,A00,626690,Ruiz; Jonathan Joseph,24,0,25,1
1713334052023,SOCI 138GS,A00,494222,Navon; Daniel,23,0,28,5
1713334054072,SOCI 145,A00,494224,Staff,40,0,45,5
1713334055097,SOCI 153,A00,494225,Staff,28,0,30,2
1713334056125,SOCI 160E,A00,494226,Ng; Kwai,29,0,40,11
1713334057154,SOCI 180,A00,494227,Staff,29,0,30,1
1713334058181,SOCI 189GS,A00,494228,Ribas Norris; Janet Vanesa,11,0,11,0
1713334059205,SOCI 190GS,A00,553232,Ribas Norris; Janet Vanesa,11,0,11,0
1713334060231,SOMI 220,A00,627178,Schneid; Stephen David,30,0,30,0
1713334061257,SYN 2,001,490768,Staff,13,0,15,2
1713334061257,SYN 2,002,490769,Staff,14,0,15,1
1713334061257,SYN 2,004,490775,Staff,0,0,0,0
1713334061257,SYN 2,003,490774,Staff,0,0,0,0
1713334061257,SYN 2,005,490776,Staff,0,0,0,0
1713334062281,SYN 2R,001,490779,Staff,11,0,15,4
1713334062281,SYN 2R,002,514635,Staff,14,0,15,1
1713334063306,SYN 100,A01,490783,Staff,9,0,20,11
1713334063306,SYN 100,B01,490787,Staff,9,0,20,11
1713334063306,SYN 100,C01,490789,Staff,10,0,20,10
1713334064332,SYN 150,A00,490817,Staff,14,0,15,1
1713334064332,SYN 150,B00,514610,Staff,15,0,15,0
1713334065359,TDAC 1,A00,492753,Walsh; Kim C.,19,0,20,1
1713334065359,TDAC 1,B00,492754,Harting; Carla Kelso,19,0,20,1
1713334065359,TDAC 1,C00,513995,Salovey; Todd,15,0,20,5
1713334066387,TDAC 101,A00,492766,Harting; Carla Kelso,17,0,20,3
1713334067412,TDAC 102,A00,492768,Basso; Beatrice,19,0,20,1
1713334068440,TDDE 111,A00,492769,Staff,25,0,25,0
1713334069467,TDDE 131,A00,492770,Staff,15,0,15,0
1713334069467,TDDE 131,B00,492771,Staff,15,0,15,0
1713334070492,TDDE 131GS,A00,523716,Guirguis; Mark C,23,0,28,5
1713334071517,TDGE 1,A01,492756,Salovey; Todd,56,0,60,4
1713334072541,TDGE 5,A01,492758,Staff,23,0,25,2
1713334073570,TDGE 10,A00,492759,Fulton; Julia,203,0,220,17
1713334074601,TDGE 11,A00,492760,Castro; Robert Jess,198,0,200,2
1713334076659,TDGE 124,A00,492772,Fulton; Julia,184,0,220,36
1713334077692,TDGE 125,A00,492773,Meyer; Ursula,38,0,50,12
1713334077692,TDGE 125,B00,492774,Staff,49,0,50,1
1713334077692,TDGE 125,C00,523565,Staff,48,0,50,2
1713334078716,TDGE 125GS,A00,523580,Guirguis; Mark C,23,0,28,5
1713334079742,TDGE 127,A00,492775,Havis; Allan,33,0,50,17
1713334080767,TDHT 101,A00,492776,Staff,34,0,35,1
1713334081799,TDMV 1,A00,492762,Caligagan; Maria T.,29,0,30,1
1713334081799,TDMV 1,B00,492763,Arcidiacono; Kristin,26,0,30,4
1713334082824,TDMV 2,A00,492764,Weinberg; Sadie,28,0,30,2
1713334083854,TDMV 3,A00,492765,Mack; Kara Shanai',37,0,40,3
1713334084880,TDMV 138,A00,492777,Mack; Kara Shanai',34,0,40,6
1713334085909,TDMV 140,A00,492778,Lima; Paulo Henrique,40,0,40,0
1713334086934,TDMV 142,A00,492779,Caligagan; Maria T.,33,0,40,7
1713334086934,TDMV 142,B00,492780,Caligagan; Tony,37,0,40,3
1713334087961,TDMV 143,A00,492781,Fyall; Daunte Edward,39,0,40,1
1713334088991,USP 1,A01,492401,Kwak; Nancy,27,0,35,8
1713334090017,USP 2,A01,492453,Hinds; Juli Beth,35,0,35,0
1713334091045,USP 3,A01,492516,Staff,28,0,35,7
1713334092070,USP 4,A00,492522,McTague; Sarah,16,0,25,9
1713334093099,USP 100,A00,492523,Staff,32,0,35,3
1713334094128,USP 101,A00,492524,Staff,13,0,15,2
1713334095153,USP 105,A00,492525,Staff,21,0,25,4
1713334096183,USP 151,A00,492526,Shenkman; Michael Thomas,32,0,35,3
1713334097212,USP 170,A00,492545,Hinds; Juli Beth,33,0,35,2
1713334098239,USP 171GS,A00,492608,Bussell; Mirle Rabinowitz,24,0,28,4
1713334099265,USP 183GS,A00,492613,Peerson; Susan,24,0,28,4
1713334100297,VIS 30,A01,490693,Yoldas; Pinar,19,0,22,3
1713334100297,VIS 30,A02,490694,Yoldas; Pinar,18,0,22,4
1713334101327,VIS 83,A00,490695,Kester; Grant,63,0,75,12
1713334102359,VIS 105D,A00,490696,Staff,22,0,25,3
1713334103389,VIS 124CN,A00,490699,Rose; Jordan M,65,0,75,10
1713334104413,VIS 125GS,A00,511221,Williams; Alena J,21,0,22,1
1713334105441,VIS 128D,A00,490700,Staff,73,0,75,2
1713334106469,VIS 151,A01,490717,Staff,33,0,34,1
1713334106469,VIS 151,A02,490766,Staff,33,0,34,1
1713334107495,VIS 154GS,A00,511972,Williams; Alena J,21,0,22,1
1713334108520,VIS 160A,A00,490767,Stone; Patricia,7,0,10,3
1713334109558,WCWP 10A,A00,490638,Staff,14,0,15,1
1713334109558,WCWP 10A,B00,490640,Staff,15,0,15,0
1713334110584,WCWP 10B,A00,490641,Staff,0,0,0,0
1713334110584,WCWP 10B,B00,490642,Staff,14,0,15,1
1713334110584,WCWP 10B,C00,490644,Staff,13,0,15,2
1713334110584,WCWP 10B,D00,490647,Staff,0,0,0,0
1713334111608,WCWP 100,A00,490655,Staff,0,0,0,0
1713334111608,WCWP 100,B00,490687,Staff,10,0,15,5
1713334113703,ANAR 153,A00,487222,Braswell; Geoffrey E.,53,0,60,7
1713334114728,ANBI 134,A00,487223,Staff,5,0,20,15
1713334115756,ANBI 143GS,A00,487224,Noel; Geoffroy Pierre Jean,18,0,24,6
1713334116780,ANBI 144GS,A00,519548,Noel; Geoffroy Pierre Jean,18,0,24,6
1713334117808,ANSC 101,A00,487225,Staff,18,0,20,2
1713334118835,ANSC 125,A00,487227,Brenner; Suzanne A,38,0,40,2
1713334120887,ANSC 146,A00,487229,Staff,35,0,40,5
1713334121912,ANSC 148,A00,487230,Olivas Hernandez; Olga Lid,39,0,40,1
1713334122947,ANSC 150,A00,504165,Sloane; Julia Kathryn,18,0,20,2
1713334123972,ANSC 180,A00,487232,Staff,14,0,15,1
1713334124999,ANSC 188,A00,627155,Staff,38,0,40,2
1713334126025,ANTH 5,A00,519529,Semendeferi; Ekaterini,15,0,15,0
1713334127053,ANTH 10,A00,487219,Staff,58,0,60,2
1713334128079,ANTH 23,A01,487221,Staff,17,0,20,3
1713334129104,ANTH 102,A00,487233,Wilder; Linnea Lorene,51,0,60,9
1713334130135,ANTH 103,A00,487234,Varma; Saiba,55,0,60,5
1713334131164,ANTH 105,A00,487235,Stewart; Alexander B,54,0,60,6
1713334132193,BENG 100,A01,516685,Taylor Amos; Alyssa C,26,0,30,4
1713334133219,BIBC 102,A01,491316,Flagg; Matthew Paul,8,0,88,80
1713334133219,BIBC 102,A02,491366,Flagg; Matthew Paul,78,0,88,10
1713334134247,BIBC 103,A01,491486,Boumechache; Miyyada,16,0,24,8
1713334134247,BIBC 103,A02,491487,Boumechache; Miyyada,24,0,24,0
1713334135278,BICD 100,A01,516882,Staff,73,0,75,2
1713334135278,BICD 100,A02,516890,Staff,69,0,75,6
1713334136304,BICD 102GS,A00,491488,Lo; Stanley M.,26,0,28,2
1713334137330,BIEB 136GS,A00,516940,Holway; David A. & Shurin; Jonathan,18,0,24,6
1713334138358,BIEB 137GS,A01,517034,Holway; David A. & Shurin; Jonathan,18,0,24,6
1713334139387,BIEB 138GS,A01,491492,Pirino; Giorgia,21,0,28,7
1713334140416,BILD 1,A01,491296,Staff,60,0,63,3
1713334140416,BILD 1,A02,491297,Staff,63,0,63,0
1713334141445,BILD 4,A01,517099,Gonzalez Gamboa; Ivonne,22,0,24,2
1713334141445,BILD 4,A02,517100,Gonzalez Gamboa; Ivonne,24,0,24,0
1713334142471,BILD 60GS,A00,491309,Lo; Stanley M.,26,0,28,2
1713334143497,BIMM 100,A01,517136,Staff,83,0,100,17
1713334144525,BIMM 110,A01,517182,Staff,54,0,100,46
1713334145557,BIMM 120,A01,517228,Pickett; Brooke Elizabeth,28,0,63,35
1713334145557,BIMM 120,A02,517240,Pickett; Brooke Elizabeth,44,0,63,19
1713334146587,BIMM 132GS,A01,491498,Pirino; Giorgia,21,0,28,7
1713334147617,BIMM 143,A01,491589,Bozinovic; Goran,12,0,40,28
1713334148643,BIPN 100,A01,491594,Armour; Jon Christopher,83,0,100,17
1713334149670,BIPN 140,A01,491602,Marino; Marc J,25,0,50,25
1713334151730,CAT 125,A00,515973,Staff,18,0,20,2
1713334152758,CAT 125GS,A00,515974,Rahimi; Babak,17,0,20,3
1713334153839,CAT 125R,A00,515980,Staff,12,0,20,8
1713334153839,CAT 125R,B00,515981,Tosun; Adriana,19,0,20,1
1713334153839,CAT 125R,C00,515987,Hyland; Tina Mae,0,3,20,20
1713334153839,CAT 125R,D00,515988,Bronstein; Phoebe Malan,16,0,20,4
1713334154872,CENG 15,A01,488699,Drews; Aaron,25,0,25,0
1713334155903,CENG 100,A00,505196,Opatkiewicz; Justin Paul,25,0,25,0
1713334156928,CGS 2A,A01,489598,Staff,33,0,35,2
1713334157953,CGS 112,A00,489599,Staff,15,0,15,0
1713334158979,CGS 119,A00,489603,Staff,10,0,10,0
1713334160007,CGS 120,A00,489604,Staff,14,0,15,1
1713334161033,CGS 150,A00,489607,Staff,15,0,15,0
1713334162060,CHEM 6A,A01,488715,Staff,97,0,100,3
1713334163087,CHEM 6B,A01,488719,Piercy; Marc Anthony,99,0,100,1
1713334164113,CHEM 6C,A01,488723,Albizati; Kim F.,93,0,100,7
1713334165140,CHEM 7L,A01,488728,Schurmeier; Kimberly,18,0,24,6
1713334165140,CHEM 7L,A02,488730,Schurmeier; Kimberly,23,0,24,1
1713334165140,CHEM 7L,A03,488734,Schurmeier; Kimberly,20,0,24,4
1713334165140,CHEM 7L,A04,488763,Schurmeier; Kimberly,23,0,24,1
1713334165140,CHEM 7L,B01,488798,Schurmeier; Kimberly,17,0,24,7
1713334165140,CHEM 7L,B02,488801,Schurmeier; Kimberly,22,0,24,2
1713334165140,CHEM 7L,B03,488808,Schurmeier; Kimberly,22,0,24,2
1713334165140,CHEM 7L,B04,488811,Schurmeier; Kimberly,24,0,24,0
1713334166166,CHEM 11,A01,488897,Stallings; Dontarie M,95,0,100,5
1713334167195,CHEM 40A,A01,488913,Albizati; Kim F.,83,0,100,17
1713334168222,CHEM 40B,A01,488920,Weizman; Haim,43,0,50,7
1713334168222,CHEM 40B,A02,488938,Weizman; Haim,44,0,50,6
1713334169252,CHEM 41A,A01,489029,Klosterman; Jeremy K,57,0,60,3
1713334170277,CHEM 41C,A01,500436,Tor; Yitzhak,55,0,60,5
1713334171311,CHEM 43A,A01,500426,Weizman; Haim,0,1,24,24
1713334171311,CHEM 43A,A02,500430,Weizman; Haim,6,0,24,18
1713334171311,CHEM 43A,B01,514041,Klosterman; Jeremy K,16,0,24,8
1713334171311,CHEM 43A,B02,514047,Klosterman; Jeremy K,23,0,24,1
1713334172335,CHEM 108,A01,489140,Jennings; Patricia A.,8,0,24,16
1713334172335,CHEM 108,A02,489142,Jennings; Patricia A.,14,0,24,10
1713334173360,CHEM 114A,A01,489147,Stallings; Dontarie M,68,0,100,32
1713334174386,CHIN 169A,A00,489171,Wang; Xiao,19,0,20,1
1713334176442,COGS 3,A01,518827,Boyle; Mary E. T.,25,0,40,15
1713334177467,COGS 11,A01,489175,Staff,27,0,30,3
1713334178493,COGS 14A,A01,518829,Staff,51,0,60,9
1713334179518,COGS 14B,A01,489177,Hoffman; Drew Ellen,62,0,75,13
1713334180544,COGS 100,A01,489181,Allen; Michael Gordon,62,0,75,13
1713334181573,COGS 101A,A01,489183,Staff,45,0,60,15
1713334182603,COGS 101B,A01,489185,Allen; Michael Gordon,8,0,30,22
1713334183628,COGS 101C,A01,526786,Staff,23,0,30,7
1713334185682,COGS 107A,A01,489189,Boyle; Mary E. T.,17,0,35,18
1713334186709,COGS 107B,A01,627144,Mooshagian; Eric Frederick,60,0,60,0
1713334187737,COGS 118A,A01,489191,Staff,0,46,40,40
1713334189788,COGS 171GS,A01,489194,Pineda; Jaime A,19,0,28,9
1713334190818,COGS 172,A01,489196,Staff,2,0,30,28
1713334191844,COGS 174GS,A01,489264,Pineda; Jaime A,19,0,28,9
1713334192872,COGS 180,A01,627150,Staff,28,0,30,2
1713334193897,COGS 186,A01,489274,Staff,0,1,30,30
1713334194922,COMM 10,A01,489276,Staff,23,0,25,2
1713334194922,COMM 10,A02,489303,Staff,23,0,25,2
1713334195948,COMM 100A,A01,489312,Staff,14,0,25,11
1713334195948,COMM 100A,A02,489313,Staff,24,0,25,1
1713334196978,COMM 106T,A00,512540,Staff,33,0,35,2
1713334198007,COMM 107,A00,489347,Staff,27,0,35,8
1713334199031,COMM 109P,A00,489358,Staff,31,0,35,4
1713334200062,COMM 132,A00,489361,McKenna; Denise,27,0,30,3
1713334201089,COMM 146,A00,489362,Halm; Gavin Patrick,26,0,30,4
1713334202118,COMM 190,A00,489363,Abuelhiga; Soraya Jill,17,0,23,6
1713334203156,CSE 8A,A50,489366,Staff,21,0,25,4
1713334203156,CSE 8A,A51,489367,Staff,24,0,25,1
1713334204185,CSE 11,A01,489398,Cao; Yingjun,72,0,100,28
1713334205216,CSE 12,A01,489487,Staff,43,0,50,7
1713334206240,CSE 20,A01,489497,Staff,48,0,50,2
1713334207269,CSE 21,A01,489517,Braun; Oliver,42,0,50,8
1713334208295,CSE 101,A01,489524,Braun; Oliver,0,32,50,50
1713334209321,CSE 105,A01,512594,Jones; Miles E,72,0,100,28
1713334209321,CSE 105,B01,512598,Jones; Miles E,52,0,100,48
1713334210347,CSE 140,A01,489538,Staff,41,0,50,9
1713334211372,CSE 141,A01,489550,Eldon; John,67,0,100,33
1713334212403,CSE 141L,A01,489571,Eldon; John,65,0,100,35
1713334213430,CSE 151A,A01,489583,Solares; Edwin A,141,0,200,59
1713334214461,CSE 175,A01,510886,Kumar; Rakesh,30,0,30,0
1713334215491,CSE 190,A00,516828,Dubnov; Shlomo,38,0,49,11
1713334216519,DOC 100D,A00,489667,Pass; Natalye Joann,19,0,25,6
1713334217551,DSC 10,A01,624268,Staff,72,0,75,3
1713334218577,DSC 20,A01,624476,Staff,50,0,50,0
1713334219606,DSC 40A,A01,624608,Staff,39,0,40,1
1713334220633,DSGN 1,A01,489179,Rill; Bryan,32,0,50,18
1713334221661,ECE 17,A01,490489,Sahay; Rajeev,18,0,30,12
1713334222686,ECE 65,A50,490492,Staff,11,0,20,9
1713334222686,ECE 65,A51,490493,Staff,18,0,20,2
1713334223717,ECON 1,A01,489715,Famulari; Melissa,67,0,70,3
1713334224743,ECON 2,A01,489717,Levkoff; Steven B.,67,0,70,3
1713334225769,ECON 3,A01,489948,Staff,70,0,70,0
1713334227825,ECON 5,A01,490103,Staff,27,0,30,3
1713334227825,ECON 5,B01,626281,Dai; Yinlin,45,0,45,0
1713334228853,ECON 100A,A01,490127,Famulari; Melissa,64,0,70,6
1713334229883,ECON 100B,A01,490129,Staff,64,0,70,6
1713334230915,ECON 109,A01,490187,Shishkin; Denis,27,0,35,8
1713334231941,ECON 110A,A01,490190,Levkoff; Steven B.,60,0,70,10
1713334232966,ECON 120A,A01,490245,Dai; Yinlin,60,0,70,10
1713334233992,ECON 120B,A01,490247,Nieto-Barthaburu; Augusto,40,0,70,30
1713334235017,ECON 120C,A01,490253,Sun; Yixiao,30,0,35,5
1713334235017,ECON 120C,B01,490255,Sun; Yixiao,34,0,35,1
1713334236043,ECON 129,A00,490256,Eckert; Fabian Paul,22,0,35,13
1713334237069,ECON 131,A00,490257,Nieto-Barthaburu; Augusto,0,6,35,35
1713334238097,ECON 138,A00,490258,Bharadwaj; Prashant,13,0,35,22
1713334238097,ECON 138,B00,490259,Bharadwaj; Prashant,15,0,35,20
1713334239128,ECON 159,A00,490260,Hendrickson; Gerald M.,0,9,0,0
1713334240157,ECON 178,A01,553995,Zhu; Ying,24,0,35,11
1713334241184,EDS 40,A01,512576,Black; Alison Michelle,20,0,20,0
1713334242212,EDS 107,A01,515848,Staff,30,0,30,0
1713334243238,EDS 110R,A01,490262,Staff,26,0,30,4
1713334244269,EDS 112,A01,490264,Chapman; Thandeka K,40,0,50,10
1713334245294,EDS 113,A00,490266,Staff,26,0,30,4
1713334246322,EDS 118,A00,490267,Warstadt; Melissa Fawn,20,0,30,10
1713334247347,EDS 124BR,A00,490268,Eguchi; Emi,4,0,25,21
1713334247347,EDS 124BR,B00,490269,Eguchi; Emi,23,0,25,2
1713334248375,EDS 126,A01,490271,Jones; Makeba,43,0,50,7
1713334249401,EDS 135,A01,490316,Staff,19,0,20,1
1713334250426,ENVR 142GS,A00,519514,Chang; Edmond Yi-Teh,26,0,28,2
1713334251454,ETHN 103,A00,490504,Staff,25,0,36,11
1713334252485,ETHN 103A,A00,490505,Man; Simeon S,4,0,9,5
1713334253511,ETHN 109,A00,490506,Staff,28,0,30,2
1713334254536,ETHN 118,A00,490507,Staff,35,0,36,1
1713334255561,ETHN 119,A00,490508,Staff,33,0,36,3
1713334256590,ETHN 121R,A00,490518,Choi; Esther Min,21,0,36,15
1713334257674,ETHN 127,A00,490528,Staff,14,0,15,1
1713334258702,ETHN 139,A00,490573,Staff,10,0,10,0
1713334259769,ETHN 150,A00,490575,Staff,15,0,15,0
1713334260795,GLBH 20,A00,491705,Elwardani; Nile Regina,38,0,40,2
1713334261821,GLBH 101,A00,491706,Staff,20,0,20,0
1713334262846,GLBH 111,A01,491708,Burgos; Jose L.,15,0,15,0
1713334263875,GLBH 146,A00,491709,Staff,9,0,20,11
1713334264904,GLBH 148,A00,491710,Olivas Hernandez; Olga Lid,11,0,20,9
1713334265938,GLBH 150,A00,491711,Sloane; Julia Kathryn,19,0,20,1
1713334266963,HIEA 131,A00,491760,Staff,28,0,32,4
1713334267989,HIEA 153,A00,491762,Staff,28,0,30,2
1713334269012,HIEU 124,A00,491811,Staff,26,0,32,6
1713334270042,HIEU 124GS,A00,491812,Markman; Kristina,27,0,28,1
1713334271067,HIEU 147,A00,491813,Staff,30,0,32,2
1713334272094,HIEU 149GS,A00,491816,Caldwell; Michael Alan,28,0,28,0
1713334273126,HILD 2C,A01,491713,Hendrickson; Gerald M.,26,0,30,4
1713334274152,HILD 7B,A01,491715,Kwak; Nancy,0,2,30,30
1713334275176,HILD 10,A01,491717,Staff,10,0,20,10
1713334276205,HILD 30GS,A00,491719,Edington; Claire Ellen,23,0,28,5
1713334277230,HINE 109,A00,491818,Shafir; Nir,27,0,32,5
1713334278255,HINE 128,A00,491821,Shafir; Nir,31,0,32,1
1713334279281,HISC 117,A00,491830,Staff,27,0,32,5
1713334280312,HIUS 103,A00,491834,Man; Simeon S,14,0,23,9
1713334281338,HIUS 108B,A00,491835,Staff,27,0,30,3
1713334282362,HIUS 141,A00,491836,Hendrickson; Gerald M.,28,0,32,4
1713334283391,HIUS 149,A00,491839,Staff,24,0,32,8
1713334284423,HUM 3,A01,512617,Crum; Matthew Stephen,42,0,50,8
1713334284423,HUM 3,A02,512618,Crum; Matthew Stephen,48,0,50,2
1713334285448,HUM 3GS,A00,512663,Markman; Kristina,0,0,0,1
1713334285448,HUM 3GS,B00,512664,Staff,0,0,0,0
1713334286474,HUM 4,A01,512620,West; Geoffrey Scott,25,0,50,25
1713334287502,HUM 4GS,A00,512666,Lyon; Antony J.,0,0,0,5
1713334288529,HUM 4R,A01,512625,Watkins; Eric,49,0,50,1
1713334289634,HUM 5,A01,512649,Zavodny; Tatiana Sophia,22,0,50,28
1713334289634,HUM 5,B01,512661,Zroka; Ryan Edward,48,0,50,2
1713334290660,INTL 190,A00,490577,Segui; Alan S,0,0,0,5
1713334291687,JAPN 20AR,A01,491267,Ross; Kayoko F,7,0,20,13
1713334292714,JAPN 180,A00,491285,Berman; Michael David,33,0,40,7
1713334293744,LATI 50,A01,502536,Kokinis; Troy Andreas,16,0,22,6
1713334293744,LATI 50,A02,502551,Kokinis; Troy Andreas,22,0,22,0
1713334293744,LATI 50,A03,502650,Kokinis; Troy Andreas,22,0,22,0
1713334293744,LATI 50,A04,502909,Kokinis; Troy Andreas,21,0,22,1
1713334294773,LATI 160,A01,502920,Kokinis; Troy Andreas,30,0,30,0
1713334295803,LIFR 1A,A00,490494,Van Moer; Vinciane G,17,0,20,3
1713334296828,LIFR 1AX,A00,490495,Van Moer; Vinciane G,17,0,20,3
1713334297858,LIFR 1B,A00,490496,Van Moer; Vinciane G,17,0,20,3
1713334298886,LIFR 1BX,A00,490497,Van Moer; Vinciane G,17,0,20,3
1713334299916,LIGN 8,A00,505198,McIntosh; Justin Daniel,134,0,150,16
1713334300941,LIGN 9GS,A00,491239,Lott; Margaret S.,18,0,20,2
1713334302052,LIGN 101,A01,505200,McIntosh; Justin Daniel,22,0,30,8
1713334303083,LIGN 120,A01,491244,Staff,22,0,30,8
1713334304109,LIGN 149GS,A00,491245,Lott; Margaret S.,18,0,20,2
1713334305137,LIGN 170,A00,491247,Staff,22,0,30,8
1713334306163,LISP 1D,A00,490498,Munoz Sanchez; Alicia,8,0,14,6
1713334306163,LISP 1D,B00,490499,Munoz Sanchez; Alicia,6,0,14,8
1713334306163,LISP 1D,C00,490500,Munoz Sanchez; Alicia,7,0,14,7
1713334306163,LISP 1D,D00,490501,Munoz Sanchez; Alicia,10,0,14,4
1713334307191,LISP 1DX,A00,490502,Munoz Sanchez; Alicia,13,0,28,15
1713334307191,LISP 1DX,B00,490503,Munoz Sanchez; Alicia,16,0,28,12
1713334309251,LTAM 110,A00,491847,Staff,22,0,25,3
1713334310275,LTCS 119,A00,491848,Staff,11,0,15,4
1713334311299,LTCS 130,A00,491849,Staff,24,0,25,1
1713334313351,LTEA 120C,A00,491852,Staff,32,0,40,8
1713334314375,LTEN 130GS,A00,491853,Lyon; Antony J.,23,0,28,5
1713334315400,LTEN 148,A00,491855,Staff,23,0,25,2
1713334316426,LTEN 159,A00,491856,Staff,20,0,25,5
1713334317453,LTEN 180,A00,491857,Staff,8,0,15,7
1713334319507,LTSP 123GS,A00,505928,Bessett; Ryan Matthew,24,0,28,4
1713334320535,LTSP 174GS,A00,506037,Bessett; Ryan Matthew,24,0,28,4
1713334322588,LTWR 102,A00,491861,Staff,9,0,15,6
1713334323615,LTWR 106,A00,491862,Staff,8,0,15,7
1713334324641,MAE 11,A00,490930,Bahadori; Mohammad Yousef,95,0,100,5
1713334325673,MAE 30A,A00,490931,Qi; Huihui,37,0,40,3
1713334326699,MAE 101A,A00,491036,Sadeghizadeh; Zahra,92,0,100,8
1713334327726,MAE 101C,A00,491037,Seshadri; Kalyanasundaram,64,0,100,36
1713334328750,MAE 113,A00,491040,Seshadri; Kalyanasundaram,65,0,80,15
1713334329780,MAE 131A,A00,491041,Ghazinejad; Maziar,37,0,40,3
1713334330810,MAE 142,A00,491053,Staff,39,0,40,1
1713334331836,MAE 143A,A00,491054,Staff,31,0,50,19
1713334332863,MAE 150,A00,491092,Truong; Phuong Thi Ngoc,23,0,35,12
1713334333890,MATH 3C,A01,494031,Pardo Guerra; Sebastian,30,0,30,0
1713334333890,MATH 3C,A02,494032,Pardo Guerra; Sebastian,29,0,30,1
1713334334921,MATH 10A,A01,494034,Staff,27,0,30,3
1713334334921,MATH 10A,A02,494035,Staff,28,0,30,2
1713334334921,MATH 10A,B01,494037,Staff,27,0,30,3
1713334334921,MATH 10A,B02,494038,Staff,29,0,30,1
1713334335956,MATH 10B,A01,494040,Habib; Yousaf,22,0,30,8
1713334335956,MATH 10B,A02,494041,Habib; Yousaf,28,0,30,2
1713334335956,MATH 10B,A03,494042,Habib; Yousaf,29,0,30,1
1713334335956,MATH 10B,A04,494043,Habib; Yousaf,30,0,30,0
1713334335956,MATH 10B,B01,494045,Habib; Yousaf,25,0,30,5
1713334335956,MATH 10B,B02,494046,Habib; Yousaf,30,0,30,0
1713334335956,MATH 10B,B03,494047,Habib; Yousaf,30,0,30,0
1713334335956,MATH 10B,B04,494048,Habib; Yousaf,30,0,30,0
1713334336991,MATH 18,A01,494050,Kemp; Todd Aahron,25,0,30,5
1713334336991,MATH 18,A02,494051,Kemp; Todd Aahron,29,0,30,1
1713334336991,MATH 18,B01,494054,Kemp; Todd Aahron,25,0,30,5
1713334336991,MATH 18,B02,494055,Kemp; Todd Aahron,29,0,30,1
1713334338017,MATH 20A,A01,494059,Suk; Andrew Hoon,30,0,30,0
1713334339043,MATH 20B,A01,494061,Briones; Jor-el Thomas Caparas,33,0,35,2
1713334339043,MATH 20B,B01,494063,Bach; Quang Tran,34,0,35,1
1713334340077,MATH 20C,A01,494065,Staff,28,0,30,2
1713334340077,MATH 20C,A02,494066,Staff,30,0,30,0
1713334340077,MATH 20C,A03,494067,Staff,30,0,30,0
1713334340077,MATH 20C,A04,494068,Staff,30,0,30,0
1713334340077,MATH 20C,B01,494070,Zhang; Ming,25,0,30,5
1713334340077,MATH 20C,B02,494071,Zhang; Ming,27,0,30,3
1713334340077,MATH 20C,B03,494072,Zhang; Ming,29,0,30,1
1713334340077,MATH 20C,B04,494073,Zhang; Ming,29,0,30,1
1713334341106,MATH 20D,A01,494075,Staff,22,0,30,8
1713334341106,MATH 20D,A02,494076,Staff,29,0,30,1
1713334342133,MATH 20E,A01,494079,Staff,24,0,30,6
1713334342133,MATH 20E,A02,494080,Staff,26,0,30,4
1713334342133,MATH 20E,B01,494082,Staff,25,0,30,5
1713334342133,MATH 20E,B02,494083,Staff,25,0,30,5
1713334343163,MATH 103A,A01,494085,Aliabadi Sr.; Mohsen,13,0,30,17
1713334343163,MATH 103A,A02,494086,Aliabadi Sr.; Mohsen,28,0,30,2
1713334343163,MATH 103A,B01,494088,Aliabadi Sr.; Mohsen,21,0,30,9
1713334343163,MATH 103A,B02,494089,Aliabadi Sr.; Mohsen,27,0,30,3
1713334344196,MATH 109,A01,494091,Staff,30,0,30,0
1713334344196,MATH 109,A02,494092,Staff,29,0,30,1
1713334344196,MATH 109,B01,494094,Staff,27,0,30,3
1713334344196,MATH 109,B02,494095,Staff,29,0,30,1
1713334345230,MATH 142A,A01,494097,Chow; Bennett,14,0,30,16
1713334345230,MATH 142A,A02,494098,Chow; Bennett,23,0,30,7
1713334345230,MATH 142A,B01,494100,Chow; Bennett,19,0,30,11
1713334345230,MATH 142A,B02,494101,Chow; Bennett,29,0,30,1
1713334347279,MATH 168A,A01,516677,Dumitriu; Ioana,16,0,35,19
1713334348309,MATH 170A,A01,516679,Dumitriu; Ioana,18,0,30,12
1713334348309,MATH 170A,A02,516680,Dumitriu; Ioana,28,0,30,2
1713334349337,MATH 193A,A01,494107,Staff,13,0,30,17
1713334349337,MATH 193A,A02,494108,Staff,19,0,30,11
1713334349337,MATH 193A,A03,494109,Staff,29,0,30,1
1713334349337,MATH 193A,A04,494110,Staff,22,0,30,8
1713334352420,MGT 16,A00,491930,McKay; Michael J,92,0,98,6
1713334353451,MGT 18,A00,491992,McKay; Michael J,96,0,98,2
1713334354479,MGT 71,A00,492003,Staff,63,0,98,35
1713334355511,MGT 103,A00,505209,Eberhard; Craig A,81,0,98,17
1713334356537,MGT 131A,A00,505210,Anderson; John Charles,89,0,98,9
1713334358594,MGT 153,A00,492077,Perols; Johan Lars,18,0,90,72
1713334361726,MGT 164,A00,492222,McKay; Mary A,91,0,98,7
1713334362758,MGT 172,A00,492245,Staff,59,0,60,1
1713334362758,MGT 172,B00,505526,Hedges; Kathleen,65,0,98,33
1713334363782,MGT 181,A00,505669,Dunn; Louis Jean,80,0,98,18
1713334364814,MMW 14,A01,494399,Staff,15,0,28,13
1713334364814,MMW 14,A02,494400,Staff,25,0,28,3
1713334364814,MMW 14,A03,494401,Staff,28,0,28,0
1713334364814,MMW 14,A04,494402,Staff,28,0,28,0
1713334364814,MMW 14,B01,494404,Carreras; Maria Victoria,8,0,28,20
1713334364814,MMW 14,B02,494405,Carreras; Maria Victoria,25,0,28,3
1713334364814,MMW 14,B03,494406,Carreras; Maria Victoria,27,0,28,1
1713334364814,MMW 14,B04,494407,Carreras; Maria Victoria,28,0,28,0
1713334365840,MMW 14GS,A00,506250,Chang; Edmond Yi-Teh,0,0,0,0
1713334366865,MMW 121R,A01,494415,Adamiak; Patrick John,10,0,28,18
1713334366865,MMW 121R,A02,494416,Adamiak; Patrick John,24,0,28,4
1713334367895,MUS 1A,A01,494113,Staff,12,0,25,13
1713334367895,MUS 1A,A02,494114,Staff,24,0,25,1
1713334368922,MUS 4,A01,494116,Staff,23,0,25,2
1713334368922,MUS 4,A02,494117,Staff,22,0,25,3
1713334369949,MUS 5R,A01,494236,Dubnov; Shlomo,6,0,25,19
1713334369949,MUS 5R,A02,494237,Dubnov; Shlomo,25,0,25,0
1713334370975,MUS 6,A01,494122,Staff,9,0,25,16
1713334370975,MUS 6,A02,494123,Staff,23,0,25,2
1713334372002,MUS 7,A01,494125,Staff,16,0,25,9
1713334372002,MUS 7,A02,494126,Staff,24,0,25,1
1713334373032,MUS 11,A01,494128,Staff,23,0,25,2
1713334373032,MUS 11,A02,494129,Staff,24,0,25,1
1713334374059,MUS 13,A01,494131,Staff,25,0,25,0
1713334374059,MUS 13,A02,494132,Staff,25,0,25,0
1713334375086,MUS 15,A01,494134,Staff,16,0,25,9
1713334375086,MUS 15,A02,494135,Staff,25,0,25,0
1713334375086,MUS 15,B01,494137,Staff,24,0,25,1
1713334376114,MUS 80,A00,494232,Staff,24,0,25,1
1713334376114,MUS 80,B00,494233,Staff,25,0,25,0
1713334376114,MUS 80,C00,494234,Staff,23,0,25,2
1713334377137,MUS 95C,A00,494141,Staff,70,0,75,5
1713334378165,MUS 114,A00,494142,Staff,40,0,50,10
1713334379196,NANO 15,A01,490636,Drews; Aaron,7,0,7,0
1713334380222,PHIL 1,A00,490578,Grush; Rick Scott,49,0,50,1
1713334381252,PHIL 10,A01,490580,Grush; Rick Scott,33,0,35,2
1713334381252,PHIL 10,A02,490586,Grush; Rick Scott,32,0,35,3
1713334382280,PHIL 27,A01,490591,Staff,22,0,25,3
1713334382280,PHIL 27,A02,490592,Staff,25,0,25,0
1713334382280,PHIL 27,A03,490593,Staff,25,0,25,0
1713334382280,PHIL 27,A04,490598,Staff,25,0,25,0
1713334383304,PHIL 32,A01,490611,Staff,20,0,20,0
1713334383304,PHIL 32,A02,490618,Staff,20,0,20,0
1713334384330,PHIL 90,A00,490624,Staff,40,0,40,0
1713334385357,PHIL 136,A00,490627,Cohen; Jonathan David,37,0,40,3
1713334386387,PHIL 155,A00,490634,Staff,62,0,70,8
1713334387415,PHYS 1A,A00,491610,Staff,245,0,250,5
1713334388444,PHYS 1AL,001,491616,Tsai; Philbert S,27,0,30,3
1713334388444,PHYS 1AL,002,491618,Tsai; Philbert S,30,0,30,0
1713334389470,PHYS 1B,A00,491623,Staff,236,0,250,14
1713334390494,PHYS 1BL,001,491626,Tsai; Philbert S,22,0,30,8
1713334390494,PHYS 1BL,002,491628,Tsai; Philbert S,26,0,30,4
1713334391518,PHYS 1C,A00,491632,Staff,213,0,245,32
1713334392542,PHYS 1CL,001,491635,Tsai; Philbert S,2,0,30,28
1713334392542,PHYS 1CL,002,491643,Tsai; Philbert S,22,0,30,8
1713334393574,PHYS 2AR,A01,491651,Meyertholen; Andrew D.,44,0,50,6
1713334394601,PHYS 2B,A01,491659,Staff,106,0,115,9
1713334395630,PHYS 2BL,A01,491685,Staff,21,0,24,3
1713334395630,PHYS 2BL,A02,491700,Staff,21,0,24,3
1713334396657,PHYS 2C,A01,505161,Staff,101,0,115,14
1713334397693,PHYS 4A,A01,491704,Grinstein; Benjamin,99,0,100,1
1713334398721,POLI 5D,A01,494144,Staff,3,0,5,2
1713334398721,POLI 5D,B01,626283,Dai; Yinlin,5,0,5,0
1713334399747,POLI 12,A00,494145,Staff,43,0,45,2
1713334400776,POLI 13R,A00,494146,Forman; Fonna,45,0,50,5
1713334401805,POLI 27,A01,494148,Staff,54,0,60,6
1713334402830,POLI 30,A00,494149,Staff,49,0,50,1
1713334403874,POLI 100DA,A00,494150,Staff,21,0,25,4
1713334405926,POLI 100I,A00,494152,Staff,27,0,30,3
1713334406958,POLI 104B,A00,494153,Smith; Glenn Chatmas,53,0,55,2
1713334407984,POLI 104F,A00,494154,Staff,28,0,30,2
1713334409009,POLI 104I,A00,494155,Smith; Glenn Chatmas,29,0,30,1
1713334410037,POLI 110C,A00,494156,Ingham; Sean,23,0,25,2
1713334411063,POLI 117R,A00,494157,Forman; Fonna,5,0,20,15
1713334412090,POLI 118,A00,494158,Ingham; Sean,21,0,25,4
1713334413116,POLI 120H,A00,494159,Fisk; David Lee,39,0,45,6
1713334414139,POLI 131CR,A00,494160,Hoston; Germaine,35,0,45,10
1713334415165,POLI 133J,A00,494161,Staff,31,0,35,4
1713334416189,POLI 135,A00,494162,Fisk; David Lee,33,0,35,2
1713334417214,POLI 140A,A00,494164,Staff,19,0,30,11
1713334418238,POLI 142I,A00,494165,Staff,30,0,30,0
1713334419262,POLI 144D,A00,494166,Staff,23,0,25,2
1713334420287,POLI 151,A00,494167,Staff,30,0,30,0
1713334421312,POLI 153,A00,494168,Staff,33,0,35,2
1713334422337,POLI 160AA,A00,494169,Staff,34,0,40,6
1713334423363,POLI 162,A00,494170,Mignozzetti; Umberto,18,0,25,7
1713334424391,POLI 171,A00,494171,Mignozzetti; Umberto,18,0,25,7
1713334425420,PSYC 1,A00,494172,Staff,95,0,100,5
1713334426449,PSYC 2,A00,494173,Moranton; Nirelia Melbina-,34,0,50,16
1713334427474,PSYC 3,A00,494174,Staff,29,0,30,1
1713334428499,PSYC 6,A00,494175,Staff,17,0,20,3
1713334429525,PSYC 60,A01,494177,Staff,37,0,45,8
1713334430551,PSYC 70,A01,505724,Geller; Emma Harlan,42,0,45,3
1713334431581,PSYC 101,A00,494180,Heyman; Gail D.,84,0,100,16
1713334432610,PSYC 105,A00,494181,Geller; Emma Harlan,51,0,90,39
1713334433637,PSYC 106,A00,494182,Dobkins; Karen R.,27,0,45,18
1713334434663,PSYC 108,A00,494183,Adrian; Julia Anna,89,0,100,11
1713334435693,PSYC 114,A01,494185,Winkielman; Piotr,0,3,30,30
1713334436719,PSYC 122,A00,494186,Moranton; Nirelia Melbina-,27,0,50,23
1713334437745,PSYC 124,A00,494187,Chapman; Eddie Nathaniel,70,0,80,10
1713334438775,PSYC 131,A00,494188,Anagnostaras; Stephan,40,0,80,40
1713334439922,PSYC 144,A00,494189,Staff,1,0,50,49
1713334440952,PSYC 154,A00,494190,Lacefield; Katharine I,106,0,180,74
1713334441980,PSYC 162,A00,494191,Wixted; John T,71,0,100,29
1713334443009,PSYC 172,A00,494192,Gorman; Michael R.,36,0,45,9
1713334444035,PSYC 178,A00,494193,Glaser; Dale,34,0,45,11
1713334445214,PSYC 193,A00,505725,Chapman; Eddie Nathaniel,20,0,20,0
1713334446240,RELI 145GS,A00,519817,Rahimi; Babak,18,0,20,2
1713334447272,SE 101A,A01,490862,Chadha; Mayank,23,0,25,2
1713334448298,SE 101C,A01,490924,Krysl; Petr,15,0,20,5
1713334449329,SE 110A,A01,490928,Staff,19,0,20,1
1713334450356,SE 130A,A00,490929,Morrison; Machel Leigh,54,0,70,16
1713334451385,SIO 1,A01,519325,Staff,39,0,40,1
1713334452409,SIO 30,A01,519327,Staff,38,0,40,2
1713334453433,SIO 40,A00,519328,Staff,39,0,40,1
1713334454463,SIO 46GS,A00,519819,Cook; Geoffrey W,17,0,25,8
1713334455486,SIO 109R,A00,494197,Forman; Fonna,0,3,20,20
1713334456511,SIO 121GS,A00,519827,Cook; Geoffrey W,17,0,25,8
1713334457537,SIO 132,A01,519330,Staff,38,0,40,2
1713334458565,SIO 133,A01,519397,Staff,37,0,40,3
1713334459592,SIO 139,A00,519396,Kacev; David,29,0,40,11
1713334460624,SOCI 1,A01,494199,Thorpe; Charles Robert,21,0,30,9
1713334460624,SOCI 1,A02,494200,Thorpe; Charles Robert,30,0,30,0
1713334460624,SOCI 1,A03,494201,Thorpe; Charles Robert,29,0,30,1
1713334460624,SOCI 1,A04,494202,Thorpe; Charles Robert,29,0,30,1
1713334460624,SOCI 1,A05,494203,Thorpe; Charles Robert,29,0,30,1
1713334460624,SOCI 1,A06,494204,Thorpe; Charles Robert,30,0,30,0
1713334460624,SOCI 1,A07,494205,Thorpe; Charles Robert,28,0,30,2
1713334461651,SOCI 60,A01,494207,Staff,34,0,40,6
1713334461651,SOCI 60,A02,494208,Staff,39,0,40,1
1713334462676,SOCI 100,A01,494210,Payne; Christine Anna,25,0,30,5
1713334462676,SOCI 100,A02,494211,Payne; Christine Anna,26,0,30,4
1713334463705,SOCI 109M,A00,494212,Staff,20,0,20,0
1713334464731,SOCI 110,A00,494213,Staff,34,0,40,6
1713334466838,SOCI 118E,A00,494215,Ng; Kwai,37,0,40,3
1713334467862,SOCI 125,A00,494216,Calderon-Zaks; Michael Aar,40,0,45,5
1713334468892,SOCI 126,A01,494218,Jones; Makeba,3,0,5,2
1713334469960,SOCI 131,A00,494219,Thorpe; Charles Robert,26,0,30,4
1713334472019,SOCI 135,A00,494221,Payne; Christine Anna,28,0,50,22
1713334473048,SOCI 136E,A00,626690,Ruiz; Jonathan Joseph,24,0,25,1
1713334474073,SOCI 138GS,A00,494222,Navon; Daniel,23,0,28,5
1713334476126,SOCI 145,A00,494224,Staff,40,0,45,5
1713334477159,SOCI 153,A00,494225,Staff,28,0,30,2
1713334478193,SOCI 160E,A00,494226,Ng; Kwai,29,0,40,11
1713334479217,SOCI 180,A00,494227,Staff,29,0,30,1
1713334480242,SOCI 189GS,A00,494228,Ribas Norris; Janet Vanesa,11,0,11,0
1713334481267,SOCI 190GS,A00,553232,Ribas Norris; Janet Vanesa,11,0,11,0
1713334482293,SOMI 220,A00,627178,Schneid; Stephen David,30,0,30,0
1713334483320,SYN 2,001,490768,Staff,13,0,15,2
1713334483320,SYN 2,002,490769,Staff,14,0,15,1
1713334483320,SYN 2,004,490775,Staff,0,0,0,0
1713334483320,SYN 2,003,490774,Staff,0,0,0,0
1713334483320,SYN 2,005,490776,Staff,0,0,0,0
1713334484345,SYN 2R,001,490779,Staff,11,0,15,4
1713334484345,SYN 2R,002,514635,Staff,14,0,15,1
1713334485371,SYN 100,A01,490783,Staff,9,0,20,11
1713334485371,SYN 100,B01,490787,Staff,9,0,20,11
1713334485371,SYN 100,C01,490789,Staff,10,0,20,10
1713334486400,SYN 150,A00,490817,Staff,14,0,15,1
1713334486400,SYN 150,B00,514610,Staff,15,0,15,0
1713334487428,TDAC 1,A00,492753,Walsh; Kim C.,19,0,20,1
1713334487428,TDAC 1,B00,492754,Harting; Carla Kelso,19,0,20,1
1713334487428,TDAC 1,C00,513995,Salovey; Todd,15,0,20,5
1713334488453,TDAC 101,A00,492766,Harting; Carla Kelso,17,0,20,3
1713334489479,TDAC 102,A00,492768,Basso; Beatrice,19,0,20,1
1713334490504,TDDE 111,A00,492769,Staff,25,0,25,0
1713334491536,TDDE 131,A00,492770,Staff,15,0,15,0
1713334491536,TDDE 131,B00,492771,Staff,15,0,15,0
1713334492562,TDDE 131GS,A00,523716,Guirguis; Mark C,23,0,28,5
1713334493588,TDGE 1,A01,492756,Salovey; Todd,56,0,60,4
1713334494614,TDGE 5,A01,492758,Staff,23,0,25,2
1713334495638,TDGE 10,A00,492759,Fulton; Julia,203,0,220,17
1713334496662,TDGE 11,A00,492760,Castro; Robert Jess,198,0,200,2
1713334498716,TDGE 124,A00,492772,Fulton; Julia,184,0,220,36
1713334499745,TDGE 125,A00,492773,Meyer; Ursula,38,0,50,12
1713334499745,TDGE 125,B00,492774,Staff,49,0,50,1
1713334499745,TDGE 125,C00,523565,Staff,48,0,50,2
1713334500770,TDGE 125GS,A00,523580,Guirguis; Mark C,23,0,28,5
1713334501796,TDGE 127,A00,492775,Havis; Allan,33,0,50,17
1713334502825,TDHT 101,A00,492776,Staff,34,0,35,1
1713334503862,TDMV 1,A00,492762,Caligagan; Maria T.,29,0,30,1
1713334503862,TDMV 1,B00,492763,Arcidiacono; Kristin,26,0,30,4
1713334504891,TDMV 2,A00,492764,Weinberg; Sadie,28,0,30,2
1713334505916,TDMV 3,A00,492765,Mack; Kara Shanai',37,0,40,3
1713334506943,TDMV 138,A00,492777,Mack; Kara Shanai',34,0,40,6
1713334507970,TDMV 140,A00,492778,Lima; Paulo Henrique,40,0,40,0
1713334509002,TDMV 142,A00,492779,Caligagan; Maria T.,33,0,40,7
1713334509002,TDMV 142,B00,492780,Caligagan; Tony,37,0,40,3
1713334510029,TDMV 143,A00,492781,Fyall; Daunte Edward,39,0,40,1
1713334511059,USP 1,A01,492401,Kwak; Nancy,27,0,35,8
1713334512086,USP 2,A01,492453,Hinds; Juli Beth,35,0,35,0
1713334513111,USP 3,A01,492516,Staff,28,0,35,7
1713334514137,USP 4,A00,492522,McTague; Sarah,16,0,25,9
1713334515166,USP 100,A00,492523,Staff,32,0,35,3
1713334516192,USP 101,A00,492524,Staff,13,0,15,2
1713334517218,USP 105,A00,492525,Staff,21,0,25,4
1713334518247,USP 151,A00,492526,Shenkman; Michael Thomas,32,0,35,3
1713334519273,USP 170,A00,492545,Hinds; Juli Beth,33,0,35,2
1713334520300,USP 171GS,A00,492608,Bussell; Mirle Rabinowitz,24,0,28,4
1713334521331,USP 183GS,A00,492613,Peerson; Susan,24,0,28,4
1713334522359,VIS 30,A01,490693,Yoldas; Pinar,19,0,22,3
1713334522359,VIS 30,A02,490694,Yoldas; Pinar,18,0,22,4
1713334523387,VIS 83,A00,490695,Kester; Grant,63,0,75,12
1713334524416,VIS 105D,A00,490696,Staff,22,0,25,3
1713334525446,VIS 124CN,A00,490699,Rose; Jordan M,65,0,75,10
1713334526474,VIS 125GS,A00,511221,Williams; Alena J,21,0,22,1
1713334527500,VIS 128D,A00,490700,Staff,73,0,75,2
1713334528526,VIS 151,A01,490717,Staff,33,0,34,1
1713334528526,VIS 151,A02,490766,Staff,33,0,34,1
1713334529555,VIS 154GS,A00,511972,Williams; Alena J,21,0,22,1
1713334530581,VIS 160A,A00,490767,Stone; Patricia,7,0,10,3
1713334531610,WCWP 10A,A00,490638,Staff,14,0,15,1
1713334531610,WCWP 10A,B00,490640,Staff,15,0,15,0
1713334532639,WCWP 10B,A00,490641,Staff,0,0,0,0
1713334532639,WCWP 10B,B00,490642,Staff,14,0,15,1
1713334532639,WCWP 10B,C00,490644,Staff,13,0,15,2
1713334532639,WCWP 10B,D00,490647,Staff,0,0,0,0
1713334533670,WCWP 100,A00,490655,Staff,0,0,0,0
1713334533670,WCWP 100,B00,490687,Staff,10,0,15,5
1713334535769,ANAR 153,A00,487222,Braswell; Geoffrey E.,53,0,60,7
1713334536801,ANBI 134,A00,487223,Staff,5,0,20,15
1713334537828,ANBI 143GS,A00,487224,Noel; Geoffroy Pierre Jean,18,0,24,6
1713334538857,ANBI 144GS,A00,519548,Noel; Geoffroy Pierre Jean,18,0,24,6
1713334539884,ANSC 101,A00,487225,Staff,18,0,20,2
1713334540914,ANSC 125,A00,487227,Brenner; Suzanne A,38,0,40,2
1713334542966,ANSC 146,A00,487229,Staff,35,0,40,5
1713334543991,ANSC 148,A00,487230,Olivas Hernandez; Olga Lid,39,0,40,1
1713334545017,ANSC 150,A00,504165,Sloane; Julia Kathryn,18,0,20,2
1713334546044,ANSC 180,A00,487232,Staff,14,0,15,1
1713334547074,ANSC 188,A00,627155,Staff,38,0,40,2
1713334548099,ANTH 5,A00,519529,Semendeferi; Ekaterini,15,0,15,0
1713334549124,ANTH 10,A00,487219,Staff,58,0,60,2
1713334550153,ANTH 23,A01,487221,Staff,17,0,20,3
1713334551185,ANTH 102,A00,487233,Wilder; Linnea Lorene,51,0,60,9
1713334552218,ANTH 103,A00,487234,Varma; Saiba,55,0,60,5
1713334553252,ANTH 105,A00,487235,Stewart; Alexander B,54,0,60,6
1713334554283,BENG 100,A01,516685,Taylor Amos; Alyssa C,26,0,30,4
1713334555311,BIBC 102,A01,491316,Flagg; Matthew Paul,8,0,88,80
1713334555311,BIBC 102,A02,491366,Flagg; Matthew Paul,78,0,88,10
1713334556337,BIBC 103,A01,491486,Boumechache; Miyyada,16,0,24,8
1713334556337,BIBC 103,A02,491487,Boumechache; Miyyada,24,0,24,0
1713334557360,BICD 100,A01,516882,Staff,73,0,75,2
1713334557360,BICD 100,A02,516890,Staff,69,0,75,6
1713334558393,BICD 102GS,A00,491488,Lo; Stanley M.,26,0,28,2
1713334559423,BIEB 136GS,A00,516940,Holway; David A. & Shurin; Jonathan,18,0,24,6
1713334560454,BIEB 137GS,A01,517034,Holway; David A. & Shurin; Jonathan,18,0,24,6
1713334561478,BIEB 138GS,A01,491492,Pirino; Giorgia,21,0,28,7
1713334562505,BILD 1,A01,491296,Staff,60,0,63,3
1713334562505,BILD 1,A02,491297,Staff,63,0,63,0
1713334563530,BILD 4,A01,517099,Gonzalez Gamboa; Ivonne,22,0,24,2
1713334563530,BILD 4,A02,517100,Gonzalez Gamboa; Ivonne,24,0,24,0
1713334564559,BILD 60GS,A00,491309,Lo; Stanley M.,26,0,28,2
1713334565585,BIMM 100,A01,517136,Staff,83,0,100,17
1713334566610,BIMM 110,A01,517182,Staff,54,0,100,46
1713334567638,BIMM 120,A01,517228,Pickett; Brooke Elizabeth,28,0,63,35
1713334567638,BIMM 120,A02,517240,Pickett; Brooke Elizabeth,44,0,63,19
1713334568663,BIMM 132GS,A01,491498,Pirino; Giorgia,21,0,28,7
1713334569745,BIMM 143,A01,491589,Bozinovic; Goran,12,0,40,28
1713334570772,BIPN 100,A01,491594,Armour; Jon Christopher,83,0,100,17
1713334571799,BIPN 140,A01,491602,Marino; Marc J,25,0,50,25
1713334573848,CAT 125,A00,515973,Staff,18,0,20,2
1713334574879,CAT 125GS,A00,515974,Rahimi; Babak,17,0,20,3
1713334575912,CAT 125R,A00,515980,Staff,12,0,20,8
1713334575912,CAT 125R,B00,515981,Tosun; Adriana,19,0,20,1
1713334575912,CAT 125R,C00,515987,Hyland; Tina Mae,0,3,20,20
1713334575912,CAT 125R,D00,515988,Bronstein; Phoebe Malan,16,0,20,4
1713334576939,CENG 15,A01,488699,Drews; Aaron,25,0,25,0
1713334577967,CENG 100,A00,505196,Opatkiewicz; Justin Paul,25,0,25,0
1713334578997,CGS 2A,A01,489598,Staff,33,0,35,2
1713334580025,CGS 112,A00,489599,Staff,15,0,15,0
1713334581055,CGS 119,A00,489603,Staff,10,0,10,0
1713334582088,CGS 120,A00,489604,Staff,13,0,15,2
1713334583115,CGS 150,A00,489607,Staff,15,0,15,0
1713334584141,CHEM 6A,A01,488715,Staff,97,0,100,3
1713334585166,CHEM 6B,A01,488719,Piercy; Marc Anthony,99,0,100,1
1713334586192,CHEM 6C,A01,488723,Albizati; Kim F.,93,0,100,7
1713334587221,CHEM 7L,A01,488728,Schurmeier; Kimberly,18,0,24,6
1713334587221,CHEM 7L,A02,488730,Schurmeier; Kimberly,23,0,24,1
1713334587221,CHEM 7L,A03,488734,Schurmeier; Kimberly,20,0,24,4
1713334587221,CHEM 7L,A04,488763,Schurmeier; Kimberly,23,0,24,1
1713334587221,CHEM 7L,B01,488798,Schurmeier; Kimberly,17,0,24,7
1713334587221,CHEM 7L,B02,488801,Schurmeier; Kimberly,22,0,24,2
1713334587221,CHEM 7L,B03,488808,Schurmeier; Kimberly,22,0,24,2
1713334587221,CHEM 7L,B04,488811,Schurmeier; Kimberly,24,0,24,0
1713334588254,CHEM 11,A01,488897,Stallings; Dontarie M,95,0,100,5
1713334589280,CHEM 40A,A01,488913,Albizati; Kim F.,83,0,100,17
1713334590308,CHEM 40B,A01,488920,Weizman; Haim,43,0,50,7
1713334590308,CHEM 40B,A02,488938,Weizman; Haim,44,0,50,6
1713334591333,CHEM 41A,A01,489029,Klosterman; Jeremy K,57,0,60,3
1713334592360,CHEM 41C,A01,500436,Tor; Yitzhak,55,0,60,5
1713334593385,CHEM 43A,A01,500426,Weizman; Haim,0,1,24,24
1713334593385,CHEM 43A,A02,500430,Weizman; Haim,6,0,24,18
1713334593385,CHEM 43A,B01,514041,Klosterman; Jeremy K,16,0,24,8
1713334593385,CHEM 43A,B02,514047,Klosterman; Jeremy K,23,0,24,1
1713334594412,CHEM 108,A01,489140,Jennings; Patricia A.,7,0,24,17
1713334594412,CHEM 108,A02,489142,Jennings; Patricia A.,14,0,24,10
1713334595437,CHEM 114A,A01,489147,Stallings; Dontarie M,66,0,100,34
1713334596466,CHIN 169A,A00,489171,Wang; Xiao,19,0,20,1
1713334598525,COGS 3,A01,518827,Boyle; Mary E. T.,25,0,40,15
1713334599553,COGS 11,A01,489175,Staff,27,0,30,3
1713334600580,COGS 14A,A01,518829,Staff,51,0,60,9
1713334601611,COGS 14B,A01,489177,Hoffman; Drew Ellen,62,0,75,13
1713334602637,COGS 100,A01,489181,Allen; Michael Gordon,62,0,75,13
1713334603666,COGS 101A,A01,489183,Staff,45,0,60,15
1713334604696,COGS 101B,A01,489185,Allen; Michael Gordon,8,0,30,22
1713334605724,COGS 101C,A01,526786,Staff,23,0,30,7
1713334607779,COGS 107A,A01,489189,Boyle; Mary E. T.,17,0,35,18
1713334608805,COGS 107B,A01,627144,Mooshagian; Eric Frederick,60,0,60,0
1713334609829,COGS 118A,A01,489191,Staff,0,46,40,40
1713334611881,COGS 171GS,A01,489194,Pineda; Jaime A,19,0,28,9
1713334612908,COGS 172,A01,489196,Staff,2,0,30,28
1713334613939,COGS 174GS,A01,489264,Pineda; Jaime A,19,0,28,9
1713334614965,COGS 180,A01,627150,Staff,28,0,30,2
1713334615990,COGS 186,A01,489274,Staff,0,1,30,30
1713334617014,COMM 10,A01,489276,Staff,23,0,25,2
1713334617014,COMM 10,A02,489303,Staff,23,0,25,2
1713334618044,COMM 100A,A01,489312,Staff,14,0,25,11
1713334618044,COMM 100A,A02,489313,Staff,24,0,25,1
1713334619071,COMM 106T,A00,512540,Staff,33,0,35,2
1713334620097,COMM 107,A00,489347,Staff,27,0,35,8
1713334621125,COMM 109P,A00,489358,Staff,31,0,35,4
1713334622156,COMM 132,A00,489361,McKenna; Denise,27,0,30,3
1713334623185,COMM 146,A00,489362,Halm; Gavin Patrick,26,0,30,4
1713334624215,COMM 190,A00,489363,Abuelhiga; Soraya Jill,17,0,23,6
1713334625246,CSE 8A,A50,489366,Staff,21,0,25,4
1713334625246,CSE 8A,A51,489367,Staff,24,0,25,1
1713334626271,CSE 11,A01,489398,Cao; Yingjun,72,0,100,28
1713334627302,CSE 12,A01,489487,Staff,43,0,50,7
1713334628327,CSE 20,A01,489497,Staff,48,0,50,2
1713334629358,CSE 21,A01,489517,Braun; Oliver,42,0,50,8
1713334630385,CSE 101,A01,489524,Braun; Oliver,0,32,50,50
1713334631411,CSE 105,A01,512594,Jones; Miles E,72,0,100,28
1713334631411,CSE 105,B01,512598,Jones; Miles E,52,0,100,48
1713334632438,CSE 140,A01,489538,Staff,41,0,50,9
1713334633464,CSE 141,A01,489550,Eldon; John,67,0,100,33
1713334634488,CSE 141L,A01,489571,Eldon; John,65,0,100,35
1713334635518,CSE 151A,A01,489583,Solares; Edwin A,141,0,200,59
1713334636543,CSE 175,A01,510886,Kumar; Rakesh,30,0,30,0
1713334637568,CSE 190,A00,516828,Dubnov; Shlomo,38,0,49,11
1713334638593,DOC 100D,A00,489667,Pass; Natalye Joann,19,0,25,6
1713334639619,DSC 10,A01,624268,Staff,72,0,75,3
1713334640644,DSC 20,A01,624476,Staff,50,0,50,0
1713334641669,DSC 40A,A01,624608,Staff,39,0,40,1
1713334642695,DSGN 1,A01,489179,Rill; Bryan,32,0,50,18
1713334643722,ECE 17,A01,490489,Sahay; Rajeev,18,0,30,12
1713334644748,ECE 65,A50,490492,Staff,11,0,20,9
1713334644748,ECE 65,A51,490493,Staff,18,0,20,2
1713334645773,ECON 1,A01,489715,Famulari; Melissa,67,0,70,3
1713334646799,ECON 2,A01,489717,Levkoff; Steven B.,67,0,70,3
1713334647825,ECON 3,A01,489948,Staff,70,0,70,0
1713334649884,ECON 5,A01,490103,Staff,27,0,30,3
1713334649884,ECON 5,B01,626281,Dai; Yinlin,45,0,45,0
1713334650961,ECON 100A,A01,490127,Famulari; Melissa,64,0,70,6
1713334651985,ECON 100B,A01,490129,Staff,64,0,70,6
1713334653011,ECON 109,A01,490187,Shishkin; Denis,27,0,35,8
1713334654040,ECON 110A,A01,490190,Levkoff; Steven B.,60,0,70,10
1713334655065,ECON 120A,A01,490245,Dai; Yinlin,60,0,70,10
1713334656096,ECON 120B,A01,490247,Nieto-Barthaburu; Augusto,40,0,70,30
1713334657122,ECON 120C,A01,490253,Sun; Yixiao,30,0,35,5
1713334657122,ECON 120C,B01,490255,Sun; Yixiao,34,0,35,1
1713334658148,ECON 129,A00,490256,Eckert; Fabian Paul,22,0,35,13
1713334659176,ECON 131,A00,490257,Nieto-Barthaburu; Augusto,0,6,35,35
1713334660200,ECON 138,A00,490258,Bharadwaj; Prashant,13,0,35,22
1713334660200,ECON 138,B00,490259,Bharadwaj; Prashant,15,0,35,20
1713334661228,ECON 159,A00,490260,Hendrickson; Gerald M.,0,9,0,0
1713334662261,ECON 178,A01,553995,Zhu; Ying,24,0,35,11
1713334663288,EDS 40,A01,512576,Black; Alison Michelle,20,0,20,0
1713334664312,EDS 107,A01,515848,Staff,30,0,30,0
1713334665341,EDS 110R,A01,490262,Staff,26,0,30,4
1713334666372,EDS 112,A01,490264,Chapman; Thandeka K,40,0,50,10
1713334667398,EDS 113,A00,490266,Staff,26,0,30,4
1713334668424,EDS 118,A00,490267,Warstadt; Melissa Fawn,18,0,30,12
1713334669454,EDS 124BR,A00,490268,Eguchi; Emi,4,0,25,21
1713334669454,EDS 124BR,B00,490269,Eguchi; Emi,23,0,25,2
1713334670485,EDS 126,A01,490271,Jones; Makeba,43,0,50,7
1713334671515,EDS 135,A01,490316,Staff,19,0,20,1
1713334672540,ENVR 142GS,A00,519514,Chang; Edmond Yi-Teh,26,0,28,2
1713334673619,ETHN 103,A00,490504,Staff,25,0,36,11
1713334674650,ETHN 103A,A00,490505,Man; Simeon S,4,0,9,5
1713334675679,ETHN 109,A00,490506,Staff,28,0,30,2
1713334676709,ETHN 118,A00,490507,Staff,35,0,36,1
1713334677738,ETHN 119,A00,490508,Staff,33,0,36,3
1713334678762,ETHN 121R,A00,490518,Choi; Esther Min,21,0,36,15
1713334679789,ETHN 127,A00,490528,Staff,14,0,15,1
1713334680819,ETHN 139,A00,490573,Staff,10,0,10,0
1713334681848,ETHN 150,A00,490575,Staff,15,0,15,0
1713334682877,GLBH 20,A00,491705,Elwardani; Nile Regina,38,0,40,2
1713334683901,GLBH 101,A00,491706,Staff,20,0,20,0
1713334684928,GLBH 111,A01,491708,Burgos; Jose L.,15,0,15,0
1713334685953,GLBH 146,A00,491709,Staff,9,0,20,11
1713334686978,GLBH 148,A00,491710,Olivas Hernandez; Olga Lid,11,0,20,9
1713334688007,GLBH 150,A00,491711,Sloane; Julia Kathryn,19,0,20,1
1713334689032,HIEA 131,A00,491760,Staff,28,0,32,4
1713334690067,HIEA 153,A00,491762,Staff,28,0,30,2
1713334691090,HIEU 124,A00,491811,Staff,26,0,32,6
1713334692114,HIEU 124GS,A00,491812,Markman; Kristina,27,0,28,1
1713334693139,HIEU 147,A00,491813,Staff,30,0,32,2
1713334694165,HIEU 149GS,A00,491816,Caldwell; Michael Alan,28,0,28,0
1713334695197,HILD 2C,A01,491713,Hendrickson; Gerald M.,26,0,30,4
1713334696221,HILD 7B,A01,491715,Kwak; Nancy,0,2,30,30
1713334697249,HILD 10,A01,491717,Staff,9,0,20,11
1713334698275,HILD 30GS,A00,491719,Edington; Claire Ellen,23,0,28,5
1713334699305,HINE 109,A00,491818,Shafir; Nir,27,0,32,5
1713334700330,HINE 128,A00,491821,Shafir; Nir,31,0,32,1
1713334701354,HISC 117,A00,491830,Staff,27,0,32,5
1713334702380,HIUS 103,A00,491834,Man; Simeon S,14,0,23,9
1713334703407,HIUS 108B,A00,491835,Staff,27,0,30,3
1713334704430,HIUS 141,A00,491836,Hendrickson; Gerald M.,28,0,32,4
1713334705455,HIUS 149,A00,491839,Staff,24,0,32,8
1713334706482,HUM 3,A01,512617,Crum; Matthew Stephen,42,0,50,8
1713334706482,HUM 3,A02,512618,Crum; Matthew Stephen,48,0,50,2
1713334707506,HUM 3GS,A00,512663,Markman; Kristina,0,0,0,1
1713334707506,HUM 3GS,B00,512664,Staff,0,0,0,0
1713334708534,HUM 4,A01,512620,West; Geoffrey Scott,25,0,50,25
1713334709561,HUM 4GS,A00,512666,Lyon; Antony J.,0,0,0,5
1713334710588,HUM 4R,A01,512625,Watkins; Eric,49,0,50,1
1713334711622,HUM 5,A01,512649,Zavodny; Tatiana Sophia,21,0,50,29
1713334711622,HUM 5,B01,512661,Zroka; Ryan Edward,48,0,50,2
1713334712746,INTL 190,A00,490577,Segui; Alan S,0,0,0,5
1713334713776,JAPN 20AR,A01,491267,Ross; Kayoko F,7,0,20,13
1713334714803,JAPN 180,A00,491285,Berman; Michael David,33,0,40,7
1713334715831,LATI 50,A01,502536,Kokinis; Troy Andreas,16,0,22,6
1713334715831,LATI 50,A02,502551,Kokinis; Troy Andreas,22,0,22,0
1713334715831,LATI 50,A03,502650,Kokinis; Troy Andreas,22,0,22,0
1713334715831,LATI 50,A04,502909,Kokinis; Troy Andreas,21,0,22,1
1713334716856,LATI 160,A01,502920,Kokinis; Troy Andreas,30,0,30,0
1713334717882,LIFR 1A,A00,490494,Van Moer; Vinciane G,17,0,20,3
1713334718913,LIFR 1AX,A00,490495,Van Moer; Vinciane G,17,0,20,3
1713334719940,LIFR 1B,A00,490496,Van Moer; Vinciane G,17,0,20,3
1713334720965,LIFR 1BX,A00,490497,Van Moer; Vinciane G,17,0,20,3
1713334721990,LIGN 8,A00,505198,McIntosh; Justin Daniel,134,0,150,16
1713334723021,LIGN 9GS,A00,491239,Lott; Margaret S.,18,0,20,2
1713334724051,LIGN 101,A01,505200,McIntosh; Justin Daniel,22,0,30,8
1713334725077,LIGN 120,A01,491244,Staff,22,0,30,8
1713334726105,LIGN 149GS,A00,491245,Lott; Margaret S.,18,0,20,2
1713334727131,LIGN 170,A00,491247,Staff,22,0,30,8
1713334728161,LISP 1D,A00,490498,Munoz Sanchez; Alicia,8,0,14,6
1713334728161,LISP 1D,B00,490499,Munoz Sanchez; Alicia,6,0,14,8
1713334728161,LISP 1D,C00,490500,Munoz Sanchez; Alicia,7,0,14,7
1713334728161,LISP 1D,D00,490501,Munoz Sanchez; Alicia,10,0,14,4
1713334729190,LISP 1DX,A00,490502,Munoz Sanchez; Alicia,13,0,28,15
1713334729190,LISP 1DX,B00,490503,Munoz Sanchez; Alicia,16,0,28,12
1713334731251,LTAM 110,A00,491847,Staff,22,0,25,3
1713334732281,LTCS 119,A00,491848,Staff,11,0,15,4
1713334733304,LTCS 130,A00,491849,Staff,24,0,25,1
1713334735358,LTEA 120C,A00,491852,Staff,32,0,40,8
1713334736389,LTEN 130GS,A00,491853,Lyon; Antony J.,23,0,28,5
1713334737420,LTEN 148,A00,491855,Staff,23,0,25,2
1713334738446,LTEN 159,A00,491856,Staff,20,0,25,5
1713334739470,LTEN 180,A00,491857,Staff,8,0,15,7
1713334741528,LTSP 123GS,A00,505928,Bessett; Ryan Matthew,24,0,28,4
1713334742552,LTSP 174GS,A00,506037,Bessett; Ryan Matthew,24,0,28,4
1713334744607,LTWR 102,A00,491861,Staff,9,0,15,6
1713334745631,LTWR 106,A00,491862,Staff,8,0,15,7
1713334746656,MAE 11,A00,490930,Bahadori; Mohammad Yousef,95,0,100,5
1713334747685,MAE 30A,A00,490931,Qi; Huihui,37,0,40,3
1713334748710,MAE 101A,A00,491036,Sadeghizadeh; Zahra,92,0,100,8
1713334749743,MAE 101C,A00,491037,Seshadri; Kalyanasundaram,64,0,100,36
1713334750773,MAE 113,A00,491040,Seshadri; Kalyanasundaram,65,0,80,15
1713334751800,MAE 131A,A00,491041,Ghazinejad; Maziar,37,0,40,3
1713334752824,MAE 142,A00,491053,Staff,39,0,40,1
1713334753849,MAE 143A,A00,491054,Staff,31,0,50,19
1713334754874,MAE 150,A00,491092,Truong; Phuong Thi Ngoc,23,0,35,12
1713334755900,MATH 3C,A01,494031,Pardo Guerra; Sebastian,30,0,30,0
1713334755900,MATH 3C,A02,494032,Pardo Guerra; Sebastian,29,0,30,1
1713334756931,MATH 10A,A01,494034,Staff,27,0,30,3
1713334756931,MATH 10A,A02,494035,Staff,28,0,30,2
1713334756931,MATH 10A,B01,494037,Staff,27,0,30,3
1713334756931,MATH 10A,B02,494038,Staff,29,0,30,1
1713334757960,MATH 10B,A01,494040,Habib; Yousaf,22,0,30,8
1713334757960,MATH 10B,A02,494041,Habib; Yousaf,28,0,30,2
1713334757960,MATH 10B,A03,494042,Habib; Yousaf,29,0,30,1
1713334757960,MATH 10B,A04,494043,Habib; Yousaf,30,0,30,0
1713334757960,MATH 10B,B01,494045,Habib; Yousaf,25,0,30,5
1713334757960,MATH 10B,B02,494046,Habib; Yousaf,30,0,30,0
1713334757960,MATH 10B,B03,494047,Habib; Yousaf,30,0,30,0
1713334757960,MATH 10B,B04,494048,Habib; Yousaf,30,0,30,0
1713334758987,MATH 18,A01,494050,Kemp; Todd Aahron,25,0,30,5
1713334758987,MATH 18,A02,494051,Kemp; Todd Aahron,29,0,30,1
1713334758987,MATH 18,B01,494054,Kemp; Todd Aahron,25,0,30,5
1713334758987,MATH 18,B02,494055,Kemp; Todd Aahron,29,0,30,1
1713334760014,MATH 20A,A01,494059,Suk; Andrew Hoon,30,0,30,0
1713334761048,MATH 20B,A01,494061,Briones; Jor-el Thomas Caparas,33,0,35,2
1713334761048,MATH 20B,B01,494063,Bach; Quang Tran,34,0,35,1
1713334762081,MATH 20C,A01,494065,Staff,28,0,30,2
1713334762081,MATH 20C,A02,494066,Staff,30,0,30,0
1713334762081,MATH 20C,A03,494067,Staff,30,0,30,0
1713334762081,MATH 20C,A04,494068,Staff,30,0,30,0
1713334762081,MATH 20C,B01,494070,Zhang; Ming,25,0,30,5
1713334762081,MATH 20C,B02,494071,Zhang; Ming,27,0,30,3
1713334762081,MATH 20C,B03,494072,Zhang; Ming,29,0,30,1
1713334762081,MATH 20C,B04,494073,Zhang; Ming,29,0,30,1
1713334763107,MATH 20D,A01,494075,Staff,22,0,30,8
1713334763107,MATH 20D,A02,494076,Staff,29,0,30,1
1713334764138,MATH 20E,A01,494079,Staff,24,0,30,6
1713334764138,MATH 20E,A02,494080,Staff,26,0,30,4
1713334764138,MATH 20E,B01,494082,Staff,25,0,30,5
1713334764138,MATH 20E,B02,494083,Staff,25,0,30,5
1713334765171,MATH 103A,A01,494085,Aliabadi Sr.; Mohsen,13,0,30,17
1713334765171,MATH 103A,A02,494086,Aliabadi Sr.; Mohsen,28,0,30,2
1713334765171,MATH 103A,B01,494088,Aliabadi Sr.; Mohsen,21,0,30,9
1713334765171,MATH 103A,B02,494089,Aliabadi Sr.; Mohsen,27,0,30,3
1713334766197,MATH 109,A01,494091,Staff,30,0,30,0
1713334766197,MATH 109,A02,494092,Staff,29,0,30,1
1713334766197,MATH 109,B01,494094,Staff,27,0,30,3
1713334766197,MATH 109,B02,494095,Staff,29,0,30,1
1713334767229,MATH 142A,A01,494097,Chow; Bennett,14,0,30,16
1713334767229,MATH 142A,A02,494098,Chow; Bennett,23,0,30,7
1713334767229,MATH 142A,B01,494100,Chow; Bennett,19,0,30,11
1713334767229,MATH 142A,B02,494101,Chow; Bennett,29,0,30,1
1713334769279,MATH 168A,A01,516677,Dumitriu; Ioana,16,0,35,19
1713334770304,MATH 170A,A01,516679,Dumitriu; Ioana,18,0,30,12
1713334770304,MATH 170A,A02,516680,Dumitriu; Ioana,28,0,30,2
1713334771334,MATH 193A,A01,494107,Staff,13,0,30,17
1713334771334,MATH 193A,A02,494108,Staff,19,0,30,11
1713334771334,MATH 193A,A03,494109,Staff,29,0,30,1
1713334771334,MATH 193A,A04,494110,Staff,22,0,30,8
1713334774418,MGT 16,A00,491930,McKay; Michael J,92,0,98,6
1713334775443,MGT 18,A00,491992,McKay; Michael J,96,0,98,2
1713334776471,MGT 71,A00,492003,Staff,63,0,98,35
1713334777550,MGT 103,A00,505209,Eberhard; Craig A,81,0,98,17
1713334778574,MGT 131A,A00,505210,Anderson; John Charles,89,0,98,9
1713334780627,MGT 153,A00,492077,Perols; Johan Lars,18,0,90,72
1713334783706,MGT 164,A00,492222,McKay; Mary A,91,0,98,7
1713334784733,MGT 172,A00,492245,Staff,59,0,60,1
1713334784733,MGT 172,B00,505526,Hedges; Kathleen,65,0,98,33
1713334785762,MGT 181,A00,505669,Dunn; Louis Jean,80,0,98,18
1713334786795,MMW 14,A01,494399,Staff,15,0,28,13
1713334786795,MMW 14,A02,494400,Staff,25,0,28,3
1713334786795,MMW 14,A03,494401,Staff,28,0,28,0
1713334786795,MMW 14,A04,494402,Staff,28,0,28,0
1713334786795,MMW 14,B01,494404,Carreras; Maria Victoria,8,0,28,20
1713334786795,MMW 14,B02,494405,Carreras; Maria Victoria,25,0,28,3
1713334786795,MMW 14,B03,494406,Carreras; Maria Victoria,27,0,28,1
1713334786795,MMW 14,B04,494407,Carreras; Maria Victoria,28,0,28,0
1713334787821,MMW 14GS,A00,506250,Chang; Edmond Yi-Teh,0,0,0,0
1713334788851,MMW 121R,A01,494415,Adamiak; Patrick John,10,0,28,18
1713334788851,MMW 121R,A02,494416,Adamiak; Patrick John,24,0,28,4
1713334789877,MUS 1A,A01,494113,Staff,12,0,25,13
1713334789877,MUS 1A,A02,494114,Staff,24,0,25,1
1713334790904,MUS 4,A01,494116,Staff,23,0,25,2
1713334790904,MUS 4,A02,494117,Staff,22,0,25,3
1713334791930,MUS 5R,A01,494236,Dubnov; Shlomo,6,0,25,19
1713334791930,MUS 5R,A02,494237,Dubnov; Shlomo,25,0,25,0
1713334792955,MUS 6,A01,494122,Staff,9,0,25,16
1713334792955,MUS 6,A02,494123,Staff,23,0,25,2
1713334793986,MUS 7,A01,494125,Staff,16,0,25,9
1713334793986,MUS 7,A02,494126,Staff,24,0,25,1
1713334795014,MUS 11,A01,494128,Staff,23,0,25,2
1713334795014,MUS 11,A02,494129,Staff,24,0,25,1
1713334796044,MUS 13,A01,494131,Staff,25,0,25,0
1713334796044,MUS 13,A02,494132,Staff,25,0,25,0
1713334797068,MUS 15,A01,494134,Staff,16,0,25,9
1713334797068,MUS 15,A02,494135,Staff,25,0,25,0
1713334797068,MUS 15,B01,494137,Staff,24,0,25,1
1713334798094,MUS 80,A00,494232,Staff,24,0,25,1
1713334798094,MUS 80,B00,494233,Staff,25,0,25,0
1713334798094,MUS 80,C00,494234,Staff,23,0,25,2
1713334799118,MUS 95C,A00,494141,Staff,70,0,75,5
1713334800145,MUS 114,A00,494142,Staff,40,0,50,10
1713334801176,NANO 15,A01,490636,Drews; Aaron,7,0,7,0
1713334802202,PHIL 1,A00,490578,Grush; Rick Scott,49,0,50,1
1713334803231,PHIL 10,A01,490580,Grush; Rick Scott,33,0,35,2
1713334803231,PHIL 10,A02,490586,Grush; Rick Scott,32,0,35,3
1713334804260,PHIL 27,A01,490591,Staff,22,0,25,3
1713334804260,PHIL 27,A02,490592,Staff,25,0,25,0
1713334804260,PHIL 27,A03,490593,Staff,25,0,25,0
1713334804260,PHIL 27,A04,490598,Staff,25,0,25,0
1713334805289,PHIL 32,A01,490611,Staff,20,0,20,0
1713334805289,PHIL 32,A02,490618,Staff,20,0,20,0
1713334806314,PHIL 90,A00,490624,Staff,40,0,40,0
1713334807341,PHIL 136,A00,490627,Cohen; Jonathan David,37,0,40,3
1713334808371,PHIL 155,A00,490634,Staff,62,0,70,8
1713334809401,PHYS 1A,A00,491610,Staff,245,0,250,5
1713334810433,PHYS 1AL,001,491616,Tsai; Philbert S,27,0,30,3
1713334810433,PHYS 1AL,002,491618,Tsai; Philbert S,30,0,30,0
1713334811461,PHYS 1B,A00,491623,Staff,236,0,250,14
1713334812486,PHYS 1BL,001,491626,Tsai; Philbert S,21,0,30,9
1713334812486,PHYS 1BL,002,491628,Tsai; Philbert S,26,0,30,4
1713334813511,PHYS 1C,A00,491632,Staff,213,0,245,32
1713334814541,PHYS 1CL,001,491635,Tsai; Philbert S,3,0,30,27
1713334814541,PHYS 1CL,002,491643,Tsai; Philbert S,22,0,30,8
1713334815568,PHYS 2AR,A01,491651,Meyertholen; Andrew D.,44,0,50,6
1713334816596,PHYS 2B,A01,491659,Staff,106,0,115,9
1713334817622,PHYS 2BL,A01,491685,Staff,21,0,24,3
1713334817622,PHYS 2BL,A02,491700,Staff,21,0,24,3
1713334818648,PHYS 2C,A01,505161,Staff,101,0,115,14
1713334819682,PHYS 4A,A01,491704,Grinstein; Benjamin,99,0,100,1
1713334820724,POLI 5D,A01,494144,Staff,3,0,5,2
1713334820724,POLI 5D,B01,626283,Dai; Yinlin,5,0,5,0
1713334821750,POLI 12,A00,494145,Staff,43,0,45,2
1713334822779,POLI 13R,A00,494146,Forman; Fonna,45,0,50,5
1713334823805,POLI 27,A01,494148,Staff,54,0,60,6
1713334824830,POLI 30,A00,494149,Staff,49,0,50,1
1713334825861,POLI 100DA,A00,494150,Staff,21,0,25,4
1713334827919,POLI 100I,A00,494152,Staff,27,0,30,3
1713334828946,POLI 104B,A00,494153,Smith; Glenn Chatmas,53,0,55,2
1713334829971,POLI 104F,A00,494154,Staff,28,0,30,2
1713334831001,POLI 104I,A00,494155,Smith; Glenn Chatmas,29,0,30,1
1713334832028,POLI 110C,A00,494156,Ingham; Sean,23,0,25,2
1713334833057,POLI 117R,A00,494157,Forman; Fonna,5,0,20,15
1713334834089,POLI 118,A00,494158,Ingham; Sean,21,0,25,4
1713334835115,POLI 120H,A00,494159,Fisk; David Lee,39,0,45,6
1713334836143,POLI 131CR,A00,494160,Hoston; Germaine,35,0,45,10
1713334837169,POLI 133J,A00,494161,Staff,31,0,35,4
1713334838194,POLI 135,A00,494162,Fisk; David Lee,33,0,35,2
1713334839222,POLI 140A,A00,494164,Staff,19,0,30,11
1713334840247,POLI 142I,A00,494165,Staff,30,0,30,0
1713334841273,POLI 144D,A00,494166,Staff,23,0,25,2
1713334842302,POLI 151,A00,494167,Staff,30,0,30,0
1713334843326,POLI 153,A00,494168,Staff,33,0,35,2
1713334844354,POLI 160AA,A00,494169,Staff,34,0,40,6
1713334845379,POLI 162,A00,494170,Mignozzetti; Umberto,18,0,25,7
1713334846404,POLI 171,A00,494171,Mignozzetti; Umberto,18,0,25,7
1713334847429,PSYC 1,A00,494172,Staff,95,0,100,5
1713334848454,PSYC 2,A00,494173,Moranton; Nirelia Melbina-,34,0,50,16
1713334849478,PSYC 3,A00,494174,Staff,29,0,30,1
1713334850504,PSYC 6,A00,494175,Staff,17,0,20,3
1713334851532,PSYC 60,A01,494177,Staff,37,0,45,8
1713334852557,PSYC 70,A01,505724,Geller; Emma Harlan,42,0,45,3
1713334853582,PSYC 101,A00,494180,Heyman; Gail D.,84,0,100,16
1713334854608,PSYC 105,A00,494181,Geller; Emma Harlan,51,0,90,39
1713334855634,PSYC 106,A00,494182,Dobkins; Karen R.,27,0,45,18
1713334856666,PSYC 108,A00,494183,Adrian; Julia Anna,89,0,100,11
1713334857693,PSYC 114,A01,494185,Winkielman; Piotr,0,3,30,30
1713334858724,PSYC 122,A00,494186,Moranton; Nirelia Melbina-,27,0,50,23
1713334859749,PSYC 124,A00,494187,Chapman; Eddie Nathaniel,70,0,80,10
1713334860774,PSYC 131,A00,494188,Anagnostaras; Stephan,40,0,80,40
1713334861799,PSYC 144,A00,494189,Staff,1,0,50,49
1713334862825,PSYC 154,A00,494190,Lacefield; Katharine I,106,0,180,74
1713334863861,PSYC 162,A00,494191,Wixted; John T,71,0,100,29
1713334864888,PSYC 172,A00,494192,Gorman; Michael R.,36,0,45,9
1713334865913,PSYC 178,A00,494193,Glaser; Dale,34,0,45,11
1713334866939,PSYC 193,A00,505725,Chapman; Eddie Nathaniel,20,0,20,0
1713334867970,RELI 145GS,A00,519817,Rahimi; Babak,18,0,20,2
1713334869004,SE 101A,A01,490862,Chadha; Mayank,23,0,25,2
1713334870029,SE 101C,A01,490924,Krysl; Petr,15,0,20,5
1713334871059,SE 110A,A01,490928,Staff,19,0,20,1
1713334872085,SE 130A,A00,490929,Morrison; Machel Leigh,54,0,70,16
1713334873115,SIO 1,A01,519325,Staff,39,0,40,1
1713334874142,SIO 30,A01,519327,Staff,38,0,40,2
1713334875172,SIO 40,A00,519328,Staff,39,0,40,1
1713334876200,SIO 46GS,A00,519819,Cook; Geoffrey W,17,0,25,8
1713334877226,SIO 109R,A00,494197,Forman; Fonna,0,3,20,20
1713334878254,SIO 121GS,A00,519827,Cook; Geoffrey W,17,0,25,8
1713334879284,SIO 132,A01,519330,Staff,38,0,40,2
1713334880313,SIO 133,A01,519397,Staff,37,0,40,3
1713334881393,SIO 139,A00,519396,Kacev; David,29,0,40,11
1713334882422,SOCI 1,A01,494199,Thorpe; Charles Robert,21,0,30,9
1713334882422,SOCI 1,A02,494200,Thorpe; Charles Robert,30,0,30,0
1713334882422,SOCI 1,A03,494201,Thorpe; Charles Robert,29,0,30,1
1713334882422,SOCI 1,A04,494202,Thorpe; Charles Robert,29,0,30,1
1713334882422,SOCI 1,A05,494203,Thorpe; Charles Robert,29,0,30,1
1713334882422,SOCI 1,A06,494204,Thorpe; Charles Robert,30,0,30,0
1713334882422,SOCI 1,A07,494205,Thorpe; Charles Robert,28,0,30,2
1713334883451,SOCI 60,A01,494207,Staff,34,0,40,6
1713334883451,SOCI 60,A02,494208,Staff,39,0,40,1
1713334884476,SOCI 100,A01,494210,Payne; Christine Anna,25,0,30,5
1713334884476,SOCI 100,A02,494211,Payne; Christine Anna,26,0,30,4
1713334885504,SOCI 109M,A00,494212,Staff,20,0,20,0
1713334886533,SOCI 110,A00,494213,Staff,34,0,40,6
1713334888590,SOCI 118E,A00,494215,Ng; Kwai,37,0,40,3
1713334889615,SOCI 125,A00,494216,Calderon-Zaks; Michael Aar,40,0,45,5
1713334890661,SOCI 126,A01,494218,Jones; Makeba,3,0,5,2
1713334891685,SOCI 131,A00,494219,Thorpe; Charles Robert,26,0,30,4
1713334893737,SOCI 135,A00,494221,Payne; Christine Anna,28,0,50,22
1713334894770,SOCI 136E,A00,626690,Ruiz; Jonathan Joseph,24,0,25,1
1713334895796,SOCI 138GS,A00,494222,Navon; Daniel,23,0,28,5
1713334897848,SOCI 145,A00,494224,Staff,40,0,45,5
1713334898879,SOCI 153,A00,494225,Staff,28,0,30,2
1713334899904,SOCI 160E,A00,494226,Ng; Kwai,28,0,40,12
1713334900929,SOCI 180,A00,494227,Staff,29,0,30,1
1713334901954,SOCI 189GS,A00,494228,Ribas Norris; Janet Vanesa,11,0,11,0
1713334902980,SOCI 190GS,A00,553232,Ribas Norris; Janet Vanesa,11,0,11,0
1713334904035,SOMI 220,A00,627178,Schneid; Stephen David,30,0,30,0
1713334905071,SYN 2,001,490768,Staff,13,0,15,2
1713334905071,SYN 2,002,490769,Staff,14,0,15,1
1713334905071,SYN 2,004,490775,Staff,0,0,0,0
1713334905071,SYN 2,003,490774,Staff,0,0,0,0
1713334905071,SYN 2,005,490776,Staff,0,0,0,0
1713334906102,SYN 2R,001,490779,Staff,11,0,15,4
1713334906102,SYN 2R,002,514635,Staff,14,0,15,1
1713334907127,SYN 100,A01,490783,Staff,9,0,20,11
1713334907127,SYN 100,B01,490787,Staff,9,0,20,11
1713334907127,SYN 100,C01,490789,Staff,10,0,20,10
1713334908152,SYN 150,A00,490817,Staff,14,0,15,1
1713334908152,SYN 150,B00,514610,Staff,15,0,15,0
1713334909188,TDAC 1,A00,492753,Walsh; Kim C.,19,0,20,1
1713334909188,TDAC 1,B00,492754,Harting; Carla Kelso,19,0,20,1
1713334909188,TDAC 1,C00,513995,Salovey; Todd,15,0,20,5
1713334910219,TDAC 101,A00,492766,Harting; Carla Kelso,17,0,20,3
1713334911249,TDAC 102,A00,492768,Basso; Beatrice,19,0,20,1
1713334912275,TDDE 111,A00,492769,Staff,25,0,25,0
1713334913306,TDDE 131,A00,492770,Staff,15,0,15,0
1713334913306,TDDE 131,B00,492771,Staff,15,0,15,0
1713334914338,TDDE 131GS,A00,523716,Guirguis; Mark C,23,0,28,5
1713334915367,TDGE 1,A01,492756,Salovey; Todd,56,0,60,4
1713334916393,TDGE 5,A01,492758,Staff,23,0,25,2
1713334917422,TDGE 10,A00,492759,Fulton; Julia,203,0,220,17
1713334918449,TDGE 11,A00,492760,Castro; Robert Jess,198,0,200,2
1713334920514,TDGE 124,A00,492772,Fulton; Julia,182,0,220,38
1713334921542,TDGE 125,A00,492773,Meyer; Ursula,38,0,50,12
1713334921542,TDGE 125,B00,492774,Staff,49,0,50,1
1713334921542,TDGE 125,C00,523565,Staff,48,0,50,2
1713334922571,TDGE 125GS,A00,523580,Guirguis; Mark C,23,0,28,5
1713334923604,TDGE 127,A00,492775,Havis; Allan,32,0,50,18
1713334924630,TDHT 101,A00,492776,Staff,34,0,35,1
1713334925658,TDMV 1,A00,492762,Caligagan; Maria T.,29,0,30,1
1713334925658,TDMV 1,B00,492763,Arcidiacono; Kristin,26,0,30,4
1713334926684,TDMV 2,A00,492764,Weinberg; Sadie,28,0,30,2
1713334927715,TDMV 3,A00,492765,Mack; Kara Shanai',37,0,40,3
1713334928746,TDMV 138,A00,492777,Mack; Kara Shanai',34,0,40,6
1713334929772,TDMV 140,A00,492778,Lima; Paulo Henrique,40,0,40,0
1713334930805,TDMV 142,A00,492779,Caligagan; Maria T.,33,0,40,7
1713334930805,TDMV 142,B00,492780,Caligagan; Tony,37,0,40,3
1713334931831,TDMV 143,A00,492781,Fyall; Daunte Edward,39,0,40,1
1713334932864,USP 1,A01,492401,Kwak; Nancy,27,0,35,8
1713334933911,USP 2,A01,492453,Hinds; Juli Beth,35,0,35,0
1713334934941,USP 3,A01,492516,Staff,28,0,35,7
1713334935966,USP 4,A00,492522,McTague; Sarah,16,0,25,9
1713334936991,USP 100,A00,492523,Staff,32,0,35,3
1713334938017,USP 101,A00,492524,Staff,13,0,15,2
1713334939043,USP 105,A00,492525,Staff,21,0,25,4
1713334940068,USP 151,A00,492526,Shenkman; Michael Thomas,32,0,35,3
1713334941096,USP 170,A00,492545,Hinds; Juli Beth,33,0,35,2
1713334942131,USP 171GS,A00,492608,Bussell; Mirle Rabinowitz,24,0,28,4
1713334943158,USP 183GS,A00,492613,Peerson; Susan,24,0,28,4
1713334944189,VIS 30,A01,490693,Yoldas; Pinar,19,0,22,3
1713334944189,VIS 30,A02,490694,Yoldas; Pinar,18,0,22,4
1713334945215,VIS 83,A00,490695,Kester; Grant,63,0,75,12
1713334946245,VIS 105D,A00,490696,Staff,22,0,25,3
1713334947271,VIS 124CN,A00,490699,Rose; Jordan M,65,0,75,10
1713334948295,VIS 125GS,A00,511221,Williams; Alena J,21,0,22,1
1713334949324,VIS 128D,A00,490700,Staff,73,0,75,2
1713334950353,VIS 151,A01,490717,Staff,33,0,34,1
1713334950353,VIS 151,A02,490766,Staff,33,0,34,1
1713334951378,VIS 154GS,A00,511972,Williams; Alena J,21,0,22,1
1713334952408,VIS 160A,A00,490767,Stone; Patricia,7,0,10,3
1713334953434,WCWP 10A,A00,490638,Staff,14,0,15,1
1713334953434,WCWP 10A,B00,490640,Staff,15,0,15,0
1713334954462,WCWP 10B,A00,490641,Staff,0,0,0,0
1713334954462,WCWP 10B,B00,490642,Staff,14,0,15,1
1713334954462,WCWP 10B,C00,490644,Staff,13,0,15,2
1713334954462,WCWP 10B,D00,490647,Staff,0,0,0,0
1713334955490,WCWP 100,A00,490655,Staff,0,0,0,0
1713334955490,WCWP 100,B00,490687,Staff,10,0,15,5
1713334957619,ANAR 153,A00,487222,Braswell; Geoffrey E.,53,0,60,7
1713334958645,ANBI 134,A00,487223,Staff,5,0,20,15
1713334959670,ANBI 143GS,A00,487224,Noel; Geoffroy Pierre Jean,18,0,24,6
1713334960697,ANBI 144GS,A00,519548,Noel; Geoffroy Pierre Jean,18,0,24,6
1713334961722,ANSC 101,A00,487225,Staff,18,0,20,2
1713334962748,ANSC 125,A00,487227,Brenner; Suzanne A,38,0,40,2
1713334964802,ANSC 146,A00,487229,Staff,35,0,40,5
1713334965829,ANSC 148,A00,487230,Olivas Hernandez; Olga Lid,39,0,40,1
1713334966864,ANSC 150,A00,504165,Sloane; Julia Kathryn,18,0,20,2
1713334967893,ANSC 180,A00,487232,Staff,14,0,15,1
1713334968920,ANSC 188,A00,627155,Staff,38,0,40,2
1713334969948,ANTH 5,A00,519529,Semendeferi; Ekaterini,15,0,15,0
1713334970974,ANTH 10,A00,487219,Staff,58,0,60,2
1713334972001,ANTH 23,A01,487221,Staff,17,0,20,3
1713334973027,ANTH 102,A00,487233,Wilder; Linnea Lorene,51,0,60,9
1713334974056,ANTH 103,A00,487234,Varma; Saiba,55,0,60,5
1713334975079,ANTH 105,A00,487235,Stewart; Alexander B,54,0,60,6
1713334976104,BENG 100,A01,516685,Taylor Amos; Alyssa C,26,0,30,4
1713334977129,BIBC 102,A01,491316,Flagg; Matthew Paul,8,0,88,80
1713334977129,BIBC 102,A02,491366,Flagg; Matthew Paul,78,0,88,10
1713334978156,BIBC 103,A01,491486,Boumechache; Miyyada,16,0,24,8
1713334978156,BIBC 103,A02,491487,Boumechache; Miyyada,24,0,24,0
1713334979181,BICD 100,A01,516882,Staff,73,0,75,2
1713334979181,BICD 100,A02,516890,Staff,69,0,75,6
1713334980207,BICD 102GS,A00,491488,Lo; Stanley M.,26,0,28,2
1713334981233,BIEB 136GS,A00,516940,Holway; David A. & Shurin; Jonathan,18,0,24,6
1713334982259,BIEB 137GS,A01,517034,Holway; David A. & Shurin; Jonathan,18,0,24,6
1713334983289,BIEB 138GS,A01,491492,Pirino; Giorgia,21,0,28,7
1713334984316,BILD 1,A01,491296,Staff,60,0,63,3
1713334984316,BILD 1,A02,491297,Staff,63,0,63,0
1713334985400,BILD 4,A01,517099,Gonzalez Gamboa; Ivonne,22,0,24,2
1713334985400,BILD 4,A02,517100,Gonzalez Gamboa; Ivonne,24,0,24,0
1713334986429,BILD 60GS,A00,491309,Lo; Stanley M.,26,0,28,2
1713334987462,BIMM 100,A01,517136,Staff,83,0,100,17
1713334988488,BIMM 110,A01,517182,Staff,54,0,100,46
1713334989515,BIMM 120,A01,517228,Pickett; Brooke Elizabeth,28,0,63,35
1713334989515,BIMM 120,A02,517240,Pickett; Brooke Elizabeth,44,0,63,19
1713334990546,BIMM 132GS,A01,491498,Pirino; Giorgia,21,0,28,7
1713334991572,BIMM 143,A01,491589,Bozinovic; Goran,12,0,40,28
1713334992656,BIPN 100,A01,491594,Armour; Jon Christopher,83,0,100,17
1713334993680,BIPN 140,A01,491602,Marino; Marc J,25,0,50,25
1713334995738,CAT 125,A00,515973,Staff,18,0,20,2
1713334996767,CAT 125GS,A00,515974,Rahimi; Babak,17,0,20,3
1713334997794,CAT 125R,A00,515980,Staff,12,0,20,8
1713334997794,CAT 125R,B00,515981,Tosun; Adriana,19,0,20,1
1713334997794,CAT 125R,C00,515987,Hyland; Tina Mae,0,3,20,20
1713334997794,CAT 125R,D00,515988,Bronstein; Phoebe Malan,16,0,20,4
1713334998819,CENG 15,A01,488699,Drews; Aaron,25,0,25,0
1713334999848,CENG 100,A00,505196,Opatkiewicz; Justin Paul,25,0,25,0
1713335000872,CGS 2A,A01,489598,Staff,33,0,35,2
1713335001897,CGS 112,A00,489599,Staff,15,0,15,0
1713335002922,CGS 119,A00,489603,Staff,10,0,10,0
1713335003947,CGS 120,A00,489604,Staff,13,0,15,2
1713335004976,CGS 150,A00,489607,Staff,15,0,15,0
1713335006003,CHEM 6A,A01,488715,Staff,97,0,100,3
1713335007029,CHEM 6B,A01,488719,Piercy; Marc Anthony,99,0,100,1
1713335008055,CHEM 6C,A01,488723,Albizati; Kim F.,93,0,100,7
1713335009080,CHEM 7L,A01,488728,Schurmeier; Kimberly,18,0,24,6
1713335009080,CHEM 7L,A02,488730,Schurmeier; Kimberly,23,0,24,1
1713335009080,CHEM 7L,A03,488734,Schurmeier; Kimberly,20,0,24,4
1713335009080,CHEM 7L,A04,488763,Schurmeier; Kimberly,23,0,24,1
1713335009080,CHEM 7L,B01,488798,Schurmeier; Kimberly,17,0,24,7
1713335009080,CHEM 7L,B02,488801,Schurmeier; Kimberly,22,0,24,2
1713335009080,CHEM 7L,B03,488808,Schurmeier; Kimberly,22,0,24,2
1713335009080,CHEM 7L,B04,488811,Schurmeier; Kimberly,24,0,24,0
1713335010105,CHEM 11,A01,488897,Stallings; Dontarie M,95,0,100,5
1713335011130,CHEM 40A,A01,488913,Albizati; Kim F.,83,0,100,17
1713335012155,CHEM 40B,A01,488920,Weizman; Haim,43,0,50,7
1713335012155,CHEM 40B,A02,488938,Weizman; Haim,44,0,50,6
1713335013182,CHEM 41A,A01,489029,Klosterman; Jeremy K,57,0,60,3
1713335014210,CHEM 41C,A01,500436,Tor; Yitzhak,55,0,60,5
1713335015238,CHEM 43A,A01,500426,Weizman; Haim,0,1,24,24
1713335015238,CHEM 43A,A02,500430,Weizman; Haim,6,0,24,18
1713335015238,CHEM 43A,B01,514041,Klosterman; Jeremy K,16,0,24,8
1713335015238,CHEM 43A,B02,514047,Klosterman; Jeremy K,23,0,24,1
1713335016262,CHEM 108,A01,489140,Jennings; Patricia A.,7,0,24,17
1713335016262,CHEM 108,A02,489142,Jennings; Patricia A.,14,0,24,10
1713335017288,CHEM 114A,A01,489147,Stallings; Dontarie M,66,0,100,34
1713335018318,CHIN 169A,A00,489171,Wang; Xiao,19,0,20,1
1713335020368,COGS 3,A01,518827,Boyle; Mary E. T.,25,0,40,15
1713335021391,COGS 11,A01,489175,Staff,27,0,30,3
1713335022420,COGS 14A,A01,518829,Staff,51,0,60,9
1713335023446,COGS 14B,A01,489177,Hoffman; Drew Ellen,62,0,75,13
1713335024476,COGS 100,A01,489181,Allen; Michael Gordon,62,0,75,13
1713335025505,COGS 101A,A01,489183,Staff,45,0,60,15
1713335026531,COGS 101B,A01,489185,Allen; Michael Gordon,8,0,30,22
1713335027560,COGS 101C,A01,526786,Staff,23,0,30,7
1713335029615,COGS 107A,A01,489189,Boyle; Mary E. T.,16,0,35,19
1713335030644,COGS 107B,A01,627144,Mooshagian; Eric Frederick,60,0,60,0
1713335031675,COGS 118A,A01,489191,Staff,0,46,40,40
1713335033806,COGS 171GS,A01,489194,Pineda; Jaime A,19,0,28,9
1713335034831,COGS 172,A01,489196,Staff,2,0,30,28
1713335035856,COGS 174GS,A01,489264,Pineda; Jaime A,19,0,28,9
1713335036883,COGS 180,A01,627150,Staff,28,0,30,2
1713335037907,COGS 186,A01,489274,Staff,0,2,30,30
1713335038936,COMM 10,A01,489276,Staff,23,0,25,2
1713335038936,COMM 10,A02,489303,Staff,23,0,25,2
1713335039964,COMM 100A,A01,489312,Staff,14,0,25,11
1713335039964,COMM 100A,A02,489313,Staff,24,0,25,1
1713335040993,COMM 106T,A00,512540,Staff,33,0,35,2
1713335042019,COMM 107,A00,489347,Staff,27,0,35,8
1713335043045,COMM 109P,A00,489358,Staff,31,0,35,4
1713335044069,COMM 132,A00,489361,McKenna; Denise,27,0,30,3
1713335045096,COMM 146,A00,489362,Halm; Gavin Patrick,26,0,30,4
1713335046122,COMM 190,A00,489363,Abuelhiga; Soraya Jill,17,0,23,6
1713335047154,CSE 8A,A50,489366,Staff,21,0,25,4
1713335047154,CSE 8A,A51,489367,Staff,24,0,25,1
1713335048180,CSE 11,A01,489398,Cao; Yingjun,72,0,100,28
1713335049207,CSE 12,A01,489487,Staff,43,0,50,7
1713335050235,CSE 20,A01,489497,Staff,48,0,50,2
1713335051261,CSE 21,A01,489517,Braun; Oliver,42,0,50,8
1713335052290,CSE 101,A01,489524,Braun; Oliver,0,32,50,50
1713335053315,CSE 105,A01,512594,Jones; Miles E,72,0,100,28
1713335053315,CSE 105,B01,512598,Jones; Miles E,52,0,100,48
1713335054341,CSE 140,A01,489538,Staff,41,0,50,9
1713335055366,CSE 141,A01,489550,Eldon; John,67,0,100,33
1713335056395,CSE 141L,A01,489571,Eldon; John,65,0,100,35
1713335057428,CSE 151A,A01,489583,Solares; Edwin A,140,0,200,60
1713335058460,CSE 175,A01,510886,Kumar; Rakesh,30,0,30,0
1713335059487,CSE 190,A00,516828,Dubnov; Shlomo,38,0,49,11
1713335060517,DOC 100D,A00,489667,Pass; Natalye Joann,19,0,25,6
1713335061547,DSC 10,A01,624268,Staff,72,0,75,3
1713335062575,DSC 20,A01,624476,Staff,50,0,50,0
1713335063603,DSC 40A,A01,624608,Staff,39,0,40,1
1713335064630,DSGN 1,A01,489179,Rill; Bryan,32,0,50,18
1713335065661,ECE 17,A01,490489,Sahay; Rajeev,18,0,30,12
1713335066687,ECE 65,A50,490492,Staff,11,0,20,9
1713335066687,ECE 65,A51,490493,Staff,18,0,20,2
1713335067713,ECON 1,A01,489715,Famulari; Melissa,67,0,70,3
1713335068740,ECON 2,A01,489717,Levkoff; Steven B.,67,0,70,3
1713335069765,ECON 3,A01,489948,Staff,70,0,70,0
1713335071824,ECON 5,A01,490103,Staff,27,0,30,3
1713335071824,ECON 5,B01,626281,Dai; Yinlin,45,0,45,0
1713335072860,ECON 100A,A01,490127,Famulari; Melissa,64,0,70,6
1713335073893,ECON 100B,A01,490129,Staff,64,0,70,6
1713335074920,ECON 109,A01,490187,Shishkin; Denis,27,0,35,8
1713335075946,ECON 110A,A01,490190,Levkoff; Steven B.,60,0,70,10
1713335076976,ECON 120A,A01,490245,Dai; Yinlin,60,0,70,10
1713335078002,ECON 120B,A01,490247,Nieto-Barthaburu; Augusto,40,0,70,30
1713335079029,ECON 120C,A01,490253,Sun; Yixiao,30,0,35,5
1713335079029,ECON 120C,B01,490255,Sun; Yixiao,34,0,35,1
1713335080055,ECON 129,A00,490256,Eckert; Fabian Paul,22,0,35,13
1713335081081,ECON 131,A00,490257,Nieto-Barthaburu; Augusto,0,6,35,35
1713335082113,ECON 138,A00,490258,Bharadwaj; Prashant,13,0,35,22
1713335082113,ECON 138,B00,490259,Bharadwaj; Prashant,15,0,35,20
1713335083145,ECON 159,A00,490260,Hendrickson; Gerald M.,0,9,0,0
1713335084177,ECON 178,A01,553995,Zhu; Ying,24,0,35,11
1713335085206,EDS 40,A01,512576,Black; Alison Michelle,20,0,20,0
1713335086231,EDS 107,A01,515848,Staff,30,0,30,0
1713335087255,EDS 110R,A01,490262,Staff,26,0,30,4
1713335088282,EDS 112,A01,490264,Chapman; Thandeka K,40,0,50,10
1713335089363,EDS 113,A00,490266,Staff,26,0,30,4
1713335090389,EDS 118,A00,490267,Warstadt; Melissa Fawn,18,0,30,12
1713335091415,EDS 124BR,A00,490268,Eguchi; Emi,4,0,25,21
1713335091415,EDS 124BR,B00,490269,Eguchi; Emi,23,0,25,2
1713335092441,EDS 126,A01,490271,Jones; Makeba,43,0,50,7
1713335093466,EDS 135,A01,490316,Staff,19,0,20,1
1713335094492,ENVR 142GS,A00,519514,Chang; Edmond Yi-Teh,26,0,28,2
1713335095518,ETHN 103,A00,490504,Staff,25,0,36,11
1713335096544,ETHN 103A,A00,490505,Man; Simeon S,4,0,9,5
1713335097569,ETHN 109,A00,490506,Staff,28,0,30,2
1713335098594,ETHN 118,A00,490507,Staff,35,0,36,1
1713335099622,ETHN 119,A00,490508,Staff,33,0,36,3
1713335100653,ETHN 121R,A00,490518,Choi; Esther Min,21,0,36,15
1713335101682,ETHN 127,A00,490528,Staff,14,0,15,1
1713335102707,ETHN 139,A00,490573,Staff,10,0,10,0
1713335103733,ETHN 150,A00,490575,Staff,15,0,15,0
1713335104759,GLBH 20,A00,491705,Elwardani; Nile Regina,38,0,40,2
1713335105787,GLBH 101,A00,491706,Staff,20,0,20,0
1713335106813,GLBH 111,A01,491708,Burgos; Jose L.,15,0,15,0
1713335107838,GLBH 146,A00,491709,Staff,9,0,20,11
1713335108865,GLBH 148,A00,491710,Olivas Hernandez; Olga Lid,11,0,20,9
1713335109893,GLBH 150,A00,491711,Sloane; Julia Kathryn,19,0,20,1
1713335110921,HIEA 131,A00,491760,Staff,28,0,32,4
1713335111946,HIEA 153,A00,491762,Staff,28,0,30,2
1713335112973,HIEU 124,A00,491811,Staff,26,0,32,6
1713335113998,HIEU 124GS,A00,491812,Markman; Kristina,27,0,28,1
1713335115028,HIEU 147,A00,491813,Staff,30,0,32,2
1713335116056,HIEU 149GS,A00,491816,Caldwell; Michael Alan,28,0,28,0
1713335117081,HILD 2C,A01,491713,Hendrickson; Gerald M.,26,0,30,4
1713335118107,HILD 7B,A01,491715,Kwak; Nancy,0,2,30,30
1713335119132,HILD 10,A01,491717,Staff,9,0,20,11
1713335120160,HILD 30GS,A00,491719,Edington; Claire Ellen,23,0,28,5
1713335121185,HINE 109,A00,491818,Shafir; Nir,27,0,32,5
1713335122208,HINE 128,A00,491821,Shafir; Nir,31,0,32,1
1713335123236,HISC 117,A00,491830,Staff,27,0,32,5
1713335124264,HIUS 103,A00,491834,Man; Simeon S,14,0,23,9
1713335125301,HIUS 108B,A00,491835,Staff,27,0,30,3
1713335126325,HIUS 141,A00,491836,Hendrickson; Gerald M.,28,0,32,4
1713335127352,HIUS 149,A00,491839,Staff,24,0,32,8
1713335128379,HUM 3,A01,512617,Crum; Matthew Stephen,42,0,50,8
1713335128379,HUM 3,A02,512618,Crum; Matthew Stephen,48,0,50,2
1713335129403,HUM 3GS,A00,512663,Markman; Kristina,0,0,0,1
1713335129403,HUM 3GS,B00,512664,Staff,0,0,0,0
1713335130429,HUM 4,A01,512620,West; Geoffrey Scott,25,0,50,25
1713335131465,HUM 4GS,A00,512666,Lyon; Antony J.,0,0,0,5
1713335132491,HUM 4R,A01,512625,Watkins; Eric,49,0,50,1
1713335133515,HUM 5,A01,512649,Zavodny; Tatiana Sophia,21,0,50,29
1713335133515,HUM 5,B01,512661,Zroka; Ryan Edward,48,0,50,2
1713335134542,INTL 190,A00,490577,Segui; Alan S,0,0,0,5
1713335135568,JAPN 20AR,A01,491267,Ross; Kayoko F,7,0,20,13
1713335136605,JAPN 180,A00,491285,Berman; Michael David,33,0,40,7
1713335137636,LATI 50,A01,502536,Kokinis; Troy Andreas,16,0,22,6
1713335137636,LATI 50,A02,502551,Kokinis; Troy Andreas,22,0,22,0
1713335137636,LATI 50,A03,502650,Kokinis; Troy Andreas,22,0,22,0
1713335137636,LATI 50,A04,502909,Kokinis; Troy Andreas,21,0,22,1
1713335138662,LATI 160,A01,502920,Kokinis; Troy Andreas,30,0,30,0
1713335139691,LIFR 1A,A00,490494,Van Moer; Vinciane G,17,0,20,3
1713335140722,LIFR 1AX,A00,490495,Van Moer; Vinciane G,17,0,20,3
1713335141751,LIFR 1B,A00,490496,Van Moer; Vinciane G,17,0,20,3
1713335142775,LIFR 1BX,A00,490497,Van Moer; Vinciane G,17,0,20,3
1713335143804,LIGN 8,A00,505198,McIntosh; Justin Daniel,134,0,150,16
1713335144829,LIGN 9GS,A00,491239,Lott; Margaret S.,18,0,20,2
1713335145855,LIGN 101,A01,505200,McIntosh; Justin Daniel,22,0,30,8
1713335146881,LIGN 120,A01,491244,Staff,22,0,30,8
1713335147909,LIGN 149GS,A00,491245,Lott; Margaret S.,18,0,20,2
1713335148935,LIGN 170,A00,491247,Staff,22,0,30,8
1713335149960,LISP 1D,A00,490498,Munoz Sanchez; Alicia,8,0,14,6
1713335149960,LISP 1D,B00,490499,Munoz Sanchez; Alicia,6,0,14,8
1713335149960,LISP 1D,C00,490500,Munoz Sanchez; Alicia,7,0,14,7
1713335149960,LISP 1D,D00,490501,Munoz Sanchez; Alicia,10,0,14,4
1713335150987,LISP 1DX,A00,490502,Munoz Sanchez; Alicia,13,0,28,15
1713335150987,LISP 1DX,B00,490503,Munoz Sanchez; Alicia,16,0,28,12
1713335153044,LTAM 110,A00,491847,Staff,22,0,25,3
1713335154072,LTCS 119,A00,491848,Staff,11,0,15,4
1713335155103,LTCS 130,A00,491849,Staff,24,0,25,1
1713335157155,LTEA 120C,A00,491852,Staff,32,0,40,8
1713335158182,LTEN 130GS,A00,491853,Lyon; Antony J.,23,0,28,5
1713335159213,LTEN 148,A00,491855,Staff,23,0,25,2
1713335160239,LTEN 159,A00,491856,Staff,20,0,25,5
1713335161264,LTEN 180,A00,491857,Staff,8,0,15,7
1713335163320,LTSP 123GS,A00,505928,Bessett; Ryan Matthew,24,0,28,4
1713335164350,LTSP 174GS,A00,506037,Bessett; Ryan Matthew,24,0,28,4
1713335166404,LTWR 102,A00,491861,Staff,9,0,15,6
1713335167428,LTWR 106,A00,491862,Staff,8,0,15,7
1713335168459,MAE 11,A00,490930,Bahadori; Mohammad Yousef,95,0,100,5
1713335169488,MAE 30A,A00,490931,Qi; Huihui,37,0,40,3
1713335170517,MAE 101A,A00,491036,Sadeghizadeh; Zahra,92,0,100,8
1713335171544,MAE 101C,A00,491037,Seshadri; Kalyanasundaram,64,0,100,36
1713335172570,MAE 113,A00,491040,Seshadri; Kalyanasundaram,65,0,80,15
1713335173595,MAE 131A,A00,491041,Ghazinejad; Maziar,37,0,40,3
1713335174620,MAE 142,A00,491053,Staff,39,0,40,1
1713335175650,MAE 143A,A00,491054,Staff,31,0,50,19
1713335176685,MAE 150,A00,491092,Truong; Phuong Thi Ngoc,23,0,35,12
1713335177710,MATH 3C,A01,494031,Pardo Guerra; Sebastian,30,0,30,0
1713335177710,MATH 3C,A02,494032,Pardo Guerra; Sebastian,29,0,30,1
1713335178739,MATH 10A,A01,494034,Staff,27,0,30,3
1713335178739,MATH 10A,A02,494035,Staff,28,0,30,2
1713335178739,MATH 10A,B01,494037,Staff,27,0,30,3
1713335178739,MATH 10A,B02,494038,Staff,29,0,30,1
1713335179767,MATH 10B,A01,494040,Habib; Yousaf,22,0,30,8
1713335179767,MATH 10B,A02,494041,Habib; Yousaf,28,0,30,2
1713335179767,MATH 10B,A03,494042,Habib; Yousaf,29,0,30,1
1713335179767,MATH 10B,A04,494043,Habib; Yousaf,30,0,30,0
1713335179767,MATH 10B,B01,494045,Habib; Yousaf,25,0,30,5
1713335179767,MATH 10B,B02,494046,Habib; Yousaf,30,0,30,0
1713335179767,MATH 10B,B03,494047,Habib; Yousaf,30,0,30,0
1713335179767,MATH 10B,B04,494048,Habib; Yousaf,30,0,30,0
1713335180796,MATH 18,A01,494050,Kemp; Todd Aahron,25,0,30,5
1713335180796,MATH 18,A02,494051,Kemp; Todd Aahron,29,0,30,1
1713335180796,MATH 18,B01,494054,Kemp; Todd Aahron,25,0,30,5
1713335180796,MATH 18,B02,494055,Kemp; Todd Aahron,29,0,30,1
1713335181822,MATH 20A,A01,494059,Suk; Andrew Hoon,30,0,30,0
1713335182850,MATH 20B,A01,494061,Briones; Jor-el Thomas Caparas,33,0,35,2
1713335182850,MATH 20B,B01,494063,Bach; Quang Tran,34,0,35,1
1713335183883,MATH 20C,A01,494065,Staff,28,0,30,2
1713335183883,MATH 20C,A02,494066,Staff,30,0,30,0
1713335183883,MATH 20C,A03,494067,Staff,30,0,30,0
1713335183883,MATH 20C,A04,494068,Staff,30,0,30,0
1713335183883,MATH 20C,B01,494070,Zhang; Ming,25,0,30,5
1713335183883,MATH 20C,B02,494071,Zhang; Ming,27,0,30,3
1713335183883,MATH 20C,B03,494072,Zhang; Ming,29,0,30,1
1713335183883,MATH 20C,B04,494073,Zhang; Ming,29,0,30,1
1713335184913,MATH 20D,A01,494075,Staff,22,0,30,8
1713335184913,MATH 20D,A02,494076,Staff,29,0,30,1
1713335185944,MATH 20E,A01,494079,Staff,24,0,30,6
1713335185944,MATH 20E,A02,494080,Staff,26,0,30,4
1713335185944,MATH 20E,B01,494082,Staff,25,0,30,5
1713335185944,MATH 20E,B02,494083,Staff,25,0,30,5
1713335186975,MATH 103A,A01,494085,Aliabadi Sr.; Mohsen,13,0,30,17
1713335186975,MATH 103A,A02,494086,Aliabadi Sr.; Mohsen,28,0,30,2
1713335186975,MATH 103A,B01,494088,Aliabadi Sr.; Mohsen,21,0,30,9
1713335186975,MATH 103A,B02,494089,Aliabadi Sr.; Mohsen,27,0,30,3
1713335187999,MATH 109,A01,494091,Staff,30,0,30,0
1713335187999,MATH 109,A02,494092,Staff,29,0,30,1
1713335187999,MATH 109,B01,494094,Staff,27,0,30,3
1713335187999,MATH 109,B02,494095,Staff,29,0,30,1
1713335189060,MATH 142A,A01,494097,Chow; Bennett,14,0,30,16
1713335189060,MATH 142A,A02,494098,Chow; Bennett,23,0,30,7
1713335189060,MATH 142A,B01,494100,Chow; Bennett,19,0,30,11
1713335189060,MATH 142A,B02,494101,Chow; Bennett,29,0,30,1
1713335191177,MATH 168A,A01,516677,Dumitriu; Ioana,16,0,35,19
1713335192202,MATH 170A,A01,516679,Dumitriu; Ioana,18,0,30,12
1713335192202,MATH 170A,A02,516680,Dumitriu; Ioana,28,0,30,2
1713335193281,MATH 193A,A01,494107,Staff,13,0,30,17
1713335193281,MATH 193A,A02,494108,Staff,19,0,30,11
1713335193281,MATH 193A,A03,494109,Staff,29,0,30,1
1713335193281,MATH 193A,A04,494110,Staff,22,0,30,8
1713335196434,MGT 16,A00,491930,McKay; Michael J,92,0,98,6
1713335197464,MGT 18,A00,491992,McKay; Michael J,96,0,98,2
1713335198493,MGT 71,A00,492003,Staff,63,0,98,35
1713335199566,MGT 103,A00,505209,Eberhard; Craig A,81,0,98,17
1713335200592,MGT 131A,A00,505210,Anderson; John Charles,89,0,98,9
1713335202642,MGT 153,A00,492077,Perols; Johan Lars,17,0,90,73
1713335205716,MGT 164,A00,492222,McKay; Mary A,91,0,98,7
1713335206742,MGT 172,A00,492245,Staff,59,0,60,1
1713335206742,MGT 172,B00,505526,Hedges; Kathleen,65,0,98,33
1713335207768,MGT 181,A00,505669,Dunn; Louis Jean,80,0,98,18
1713335208799,MMW 14,A01,494399,Staff,15,0,28,13
1713335208799,MMW 14,A02,494400,Staff,25,0,28,3
1713335208799,MMW 14,A03,494401,Staff,28,0,28,0
1713335208799,MMW 14,A04,494402,Staff,28,0,28,0
1713335208799,MMW 14,B01,494404,Carreras; Maria Victoria,8,0,28,20
1713335208799,MMW 14,B02,494405,Carreras; Maria Victoria,25,0,28,3
1713335208799,MMW 14,B03,494406,Carreras; Maria Victoria,27,0,28,1
1713335208799,MMW 14,B04,494407,Carreras; Maria Victoria,28,0,28,0
1713335209824,MMW 14GS,A00,506250,Chang; Edmond Yi-Teh,0,0,0,0
1713335210850,MMW 121R,A01,494415,Adamiak; Patrick John,10,0,28,18
1713335210850,MMW 121R,A02,494416,Adamiak; Patrick John,24,0,28,4
1713335211877,MUS 1A,A01,494113,Staff,12,0,25,13
1713335211877,MUS 1A,A02,494114,Staff,24,0,25,1
1713335212906,MUS 4,A01,494116,Staff,23,0,25,2
1713335212906,MUS 4,A02,494117,Staff,22,0,25,3
1713335213933,MUS 5R,A01,494236,Dubnov; Shlomo,6,0,25,19
1713335213933,MUS 5R,A02,494237,Dubnov; Shlomo,25,0,25,0
1713335214961,MUS 6,A01,494122,Staff,9,0,25,16
1713335214961,MUS 6,A02,494123,Staff,23,0,25,2
1713335215986,MUS 7,A01,494125,Staff,16,0,25,9
1713335215986,MUS 7,A02,494126,Staff,24,0,25,1
1713335217012,MUS 11,A01,494128,Staff,23,0,25,2
1713335217012,MUS 11,A02,494129,Staff,24,0,25,1
1713335218036,MUS 13,A01,494131,Staff,25,0,25,0
1713335218036,MUS 13,A02,494132,Staff,25,0,25,0
1713335219067,MUS 15,A01,494134,Staff,16,0,25,9
1713335219067,MUS 15,A02,494135,Staff,25,0,25,0
1713335219067,MUS 15,B01,494137,Staff,24,0,25,1
1713335220091,MUS 80,A00,494232,Staff,24,0,25,1
1713335220091,MUS 80,B00,494233,Staff,25,0,25,0
1713335220091,MUS 80,C00,494234,Staff,23,0,25,2
1713335221117,MUS 95C,A00,494141,Staff,70,0,75,5
1713335222146,MUS 114,A00,494142,Staff,40,0,50,10
1713335223172,NANO 15,A01,490636,Drews; Aaron,7,0,7,0
1713335224203,PHIL 1,A00,490578,Grush; Rick Scott,49,0,50,1
1713335225229,PHIL 10,A01,490580,Grush; Rick Scott,33,0,35,2
1713335225229,PHIL 10,A02,490586,Grush; Rick Scott,32,0,35,3
1713335226259,PHIL 27,A01,490591,Staff,22,0,25,3
1713335226259,PHIL 27,A02,490592,Staff,25,0,25,0
1713335226259,PHIL 27,A03,490593,Staff,25,0,25,0
1713335226259,PHIL 27,A04,490598,Staff,25,0,25,0
1713335227287,PHIL 32,A01,490611,Staff,20,0,20,0
1713335227287,PHIL 32,A02,490618,Staff,20,0,20,0
1713335228315,PHIL 90,A00,490624,Staff,40,0,40,0
1713335229340,PHIL 136,A00,490627,Cohen; Jonathan David,37,0,40,3
1713335230375,PHIL 155,A00,490634,Staff,62,0,70,8
1713335231402,PHYS 1A,A00,491610,Staff,245,0,250,5
1713335232426,PHYS 1AL,001,491616,Tsai; Philbert S,27,0,30,3
1713335232426,PHYS 1AL,002,491618,Tsai; Philbert S,30,0,30,0
1713335233454,PHYS 1B,A00,491623,Staff,236,0,250,14
1713335234479,PHYS 1BL,001,491626,Tsai; Philbert S,21,0,30,9
1713335234479,PHYS 1BL,002,491628,Tsai; Philbert S,26,0,30,4
1713335235505,PHYS 1C,A00,491632,Staff,213,0,245,32
1713335236533,PHYS 1CL,001,491635,Tsai; Philbert S,3,0,30,27
1713335236533,PHYS 1CL,002,491643,Tsai; Philbert S,22,0,30,8
1713335237564,PHYS 2AR,A01,491651,Meyertholen; Andrew D.,44,0,50,6
1713335238588,PHYS 2B,A01,491659,Staff,106,0,115,9
1713335239614,PHYS 2BL,A01,491685,Staff,21,0,24,3
1713335239614,PHYS 2BL,A02,491700,Staff,21,0,24,3
1713335240643,PHYS 2C,A01,505161,Staff,101,0,115,14
1713335241669,PHYS 4A,A01,491704,Grinstein; Benjamin,99,0,100,1
1713335242699,POLI 5D,A01,494144,Staff,3,0,5,2
1713335242699,POLI 5D,B01,626283,Dai; Yinlin,5,0,5,0
1713335243727,POLI 12,A00,494145,Staff,43,0,45,2
1713335244754,POLI 13R,A00,494146,Forman; Fonna,45,0,50,5
1713335245781,POLI 27,A01,494148,Staff,54,0,60,6
1713335246809,POLI 30,A00,494149,Staff,49,0,50,1
1713335247835,POLI 100DA,A00,494150,Staff,20,0,25,5
1713335249888,POLI 100I,A00,494152,Staff,27,0,30,3
1713335250919,POLI 104B,A00,494153,Smith; Glenn Chatmas,53,0,55,2
1713335251947,POLI 104F,A00,494154,Staff,28,0,30,2
1713335252974,POLI 104I,A00,494155,Smith; Glenn Chatmas,29,0,30,1
1713335254007,POLI 110C,A00,494156,Ingham; Sean,23,0,25,2
1713335255035,POLI 117R,A00,494157,Forman; Fonna,5,0,20,15
1713335256061,POLI 118,A00,494158,Ingham; Sean,21,0,25,4
1713335257087,POLI 120H,A00,494159,Fisk; David Lee,39,0,45,6
1713335258111,POLI 131CR,A00,494160,Hoston; Germaine,34,0,45,11
1713335259142,POLI 133J,A00,494161,Staff,31,0,35,4
1713335260167,POLI 135,A00,494162,Fisk; David Lee,33,0,35,2
1713335261202,POLI 140A,A00,494164,Staff,18,0,30,12
1713335262227,POLI 142I,A00,494165,Staff,30,0,30,0
1713335263254,POLI 144D,A00,494166,Staff,23,0,25,2
1713335264279,POLI 151,A00,494167,Staff,30,0,30,0
1713335265304,POLI 153,A00,494168,Staff,33,0,35,2
1713335266329,POLI 160AA,A00,494169,Staff,34,0,40,6
1713335267360,POLI 162,A00,494170,Mignozzetti; Umberto,18,0,25,7
1713335268384,POLI 171,A00,494171,Mignozzetti; Umberto,18,0,25,7
1713335269413,PSYC 1,A00,494172,Staff,95,0,100,5
1713335270443,PSYC 2,A00,494173,Moranton; Nirelia Melbina-,34,0,50,16
1713335271468,PSYC 3,A00,494174,Staff,29,0,30,1
1713335272494,PSYC 6,A00,494175,Staff,17,0,20,3
1713335273524,PSYC 60,A01,494177,Staff,37,0,45,8
1713335274549,PSYC 70,A01,505724,Geller; Emma Harlan,42,0,45,3
1713335275574,PSYC 101,A00,494180,Heyman; Gail D.,84,0,100,16
1713335276600,PSYC 105,A00,494181,Geller; Emma Harlan,51,0,90,39
1713335277629,PSYC 106,A00,494182,Dobkins; Karen R.,26,0,45,19
1713335278653,PSYC 108,A00,494183,Adrian; Julia Anna,89,0,100,11
1713335279680,PSYC 114,A01,494185,Winkielman; Piotr,0,3,30,30
1713335280708,PSYC 122,A00,494186,Moranton; Nirelia Melbina-,27,0,50,23
1713335281735,PSYC 124,A00,494187,Chapman; Eddie Nathaniel,70,0,80,10
1713335282769,PSYC 131,A00,494188,Anagnostaras; Stephan,40,0,80,40
1713335283800,PSYC 144,A00,494189,Staff,1,0,50,49
1713335284826,PSYC 154,A00,494190,Lacefield; Katharine I,106,0,180,74
1713335285854,PSYC 162,A00,494191,Wixted; John T,71,0,100,29
1713335286884,PSYC 172,A00,494192,Gorman; Michael R.,36,0,45,9
1713335287909,PSYC 178,A00,494193,Glaser; Dale,34,0,45,11
1713335288936,PSYC 193,A00,505725,Chapman; Eddie Nathaniel,20,0,20,0
1713335289960,RELI 145GS,A00,519817,Rahimi; Babak,18,0,20,2
1713335290995,SE 101A,A01,490862,Chadha; Mayank,23,0,25,2
1713335292022,SE 101C,A01,490924,Krysl; Petr,15,0,20,5
1713335293048,SE 110A,A01,490928,Staff,19,0,20,1
1713335294082,SE 130A,A00,490929,Morrison; Machel Leigh,54,0,70,16
1713335295107,SIO 1,A01,519325,Staff,39,0,40,1
1713335296133,SIO 30,A01,519327,Staff,38,0,40,2
1713335297214,SIO 40,A00,519328,Staff,39,0,40,1
1713335298237,SIO 46GS,A00,519819,Cook; Geoffrey W,17,0,25,8
1713335299265,SIO 109R,A00,494197,Forman; Fonna,0,3,20,20
1713335300293,SIO 121GS,A00,519827,Cook; Geoffrey W,17,0,25,8
1713335301318,SIO 132,A01,519330,Staff,38,0,40,2
1713335302343,SIO 133,A01,519397,Staff,37,0,40,3
1713335303375,SIO 139,A00,519396,Kacev; David,29,0,40,11
1713335304406,SOCI 1,A01,494199,Thorpe; Charles Robert,21,0,30,9
1713335304406,SOCI 1,A02,494200,Thorpe; Charles Robert,30,0,30,0
1713335304406,SOCI 1,A03,494201,Thorpe; Charles Robert,29,0,30,1
1713335304406,SOCI 1,A04,494202,Thorpe; Charles Robert,29,0,30,1
1713335304406,SOCI 1,A05,494203,Thorpe; Charles Robert,29,0,30,1
1713335304406,SOCI 1,A06,494204,Thorpe; Charles Robert,30,0,30,0
1713335304406,SOCI 1,A07,494205,Thorpe; Charles Robert,28,0,30,2
1713335305432,SOCI 60,A01,494207,Staff,34,0,40,6
1713335305432,SOCI 60,A02,494208,Staff,39,0,40,1
1713335306463,SOCI 100,A01,494210,Payne; Christine Anna,25,0,30,5
1713335306463,SOCI 100,A02,494211,Payne; Christine Anna,26,0,30,4
1713335307487,SOCI 109M,A00,494212,Staff,20,0,20,0
1713335308517,SOCI 110,A00,494213,Staff,34,0,40,6
1713335310567,SOCI 118E,A00,494215,Ng; Kwai,37,0,40,3
1713335311590,SOCI 125,A00,494216,Calderon-Zaks; Michael Aar,40,0,45,5
1713335312616,SOCI 126,A01,494218,Jones; Makeba,3,0,5,2
1713335313644,SOCI 131,A00,494219,Thorpe; Charles Robert,26,0,30,4
1713335315694,SOCI 135,A00,494221,Payne; Christine Anna,28,0,50,22
1713335316725,SOCI 136E,A00,626690,Ruiz; Jonathan Joseph,24,0,25,1
1713335317751,SOCI 138GS,A00,494222,Navon; Daniel,23,0,28,5
1713335319803,SOCI 145,A00,494224,Staff,40,0,45,5
1713335320831,SOCI 153,A00,494225,Staff,28,0,30,2
1713335321857,SOCI 160E,A00,494226,Ng; Kwai,28,0,40,12
1713335322880,SOCI 180,A00,494227,Staff,29,0,30,1
1713335323909,SOCI 189GS,A00,494228,Ribas Norris; Janet Vanesa,11,0,11,0
1713335324934,SOCI 190GS,A00,553232,Ribas Norris; Janet Vanesa,11,0,11,0
1713335325960,SOMI 220,A00,627178,Schneid; Stephen David,30,0,30,0
1713335326992,SYN 2,001,490768,Staff,13,0,15,2
1713335326992,SYN 2,002,490769,Staff,14,0,15,1
1713335326992,SYN 2,004,490775,Staff,0,0,0,0
1713335326992,SYN 2,003,490774,Staff,0,0,0,0
1713335326992,SYN 2,005,490776,Staff,0,0,0,0
1713335328016,SYN 2R,001,490779,Staff,11,0,15,4
1713335328016,SYN 2R,002,514635,Staff,14,0,15,1
1713335329047,SYN 100,A01,490783,Staff,9,0,20,11
1713335329047,SYN 100,B01,490787,Staff,9,0,20,11
1713335329047,SYN 100,C01,490789,Staff,10,0,20,10
1713335330072,SYN 150,A00,490817,Staff,14,0,15,1
1713335330072,SYN 150,B00,514610,Staff,15,0,15,0
1713335331102,TDAC 1,A00,492753,Walsh; Kim C.,19,0,20,1
1713335331102,TDAC 1,B00,492754,Harting; Carla Kelso,19,0,20,1
1713335331102,TDAC 1,C00,513995,Salovey; Todd,15,0,20,5
1713335332133,TDAC 101,A00,492766,Harting; Carla Kelso,17,0,20,3
1713335333164,TDAC 102,A00,492768,Basso; Beatrice,19,0,20,1
1713335334190,TDDE 111,A00,492769,Staff,25,0,25,0
1713335335220,TDDE 131,A00,492770,Staff,15,0,15,0
1713335335220,TDDE 131,B00,492771,Staff,15,0,15,0
1713335336246,TDDE 131GS,A00,523716,Guirguis; Mark C,23,0,28,5
1713335337273,TDGE 1,A01,492756,Salovey; Todd,56,0,60,4
1713335338300,TDGE 5,A01,492758,Staff,23,0,25,2
1713335339326,TDGE 10,A00,492759,Fulton; Julia,203,0,220,17
1713335340352,TDGE 11,A00,492760,Castro; Robert Jess,198,0,200,2
1713335342408,TDGE 124,A00,492772,Fulton; Julia,182,0,220,38
1713335343440,TDGE 125,A00,492773,Meyer; Ursula,38,0,50,12
1713335343440,TDGE 125,B00,492774,Staff,49,0,50,1
1713335343440,TDGE 125,C00,523565,Staff,48,0,50,2
1713335344469,TDGE 125GS,A00,523580,Guirguis; Mark C,23,0,28,5
1713335345499,TDGE 127,A00,492775,Havis; Allan,32,0,50,18
1713335346525,TDHT 101,A00,492776,Staff,34,0,35,1
1713335347551,TDMV 1,A00,492762,Caligagan; Maria T.,29,0,30,1
1713335347551,TDMV 1,B00,492763,Arcidiacono; Kristin,26,0,30,4
1713335348576,TDMV 2,A00,492764,Weinberg; Sadie,28,0,30,2
1713335349602,TDMV 3,A00,492765,Mack; Kara Shanai',37,0,40,3
1713335350630,TDMV 138,A00,492777,Mack; Kara Shanai',33,0,40,7
1713335351655,TDMV 140,A00,492778,Lima; Paulo Henrique,40,0,40,0
1713335352688,TDMV 142,A00,492779,Caligagan; Maria T.,33,0,40,7
1713335352688,TDMV 142,B00,492780,Caligagan; Tony,37,0,40,3
1713335353712,TDMV 143,A00,492781,Fyall; Daunte Edward,39,0,40,1
1713335354737,USP 1,A01,492401,Kwak; Nancy,27,0,35,8
1713335355768,USP 2,A01,492453,Hinds; Juli Beth,35,0,35,0
1713335356800,USP 3,A01,492516,Staff,28,0,35,7
1713335357826,USP 4,A00,492522,McTague; Sarah,16,0,25,9
1713335358852,USP 100,A00,492523,Staff,32,0,35,3
1713335359882,USP 101,A00,492524,Staff,13,0,15,2
1713335361032,USP 105,A00,492525,Staff,21,0,25,4
1713335362057,USP 151,A00,492526,Shenkman; Michael Thomas,32,0,35,3
1713335363088,USP 170,A00,492545,Hinds; Juli Beth,33,0,35,2
1713335364113,USP 171GS,A00,492608,Bussell; Mirle Rabinowitz,24,0,28,4
1713335365137,USP 183GS,A00,492613,Peerson; Susan,24,0,28,4
1713335366162,VIS 30,A01,490693,Yoldas; Pinar,19,0,22,3
1713335366162,VIS 30,A02,490694,Yoldas; Pinar,18,0,22,4
1713335367188,VIS 83,A00,490695,Kester; Grant,63,0,75,12
1713335368217,VIS 105D,A00,490696,Staff,22,0,25,3
1713335369243,VIS 124CN,A00,490699,Rose; Jordan M,65,0,75,10
1713335370267,VIS 125GS,A00,511221,Williams; Alena J,21,0,22,1
1713335371294,VIS 128D,A00,490700,Staff,73,0,75,2
1713335372322,VIS 151,A01,490717,Staff,33,0,34,1
1713335372322,VIS 151,A02,490766,Staff,33,0,34,1
1713335373349,VIS 154GS,A00,511972,Williams; Alena J,21,0,22,1
1713335374375,VIS 160A,A00,490767,Stone; Patricia,7,0,10,3
1713335375400,WCWP 10A,A00,490638,Staff,14,0,15,1
1713335375400,WCWP 10A,B00,490640,Staff,15,0,15,0
1713335376428,WCWP 10B,A00,490641,Staff,0,0,0,0
1713335376428,WCWP 10B,B00,490642,Staff,14,0,15,1
1713335376428,WCWP 10B,C00,490644,Staff,13,0,15,2
1713335376428,WCWP 10B,D00,490647,Staff,0,0,0,0
1713335377456,WCWP 100,A00,490655,Staff,0,0,0,0
1713335377456,WCWP 100,B00,490687,Staff,10,0,15,5
1713335379554,ANAR 153,A00,487222,Braswell; Geoffrey E.,53,0,60,7
1713335380579,ANBI 134,A00,487223,Staff,5,0,20,15
1713335381609,ANBI 143GS,A00,487224,Noel; Geoffroy Pierre Jean,18,0,24,6
1713335382633,ANBI 144GS,A00,519548,Noel; Geoffroy Pierre Jean,18,0,24,6
1713335383658,ANSC 101,A00,487225,Staff,18,0,20,2
1713335384687,ANSC 125,A00,487227,Brenner; Suzanne A,38,0,40,2
1713335386739,ANSC 146,A00,487229,Staff,35,0,40,5
1713335387769,ANSC 148,A00,487230,Olivas Hernandez; Olga Lid,39,0,40,1
1713335388804,ANSC 150,A00,504165,Sloane; Julia Kathryn,18,0,20,2
1713335389831,ANSC 180,A00,487232,Staff,14,0,15,1
1713335390857,ANSC 188,A00,627155,Staff,38,0,40,2
1713335391889,ANTH 5,A00,519529,Semendeferi; Ekaterini,15,0,15,0
1713335392914,ANTH 10,A00,487219,Staff,58,0,60,2
1713335393942,ANTH 23,A01,487221,Staff,17,0,20,3
1713335394968,ANTH 102,A00,487233,Wilder; Linnea Lorene,51,0,60,9
1713335396000,ANTH 103,A00,487234,Varma; Saiba,55,0,60,5
1713335397032,ANTH 105,A00,487235,Stewart; Alexander B,54,0,60,6
1713335398062,BENG 100,A01,516685,Taylor Amos; Alyssa C,26,0,30,4
1713335399088,BIBC 102,A01,491316,Flagg; Matthew Paul,8,0,88,80
1713335399088,BIBC 102,A02,491366,Flagg; Matthew Paul,78,0,88,10
1713335400115,BIBC 103,A01,491486,Boumechache; Miyyada,16,0,24,8
1713335400115,BIBC 103,A02,491487,Boumechache; Miyyada,24,0,24,0
1713335401196,BICD 100,A01,516882,Staff,73,0,75,2
1713335401196,BICD 100,A02,516890,Staff,69,0,75,6
1713335402220,BICD 102GS,A00,491488,Lo; Stanley M.,26,0,28,2
1713335403252,BIEB 136GS,A00,516940,Holway; David A. & Shurin; Jonathan,18,0,24,6
1713335404277,BIEB 137GS,A01,517034,Holway; David A. & Shurin; Jonathan,18,0,24,6
1713335405303,BIEB 138GS,A01,491492,Pirino; Giorgia,21,0,28,7
1713335406327,BILD 1,A01,491296,Staff,60,0,63,3
1713335406327,BILD 1,A02,491297,Staff,63,0,63,0
1713335407353,BILD 4,A01,517099,Gonzalez Gamboa; Ivonne,22,0,24,2
1713335407353,BILD 4,A02,517100,Gonzalez Gamboa; Ivonne,24,0,24,0
1713335408379,BILD 60GS,A00,491309,Lo; Stanley M.,26,0,28,2
1713335409403,BIMM 100,A01,517136,Staff,83,0,100,17
1713335410429,BIMM 110,A01,517182,Staff,54,0,100,46
1713335411456,BIMM 120,A01,517228,Pickett; Brooke Elizabeth,28,0,63,35
1713335411456,BIMM 120,A02,517240,Pickett; Brooke Elizabeth,44,0,63,19
1713335412484,BIMM 132GS,A01,491498,Pirino; Giorgia,21,0,28,7
1713335413518,BIMM 143,A01,491589,Bozinovic; Goran,12,0,40,28
1713335414552,BIPN 100,A01,491594,Armour; Jon Christopher,83,0,100,17
1713335415583,BIPN 140,A01,491602,Marino; Marc J,24,0,50,26
1713335417638,CAT 125,A00,515973,Staff,18,0,20,2
1713335418662,CAT 125GS,A00,515974,Rahimi; Babak,16,0,20,4
1713335419697,CAT 125R,A00,515980,Staff,12,0,20,8
1713335419697,CAT 125R,B00,515981,Tosun; Adriana,19,0,20,1
1713335419697,CAT 125R,C00,515987,Hyland; Tina Mae,0,3,20,20
1713335419697,CAT 125R,D00,515988,Bronstein; Phoebe Malan,16,0,20,4
1713335420731,CENG 15,A01,488699,Drews; Aaron,25,0,25,0
1713335421759,CENG 100,A00,505196,Opatkiewicz; Justin Paul,25,0,25,0
1713335422783,CGS 2A,A01,489598,Staff,33,0,35,2
1713335423810,CGS 112,A00,489599,Staff,15,0,15,0
1713335424838,CGS 119,A00,489603,Staff,10,0,10,0
1713335425864,CGS 120,A00,489604,Staff,13,0,15,2
1713335426894,CGS 150,A00,489607,Staff,15,0,15,0
1713335427918,CHEM 6A,A01,488715,Staff,97,0,100,3
1713335428945,CHEM 6B,A01,488719,Piercy; Marc Anthony,99,0,100,1
1713335429972,CHEM 6C,A01,488723,Albizati; Kim F.,93,0,100,7
1713335431008,CHEM 7L,A01,488728,Schurmeier; Kimberly,18,0,24,6
1713335431008,CHEM 7L,A02,488730,Schurmeier; Kimberly,23,0,24,1
1713335431008,CHEM 7L,A03,488734,Schurmeier; Kimberly,20,0,24,4
1713335431008,CHEM 7L,A04,488763,Schurmeier; Kimberly,23,0,24,1
1713335431008,CHEM 7L,B01,488798,Schurmeier; Kimberly,17,0,24,7
1713335431008,CHEM 7L,B02,488801,Schurmeier; Kimberly,22,0,24,2
1713335431008,CHEM 7L,B03,488808,Schurmeier; Kimberly,22,0,24,2
1713335431008,CHEM 7L,B04,488811,Schurmeier; Kimberly,24,0,24,0
1713335432038,CHEM 11,A01,488897,Stallings; Dontarie M,95,0,100,5
1713335433063,CHEM 40A,A01,488913,Albizati; Kim F.,83,0,100,17
1713335434088,CHEM 40B,A01,488920,Weizman; Haim,43,0,50,7
1713335434088,CHEM 40B,A02,488938,Weizman; Haim,44,0,50,6
1713335435118,CHEM 41A,A01,489029,Klosterman; Jeremy K,57,0,60,3
1713335436143,CHEM 41C,A01,500436,Tor; Yitzhak,55,0,60,5
1713335437181,CHEM 43A,A01,500426,Weizman; Haim,0,1,24,24
1713335437181,CHEM 43A,A02,500430,Weizman; Haim,6,0,24,18
1713335437181,CHEM 43A,B01,514041,Klosterman; Jeremy K,16,0,24,8
1713335437181,CHEM 43A,B02,514047,Klosterman; Jeremy K,23,0,24,1
1713335438209,CHEM 108,A01,489140,Jennings; Patricia A.,7,0,24,17
1713335438209,CHEM 108,A02,489142,Jennings; Patricia A.,14,0,24,10
1713335439235,CHEM 114A,A01,489147,Stallings; Dontarie M,66,0,100,34
1713335440261,CHIN 169A,A00,489171,Wang; Xiao,19,0,20,1
1713335442314,COGS 3,A01,518827,Boyle; Mary E. T.,25,0,40,15
1713335443339,COGS 11,A01,489175,Staff,27,0,30,3
1713335444365,COGS 14A,A01,518829,Staff,51,0,60,9
1713335445400,COGS 14B,A01,489177,Hoffman; Drew Ellen,62,0,75,13
1713335446427,COGS 100,A01,489181,Allen; Michael Gordon,62,0,75,13
1713335447453,COGS 101A,A01,489183,Staff,45,0,60,15
1713335448478,COGS 101B,A01,489185,Allen; Michael Gordon,8,0,30,22
1713335449509,COGS 101C,A01,526786,Staff,23,0,30,7
1713335451562,COGS 107A,A01,489189,Boyle; Mary E. T.,16,0,35,19
1713335452589,COGS 107B,A01,627144,Mooshagian; Eric Frederick,60,0,60,0
1713335453613,COGS 118A,A01,489191,Staff,0,46,40,40
1713335455670,COGS 171GS,A01,489194,Pineda; Jaime A,19,0,28,9
1713335456700,COGS 172,A01,489196,Staff,2,0,30,28
1713335457725,COGS 174GS,A01,489264,Pineda; Jaime A,19,0,28,9
1713335458752,COGS 180,A01,627150,Staff,28,0,30,2
1713335459778,COGS 186,A01,489274,Staff,0,2,30,30
1713335460803,COMM 10,A01,489276,Staff,23,0,25,2
1713335460803,COMM 10,A02,489303,Staff,23,0,25,2
1713335461830,COMM 100A,A01,489312,Staff,14,0,25,11
1713335461830,COMM 100A,A02,489313,Staff,24,0,25,1
1713335462855,COMM 106T,A00,512540,Staff,33,0,35,2
1713335463880,COMM 107,A00,489347,Staff,27,0,35,8
1713335464911,COMM 109P,A00,489358,Staff,31,0,35,4
1713335465936,COMM 132,A00,489361,McKenna; Denise,27,0,30,3
1713335466961,COMM 146,A00,489362,Halm; Gavin Patrick,26,0,30,4
1713335467989,COMM 190,A00,489363,Abuelhiga; Soraya Jill,17,0,23,6
1713335469023,CSE 8A,A50,489366,Staff,21,0,25,4
1713335469023,CSE 8A,A51,489367,Staff,24,0,25,1
1713335470049,CSE 11,A01,489398,Cao; Yingjun,72,0,100,28
1713335471075,CSE 12,A01,489487,Staff,43,0,50,7
1713335472102,CSE 20,A01,489497,Staff,47,0,50,3
1713335473127,CSE 21,A01,489517,Braun; Oliver,42,0,50,8
1713335474151,CSE 101,A01,489524,Braun; Oliver,0,32,50,50
1713335475184,CSE 105,A01,512594,Jones; Miles E,72,0,100,28
1713335475184,CSE 105,B01,512598,Jones; Miles E,52,0,100,48
1713335476210,CSE 140,A01,489538,Staff,41,0,50,9
1713335477242,CSE 141,A01,489550,Eldon; John,67,0,100,33
1713335478267,CSE 141L,A01,489571,Eldon; John,65,0,100,35
1713335479291,CSE 151A,A01,489583,Solares; Edwin A,141,0,200,59
1713335480329,CSE 175,A01,510886,Kumar; Rakesh,30,0,30,0
1713335481356,CSE 190,A00,516828,Dubnov; Shlomo,37,0,49,12
1713335482389,DOC 100D,A00,489667,Pass; Natalye Joann,19,0,25,6
1713335483413,DSC 10,A01,624268,Staff,72,0,75,3
1713335484439,DSC 20,A01,624476,Staff,50,0,50,0
1713335485471,DSC 40A,A01,624608,Staff,39,0,40,1
1713335486501,DSGN 1,A01,489179,Rill; Bryan,32,0,50,18
1713335487526,ECE 17,A01,490489,Sahay; Rajeev,18,0,30,12
1713335488551,ECE 65,A50,490492,Staff,11,0,20,9
1713335488551,ECE 65,A51,490493,Staff,18,0,20,2
1713335489576,ECON 1,A01,489715,Famulari; Melissa,67,0,70,3
1713335490602,ECON 2,A01,489717,Levkoff; Steven B.,67,0,70,3
1713335491626,ECON 3,A01,489948,Staff,70,0,70,0
1713335493676,ECON 5,A01,490103,Staff,27,0,30,3
1713335493676,ECON 5,B01,626281,Dai; Yinlin,45,0,45,0
1713335494701,ECON 100A,A01,490127,Famulari; Melissa,64,0,70,6
1713335495727,ECON 100B,A01,490129,Staff,64,0,70,6
1713335496752,ECON 109,A01,490187,Shishkin; Denis,27,0,35,8
1713335497778,ECON 110A,A01,490190,Levkoff; Steven B.,60,0,70,10
1713335498807,ECON 120A,A01,490245,Dai; Yinlin,60,0,70,10
1713335499833,ECON 120B,A01,490247,Nieto-Barthaburu; Augusto,40,0,70,30
1713335500865,ECON 120C,A01,490253,Sun; Yixiao,30,0,35,5
1713335500865,ECON 120C,B01,490255,Sun; Yixiao,34,0,35,1
1713335501888,ECON 129,A00,490256,Eckert; Fabian Paul,22,0,35,13
1713335502915,ECON 131,A00,490257,Nieto-Barthaburu; Augusto,0,6,35,35
1713335503947,ECON 138,A00,490258,Bharadwaj; Prashant,13,0,35,22
1713335503947,ECON 138,B00,490259,Bharadwaj; Prashant,15,0,35,20
1713335505027,ECON 159,A00,490260,Hendrickson; Gerald M.,0,9,0,0
1713335506053,ECON 178,A01,553995,Zhu; Ying,24,0,35,11
1713335507079,EDS 40,A01,512576,Black; Alison Michelle,20,0,20,0
1713335508110,EDS 107,A01,515848,Staff,30,0,30,0
1713335509135,EDS 110R,A01,490262,Staff,26,0,30,4
1713335510161,EDS 112,A01,490264,Chapman; Thandeka K,40,0,50,10
1713335511187,EDS 113,A00,490266,Staff,26,0,30,4
1713335512213,EDS 118,A00,490267,Warstadt; Melissa Fawn,18,0,30,12
1713335513241,EDS 124BR,A00,490268,Eguchi; Emi,4,0,25,21
1713335513241,EDS 124BR,B00,490269,Eguchi; Emi,23,0,25,2
1713335514265,EDS 126,A01,490271,Jones; Makeba,43,0,50,7
1713335515293,EDS 135,A01,490316,Staff,19,0,20,1
1713335516322,ENVR 142GS,A00,519514,Chang; Edmond Yi-Teh,26,0,28,2
1713335517353,ETHN 103,A00,490504,Staff,25,0,36,11
1713335518382,ETHN 103A,A00,490505,Man; Simeon S,4,0,9,5
1713335519412,ETHN 109,A00,490506,Staff,28,0,30,2
1713335520438,ETHN 118,A00,490507,Staff,35,0,36,1
1713335521463,ETHN 119,A00,490508,Staff,33,0,36,3
1713335522489,ETHN 121R,A00,490518,Choi; Esther Min,21,0,36,15
1713335523514,ETHN 127,A00,490528,Staff,14,0,15,1
1713335524540,ETHN 139,A00,490573,Staff,10,0,10,0
1713335525566,ETHN 150,A00,490575,Staff,15,0,15,0
1713335526599,GLBH 20,A00,491705,Elwardani; Nile Regina,38,0,40,2
1713335527627,GLBH 101,A00,491706,Staff,20,0,20,0
1713335528653,GLBH 111,A01,491708,Burgos; Jose L.,15,0,15,0
1713335529681,GLBH 146,A00,491709,Staff,9,0,20,11
1713335530713,GLBH 148,A00,491710,Olivas Hernandez; Olga Lid,11,0,20,9
1713335531744,GLBH 150,A00,491711,Sloane; Julia Kathryn,19,0,20,1
1713335532771,HIEA 131,A00,491760,Staff,28,0,32,4
1713335533797,HIEA 153,A00,491762,Staff,28,0,30,2
1713335534823,HIEU 124,A00,491811,Staff,26,0,32,6
1713335535849,HIEU 124GS,A00,491812,Markman; Kristina,27,0,28,1
1713335536877,HIEU 147,A00,491813,Staff,30,0,32,2
1713335537909,HIEU 149GS,A00,491816,Caldwell; Michael Alan,28,0,28,0
1713335538934,HILD 2C,A01,491713,Hendrickson; Gerald M.,26,0,30,4
1713335539960,HILD 7B,A01,491715,Kwak; Nancy,0,2,30,30
1713335540985,HILD 10,A01,491717,Staff,9,0,20,11
1713335542010,HILD 30GS,A00,491719,Edington; Claire Ellen,23,0,28,5
1713335543036,HINE 109,A00,491818,Shafir; Nir,27,0,32,5
1713335544062,HINE 128,A00,491821,Shafir; Nir,31,0,32,1
1713335545088,HISC 117,A00,491830,Staff,27,0,32,5
1713335546114,HIUS 103,A00,491834,Man; Simeon S,14,0,23,9
1713335547140,HIUS 108B,A00,491835,Staff,27,0,30,3
1713335548165,HIUS 141,A00,491836,Hendrickson; Gerald M.,28,0,32,4
1713335549191,HIUS 149,A00,491839,Staff,24,0,32,8
1713335550217,HUM 3,A01,512617,Crum; Matthew Stephen,42,0,50,8
1713335550217,HUM 3,A02,512618,Crum; Matthew Stephen,48,0,50,2
1713335551244,HUM 3GS,A00,512663,Markman; Kristina,0,0,0,1
1713335551244,HUM 3GS,B00,512664,Staff,0,0,0,0
1713335552273,HUM 4,A01,512620,West; Geoffrey Scott,25,0,50,25
1713335553298,HUM 4GS,A00,512666,Lyon; Antony J.,0,0,0,5
1713335554323,HUM 4R,A01,512625,Watkins; Eric,49,0,50,1
1713335555357,HUM 5,A01,512649,Zavodny; Tatiana Sophia,21,0,50,29
1713335555357,HUM 5,B01,512661,Zroka; Ryan Edward,48,0,50,2
1713335556388,INTL 190,A00,490577,Segui; Alan S,0,0,0,5
1713335557419,JAPN 20AR,A01,491267,Ross; Kayoko F,7,0,20,13
1713335558445,JAPN 180,A00,491285,Berman; Michael David,33,0,40,7
1713335559476,LATI 50,A01,502536,Kokinis; Troy Andreas,16,0,22,6
1713335559476,LATI 50,A02,502551,Kokinis; Troy Andreas,22,0,22,0
1713335559476,LATI 50,A03,502650,Kokinis; Troy Andreas,22,0,22,0
1713335559476,LATI 50,A04,502909,Kokinis; Troy Andreas,21,0,22,1
1713335560501,LATI 160,A01,502920,Kokinis; Troy Andreas,30,0,30,0
1713335561532,LIFR 1A,A00,490494,Van Moer; Vinciane G,17,0,20,3
1713335562556,LIFR 1AX,A00,490495,Van Moer; Vinciane G,17,0,20,3
1713335563585,LIFR 1B,A00,490496,Van Moer; Vinciane G,17,0,20,3
1713335564613,LIFR 1BX,A00,490497,Van Moer; Vinciane G,17,0,20,3
1713335565640,LIGN 8,A00,505198,McIntosh; Justin Daniel,134,0,150,16
1713335566669,LIGN 9GS,A00,491239,Lott; Margaret S.,18,0,20,2
1713335567699,LIGN 101,A01,505200,McIntosh; Justin Daniel,22,0,30,8
1713335568726,LIGN 120,A01,491244,Staff,22,0,30,8
1713335569753,LIGN 149GS,A00,491245,Lott; Margaret S.,18,0,20,2
1713335570778,LIGN 170,A00,491247,Staff,22,0,30,8
1713335571803,LISP 1D,A00,490498,Munoz Sanchez; Alicia,8,0,14,6
1713335571803,LISP 1D,B00,490499,Munoz Sanchez; Alicia,6,0,14,8
1713335571803,LISP 1D,C00,490500,Munoz Sanchez; Alicia,7,0,14,7
1713335571803,LISP 1D,D00,490501,Munoz Sanchez; Alicia,10,0,14,4
1713335572832,LISP 1DX,A00,490502,Munoz Sanchez; Alicia,13,0,28,15
1713335572832,LISP 1DX,B00,490503,Munoz Sanchez; Alicia,16,0,28,12
1713335574881,LTAM 110,A00,491847,Staff,22,0,25,3
1713335575906,LTCS 119,A00,491848,Staff,11,0,15,4
1713335576938,LTCS 130,A00,491849,Staff,24,0,25,1
1713335578994,LTEA 120C,A00,491852,Staff,32,0,40,8
1713335580019,LTEN 130GS,A00,491853,Lyon; Antony J.,23,0,28,5
1713335581044,LTEN 148,A00,491855,Staff,23,0,25,2
1713335582070,LTEN 159,A00,491856,Staff,20,0,25,5
1713335583100,LTEN 180,A00,491857,Staff,8,0,15,7
1713335585151,LTSP 123GS,A00,505928,Bessett; Ryan Matthew,24,0,28,4
1713335586175,LTSP 174GS,A00,506037,Bessett; Ryan Matthew,24,0,28,4
1713335588225,LTWR 102,A00,491861,Staff,9,0,15,6
1713335589250,LTWR 106,A00,491862,Staff,8,0,15,7
1713335590276,MAE 11,A00,490930,Bahadori; Mohammad Yousef,95,0,100,5
1713335591306,MAE 30A,A00,490931,Qi; Huihui,37,0,40,3
1713335592335,MAE 101A,A00,491036,Sadeghizadeh; Zahra,92,0,100,8
1713335593360,MAE 101C,A00,491037,Seshadri; Kalyanasundaram,64,0,100,36
1713335594386,MAE 113,A00,491040,Seshadri; Kalyanasundaram,65,0,80,15
1713335595417,MAE 131A,A00,491041,Ghazinejad; Maziar,37,0,40,3
1713335596443,MAE 142,A00,491053,Staff,39,0,40,1
1713335597472,MAE 143A,A00,491054,Staff,31,0,50,19
1713335598505,MAE 150,A00,491092,Truong; Phuong Thi Ngoc,23,0,35,12
1713335599531,MATH 3C,A01,494031,Pardo Guerra; Sebastian,30,0,30,0
1713335599531,MATH 3C,A02,494032,Pardo Guerra; Sebastian,29,0,30,1
1713335600556,MATH 10A,A01,494034,Staff,27,0,30,3
1713335600556,MATH 10A,A02,494035,Staff,28,0,30,2
1713335600556,MATH 10A,B01,494037,Staff,27,0,30,3
1713335600556,MATH 10A,B02,494038,Staff,29,0,30,1
1713335601586,MATH 10B,A01,494040,Habib; Yousaf,22,0,30,8
1713335601586,MATH 10B,A02,494041,Habib; Yousaf,28,0,30,2
1713335601586,MATH 10B,A03,494042,Habib; Yousaf,29,0,30,1
1713335601586,MATH 10B,A04,494043,Habib; Yousaf,30,0,30,0
1713335601586,MATH 10B,B01,494045,Habib; Yousaf,25,0,30,5
1713335601586,MATH 10B,B02,494046,Habib; Yousaf,30,0,30,0
1713335601586,MATH 10B,B03,494047,Habib; Yousaf,30,0,30,0
1713335601586,MATH 10B,B04,494048,Habib; Yousaf,30,0,30,0
1713335602613,MATH 18,A01,494050,Kemp; Todd Aahron,25,0,30,5
1713335602613,MATH 18,A02,494051,Kemp; Todd Aahron,29,0,30,1
1713335602613,MATH 18,B01,494054,Kemp; Todd Aahron,25,0,30,5
1713335602613,MATH 18,B02,494055,Kemp; Todd Aahron,29,0,30,1
1713335603638,MATH 20A,A01,494059,Suk; Andrew Hoon,30,0,30,0
1713335604674,MATH 20B,A01,494061,Briones; Jor-el Thomas Caparas,33,0,35,2
1713335604674,MATH 20B,B01,494063,Bach; Quang Tran,34,0,35,1
1713335605703,MATH 20C,A01,494065,Staff,28,0,30,2
1713335605703,MATH 20C,A02,494066,Staff,30,0,30,0
1713335605703,MATH 20C,A03,494067,Staff,30,0,30,0
1713335605703,MATH 20C,A04,494068,Staff,30,0,30,0
1713335605703,MATH 20C,B01,494070,Zhang; Ming,25,0,30,5
1713335605703,MATH 20C,B02,494071,Zhang; Ming,27,0,30,3
1713335605703,MATH 20C,B03,494072,Zhang; Ming,29,0,30,1
1713335605703,MATH 20C,B04,494073,Zhang; Ming,29,0,30,1
1713335606730,MATH 20D,A01,494075,Staff,22,0,30,8
1713335606730,MATH 20D,A02,494076,Staff,29,0,30,1
1713335607754,MATH 20E,A01,494079,Staff,24,0,30,6
1713335607754,MATH 20E,A02,494080,Staff,26,0,30,4
1713335607754,MATH 20E,B01,494082,Staff,25,0,30,5
1713335607754,MATH 20E,B02,494083,Staff,25,0,30,5
1713335608834,MATH 103A,A01,494085,Aliabadi Sr.; Mohsen,13,0,30,17
1713335608834,MATH 103A,A02,494086,Aliabadi Sr.; Mohsen,28,0,30,2
1713335608834,MATH 103A,B01,494088,Aliabadi Sr.; Mohsen,21,0,30,9
1713335608834,MATH 103A,B02,494089,Aliabadi Sr.; Mohsen,27,0,30,3
1713335609864,MATH 109,A01,494091,Staff,30,0,30,0
1713335609864,MATH 109,A02,494092,Staff,29,0,30,1
1713335609864,MATH 109,B01,494094,Staff,27,0,30,3
1713335609864,MATH 109,B02,494095,Staff,29,0,30,1
1713335610892,MATH 142A,A01,494097,Chow; Bennett,14,0,30,16
1713335610892,MATH 142A,A02,494098,Chow; Bennett,23,0,30,7
1713335610892,MATH 142A,B01,494100,Chow; Bennett,19,0,30,11
1713335610892,MATH 142A,B02,494101,Chow; Bennett,29,0,30,1
1713335612947,MATH 168A,A01,516677,Dumitriu; Ioana,16,0,35,19
1713335613977,MATH 170A,A01,516679,Dumitriu; Ioana,18,0,30,12
1713335613977,MATH 170A,A02,516680,Dumitriu; Ioana,28,0,30,2
1713335615003,MATH 193A,A01,494107,Staff,13,0,30,17
1713335615003,MATH 193A,A02,494108,Staff,19,0,30,11
1713335615003,MATH 193A,A03,494109,Staff,29,0,30,1
1713335615003,MATH 193A,A04,494110,Staff,22,0,30,8
1713335618082,MGT 16,A00,491930,McKay; Michael J,92,0,98,6
1713335619199,MGT 18,A00,491992,McKay; Michael J,96,0,98,2
1713335620230,MGT 71,A00,492003,Staff,63,0,98,35
1713335621256,MGT 103,A00,505209,Eberhard; Craig A,80,0,98,18
1713335622286,MGT 131A,A00,505210,Anderson; John Charles,89,0,98,9
1713335624339,MGT 153,A00,492077,Perols; Johan Lars,17,0,90,73
1713335627419,MGT 164,A00,492222,McKay; Mary A,91,0,98,7
1713335628451,MGT 172,A00,492245,Staff,59,0,60,1
1713335628451,MGT 172,B00,505526,Hedges; Kathleen,65,0,98,33
1713335629479,MGT 181,A00,505669,Dunn; Louis Jean,80,0,98,18
1713335630511,MMW 14,A01,494399,Staff,15,0,28,13
1713335630511,MMW 14,A02,494400,Staff,25,0,28,3
1713335630511,MMW 14,A03,494401,Staff,28,0,28,0
1713335630511,MMW 14,A04,494402,Staff,28,0,28,0
1713335630511,MMW 14,B01,494404,Carreras; Maria Victoria,8,0,28,20
1713335630511,MMW 14,B02,494405,Carreras; Maria Victoria,25,0,28,3
1713335630511,MMW 14,B03,494406,Carreras; Maria Victoria,27,0,28,1
1713335630511,MMW 14,B04,494407,Carreras; Maria Victoria,28,0,28,0
1713335631539,MMW 14GS,A00,506250,Chang; Edmond Yi-Teh,0,0,0,0
1713335632567,MMW 121R,A01,494415,Adamiak; Patrick John,10,0,28,18
1713335632567,MMW 121R,A02,494416,Adamiak; Patrick John,24,0,28,4
1713335633594,MUS 1A,A01,494113,Staff,12,0,25,13
1713335633594,MUS 1A,A02,494114,Staff,24,0,25,1
1713335634620,MUS 4,A01,494116,Staff,23,0,25,2
1713335634620,MUS 4,A02,494117,Staff,22,0,25,3
1713335635647,MUS 5R,A01,494236,Dubnov; Shlomo,5,0,25,20
1713335635647,MUS 5R,A02,494237,Dubnov; Shlomo,25,0,25,0
1713335636676,MUS 6,A01,494122,Staff,9,0,25,16
1713335636676,MUS 6,A02,494123,Staff,23,0,25,2
1713335637701,MUS 7,A01,494125,Staff,16,0,25,9
1713335637701,MUS 7,A02,494126,Staff,24,0,25,1
1713335638730,MUS 11,A01,494128,Staff,23,0,25,2
1713335638730,MUS 11,A02,494129,Staff,24,0,25,1
1713335639759,MUS 13,A01,494131,Staff,25,0,25,0
1713335639759,MUS 13,A02,494132,Staff,25,0,25,0
1713335640784,MUS 15,A01,494134,Staff,16,0,25,9
1713335640784,MUS 15,A02,494135,Staff,25,0,25,0
1713335640784,MUS 15,B01,494137,Staff,24,0,25,1
1713335641816,MUS 80,A00,494232,Staff,24,0,25,1
1713335641816,MUS 80,B00,494233,Staff,25,0,25,0
1713335641816,MUS 80,C00,494234,Staff,23,0,25,2
1713335642841,MUS 95C,A00,494141,Staff,70,0,75,5
1713335643870,MUS 114,A00,494142,Staff,40,0,50,10
1713335644897,NANO 15,A01,490636,Drews; Aaron,7,0,7,0
1713335645930,PHIL 1,A00,490578,Grush; Rick Scott,49,0,50,1
1713335646962,PHIL 10,A01,490580,Grush; Rick Scott,33,0,35,2
1713335646962,PHIL 10,A02,490586,Grush; Rick Scott,32,0,35,3
1713335647990,PHIL 27,A01,490591,Staff,22,0,25,3
1713335647990,PHIL 27,A02,490592,Staff,25,0,25,0
1713335647990,PHIL 27,A03,490593,Staff,25,0,25,0
1713335647990,PHIL 27,A04,490598,Staff,25,0,25,0
1713335649018,PHIL 32,A01,490611,Staff,20,0,20,0
1713335649018,PHIL 32,A02,490618,Staff,20,0,20,0
1713335650042,PHIL 90,A00,490624,Staff,40,0,40,0
1713335651072,PHIL 136,A00,490627,Cohen; Jonathan David,37,0,40,3
1713335652097,PHIL 155,A00,490634,Staff,62,0,70,8
1713335653121,PHYS 1A,A00,491610,Staff,245,0,250,5
1713335654147,PHYS 1AL,001,491616,Tsai; Philbert S,27,0,30,3
1713335654147,PHYS 1AL,002,491618,Tsai; Philbert S,30,0,30,0
1713335655176,PHYS 1B,A00,491623,Staff,236,0,250,14
1713335656205,PHYS 1BL,001,491626,Tsai; Philbert S,21,0,30,9
1713335656205,PHYS 1BL,002,491628,Tsai; Philbert S,26,0,30,4
1713335657229,PHYS 1C,A00,491632,Staff,213,0,245,32
1713335658254,PHYS 1CL,001,491635,Tsai; Philbert S,3,0,30,27
1713335658254,PHYS 1CL,002,491643,Tsai; Philbert S,22,0,30,8
1713335659281,PHYS 2AR,A01,491651,Meyertholen; Andrew D.,44,0,50,6
1713335660306,PHYS 2B,A01,491659,Staff,106,0,115,9
1713335661330,PHYS 2BL,A01,491685,Staff,21,0,24,3
1713335661330,PHYS 2BL,A02,491700,Staff,21,0,24,3
1713335662357,PHYS 2C,A01,505161,Staff,101,0,115,14
1713335663387,PHYS 4A,A01,491704,Grinstein; Benjamin,99,0,100,1
1713335664418,POLI 5D,A01,494144,Staff,3,0,5,2
1713335664418,POLI 5D,B01,626283,Dai; Yinlin,5,0,5,0
1713335665443,POLI 12,A00,494145,Staff,43,0,45,2
1713335666470,POLI 13R,A00,494146,Forman; Fonna,45,0,50,5
1713335667496,POLI 27,A01,494148,Staff,54,0,60,6
1713335668519,POLI 30,A00,494149,Staff,49,0,50,1
1713335669544,POLI 100DA,A00,494150,Staff,20,0,25,5
1713335671592,POLI 100I,A00,494152,Staff,27,0,30,3
1713335672623,POLI 104B,A00,494153,Smith; Glenn Chatmas,53,0,55,2
1713335673648,POLI 104F,A00,494154,Staff,28,0,30,2
1713335674673,POLI 104I,A00,494155,Smith; Glenn Chatmas,29,0,30,1
1713335675705,POLI 110C,A00,494156,Ingham; Sean,23,0,25,2
1713335676735,POLI 117R,A00,494157,Forman; Fonna,5,0,20,15
1713335677764,POLI 118,A00,494158,Ingham; Sean,21,0,25,4
1713335678794,POLI 120H,A00,494159,Fisk; David Lee,39,0,45,6
1713335679821,POLI 131CR,A00,494160,Hoston; Germaine,35,0,45,10
1713335680851,POLI 133J,A00,494161,Staff,31,0,35,4
1713335681878,POLI 135,A00,494162,Fisk; David Lee,33,0,35,2
1713335682905,POLI 140A,A00,494164,Staff,18,0,30,12
1713335683931,POLI 142I,A00,494165,Staff,30,0,30,0
1713335684961,POLI 144D,A00,494166,Staff,23,0,25,2
1713335685989,POLI 151,A00,494167,Staff,30,0,30,0
1713335687015,POLI 153,A00,494168,Staff,33,0,35,2
1713335688041,POLI 160AA,A00,494169,Staff,34,0,40,6
1713335689072,POLI 162,A00,494170,Mignozzetti; Umberto,18,0,25,7
1713335690098,POLI 171,A00,494171,Mignozzetti; Umberto,18,0,25,7
1713335691123,PSYC 1,A00,494172,Staff,95,0,100,5
1713335692153,PSYC 2,A00,494173,Moranton; Nirelia Melbina-,34,0,50,16
1713335693182,PSYC 3,A00,494174,Staff,29,0,30,1
1713335694210,PSYC 6,A00,494175,Staff,17,0,20,3
1713335695236,PSYC 60,A01,494177,Staff,37,0,45,8
1713335696269,PSYC 70,A01,505724,Geller; Emma Harlan,42,0,45,3
1713335697299,PSYC 101,A00,494180,Heyman; Gail D.,84,0,100,16
1713335698324,PSYC 105,A00,494181,Geller; Emma Harlan,51,0,90,39
1713335699351,PSYC 106,A00,494182,Dobkins; Karen R.,26,0,45,19
1713335700374,PSYC 108,A00,494183,Adrian; Julia Anna,89,0,100,11
1713335701407,PSYC 114,A01,494185,Winkielman; Piotr,0,3,30,30
1713335702433,PSYC 122,A00,494186,Moranton; Nirelia Melbina-,27,0,50,23
1713335703458,PSYC 124,A00,494187,Chapman; Eddie Nathaniel,70,0,80,10
1713335704487,PSYC 131,A00,494188,Anagnostaras; Stephan,40,0,80,40
1713335705512,PSYC 144,A00,494189,Staff,1,0,50,49
1713335706538,PSYC 154,A00,494190,Lacefield; Katharine I,106,0,180,74
1713335707568,PSYC 162,A00,494191,Wixted; John T,71,0,100,29
1713335708594,PSYC 172,A00,494192,Gorman; Michael R.,36,0,45,9
1713335709619,PSYC 178,A00,494193,Glaser; Dale,34,0,45,11
1713335710646,PSYC 193,A00,505725,Chapman; Eddie Nathaniel,20,0,20,0
1713335711674,RELI 145GS,A00,519817,Rahimi; Babak,17,0,20,3
1713335712760,SE 101A,A01,490862,Chadha; Mayank,23,0,25,2
1713335713791,SE 101C,A01,490924,Krysl; Petr,15,0,20,5
1713335714816,SE 110A,A01,490928,Staff,19,0,20,1
1713335715843,SE 130A,A00,490929,Morrison; Machel Leigh,54,0,70,16
1713335716870,SIO 1,A01,519325,Staff,39,0,40,1
1713335717895,SIO 30,A01,519327,Staff,38,0,40,2
1713335718920,SIO 40,A00,519328,Staff,39,0,40,1
1713335719946,SIO 46GS,A00,519819,Cook; Geoffrey W,17,0,25,8
1713335720974,SIO 109R,A00,494197,Forman; Fonna,0,3,20,20
1713335721998,SIO 121GS,A00,519827,Cook; Geoffrey W,17,0,25,8
1713335723026,SIO 132,A01,519330,Staff,38,0,40,2
1713335724052,SIO 133,A01,519397,Staff,37,0,40,3
1713335725077,SIO 139,A00,519396,Kacev; David,29,0,40,11
1713335726104,SOCI 1,A01,494199,Thorpe; Charles Robert,21,0,30,9
1713335726104,SOCI 1,A02,494200,Thorpe; Charles Robert,30,0,30,0
1713335726104,SOCI 1,A03,494201,Thorpe; Charles Robert,29,0,30,1
1713335726104,SOCI 1,A04,494202,Thorpe; Charles Robert,29,0,30,1
1713335726104,SOCI 1,A05,494203,Thorpe; Charles Robert,29,0,30,1
1713335726104,SOCI 1,A06,494204,Thorpe; Charles Robert,30,0,30,0
1713335726104,SOCI 1,A07,494205,Thorpe; Charles Robert,28,0,30,2
1713335727133,SOCI 60,A01,494207,Staff,34,0,40,6
1713335727133,SOCI 60,A02,494208,Staff,39,0,40,1
1713335728158,SOCI 100,A01,494210,Payne; Christine Anna,25,0,30,5
1713335728158,SOCI 100,A02,494211,Payne; Christine Anna,26,0,30,4
1713335729186,SOCI 109M,A00,494212,Staff,20,0,20,0
1713335730213,SOCI 110,A00,494213,Staff,34,0,40,6
1713335732264,SOCI 118E,A00,494215,Ng; Kwai,37,0,40,3
1713335733291,SOCI 125,A00,494216,Calderon-Zaks; Michael Aar,40,0,45,5
1713335734323,SOCI 126,A01,494218,Jones; Makeba,3,0,5,2
1713335735352,SOCI 131,A00,494219,Thorpe; Charles Robert,26,0,30,4
1713335737401,SOCI 135,A00,494221,Payne; Christine Anna,28,0,50,22
1713335738434,SOCI 136E,A00,626690,Ruiz; Jonathan Joseph,24,0,25,1
1713335739458,SOCI 138GS,A00,494222,Navon; Daniel,23,0,28,5
1713335741513,SOCI 145,A00,494224,Staff,40,0,45,5
1713335742537,SOCI 153,A00,494225,Staff,28,0,30,2
1713335743563,SOCI 160E,A00,494226,Ng; Kwai,27,0,40,13
1713335744654,SOCI 180,A00,494227,Staff,29,0,30,1
1713335745679,SOCI 189GS,A00,494228,Ribas Norris; Janet Vanesa,11,0,11,0
1713335746710,SOCI 190GS,A00,553232,Ribas Norris; Janet Vanesa,11,0,11,0
1713335747738,SOMI 220,A00,627178,Schneid; Stephen David,30,0,30,0
1713335748765,SYN 2,001,490768,Staff,13,0,15,2
1713335748765,SYN 2,002,490769,Staff,14,0,15,1
1713335748765,SYN 2,004,490775,Staff,0,0,0,0
1713335748765,SYN 2,003,490774,Staff,0,0,0,0
1713335748765,SYN 2,005,490776,Staff,0,0,0,0
1713335749791,SYN 2R,001,490779,Staff,11,0,15,4
1713335749791,SYN 2R,002,514635,Staff,14,0,15,1
1713335750818,SYN 100,A01,490783,Staff,9,0,20,11
1713335750818,SYN 100,B01,490787,Staff,9,0,20,11
1713335750818,SYN 100,C01,490789,Staff,10,0,20,10
1713335751840,SYN 150,A00,490817,Staff,14,0,15,1
1713335751840,SYN 150,B00,514610,Staff,15,0,15,0
1713335752872,TDAC 1,A00,492753,Walsh; Kim C.,19,0,20,1
1713335752872,TDAC 1,B00,492754,Harting; Carla Kelso,19,0,20,1
1713335752872,TDAC 1,C00,513995,Salovey; Todd,15,0,20,5
1713335753901,TDAC 101,A00,492766,Harting; Carla Kelso,17,0,20,3
1713335754930,TDAC 102,A00,492768,Basso; Beatrice,19,0,20,1
1713335755963,TDDE 111,A00,492769,Staff,25,0,25,0
1713335756999,TDDE 131,A00,492770,Staff,15,0,15,0
1713335756999,TDDE 131,B00,492771,Staff,15,0,15,0
1713335758024,TDDE 131GS,A00,523716,Guirguis; Mark C,23,0,28,5
1713335759054,TDGE 1,A01,492756,Salovey; Todd,56,0,60,4
1713335760082,TDGE 5,A01,492758,Staff,23,0,25,2
1713335761116,TDGE 10,A00,492759,Fulton; Julia,203,0,220,17
1713335762142,TDGE 11,A00,492760,Castro; Robert Jess,198,0,200,2
1713335764200,TDGE 124,A00,492772,Fulton; Julia,182,0,220,38
1713335765232,TDGE 125,A00,492773,Meyer; Ursula,38,0,50,12
1713335765232,TDGE 125,B00,492774,Staff,49,0,50,1
1713335765232,TDGE 125,C00,523565,Staff,48,0,50,2
1713335766259,TDGE 125GS,A00,523580,Guirguis; Mark C,23,0,28,5
1713335767286,TDGE 127,A00,492775,Havis; Allan,32,0,50,18
1713335768311,TDHT 101,A00,492776,Staff,34,0,35,1
1713335769336,TDMV 1,A00,492762,Caligagan; Maria T.,29,0,30,1
1713335769336,TDMV 1,B00,492763,Arcidiacono; Kristin,26,0,30,4
1713335770365,TDMV 2,A00,492764,Weinberg; Sadie,28,0,30,2
1713335771390,TDMV 3,A00,492765,Mack; Kara Shanai',37,0,40,3
1713335772416,TDMV 138,A00,492777,Mack; Kara Shanai',33,0,40,7
1713335773440,TDMV 140,A00,492778,Lima; Paulo Henrique,40,0,40,0
1713335774465,TDMV 142,A00,492779,Caligagan; Maria T.,33,0,40,7
1713335774465,TDMV 142,B00,492780,Caligagan; Tony,37,0,40,3
1713335775492,TDMV 143,A00,492781,Fyall; Daunte Edward,39,0,40,1
1713335776519,USP 1,A01,492401,Kwak; Nancy,27,0,35,8
1713335777543,USP 2,A01,492453,Hinds; Juli Beth,35,0,35,0
1713335778568,USP 3,A01,492516,Staff,28,0,35,7
1713335779598,USP 4,A00,492522,McTague; Sarah,16,0,25,9
1713335780622,USP 100,A00,492523,Staff,32,0,35,3
1713335781647,USP 101,A00,492524,Staff,13,0,15,2
1713335782674,USP 105,A00,492525,Staff,21,0,25,4
1713335783704,USP 151,A00,492526,Shenkman; Michael Thomas,32,0,35,3
1713335784732,USP 170,A00,492545,Hinds; Juli Beth,33,0,35,2
1713335785756,USP 171GS,A00,492608,Bussell; Mirle Rabinowitz,24,0,28,4
1713335786782,USP 183GS,A00,492613,Peerson; Susan,24,0,28,4
1713335787810,VIS 30,A01,490693,Yoldas; Pinar,19,0,22,3
1713335787810,VIS 30,A02,490694,Yoldas; Pinar,18,0,22,4
1713335788840,VIS 83,A00,490695,Kester; Grant,63,0,75,12
1713335789866,VIS 105D,A00,490696,Staff,22,0,25,3
1713335790892,VIS 124CN,A00,490699,Rose; Jordan M,65,0,75,10
1713335791919,VIS 125GS,A00,511221,Williams; Alena J,21,0,22,1
1713335792946,VIS 128D,A00,490700,Staff,73,0,75,2
1713335793975,VIS 151,A01,490717,Staff,33,0,34,1
1713335793975,VIS 151,A02,490766,Staff,33,0,34,1
1713335795000,VIS 154GS,A00,511972,Williams; Alena J,21,0,22,1
1713335796028,VIS 160A,A00,490767,Stone; Patricia,7,0,10,3
1713335797057,WCWP 10A,A00,490638,Staff,14,0,15,1
1713335797057,WCWP 10A,B00,490640,Staff,15,0,15,0
1713335798083,WCWP 10B,A00,490641,Staff,0,0,0,0
1713335798083,WCWP 10B,B00,490642,Staff,14,0,15,1
1713335798083,WCWP 10B,C00,490644,Staff,13,0,15,2
1713335798083,WCWP 10B,D00,490647,Staff,0,0,0,0
1713335799110,WCWP 100,A00,490655,Staff,0,0,0,0
1713335799110,WCWP 100,B00,490687,Staff,10,0,15,5
1713335801201,ANAR 153,A00,487222,Braswell; Geoffrey E.,53,0,60,7
1713335802226,ANBI 134,A00,487223,Staff,5,0,20,15
1713335803253,ANBI 143GS,A00,487224,Noel; Geoffroy Pierre Jean,18,0,24,6
1713335804278,ANBI 144GS,A00,519548,Noel; Geoffroy Pierre Jean,18,0,24,6
1713335805304,ANSC 101,A00,487225,Staff,18,0,20,2
1713335806331,ANSC 125,A00,487227,Brenner; Suzanne A,38,0,40,2
1713335808384,ANSC 146,A00,487229,Staff,35,0,40,5
1713335809408,ANSC 148,A00,487230,Olivas Hernandez; Olga Lid,39,0,40,1
1713335810434,ANSC 150,A00,504165,Sloane; Julia Kathryn,18,0,20,2
1713335811458,ANSC 180,A00,487232,Staff,14,0,15,1
1713335812483,ANSC 188,A00,627155,Staff,38,0,40,2
1713335813512,ANTH 5,A00,519529,Semendeferi; Ekaterini,15,0,15,0
1713335814537,ANTH 10,A00,487219,Staff,58,0,60,2
1713335815568,ANTH 23,A01,487221,Staff,17,0,20,3
1713335816648,ANTH 102,A00,487233,Wilder; Linnea Lorene,51,0,60,9
1713335817679,ANTH 103,A00,487234,Varma; Saiba,55,0,60,5
1713335818706,ANTH 105,A00,487235,Stewart; Alexander B,54,0,60,6
1713335819730,BENG 100,A01,516685,Taylor Amos; Alyssa C,26,0,30,4
1713335820756,BIBC 102,A01,491316,Flagg; Matthew Paul,7,0,88,81
1713335820756,BIBC 102,A02,491366,Flagg; Matthew Paul,78,0,88,10
1713335821782,BIBC 103,A01,491486,Boumechache; Miyyada,16,0,24,8
1713335821782,BIBC 103,A02,491487,Boumechache; Miyyada,24,0,24,0
1713335822807,BICD 100,A01,516882,Staff,73,0,75,2
1713335822807,BICD 100,A02,516890,Staff,69,0,75,6
1713335823833,BICD 102GS,A00,491488,Lo; Stanley M.,26,0,28,2
1713335824859,BIEB 136GS,A00,516940,Holway; David A. & Shurin; Jonathan,18,0,24,6
1713335825885,BIEB 137GS,A01,517034,Holway; David A. & Shurin; Jonathan,18,0,24,6
1713335826912,BIEB 138GS,A01,491492,Pirino; Giorgia,21,0,28,7
1713335827940,BILD 1,A01,491296,Staff,60,0,63,3
1713335827940,BILD 1,A02,491297,Staff,63,0,63,0
1713335828967,BILD 4,A01,517099,Gonzalez Gamboa; Ivonne,22,0,24,2
1713335828967,BILD 4,A02,517100,Gonzalez Gamboa; Ivonne,24,0,24,0
1713335829993,BILD 60GS,A00,491309,Lo; Stanley M.,26,0,28,2
1713335831023,BIMM 100,A01,517136,Staff,82,0,100,18
1713335832053,BIMM 110,A01,517182,Staff,54,0,100,46
1713335833080,BIMM 120,A01,517228,Pickett; Brooke Elizabeth,28,0,63,35
1713335833080,BIMM 120,A02,517240,Pickett; Brooke Elizabeth,44,0,63,19
1713335834106,BIMM 132GS,A01,491498,Pirino; Giorgia,21,0,28,7
1713335835133,BIMM 143,A01,491589,Bozinovic; Goran,12,0,40,28
1713335836162,BIPN 100,A01,491594,Armour; Jon Christopher,83,0,100,17
1713335837192,BIPN 140,A01,491602,Marino; Marc J,24,0,50,26
1713335839248,CAT 125,A00,515973,Staff,18,0,20,2
1713335840277,CAT 125GS,A00,515974,Rahimi; Babak,16,0,20,4
1713335841304,CAT 125R,A00,515980,Staff,12,0,20,8
1713335841304,CAT 125R,B00,515981,Tosun; Adriana,19,0,20,1
1713335841304,CAT 125R,C00,515987,Hyland; Tina Mae,0,3,20,20
1713335841304,CAT 125R,D00,515988,Bronstein; Phoebe Malan,16,0,20,4
1713335842340,CENG 15,A01,488699,Drews; Aaron,25,0,25,0
1713335843366,CENG 100,A00,505196,Opatkiewicz; Justin Paul,25,0,25,0
1713335844391,CGS 2A,A01,489598,Staff,33,0,35,2
1713335845417,CGS 112,A00,489599,Staff,15,0,15,0
1713335846442,CGS 119,A00,489603,Staff,10,0,10,0
1713335847469,CGS 120,A00,489604,Staff,13,0,15,2
1713335848497,CGS 150,A00,489607,Staff,15,0,15,0
1713335849525,CHEM 6A,A01,488715,Staff,97,0,100,3
1713335850552,CHEM 6B,A01,488719,Piercy; Marc Anthony,99,0,100,1
1713335851581,CHEM 6C,A01,488723,Albizati; Kim F.,93,0,100,7
1713335852611,CHEM 7L,A01,488728,Schurmeier; Kimberly,18,0,24,6
1713335852611,CHEM 7L,A02,488730,Schurmeier; Kimberly,23,0,24,1
1713335852611,CHEM 7L,A03,488734,Schurmeier; Kimberly,20,0,24,4
1713335852611,CHEM 7L,A04,488763,Schurmeier; Kimberly,23,0,24,1
1713335852611,CHEM 7L,B01,488798,Schurmeier; Kimberly,17,0,24,7
1713335852611,CHEM 7L,B02,488801,Schurmeier; Kimberly,22,0,24,2
1713335852611,CHEM 7L,B03,488808,Schurmeier; Kimberly,22,0,24,2
1713335852611,CHEM 7L,B04,488811,Schurmeier; Kimberly,24,0,24,0
1713335853642,CHEM 11,A01,488897,Stallings; Dontarie M,95,0,100,5
1713335854672,CHEM 40A,A01,488913,Albizati; Kim F.,83,0,100,17
1713335855700,CHEM 40B,A01,488920,Weizman; Haim,43,0,50,7
1713335855700,CHEM 40B,A02,488938,Weizman; Haim,44,0,50,6
1713335856729,CHEM 41A,A01,489029,Klosterman; Jeremy K,57,0,60,3
1713335857757,CHEM 41C,A01,500436,Tor; Yitzhak,55,0,60,5
1713335858789,CHEM 43A,A01,500426,Weizman; Haim,0,1,24,24
1713335858789,CHEM 43A,A02,500430,Weizman; Haim,6,0,24,18
1713335858789,CHEM 43A,B01,514041,Klosterman; Jeremy K,16,0,24,8
1713335858789,CHEM 43A,B02,514047,Klosterman; Jeremy K,23,0,24,1
1713335859815,CHEM 108,A01,489140,Jennings; Patricia A.,7,0,24,17
1713335859815,CHEM 108,A02,489142,Jennings; Patricia A.,14,0,24,10
1713335860840,CHEM 114A,A01,489147,Stallings; Dontarie M,66,0,100,34
1713335861866,CHIN 169A,A00,489171,Wang; Xiao,19,0,20,1
1713335863923,COGS 3,A01,518827,Boyle; Mary E. T.,25,0,40,15
1713335864950,COGS 11,A01,489175,Staff,27,0,30,3
1713335865979,COGS 14A,A01,518829,Staff,51,0,60,9
1713335867012,COGS 14B,A01,489177,Hoffman; Drew Ellen,62,0,75,13
1713335868038,COGS 100,A01,489181,Allen; Michael Gordon,62,0,75,13
1713335869064,COGS 101A,A01,489183,Staff,45,0,60,15
1713335870094,COGS 101B,A01,489185,Allen; Michael Gordon,8,0,30,22
1713335871122,COGS 101C,A01,526786,Staff,23,0,30,7
1713335873177,COGS 107A,A01,489189,Boyle; Mary E. T.,16,0,35,19
1713335874203,COGS 107B,A01,627144,Mooshagian; Eric Frederick,60,0,60,0
1713335875233,COGS 118A,A01,489191,Staff,0,46,40,40
1713335877286,COGS 171GS,A01,489194,Pineda; Jaime A,19,0,28,9
1713335878340,COGS 172,A01,489196,Staff,2,0,30,28
1713335879368,COGS 174GS,A01,489264,Pineda; Jaime A,19,0,28,9
1713335880392,COGS 180,A01,627150,Staff,28,0,30,2
1713335881417,COGS 186,A01,489274,Staff,0,2,30,30
1713335882442,COMM 10,A01,489276,Staff,23,0,25,2
1713335882442,COMM 10,A02,489303,Staff,23,0,25,2
1713335883469,COMM 100A,A01,489312,Staff,14,0,25,11
1713335883469,COMM 100A,A02,489313,Staff,24,0,25,1
1713335884495,COMM 106T,A00,512540,Staff,33,0,35,2
1713335885524,COMM 107,A00,489347,Staff,27,0,35,8
1713335886549,COMM 109P,A00,489358,Staff,31,0,35,4
1713335887576,COMM 132,A00,489361,McKenna; Denise,27,0,30,3
1713335888601,COMM 146,A00,489362,Halm; Gavin Patrick,26,0,30,4
1713335889626,COMM 190,A00,489363,Abuelhiga; Soraya Jill,17,0,23,6
1713335890661,CSE 8A,A50,489366,Staff,21,0,25,4
1713335890661,CSE 8A,A51,489367,Staff,24,0,25,1
1713335891692,CSE 11,A01,489398,Cao; Yingjun,72,0,100,28
1713335892726,CSE 12,A01,489487,Staff,43,0,50,7
1713335893753,CSE 20,A01,489497,Staff,47,0,50,3
1713335894782,CSE 21,A01,489517,Braun; Oliver,42,0,50,8
1713335895810,CSE 101,A01,489524,Braun; Oliver,0,32,50,50
1713335896834,CSE 105,A01,512594,Jones; Miles E,72,0,100,28
1713335896834,CSE 105,B01,512598,Jones; Miles E,52,0,100,48
1713335897858,CSE 140,A01,489538,Staff,41,0,50,9
1713335898886,CSE 141,A01,489550,Eldon; John,67,0,100,33
1713335899912,CSE 141L,A01,489571,Eldon; John,65,0,100,35
1713335900943,CSE 151A,A01,489583,Solares; Edwin A,141,0,200,59
1713335901974,CSE 175,A01,510886,Kumar; Rakesh,30,0,30,0
1713335903000,CSE 190,A00,516828,Dubnov; Shlomo,37,0,49,12
1713335904026,DOC 100D,A00,489667,Pass; Natalye Joann,19,0,25,6
1713335905056,DSC 10,A01,624268,Staff,72,0,75,3
1713335906082,DSC 20,A01,624476,Staff,50,0,50,0
1713335907109,DSC 40A,A01,624608,Staff,39,0,40,1
1713335908135,DSGN 1,A01,489179,Rill; Bryan,32,0,50,18
1713335909169,ECE 17,A01,490489,Sahay; Rajeev,18,0,30,12
1713335910199,ECE 65,A50,490492,Staff,11,0,20,9
1713335910199,ECE 65,A51,490493,Staff,18,0,20,2
1713335911229,ECON 1,A01,489715,Famulari; Melissa,67,0,70,3
1713335912260,ECON 2,A01,489717,Levkoff; Steven B.,67,0,70,3
1713335913286,ECON 3,A01,489948,Staff,70,0,70,0
1713335915346,ECON 5,A01,490103,Staff,27,0,30,3
1713335915346,ECON 5,B01,626281,Dai; Yinlin,45,0,45,0
1713335916374,ECON 100A,A01,490127,Famulari; Melissa,63,0,70,7
1713335917403,ECON 100B,A01,490129,Staff,64,0,70,6
1713335918428,ECON 109,A01,490187,Shishkin; Denis,27,0,35,8
1713335919451,ECON 110A,A01,490190,Levkoff; Steven B.,59,0,70,11
1713335920533,ECON 120A,A01,490245,Dai; Yinlin,60,0,70,10
1713335921563,ECON 120B,A01,490247,Nieto-Barthaburu; Augusto,40,0,70,30
1713335922591,ECON 120C,A01,490253,Sun; Yixiao,30,0,35,5
1713335922591,ECON 120C,B01,490255,Sun; Yixiao,34,0,35,1
1713335923622,ECON 129,A00,490256,Eckert; Fabian Paul,22,0,35,13
1713335924655,ECON 131,A00,490257,Nieto-Barthaburu; Augusto,0,6,35,35
1713335925688,ECON 138,A00,490258,Bharadwaj; Prashant,13,0,35,22
1713335925688,ECON 138,B00,490259,Bharadwaj; Prashant,15,0,35,20
1713335926718,ECON 159,A00,490260,Hendrickson; Gerald M.,0,9,0,0
1713335927750,ECON 178,A01,553995,Zhu; Ying,24,0,35,11
1713335928776,EDS 40,A01,512576,Black; Alison Michelle,20,0,20,0
1713335929801,EDS 107,A01,515848,Staff,30,0,30,0
1713335930831,EDS 110R,A01,490262,Staff,26,0,30,4
1713335931856,EDS 112,A01,490264,Chapman; Thandeka K,40,0,50,10
1713335932886,EDS 113,A00,490266,Staff,26,0,30,4
1713335933915,EDS 118,A00,490267,Warstadt; Melissa Fawn,18,0,30,12
1713335934944,EDS 124BR,A00,490268,Eguchi; Emi,4,0,25,21
1713335934944,EDS 124BR,B00,490269,Eguchi; Emi,23,0,25,2
1713335935970,EDS 126,A01,490271,Jones; Makeba,43,0,50,7
1713335937004,EDS 135,A01,490316,Staff,19,0,20,1
1713335938030,ENVR 142GS,A00,519514,Chang; Edmond Yi-Teh,26,0,28,2
1713335939060,ETHN 103,A00,490504,Staff,25,0,36,11
1713335940087,ETHN 103A,A00,490505,Man; Simeon S,4,0,9,5
1713335941114,ETHN 109,A00,490506,Staff,28,0,30,2
1713335942138,ETHN 118,A00,490507,Staff,35,0,36,1
1713335943162,ETHN 119,A00,490508,Staff,33,0,36,3
1713335944192,ETHN 121R,A00,490518,Choi; Esther Min,21,0,36,15
1713335945218,ETHN 127,A00,490528,Staff,14,0,15,1
1713335946243,ETHN 139,A00,490573,Staff,10,0,10,0
1713335947267,ETHN 150,A00,490575,Staff,15,0,15,0
1713335948299,GLBH 20,A00,491705,Elwardani; Nile Regina,38,0,40,2
1713335949323,GLBH 101,A00,491706,Staff,20,0,20,0
1713335950351,GLBH 111,A01,491708,Burgos; Jose L.,15,0,15,0
1713335951375,GLBH 146,A00,491709,Staff,9,0,20,11
1713335952400,GLBH 148,A00,491710,Olivas Hernandez; Olga Lid,11,0,20,9
1713335953430,GLBH 150,A00,491711,Sloane; Julia Kathryn,19,0,20,1
1713335954461,HIEA 131,A00,491760,Staff,28,0,32,4
1713335955484,HIEA 153,A00,491762,Staff,28,0,30,2
1713335956508,HIEU 124,A00,491811,Staff,26,0,32,6
1713335957538,HIEU 124GS,A00,491812,Markman; Kristina,27,0,28,1
1713335958563,HIEU 147,A00,491813,Staff,30,0,32,2
1713335959589,HIEU 149GS,A00,491816,Caldwell; Michael Alan,28,0,28,0
1713335960617,HILD 2C,A01,491713,Hendrickson; Gerald M.,26,0,30,4
1713335961646,HILD 7B,A01,491715,Kwak; Nancy,0,2,30,30
1713335962671,HILD 10,A01,491717,Staff,9,0,20,11
1713335963696,HILD 30GS,A00,491719,Edington; Claire Ellen,23,0,28,5
1713335964724,HINE 109,A00,491818,Shafir; Nir,27,0,32,5
1713335965750,HINE 128,A00,491821,Shafir; Nir,31,0,32,1
1713335966777,HISC 117,A00,491830,Staff,27,0,32,5
1713335967806,HIUS 103,A00,491834,Man; Simeon S,14,0,23,9
1713335968831,HIUS 108B,A00,491835,Staff,27,0,30,3
1713335969857,HIUS 141,A00,491836,Hendrickson; Gerald M.,28,0,32,4
1713335970880,HIUS 149,A00,491839,Staff,24,0,32,8
1713335971908,HUM 3,A01,512617,Crum; Matthew Stephen,42,0,50,8
1713335971908,HUM 3,A02,512618,Crum; Matthew Stephen,48,0,50,2
1713335972933,HUM 3GS,A00,512663,Markman; Kristina,0,0,0,1
1713335972933,HUM 3GS,B00,512664,Staff,0,0,0,0
1713335973962,HUM 4,A01,512620,West; Geoffrey Scott,25,0,50,25
1713335974992,HUM 4GS,A00,512666,Lyon; Antony J.,0,0,0,5
1713335976023,HUM 4R,A01,512625,Watkins; Eric,49,0,50,1
1713335977054,HUM 5,A01,512649,Zavodny; Tatiana Sophia,20,0,50,30
1713335977054,HUM 5,B01,512661,Zroka; Ryan Edward,48,0,50,2
1713335978084,INTL 190,A00,490577,Segui; Alan S,0,0,0,5
1713335979115,JAPN 20AR,A01,491267,Ross; Kayoko F,7,0,20,13
1713335980140,JAPN 180,A00,491285,Berman; Michael David,33,0,40,7
1713335981170,LATI 50,A01,502536,Kokinis; Troy Andreas,16,0,22,6
1713335981170,LATI 50,A02,502551,Kokinis; Troy Andreas,22,0,22,0
1713335981170,LATI 50,A03,502650,Kokinis; Troy Andreas,22,0,22,0
1713335981170,LATI 50,A04,502909,Kokinis; Troy Andreas,21,0,22,1
1713335982193,LATI 160,A01,502920,Kokinis; Troy Andreas,30,0,30,0
1713335983219,LIFR 1A,A00,490494,Van Moer; Vinciane G,17,0,20,3
1713335984249,LIFR 1AX,A00,490495,Van Moer; Vinciane G,17,0,20,3
1713335985274,LIFR 1B,A00,490496,Van Moer; Vinciane G,17,0,20,3
1713335986303,LIFR 1BX,A00,490497,Van Moer; Vinciane G,17,0,20,3
1713335987332,LIGN 8,A00,505198,McIntosh; Justin Daniel,134,0,150,16
1713335988358,LIGN 9GS,A00,491239,Lott; Margaret S.,18,0,20,2
1713335989384,LIGN 101,A01,505200,McIntosh; Justin Daniel,22,0,30,8
1713335990410,LIGN 120,A01,491244,Staff,22,0,30,8
1713335991439,LIGN 149GS,A00,491245,Lott; Margaret S.,18,0,20,2
1713335992463,LIGN 170,A00,491247,Staff,22,0,30,8
1713335993489,LISP 1D,A00,490498,Munoz Sanchez; Alicia,8,0,14,6
1713335993489,LISP 1D,B00,490499,Munoz Sanchez; Alicia,6,0,14,8
1713335993489,LISP 1D,C00,490500,Munoz Sanchez; Alicia,7,0,14,7
1713335993489,LISP 1D,D00,490501,Munoz Sanchez; Alicia,10,0,14,4
1713335994514,LISP 1DX,A00,490502,Munoz Sanchez; Alicia,13,0,28,15
1713335994514,LISP 1DX,B00,490503,Munoz Sanchez; Alicia,16,0,28,12
1713335996569,LTAM 110,A00,491847,Staff,22,0,25,3
1713335997601,LTCS 119,A00,491848,Staff,11,0,15,4
1713335998630,LTCS 130,A00,491849,Staff,24,0,25,1
1713336000687,LTEA 120C,A00,491852,Staff,32,0,40,8
1713336001715,LTEN 130GS,A00,491853,Lyon; Antony J.,23,0,28,5
1713336002744,LTEN 148,A00,491855,Staff,23,0,25,2
1713336003769,LTEN 159,A00,491856,Staff,20,0,25,5
1713336004794,LTEN 180,A00,491857,Staff,8,0,15,7
1713336006848,LTSP 123GS,A00,505928,Bessett; Ryan Matthew,24,0,28,4
1713336007874,LTSP 174GS,A00,506037,Bessett; Ryan Matthew,24,0,28,4
1713336009926,LTWR 102,A00,491861,Staff,9,0,15,6
1713336010952,LTWR 106,A00,491862,Staff,8,0,15,7
1713336011978,MAE 11,A00,490930,Bahadori; Mohammad Yousef,95,0,100,5
1713336013006,MAE 30A,A00,490931,Qi; Huihui,37,0,40,3
1713336014037,MAE 101A,A00,491036,Sadeghizadeh; Zahra,92,0,100,8
1713336015063,MAE 101C,A00,491037,Seshadri; Kalyanasundaram,64,0,100,36
1713336016089,MAE 113,A00,491040,Seshadri; Kalyanasundaram,65,0,80,15
1713336017117,MAE 131A,A00,491041,Ghazinejad; Maziar,37,0,40,3
1713336018145,MAE 142,A00,491053,Staff,39,0,40,1
1713336019170,MAE 143A,A00,491054,Staff,31,0,50,19
1713336020196,MAE 150,A00,491092,Truong; Phuong Thi Ngoc,23,0,35,12
1713336021225,MATH 3C,A01,494031,Pardo Guerra; Sebastian,30,0,30,0
1713336021225,MATH 3C,A02,494032,Pardo Guerra; Sebastian,29,0,30,1
1713336022263,MATH 10A,A01,494034,Staff,27,0,30,3
1713336022263,MATH 10A,A02,494035,Staff,28,0,30,2
1713336022263,MATH 10A,B01,494037,Staff,27,0,30,3
1713336022263,MATH 10A,B02,494038,Staff,29,0,30,1
1713336023301,MATH 10B,A01,494040,Habib; Yousaf,22,0,30,8
1713336023301,MATH 10B,A02,494041,Habib; Yousaf,28,0,30,2
1713336023301,MATH 10B,A03,494042,Habib; Yousaf,29,0,30,1
1713336023301,MATH 10B,A04,494043,Habib; Yousaf,30,0,30,0
1713336023301,MATH 10B,B01,494045,Habib; Yousaf,25,0,30,5
1713336023301,MATH 10B,B02,494046,Habib; Yousaf,30,0,30,0
1713336023301,MATH 10B,B03,494047,Habib; Yousaf,30,0,30,0
1713336023301,MATH 10B,B04,494048,Habib; Yousaf,30,0,30,0
1713336024384,MATH 18,A01,494050,Kemp; Todd Aahron,25,0,30,5
1713336024384,MATH 18,A02,494051,Kemp; Todd Aahron,29,0,30,1
1713336024384,MATH 18,B01,494054,Kemp; Todd Aahron,25,0,30,5
1713336024384,MATH 18,B02,494055,Kemp; Todd Aahron,29,0,30,1
1713336025411,MATH 20A,A01,494059,Suk; Andrew Hoon,30,0,30,0
1713336026440,MATH 20B,A01,494061,Briones; Jor-el Thomas Caparas,33,0,35,2
1713336026440,MATH 20B,B01,494063,Bach; Quang Tran,34,0,35,1
1713336027474,MATH 20C,A01,494065,Staff,28,0,30,2
1713336027474,MATH 20C,A02,494066,Staff,30,0,30,0
1713336027474,MATH 20C,A03,494067,Staff,30,0,30,0
1713336027474,MATH 20C,A04,494068,Staff,30,0,30,0
1713336027474,MATH 20C,B01,494070,Zhang; Ming,24,0,30,6
1713336027474,MATH 20C,B02,494071,Zhang; Ming,27,0,30,3
1713336027474,MATH 20C,B03,494072,Zhang; Ming,29,0,30,1
1713336027474,MATH 20C,B04,494073,Zhang; Ming,29,0,30,1
1713336028502,MATH 20D,A01,494075,Staff,22,0,30,8
1713336028502,MATH 20D,A02,494076,Staff,29,0,30,1
1713336029527,MATH 20E,A01,494079,Staff,24,0,30,6
1713336029527,MATH 20E,A02,494080,Staff,26,0,30,4
1713336029527,MATH 20E,B01,494082,Staff,25,0,30,5
1713336029527,MATH 20E,B02,494083,Staff,25,0,30,5
1713336030552,MATH 103A,A01,494085,Aliabadi Sr.; Mohsen,13,0,30,17
1713336030552,MATH 103A,A02,494086,Aliabadi Sr.; Mohsen,28,0,30,2
1713336030552,MATH 103A,B01,494088,Aliabadi Sr.; Mohsen,21,0,30,9
1713336030552,MATH 103A,B02,494089,Aliabadi Sr.; Mohsen,27,0,30,3
1713336031586,MATH 109,A01,494091,Staff,30,0,30,0
1713336031586,MATH 109,A02,494092,Staff,29,0,30,1
1713336031586,MATH 109,B01,494094,Staff,27,0,30,3
1713336031586,MATH 109,B02,494095,Staff,29,0,30,1
1713336032612,MATH 142A,A01,494097,Chow; Bennett,14,0,30,16
1713336032612,MATH 142A,A02,494098,Chow; Bennett,23,0,30,7
1713336032612,MATH 142A,B01,494100,Chow; Bennett,19,0,30,11
1713336032612,MATH 142A,B02,494101,Chow; Bennett,29,0,30,1
1713336034662,MATH 168A,A01,516677,Dumitriu; Ioana,16,0,35,19
1713336035692,MATH 170A,A01,516679,Dumitriu; Ioana,18,0,30,12
1713336035692,MATH 170A,A02,516680,Dumitriu; Ioana,28,0,30,2
1713336036718,MATH 193A,A01,494107,Staff,13,0,30,17
1713336036718,MATH 193A,A02,494108,Staff,19,0,30,11
1713336036718,MATH 193A,A03,494109,Staff,29,0,30,1
1713336036718,MATH 193A,A04,494110,Staff,22,0,30,8
1713336039813,MGT 16,A00,491930,McKay; Michael J,92,0,98,6
1713336040843,MGT 18,A00,491992,McKay; Michael J,96,0,98,2
1713336041869,MGT 71,A00,492003,Staff,63,0,98,35
1713336042897,MGT 103,A00,505209,Eberhard; Craig A,80,0,98,18
1713336043925,MGT 131A,A00,505210,Anderson; John Charles,89,0,98,9
1713336045976,MGT 153,A00,492077,Perols; Johan Lars,17,0,90,73
1713336049060,MGT 164,A00,492222,McKay; Mary A,91,0,98,7
1713336050091,MGT 172,A00,492245,Staff,59,0,60,1
1713336050091,MGT 172,B00,505526,Hedges; Kathleen,65,0,98,33
1713336051116,MGT 181,A00,505669,Dunn; Louis Jean,79,0,98,19
1713336052142,MMW 14,A01,494399,Staff,15,0,28,13
1713336052142,MMW 14,A02,494400,Staff,25,0,28,3
1713336052142,MMW 14,A03,494401,Staff,28,0,28,0
1713336052142,MMW 14,A04,494402,Staff,28,0,28,0
1713336052142,MMW 14,B01,494404,Carreras; Maria Victoria,8,0,28,20
1713336052142,MMW 14,B02,494405,Carreras; Maria Victoria,25,0,28,3
1713336052142,MMW 14,B03,494406,Carreras; Maria Victoria,27,0,28,1
1713336052142,MMW 14,B04,494407,Carreras; Maria Victoria,28,0,28,0
1713336053172,MMW 14GS,A00,506250,Chang; Edmond Yi-Teh,0,0,0,0
1713336054203,MMW 121R,A01,494415,Adamiak; Patrick John,10,0,28,18
1713336054203,MMW 121R,A02,494416,Adamiak; Patrick John,24,0,28,4
1713336055229,MUS 1A,A01,494113,Staff,12,0,25,13
1713336055229,MUS 1A,A02,494114,Staff,24,0,25,1
1713336056255,MUS 4,A01,494116,Staff,23,0,25,2
1713336056255,MUS 4,A02,494117,Staff,22,0,25,3
1713336057279,MUS 5R,A01,494236,Dubnov; Shlomo,4,0,25,21
1713336057279,MUS 5R,A02,494237,Dubnov; Shlomo,25,0,25,0
1713336058314,MUS 6,A01,494122,Staff,9,0,25,16
1713336058314,MUS 6,A02,494123,Staff,23,0,25,2
1713336059344,MUS 7,A01,494125,Staff,16,0,25,9
1713336059344,MUS 7,A02,494126,Staff,24,0,25,1
1713336060375,MUS 11,A01,494128,Staff,23,0,25,2
1713336060375,MUS 11,A02,494129,Staff,24,0,25,1
1713336061401,MUS 13,A01,494131,Staff,25,0,25,0
1713336061401,MUS 13,A02,494132,Staff,25,0,25,0
1713336062433,MUS 15,A01,494134,Staff,16,0,25,9
1713336062433,MUS 15,A02,494135,Staff,25,0,25,0
1713336062433,MUS 15,B01,494137,Staff,24,0,25,1
1713336063458,MUS 80,A00,494232,Staff,24,0,25,1
1713336063458,MUS 80,B00,494233,Staff,25,0,25,0
1713336063458,MUS 80,C00,494234,Staff,23,0,25,2
1713336064489,MUS 95C,A00,494141,Staff,70,0,75,5
1713336065517,MUS 114,A00,494142,Staff,40,0,50,10
1713336066548,NANO 15,A01,490636,Drews; Aaron,7,0,7,0
1713336067579,PHIL 1,A00,490578,Grush; Rick Scott,49,0,50,1
1713336068608,PHIL 10,A01,490580,Grush; Rick Scott,33,0,35,2
1713336068608,PHIL 10,A02,490586,Grush; Rick Scott,32,0,35,3
1713336069638,PHIL 27,A01,490591,Staff,22,0,25,3
1713336069638,PHIL 27,A02,490592,Staff,25,0,25,0
1713336069638,PHIL 27,A03,490593,Staff,25,0,25,0
1713336069638,PHIL 27,A04,490598,Staff,25,0,25,0
1713336070665,PHIL 32,A01,490611,Staff,20,0,20,0
1713336070665,PHIL 32,A02,490618,Staff,20,0,20,0
1713336071696,PHIL 90,A00,490624,Staff,40,0,40,0
1713336072723,PHIL 136,A00,490627,Cohen; Jonathan David,37,0,40,3
1713336073749,PHIL 155,A00,490634,Staff,62,0,70,8
1713336074778,PHYS 1A,A00,491610,Staff,245,0,250,5
1713336075805,PHYS 1AL,001,491616,Tsai; Philbert S,27,0,30,3
1713336075805,PHYS 1AL,002,491618,Tsai; Philbert S,30,0,30,0
1713336076831,PHYS 1B,A00,491623,Staff,236,0,250,14
1713336077860,PHYS 1BL,001,491626,Tsai; Philbert S,21,0,30,9
1713336077860,PHYS 1BL,002,491628,Tsai; Philbert S,26,0,30,4
1713336078885,PHYS 1C,A00,491632,Staff,213,0,245,32
1713336079915,PHYS 1CL,001,491635,Tsai; Philbert S,3,0,30,27
1713336079915,PHYS 1CL,002,491643,Tsai; Philbert S,22,0,30,8
1713336080946,PHYS 2AR,A01,491651,Meyertholen; Andrew D.,44,0,50,6
1713336081971,PHYS 2B,A01,491659,Staff,106,0,115,9
1713336083002,PHYS 2BL,A01,491685,Staff,21,0,24,3
1713336083002,PHYS 2BL,A02,491700,Staff,21,0,24,3
1713336084029,PHYS 2C,A01,505161,Staff,101,0,115,14
1713336085056,PHYS 4A,A01,491704,Grinstein; Benjamin,99,0,100,1
1713336086089,POLI 5D,A01,494144,Staff,3,0,5,2
1713336086089,POLI 5D,B01,626283,Dai; Yinlin,5,0,5,0
1713336087114,POLI 12,A00,494145,Staff,43,0,45,2
1713336088141,POLI 13R,A00,494146,Forman; Fonna,45,0,50,5
1713336089166,POLI 27,A01,494148,Staff,54,0,60,6
1713336090194,POLI 30,A00,494149,Staff,49,0,50,1
1713336091219,POLI 100DA,A00,494150,Staff,20,0,25,5
1713336093272,POLI 100I,A00,494152,Staff,27,0,30,3
1713336094304,POLI 104B,A00,494153,Smith; Glenn Chatmas,53,0,55,2
1713336095330,POLI 104F,A00,494154,Staff,28,0,30,2
1713336096360,POLI 104I,A00,494155,Smith; Glenn Chatmas,29,0,30,1
1713336097387,POLI 110C,A00,494156,Ingham; Sean,23,0,25,2
1713336098414,POLI 117R,A00,494157,Forman; Fonna,5,0,20,15
1713336099441,POLI 118,A00,494158,Ingham; Sean,21,0,25,4
1713336100468,POLI 120H,A00,494159,Fisk; David Lee,39,0,45,6
1713336101495,POLI 131CR,A00,494160,Hoston; Germaine,35,0,45,10
1713336102521,POLI 133J,A00,494161,Staff,31,0,35,4
1713336103544,POLI 135,A00,494162,Fisk; David Lee,33,0,35,2
1713336104571,POLI 140A,A00,494164,Staff,18,0,30,12
1713336105597,POLI 142I,A00,494165,Staff,30,0,30,0
1713336106624,POLI 144D,A00,494166,Staff,23,0,25,2
1713336107647,POLI 151,A00,494167,Staff,30,0,30,0
1713336108676,POLI 153,A00,494168,Staff,33,0,35,2
1713336109701,POLI 160AA,A00,494169,Staff,34,0,40,6
1713336110730,POLI 162,A00,494170,Mignozzetti; Umberto,18,0,25,7
1713336111762,POLI 171,A00,494171,Mignozzetti; Umberto,18,0,25,7
1713336112786,PSYC 1,A00,494172,Staff,95,0,100,5
1713336113810,PSYC 2,A00,494173,Moranton; Nirelia Melbina-,34,0,50,16
1713336114836,PSYC 3,A00,494174,Staff,29,0,30,1
1713336115860,PSYC 6,A00,494175,Staff,17,0,20,3
1713336116889,PSYC 60,A01,494177,Staff,37,0,45,8
1713336117914,PSYC 70,A01,505724,Geller; Emma Harlan,42,0,45,3
1713336118945,PSYC 101,A00,494180,Heyman; Gail D.,84,0,100,16
1713336119971,PSYC 105,A00,494181,Geller; Emma Harlan,51,0,90,39
1713336120998,PSYC 106,A00,494182,Dobkins; Karen R.,26,0,45,19
1713336122026,PSYC 108,A00,494183,Adrian; Julia Anna,89,0,100,11
1713336123057,PSYC 114,A01,494185,Winkielman; Piotr,0,3,30,30
1713336124085,PSYC 122,A00,494186,Moranton; Nirelia Melbina-,27,0,50,23
1713336125110,PSYC 124,A00,494187,Chapman; Eddie Nathaniel,70,0,80,10
1713336126133,PSYC 131,A00,494188,Anagnostaras; Stephan,40,0,80,40
1713336127161,PSYC 144,A00,494189,Staff,1,0,50,49
1713336128244,PSYC 154,A00,494190,Lacefield; Katharine I,106,0,180,74
1713336129269,PSYC 162,A00,494191,Wixted; John T,71,0,100,29
1713336130294,PSYC 172,A00,494192,Gorman; Michael R.,36,0,45,9
1713336131325,PSYC 178,A00,494193,Glaser; Dale,34,0,45,11
1713336132349,PSYC 193,A00,505725,Chapman; Eddie Nathaniel,20,0,20,0
1713336133379,RELI 145GS,A00,519817,Rahimi; Babak,17,0,20,3
1713336134407,SE 101A,A01,490862,Chadha; Mayank,23,0,25,2
1713336135436,SE 101C,A01,490924,Krysl; Petr,15,0,20,5
1713336136461,SE 110A,A01,490928,Staff,19,0,20,1
1713336137488,SE 130A,A00,490929,Morrison; Machel Leigh,54,0,70,16
1713336138513,SIO 1,A01,519325,Staff,39,0,40,1
1713336139543,SIO 30,A01,519327,Staff,38,0,40,2
1713336140569,SIO 40,A00,519328,Staff,39,0,40,1
1713336141598,SIO 46GS,A00,519819,Cook; Geoffrey W,17,0,25,8
1713336142624,SIO 109R,A00,494197,Forman; Fonna,0,3,20,20
1713336143652,SIO 121GS,A00,519827,Cook; Geoffrey W,17,0,25,8
1713336144682,SIO 132,A01,519330,Staff,38,0,40,2
1713336145707,SIO 133,A01,519397,Staff,37,0,40,3
1713336146733,SIO 139,A00,519396,Kacev; David,29,0,40,11
1713336147766,SOCI 1,A01,494199,Thorpe; Charles Robert,21,0,30,9
1713336147766,SOCI 1,A02,494200,Thorpe; Charles Robert,30,0,30,0
1713336147766,SOCI 1,A03,494201,Thorpe; Charles Robert,29,0,30,1
1713336147766,SOCI 1,A04,494202,Thorpe; Charles Robert,29,0,30,1
1713336147766,SOCI 1,A05,494203,Thorpe; Charles Robert,29,0,30,1
1713336147766,SOCI 1,A06,494204,Thorpe; Charles Robert,30,0,30,0
1713336147766,SOCI 1,A07,494205,Thorpe; Charles Robert,28,0,30,2
1713336148797,SOCI 60,A01,494207,Staff,34,0,40,6
1713336148797,SOCI 60,A02,494208,Staff,39,0,40,1
1713336149827,SOCI 100,A01,494210,Payne; Christine Anna,25,0,30,5
1713336149827,SOCI 100,A02,494211,Payne; Christine Anna,26,0,30,4
1713336150852,SOCI 109M,A00,494212,Staff,20,0,20,0
1713336151880,SOCI 110,A00,494213,Staff,34,0,40,6
1713336153931,SOCI 118E,A00,494215,Ng; Kwai,37,0,40,3
1713336154956,SOCI 125,A00,494216,Calderon-Zaks; Michael Aar,40,0,45,5
1713336155983,SOCI 126,A01,494218,Jones; Makeba,3,0,5,2
1713336157010,SOCI 131,A00,494219,Thorpe; Charles Robert,26,0,30,4
1713336159062,SOCI 135,A00,494221,Payne; Christine Anna,28,0,50,22
1713336160086,SOCI 136E,A00,626690,Ruiz; Jonathan Joseph,24,0,25,1
1713336161146,SOCI 138GS,A00,494222,Navon; Daniel,23,0,28,5
1713336163199,SOCI 145,A00,494224,Staff,40,0,45,5
1713336164224,SOCI 153,A00,494225,Staff,28,0,30,2
1713336165253,SOCI 160E,A00,494226,Ng; Kwai,27,0,40,13
1713336166279,SOCI 180,A00,494227,Staff,29,0,30,1
1713336167309,SOCI 189GS,A00,494228,Ribas Norris; Janet Vanesa,11,0,11,0
1713336168334,SOCI 190GS,A00,553232,Ribas Norris; Janet Vanesa,11,0,11,0
1713336169360,SOMI 220,A00,627178,Schneid; Stephen David,30,0,30,0
1713336170387,SYN 2,001,490768,Staff,13,0,15,2
1713336170387,SYN 2,002,490769,Staff,14,0,15,1
1713336170387,SYN 2,004,490775,Staff,0,0,0,0
1713336170387,SYN 2,003,490774,Staff,0,0,0,0
1713336170387,SYN 2,005,490776,Staff,0,0,0,0
1713336171410,SYN 2R,001,490779,Staff,11,0,15,4
1713336171410,SYN 2R,002,514635,Staff,14,0,15,1
1713336172440,SYN 100,A01,490783,Staff,9,0,20,11
1713336172440,SYN 100,B01,490787,Staff,9,0,20,11
1713336172440,SYN 100,C01,490789,Staff,10,0,20,10
1713336173472,SYN 150,A00,490817,Staff,14,0,15,1
1713336173472,SYN 150,B00,514610,Staff,15,0,15,0
1713336174512,TDAC 1,A00,492753,Walsh; Kim C.,19,0,20,1
1713336174512,TDAC 1,B00,492754,Harting; Carla Kelso,19,0,20,1
1713336174512,TDAC 1,C00,513995,Salovey; Todd,15,0,20,5
1713336175536,TDAC 101,A00,492766,Harting; Carla Kelso,17,0,20,3
1713336176561,TDAC 102,A00,492768,Basso; Beatrice,19,0,20,1
1713336177591,TDDE 111,A00,492769,Staff,25,0,25,0
1713336178620,TDDE 131,A00,492770,Staff,15,0,15,0
1713336178620,TDDE 131,B00,492771,Staff,15,0,15,0
1713336179646,TDDE 131GS,A00,523716,Guirguis; Mark C,23,0,28,5
1713336180680,TDGE 1,A01,492756,Salovey; Todd,56,0,60,4
1713336181708,TDGE 5,A01,492758,Staff,23,0,25,2
1713336182735,TDGE 10,A00,492759,Fulton; Julia,203,0,220,17
1713336183766,TDGE 11,A00,492760,Castro; Robert Jess,198,0,200,2
1713336185824,TDGE 124,A00,492772,Fulton; Julia,182,0,220,38
1713336186849,TDGE 125,A00,492773,Meyer; Ursula,38,0,50,12
1713336186849,TDGE 125,B00,492774,Staff,49,0,50,1
1713336186849,TDGE 125,C00,523565,Staff,48,0,50,2
1713336187877,TDGE 125GS,A00,523580,Guirguis; Mark C,23,0,28,5
1713336188906,TDGE 127,A00,492775,Havis; Allan,32,0,50,18
1713336189930,TDHT 101,A00,492776,Staff,34,0,35,1
1713336190958,TDMV 1,A00,492762,Caligagan; Maria T.,29,0,30,1
1713336190958,TDMV 1,B00,492763,Arcidiacono; Kristin,26,0,30,4
1713336192092,TDMV 2,A00,492764,Weinberg; Sadie,28,0,30,2
1713336193122,TDMV 3,A00,492765,Mack; Kara Shanai',37,0,40,3
1713336194150,TDMV 138,A00,492777,Mack; Kara Shanai',33,0,40,7
1713336195179,TDMV 140,A00,492778,Lima; Paulo Henrique,40,0,40,0
1713336196209,TDMV 142,A00,492779,Caligagan; Maria T.,33,0,40,7
1713336196209,TDMV 142,B00,492780,Caligagan; Tony,37,0,40,3
1713336197233,TDMV 143,A00,492781,Fyall; Daunte Edward,39,0,40,1
1713336198260,USP 1,A01,492401,Kwak; Nancy,27,0,35,8
1713336199289,USP 2,A01,492453,Hinds; Juli Beth,35,0,35,0
1713336200311,USP 3,A01,492516,Staff,28,0,35,7
1713336201339,USP 4,A00,492522,McTague; Sarah,16,0,25,9
1713336202368,USP 100,A00,492523,Staff,32,0,35,3
1713336203392,USP 101,A00,492524,Staff,13,0,15,2
1713336204418,USP 105,A00,492525,Staff,21,0,25,4
1713336205442,USP 151,A00,492526,Shenkman; Michael Thomas,32,0,35,3
1713336206471,USP 170,A00,492545,Hinds; Juli Beth,33,0,35,2
1713336207498,USP 171GS,A00,492608,Bussell; Mirle Rabinowitz,24,0,28,4
1713336208526,USP 183GS,A00,492613,Peerson; Susan,24,0,28,4
1713336209552,VIS 30,A01,490693,Yoldas; Pinar,19,0,22,3
1713336209552,VIS 30,A02,490694,Yoldas; Pinar,18,0,22,4
1713336210577,VIS 83,A00,490695,Kester; Grant,63,0,75,12
1713336211605,VIS 105D,A00,490696,Staff,22,0,25,3
1713336212629,VIS 124CN,A00,490699,Rose; Jordan M,65,0,75,10
1713336213659,VIS 125GS,A00,511221,Williams; Alena J,21,0,22,1
1713336214683,VIS 128D,A00,490700,Staff,73,0,75,2
1713336215711,VIS 151,A01,490717,Staff,33,0,34,1
1713336215711,VIS 151,A02,490766,Staff,33,0,34,1
1713336216737,VIS 154GS,A00,511972,Williams; Alena J,21,0,22,1
1713336217766,VIS 160A,A00,490767,Stone; Patricia,7,0,10,3
1713336218794,WCWP 10A,A00,490638,Staff,14,0,15,1
1713336218794,WCWP 10A,B00,490640,Staff,15,0,15,0
1713336219818,WCWP 10B,A00,490641,Staff,0,0,0,0
1713336219818,WCWP 10B,B00,490642,Staff,14,0,15,1
1713336219818,WCWP 10B,C00,490644,Staff,13,0,15,2
1713336219818,WCWP 10B,D00,490647,Staff,0,0,0,0
1713336220846,WCWP 100,A00,490655,Staff,0,0,0,0
1713336220846,WCWP 100,B00,490687,Staff,10,0,15,5
1713336222940,ANAR 153,A00,487222,Braswell; Geoffrey E.,53,0,60,7
1713336223966,ANBI 134,A00,487223,Staff,6,0,20,14
1713336224997,ANBI 143GS,A00,487224,Noel; Geoffroy Pierre Jean,18,0,24,6
1713336226026,ANBI 144GS,A00,519548,Noel; Geoffroy Pierre Jean,18,0,24,6
1713336227055,ANSC 101,A00,487225,Staff,18,0,20,2
1713336228085,ANSC 125,A00,487227,Brenner; Suzanne A,38,0,40,2
1713336230138,ANSC 146,A00,487229,Staff,35,0,40,5
1713336231166,ANSC 148,A00,487230,Olivas Hernandez; Olga Lid,39,0,40,1
1713336232253,ANSC 150,A00,504165,Sloane; Julia Kathryn,18,0,20,2
1713336233278,ANSC 180,A00,487232,Staff,14,0,15,1
1713336234303,ANSC 188,A00,627155,Staff,38,0,40,2
1713336235328,ANTH 5,A00,519529,Semendeferi; Ekaterini,15,0,15,0
1713336236358,ANTH 10,A00,487219,Staff,58,0,60,2
1713336237381,ANTH 23,A01,487221,Staff,17,0,20,3
1713336238407,ANTH 102,A00,487233,Wilder; Linnea Lorene,51,0,60,9
1713336239436,ANTH 103,A00,487234,Varma; Saiba,54,0,60,6
1713336240465,ANTH 105,A00,487235,Stewart; Alexander B,54,0,60,6
1713336241495,BENG 100,A01,516685,Taylor Amos; Alyssa C,26,0,30,4
1713336242522,BIBC 102,A01,491316,Flagg; Matthew Paul,7,0,88,81
1713336242522,BIBC 102,A02,491366,Flagg; Matthew Paul,78,0,88,10
1713336243553,BIBC 103,A01,491486,Boumechache; Miyyada,16,0,24,8
1713336243553,BIBC 103,A02,491487,Boumechache; Miyyada,24,0,24,0
1713336244584,BICD 100,A01,516882,Staff,73,0,75,2
1713336244584,BICD 100,A02,516890,Staff,69,0,75,6
1713336245613,BICD 102GS,A00,491488,Lo; Stanley M.,26,0,28,2
1713336246643,BIEB 136GS,A00,516940,Holway; David A. & Shurin; Jonathan,18,0,24,6
1713336247669,BIEB 137GS,A01,517034,Holway; David A. & Shurin; Jonathan,18,0,24,6
1713336248694,BIEB 138GS,A01,491492,Pirino; Giorgia,21,0,28,7
1713336249718,BILD 1,A01,491296,Staff,60,0,63,3
1713336249718,BILD 1,A02,491297,Staff,63,0,63,0
1713336250745,BILD 4,A01,517099,Gonzalez Gamboa; Ivonne,22,0,24,2
1713336250745,BILD 4,A02,517100,Gonzalez Gamboa; Ivonne,24,0,24,0
1713336251770,BILD 60GS,A00,491309,Lo; Stanley M.,26,0,28,2
1713336252804,BIMM 100,A01,517136,Staff,82,0,100,18
1713336253829,BIMM 110,A01,517182,Staff,53,0,100,47
1713336254860,BIMM 120,A01,517228,Pickett; Brooke Elizabeth,28,0,63,35
1713336254860,BIMM 120,A02,517240,Pickett; Brooke Elizabeth,44,0,63,19
1713336255886,BIMM 132GS,A01,491498,Pirino; Giorgia,21,0,28,7
1713336256913,BIMM 143,A01,491589,Bozinovic; Goran,12,0,40,28
1713336257940,BIPN 100,A01,491594,Armour; Jon Christopher,83,0,100,17
1713336258969,BIPN 140,A01,491602,Marino; Marc J,23,0,50,27
1713336261025,CAT 125,A00,515973,Staff,18,0,20,2
1713336262052,CAT 125GS,A00,515974,Rahimi; Babak,16,0,20,4
1713336263085,CAT 125R,A00,515980,Staff,12,0,20,8
1713336263085,CAT 125R,B00,515981,Tosun; Adriana,19,0,20,1
1713336263085,CAT 125R,C00,515987,Hyland; Tina Mae,0,3,20,20
1713336263085,CAT 125R,D00,515988,Bronstein; Phoebe Malan,16,0,20,4
1713336264112,CENG 15,A01,488699,Drews; Aaron,25,0,25,0
1713336265146,CENG 100,A00,505196,Opatkiewicz; Justin Paul,25,0,25,0
1713336266175,CGS 2A,A01,489598,Staff,33,0,35,2
1713336267200,CGS 112,A00,489599,Staff,15,0,15,0
1713336268229,CGS 119,A00,489603,Staff,10,0,10,0
1713336269252,CGS 120,A00,489604,Staff,13,0,15,2
1713336270277,CGS 150,A00,489607,Staff,15,0,15,0
1713336271307,CHEM 6A,A01,488715,Staff,97,0,100,3
1713336272337,CHEM 6B,A01,488719,Piercy; Marc Anthony,99,0,100,1
1713336273367,CHEM 6C,A01,488723,Albizati; Kim F.,93,0,100,7
1713336274401,CHEM 7L,A01,488728,Schurmeier; Kimberly,18,0,24,6
1713336274401,CHEM 7L,A02,488730,Schurmeier; Kimberly,23,0,24,1
1713336274401,CHEM 7L,A03,488734,Schurmeier; Kimberly,20,0,24,4
1713336274401,CHEM 7L,A04,488763,Schurmeier; Kimberly,23,0,24,1
1713336274401,CHEM 7L,B01,488798,Schurmeier; Kimberly,17,0,24,7
1713336274401,CHEM 7L,B02,488801,Schurmeier; Kimberly,22,0,24,2
1713336274401,CHEM 7L,B03,488808,Schurmeier; Kimberly,22,0,24,2
1713336274401,CHEM 7L,B04,488811,Schurmeier; Kimberly,24,0,24,0
1713336275425,CHEM 11,A01,488897,Stallings; Dontarie M,95,0,100,5
1713336276450,CHEM 40A,A01,488913,Albizati; Kim F.,83,0,100,17
1713336277475,CHEM 40B,A01,488920,Weizman; Haim,43,0,50,7
1713336277475,CHEM 40B,A02,488938,Weizman; Haim,44,0,50,6
1713336278501,CHEM 41A,A01,489029,Klosterman; Jeremy K,57,0,60,3
1713336279526,CHEM 41C,A01,500436,Tor; Yitzhak,55,0,60,5
1713336280552,CHEM 43A,A01,500426,Weizman; Haim,0,1,24,24
1713336280552,CHEM 43A,A02,500430,Weizman; Haim,6,0,24,18
1713336280552,CHEM 43A,B01,514041,Klosterman; Jeremy K,16,0,24,8
1713336280552,CHEM 43A,B02,514047,Klosterman; Jeremy K,23,0,24,1
1713336281584,CHEM 108,A01,489140,Jennings; Patricia A.,7,0,24,17
1713336281584,CHEM 108,A02,489142,Jennings; Patricia A.,14,0,24,10
1713336282609,CHEM 114A,A01,489147,Stallings; Dontarie M,66,0,100,34
1713336283635,CHIN 169A,A00,489171,Wang; Xiao,19,0,20,1
1713336285683,COGS 3,A01,518827,Boyle; Mary E. T.,25,0,40,15
1713336286707,COGS 11,A01,489175,Staff,27,0,30,3
1713336287733,COGS 14A,A01,518829,Staff,51,0,60,9
1713336288764,COGS 14B,A01,489177,Hoffman; Drew Ellen,62,0,75,13
1713336289791,COGS 100,A01,489181,Allen; Michael Gordon,62,0,75,13
1713336290822,COGS 101A,A01,489183,Staff,45,0,60,15
1713336291847,COGS 101B,A01,489185,Allen; Michael Gordon,8,0,30,22
1713336292876,COGS 101C,A01,526786,Staff,23,0,30,7
1713336294933,COGS 107A,A01,489189,Boyle; Mary E. T.,16,0,35,19
1713336295962,COGS 107B,A01,627144,Mooshagian; Eric Frederick,60,0,60,0
1713336296986,COGS 118A,A01,489191,Staff,0,46,40,40
1713336299037,COGS 171GS,A01,489194,Pineda; Jaime A,19,0,28,9
1713336300068,COGS 172,A01,489196,Staff,2,0,30,28
1713336301094,COGS 174GS,A01,489264,Pineda; Jaime A,19,0,28,9
1713336302125,COGS 180,A01,627150,Staff,28,0,30,2
1713336303159,COGS 186,A01,489274,Staff,0,2,30,30
1713336304189,COMM 10,A01,489276,Staff,23,0,25,2
1713336304189,COMM 10,A02,489303,Staff,23,0,25,2
1713336305217,COMM 100A,A01,489312,Staff,14,0,25,11
1713336305217,COMM 100A,A02,489313,Staff,24,0,25,1
1713336306242,COMM 106T,A00,512540,Staff,33,0,35,2
1713336307271,COMM 107,A00,489347,Staff,27,0,35,8
1713336308298,COMM 109P,A00,489358,Staff,31,0,35,4
1713336309324,COMM 132,A00,489361,McKenna; Denise,27,0,30,3
1713336310353,COMM 146,A00,489362,Halm; Gavin Patrick,26,0,30,4
1713336311378,COMM 190,A00,489363,Abuelhiga; Soraya Jill,17,0,23,6
1713336312404,CSE 8A,A50,489366,Staff,21,0,25,4
1713336312404,CSE 8A,A51,489367,Staff,24,0,25,1
1713336313435,CSE 11,A01,489398,Cao; Yingjun,72,0,100,28
1713336314460,CSE 12,A01,489487,Staff,43,0,50,7
1713336315484,CSE 20,A01,489497,Staff,47,0,50,3
1713336316515,CSE 21,A01,489517,Braun; Oliver,42,0,50,8
1713336317545,CSE 101,A01,489524,Braun; Oliver,0,32,50,50
1713336318571,CSE 105,A01,512594,Jones; Miles E,72,0,100,28
1713336318571,CSE 105,B01,512598,Jones; Miles E,52,0,100,48
1713336319599,CSE 140,A01,489538,Staff,41,0,50,9
1713336320627,CSE 141,A01,489550,Eldon; John,67,0,100,33
1713336321652,CSE 141L,A01,489571,Eldon; John,65,0,100,35
1713336322679,CSE 151A,A01,489583,Solares; Edwin A,141,0,200,59
1713336323702,CSE 175,A01,510886,Kumar; Rakesh,30,0,30,0
1713336324728,CSE 190,A00,516828,Dubnov; Shlomo,37,0,49,12
1713336325758,DOC 100D,A00,489667,Pass; Natalye Joann,19,0,25,6
1713336326788,DSC 10,A01,624268,Staff,72,0,75,3
1713336327813,DSC 20,A01,624476,Staff,50,0,50,0
1713336328841,DSC 40A,A01,624608,Staff,39,0,40,1
1713336329866,DSGN 1,A01,489179,Rill; Bryan,32,0,50,18
1713336330892,ECE 17,A01,490489,Sahay; Rajeev,18,0,30,12
1713336331918,ECE 65,A50,490492,Staff,11,0,20,9
1713336331918,ECE 65,A51,490493,Staff,18,0,20,2
1713336332948,ECON 1,A01,489715,Famulari; Melissa,67,0,70,3
1713336333972,ECON 2,A01,489717,Levkoff; Steven B.,67,0,70,3
1713336335002,ECON 3,A01,489948,Staff,70,0,70,0
1713336337109,ECON 5,A01,490103,Staff,27,0,30,3
1713336337109,ECON 5,B01,626281,Dai; Yinlin,45,0,45,0
1713336338140,ECON 100A,A01,490127,Famulari; Melissa,63,0,70,7
1713336339166,ECON 100B,A01,490129,Staff,64,0,70,6
1713336340196,ECON 109,A01,490187,Shishkin; Denis,27,0,35,8
1713336341237,ECON 110A,A01,490190,Levkoff; Steven B.,59,0,70,11
1713336342267,ECON 120A,A01,490245,Dai; Yinlin,60,0,70,10
1713336343291,ECON 120B,A01,490247,Nieto-Barthaburu; Augusto,40,0,70,30
1713336344322,ECON 120C,A01,490253,Sun; Yixiao,30,0,35,5
1713336344322,ECON 120C,B01,490255,Sun; Yixiao,34,0,35,1
1713336345347,ECON 129,A00,490256,Eckert; Fabian Paul,22,0,35,13
1713336346374,ECON 131,A00,490257,Nieto-Barthaburu; Augusto,0,6,35,35
1713336347403,ECON 138,A00,490258,Bharadwaj; Prashant,13,0,35,22
1713336347403,ECON 138,B00,490259,Bharadwaj; Prashant,15,0,35,20
1713336348432,ECON 159,A00,490260,Hendrickson; Gerald M.,0,9,0,0
1713336349459,ECON 178,A01,553995,Zhu; Ying,24,0,35,11
1713336350484,EDS 40,A01,512576,Black; Alison Michelle,20,0,20,0
1713336351508,EDS 107,A01,515848,Staff,30,0,30,0
1713336352531,EDS 110R,A01,490262,Staff,26,0,30,4
1713336353558,EDS 112,A01,490264,Chapman; Thandeka K,40,0,50,10
1713336354583,EDS 113,A00,490266,Staff,26,0,30,4
1713336355607,EDS 118,A00,490267,Warstadt; Melissa Fawn,18,0,30,12
1713336356632,EDS 124BR,A00,490268,Eguchi; Emi,4,0,25,21
1713336356632,EDS 124BR,B00,490269,Eguchi; Emi,23,0,25,2
1713336357663,EDS 126,A01,490271,Jones; Makeba,43,0,50,7
1713336358690,EDS 135,A01,490316,Staff,19,0,20,1
1713336359718,ENVR 142GS,A00,519514,Chang; Edmond Yi-Teh,26,0,28,2
1713336360743,ETHN 103,A00,490504,Staff,25,0,36,11
1713336361776,ETHN 103A,A00,490505,Man; Simeon S,4,0,9,5
1713336362805,ETHN 109,A00,490506,Staff,28,0,30,2
1713336363831,ETHN 118,A00,490507,Staff,35,0,36,1
1713336364855,ETHN 119,A00,490508,Staff,32,0,36,4
1713336365881,ETHN 121R,A00,490518,Choi; Esther Min,21,0,36,15
1713336366907,ETHN 127,A00,490528,Staff,14,0,15,1
1713336367931,ETHN 139,A00,490573,Staff,10,0,10,0
1713336368957,ETHN 150,A00,490575,Staff,15,0,15,0
1713336369983,GLBH 20,A00,491705,Elwardani; Nile Regina,38,0,40,2
1713336371011,GLBH 101,A00,491706,Staff,20,0,20,0
1713336372046,GLBH 111,A01,491708,Burgos; Jose L.,15,0,15,0
1713336373072,GLBH 146,A00,491709,Staff,9,0,20,11
1713336374099,GLBH 148,A00,491710,Olivas Hernandez; Olga Lid,11,0,20,9
1713336375125,GLBH 150,A00,491711,Sloane; Julia Kathryn,19,0,20,1
1713336376156,HIEA 131,A00,491760,Staff,28,0,32,4
1713336377181,HIEA 153,A00,491762,Staff,28,0,30,2
1713336378203,HIEU 124,A00,491811,Staff,26,0,32,6
1713336379229,HIEU 124GS,A00,491812,Markman; Kristina,27,0,28,1
1713336380254,HIEU 147,A00,491813,Staff,30,0,32,2
1713336381282,HIEU 149GS,A00,491816,Caldwell; Michael Alan,28,0,28,0
1713336382308,HILD 2C,A01,491713,Hendrickson; Gerald M.,26,0,30,4
1713336383334,HILD 7B,A01,491715,Kwak; Nancy,0,2,30,30
1713336384363,HILD 10,A01,491717,Staff,9,0,20,11
1713336385387,HILD 30GS,A00,491719,Edington; Claire Ellen,23,0,28,5
1713336386417,HINE 109,A00,491818,Shafir; Nir,27,0,32,5
1713336387441,HINE 128,A00,491821,Shafir; Nir,31,0,32,1
1713336388467,HISC 117,A00,491830,Staff,27,0,32,5
1713336389496,HIUS 103,A00,491834,Man; Simeon S,14,0,23,9
1713336390525,HIUS 108B,A00,491835,Staff,27,0,30,3
1713336391554,HIUS 141,A00,491836,Hendrickson; Gerald M.,28,0,32,4
1713336392578,HIUS 149,A00,491839,Staff,24,0,32,8
1713336393604,HUM 3,A01,512617,Crum; Matthew Stephen,42,0,50,8
1713336393604,HUM 3,A02,512618,Crum; Matthew Stephen,48,0,50,2
1713336394632,HUM 3GS,A00,512663,Markman; Kristina,0,0,0,1
1713336394632,HUM 3GS,B00,512664,Staff,0,0,0,0
1713336395663,HUM 4,A01,512620,West; Geoffrey Scott,25,0,50,25
1713336396689,HUM 4GS,A00,512666,Lyon; Antony J.,0,0,0,5
1713336397715,HUM 4R,A01,512625,Watkins; Eric,49,0,50,1
1713336398746,HUM 5,A01,512649,Zavodny; Tatiana Sophia,20,0,50,30
1713336398746,HUM 5,B01,512661,Zroka; Ryan Edward,48,0,50,2
1713336399774,INTL 190,A00,490577,Segui; Alan S,0,0,0,5
1713336400820,JAPN 20AR,A01,491267,Ross; Kayoko F,7,0,20,13
1713336401846,JAPN 180,A00,491285,Berman; Michael David,33,0,40,7
1713336402871,LATI 50,A01,502536,Kokinis; Troy Andreas,16,0,22,6
1713336402871,LATI 50,A02,502551,Kokinis; Troy Andreas,22,0,22,0
1713336402871,LATI 50,A03,502650,Kokinis; Troy Andreas,22,0,22,0
1713336402871,LATI 50,A04,502909,Kokinis; Troy Andreas,21,0,22,1
1713336403900,LATI 160,A01,502920,Kokinis; Troy Andreas,30,0,30,0
1713336404927,LIFR 1A,A00,490494,Van Moer; Vinciane G,17,0,20,3
1713336405956,LIFR 1AX,A00,490495,Van Moer; Vinciane G,17,0,20,3
1713336406980,LIFR 1B,A00,490496,Van Moer; Vinciane G,17,0,20,3
1713336408007,LIFR 1BX,A00,490497,Van Moer; Vinciane G,17,0,20,3
1713336409032,LIGN 8,A00,505198,McIntosh; Justin Daniel,134,0,150,16
1713336410059,LIGN 9GS,A00,491239,Lott; Margaret S.,18,0,20,2
1713336411083,LIGN 101,A01,505200,McIntosh; Justin Daniel,22,0,30,8
1713336412111,LIGN 120,A01,491244,Staff,22,0,30,8
1713336413139,LIGN 149GS,A00,491245,Lott; Margaret S.,18,0,20,2
1713336414166,LIGN 170,A00,491247,Staff,22,0,30,8
1713336415196,LISP 1D,A00,490498,Munoz Sanchez; Alicia,8,0,14,6
1713336415196,LISP 1D,B00,490499,Munoz Sanchez; Alicia,6,0,14,8
1713336415196,LISP 1D,C00,490500,Munoz Sanchez; Alicia,7,0,14,7
1713336415196,LISP 1D,D00,490501,Munoz Sanchez; Alicia,10,0,14,4
1713336416221,LISP 1DX,A00,490502,Munoz Sanchez; Alicia,13,0,28,15
1713336416221,LISP 1DX,B00,490503,Munoz Sanchez; Alicia,16,0,28,12
1713336418272,LTAM 110,A00,491847,Staff,22,0,25,3
1713336419298,LTCS 119,A00,491848,Staff,11,0,15,4
1713336420330,LTCS 130,A00,491849,Staff,24,0,25,1
1713336422387,LTEA 120C,A00,491852,Staff,32,0,40,8
1713336423414,LTEN 130GS,A00,491853,Lyon; Antony J.,23,0,28,5
1713336424443,LTEN 148,A00,491855,Staff,23,0,25,2
1713336425470,LTEN 159,A00,491856,Staff,20,0,25,5
1713336426495,LTEN 180,A00,491857,Staff,8,0,15,7
1713336428550,LTSP 123GS,A00,505928,Bessett; Ryan Matthew,24,0,28,4
1713336429577,LTSP 174GS,A00,506037,Bessett; Ryan Matthew,24,0,28,4
1713336431632,LTWR 102,A00,491861,Staff,9,0,15,6
1713336432656,LTWR 106,A00,491862,Staff,8,0,15,7
1713336433688,MAE 11,A00,490930,Bahadori; Mohammad Yousef,95,0,100,5
1713336434714,MAE 30A,A00,490931,Qi; Huihui,37,0,40,3
1713336435740,MAE 101A,A00,491036,Sadeghizadeh; Zahra,92,0,100,8
1713336436770,MAE 101C,A00,491037,Seshadri; Kalyanasundaram,64,0,100,36
1713336437794,MAE 113,A00,491040,Seshadri; Kalyanasundaram,65,0,80,15
1713336438818,MAE 131A,A00,491041,Ghazinejad; Maziar,37,0,40,3
1713336439900,MAE 142,A00,491053,Staff,39,0,40,1
1713336440924,MAE 143A,A00,491054,Staff,31,0,50,19
1713336441950,MAE 150,A00,491092,Truong; Phuong Thi Ngoc,23,0,35,12
1713336442975,MATH 3C,A01,494031,Pardo Guerra; Sebastian,30,0,30,0
1713336442975,MATH 3C,A02,494032,Pardo Guerra; Sebastian,29,0,30,1
1713336444003,MATH 10A,A01,494034,Staff,27,0,30,3
1713336444003,MATH 10A,A02,494035,Staff,28,0,30,2
1713336444003,MATH 10A,B01,494037,Staff,27,0,30,3
1713336444003,MATH 10A,B02,494038,Staff,29,0,30,1
1713336445032,MATH 10B,A01,494040,Habib; Yousaf,22,0,30,8
1713336445032,MATH 10B,A02,494041,Habib; Yousaf,28,0,30,2
1713336445032,MATH 10B,A03,494042,Habib; Yousaf,29,0,30,1
1713336445032,MATH 10B,A04,494043,Habib; Yousaf,30,0,30,0
1713336445032,MATH 10B,B01,494045,Habib; Yousaf,25,0,30,5
1713336445032,MATH 10B,B02,494046,Habib; Yousaf,30,0,30,0
1713336445032,MATH 10B,B03,494047,Habib; Yousaf,30,0,30,0
1713336445032,MATH 10B,B04,494048,Habib; Yousaf,30,0,30,0
1713336446060,MATH 18,A01,494050,Kemp; Todd Aahron,25,0,30,5
1713336446060,MATH 18,A02,494051,Kemp; Todd Aahron,29,0,30,1
1713336446060,MATH 18,B01,494054,Kemp; Todd Aahron,25,0,30,5
1713336446060,MATH 18,B02,494055,Kemp; Todd Aahron,29,0,30,1
1713336447089,MATH 20A,A01,494059,Suk; Andrew Hoon,30,0,30,0
1713336448115,MATH 20B,A01,494061,Briones; Jor-el Thomas Caparas,33,0,35,2
1713336448115,MATH 20B,B01,494063,Bach; Quang Tran,34,0,35,1
1713336449144,MATH 20C,A01,494065,Staff,28,0,30,2
1713336449144,MATH 20C,A02,494066,Staff,30,0,30,0
1713336449144,MATH 20C,A03,494067,Staff,30,0,30,0
1713336449144,MATH 20C,A04,494068,Staff,30,0,30,0
1713336449144,MATH 20C,B01,494070,Zhang; Ming,24,0,30,6
1713336449144,MATH 20C,B02,494071,Zhang; Ming,27,0,30,3
1713336449144,MATH 20C,B03,494072,Zhang; Ming,29,0,30,1
1713336449144,MATH 20C,B04,494073,Zhang; Ming,29,0,30,1
1713336450175,MATH 20D,A01,494075,Staff,22,0,30,8
1713336450175,MATH 20D,A02,494076,Staff,29,0,30,1
1713336451208,MATH 20E,A01,494079,Staff,24,0,30,6
1713336451208,MATH 20E,A02,494080,Staff,26,0,30,4
1713336451208,MATH 20E,B01,494082,Staff,25,0,30,5
1713336451208,MATH 20E,B02,494083,Staff,25,0,30,5
1713336452236,MATH 103A,A01,494085,Aliabadi Sr.; Mohsen,13,0,30,17
1713336452236,MATH 103A,A02,494086,Aliabadi Sr.; Mohsen,28,0,30,2
1713336452236,MATH 103A,B01,494088,Aliabadi Sr.; Mohsen,20,0,30,10
1713336452236,MATH 103A,B02,494089,Aliabadi Sr.; Mohsen,27,0,30,3
1713336453267,MATH 109,A01,494091,Staff,30,0,30,0
1713336453267,MATH 109,A02,494092,Staff,29,0,30,1
1713336453267,MATH 109,B01,494094,Staff,27,0,30,3
1713336453267,MATH 109,B02,494095,Staff,29,0,30,1
1713336454295,MATH 142A,A01,494097,Chow; Bennett,14,0,30,16
1713336454295,MATH 142A,A02,494098,Chow; Bennett,23,0,30,7
1713336454295,MATH 142A,B01,494100,Chow; Bennett,19,0,30,11
1713336454295,MATH 142A,B02,494101,Chow; Bennett,29,0,30,1
1713336456349,MATH 168A,A01,516677,Dumitriu; Ioana,16,0,35,19
1713336457379,MATH 170A,A01,516679,Dumitriu; Ioana,18,0,30,12
1713336457379,MATH 170A,A02,516680,Dumitriu; Ioana,28,0,30,2
1713336458406,MATH 193A,A01,494107,Staff,13,0,30,17
1713336458406,MATH 193A,A02,494108,Staff,19,0,30,11
1713336458406,MATH 193A,A03,494109,Staff,29,0,30,1
1713336458406,MATH 193A,A04,494110,Staff,22,0,30,8
1713336461484,MGT 16,A00,491930,McKay; Michael J,92,0,98,6
1713336462509,MGT 18,A00,491992,McKay; Michael J,96,0,98,2
1713336463540,MGT 71,A00,492003,Staff,63,0,98,35
1713336464565,MGT 103,A00,505209,Eberhard; Craig A,80,0,98,18
1713336465589,MGT 131A,A00,505210,Anderson; John Charles,89,0,98,9
1713336467642,MGT 153,A00,492077,Perols; Johan Lars,17,0,90,73
1713336470728,MGT 164,A00,492222,McKay; Mary A,91,0,98,7
1713336471756,MGT 172,A00,492245,Staff,59,0,60,1
1713336471756,MGT 172,B00,505526,Hedges; Kathleen,65,0,98,33
1713336472781,MGT 181,A00,505669,Dunn; Louis Jean,79,0,98,19
1713336473810,MMW 14,A01,494399,Staff,15,0,28,13
1713336473810,MMW 14,A02,494400,Staff,25,0,28,3
1713336473810,MMW 14,A03,494401,Staff,28,0,28,0
1713336473810,MMW 14,A04,494402,Staff,28,0,28,0
1713336473810,MMW 14,B01,494404,Carreras; Maria Victoria,8,0,28,20
1713336473810,MMW 14,B02,494405,Carreras; Maria Victoria,25,0,28,3
1713336473810,MMW 14,B03,494406,Carreras; Maria Victoria,27,0,28,1
1713336473810,MMW 14,B04,494407,Carreras; Maria Victoria,28,0,28,0
1713336474835,MMW 14GS,A00,506250,Chang; Edmond Yi-Teh,0,0,0,0
1713336475861,MMW 121R,A01,494415,Adamiak; Patrick John,10,0,28,18
1713336475861,MMW 121R,A02,494416,Adamiak; Patrick John,24,0,28,4
1713336476890,MUS 1A,A01,494113,Staff,12,0,25,13
1713336476890,MUS 1A,A02,494114,Staff,24,0,25,1
1713336477920,MUS 4,A01,494116,Staff,23,0,25,2
1713336477920,MUS 4,A02,494117,Staff,22,0,25,3
1713336478951,MUS 5R,A01,494236,Dubnov; Shlomo,4,0,25,21
1713336478951,MUS 5R,A02,494237,Dubnov; Shlomo,25,0,25,0
1713336479982,MUS 6,A01,494122,Staff,9,0,25,16
1713336479982,MUS 6,A02,494123,Staff,23,0,25,2
1713336481014,MUS 7,A01,494125,Staff,16,0,25,9
1713336481014,MUS 7,A02,494126,Staff,24,0,25,1
1713336482039,MUS 11,A01,494128,Staff,23,0,25,2
1713336482039,MUS 11,A02,494129,Staff,24,0,25,1
1713336483077,MUS 13,A01,494131,Staff,25,0,25,0
1713336483077,MUS 13,A02,494132,Staff,25,0,25,0
1713336484103,MUS 15,A01,494134,Staff,16,0,25,9
1713336484103,MUS 15,A02,494135,Staff,25,0,25,0
1713336484103,MUS 15,B01,494137,Staff,24,0,25,1
1713336485138,MUS 80,A00,494232,Staff,24,0,25,1
1713336485138,MUS 80,B00,494233,Staff,25,0,25,0
1713336485138,MUS 80,C00,494234,Staff,23,0,25,2
1713336486164,MUS 95C,A00,494141,Staff,70,0,75,5
1713336487188,MUS 114,A00,494142,Staff,40,0,50,10
1713336488214,NANO 15,A01,490636,Drews; Aaron,7,0,7,0
1713336489240,PHIL 1,A00,490578,Grush; Rick Scott,49,0,50,1
1713336490270,PHIL 10,A01,490580,Grush; Rick Scott,33,0,35,2
1713336490270,PHIL 10,A02,490586,Grush; Rick Scott,32,0,35,3
1713336491312,PHIL 27,A01,490591,Staff,22,0,25,3
1713336491312,PHIL 27,A02,490592,Staff,25,0,25,0
1713336491312,PHIL 27,A03,490593,Staff,25,0,25,0
1713336491312,PHIL 27,A04,490598,Staff,25,0,25,0
1713336492340,PHIL 32,A01,490611,Staff,20,0,20,0
1713336492340,PHIL 32,A02,490618,Staff,20,0,20,0
1713336493365,PHIL 90,A00,490624,Staff,40,0,40,0
1713336494397,PHIL 136,A00,490627,Cohen; Jonathan David,37,0,40,3
1713336495428,PHIL 155,A00,490634,Staff,62,0,70,8
1713336496455,PHYS 1A,A00,491610,Staff,245,0,250,5
1713336497485,PHYS 1AL,001,491616,Tsai; Philbert S,27,0,30,3
1713336497485,PHYS 1AL,002,491618,Tsai; Philbert S,30,0,30,0
1713336498510,PHYS 1B,A00,491623,Staff,235,0,250,15
1713336499534,PHYS 1BL,001,491626,Tsai; Philbert S,20,0,30,10
1713336499534,PHYS 1BL,002,491628,Tsai; Philbert S,26,0,30,4
1713336500561,PHYS 1C,A00,491632,Staff,213,0,245,32
1713336501586,PHYS 1CL,001,491635,Tsai; Philbert S,3,0,30,27
1713336501586,PHYS 1CL,002,491643,Tsai; Philbert S,22,0,30,8
1713336502610,PHYS 2AR,A01,491651,Meyertholen; Andrew D.,44,0,50,6
1713336503635,PHYS 2B,A01,491659,Staff,106,0,115,9
1713336504665,PHYS 2BL,A01,491685,Staff,21,0,24,3
1713336504665,PHYS 2BL,A02,491700,Staff,21,0,24,3
1713336505691,PHYS 2C,A01,505161,Staff,101,0,115,14
1713336506715,PHYS 4A,A01,491704,Grinstein; Benjamin,99,0,100,1
1713336507746,POLI 5D,A01,494144,Staff,3,0,5,2
1713336507746,POLI 5D,B01,626283,Dai; Yinlin,5,0,5,0
1713336508772,POLI 12,A00,494145,Staff,43,0,45,2
1713336509796,POLI 13R,A00,494146,Forman; Fonna,45,0,50,5
1713336510825,POLI 27,A01,494148,Staff,54,0,60,6
1713336511850,POLI 30,A00,494149,Staff,49,0,50,1
1713336512875,POLI 100DA,A00,494150,Staff,20,0,25,5
1713336514926,POLI 100I,A00,494152,Staff,27,0,30,3
1713336515952,POLI 104B,A00,494153,Smith; Glenn Chatmas,53,0,55,2
1713336516980,POLI 104F,A00,494154,Staff,28,0,30,2
1713336518010,POLI 104I,A00,494155,Smith; Glenn Chatmas,29,0,30,1
1713336519034,POLI 110C,A00,494156,Ingham; Sean,23,0,25,2
1713336520060,POLI 117R,A00,494157,Forman; Fonna,5,0,20,15
1713336521088,POLI 118,A00,494158,Ingham; Sean,21,0,25,4
1713336522118,POLI 120H,A00,494159,Fisk; David Lee,39,0,45,6
1713336523149,POLI 131CR,A00,494160,Hoston; Germaine,35,0,45,10
1713336524179,POLI 133J,A00,494161,Staff,31,0,35,4
1713336525204,POLI 135,A00,494162,Fisk; David Lee,33,0,35,2
1713336526232,POLI 140A,A00,494164,Staff,19,0,30,11
1713336527258,POLI 142I,A00,494165,Staff,30,0,30,0
1713336528282,POLI 144D,A00,494166,Staff,23,0,25,2
1713336529306,POLI 151,A00,494167,Staff,30,0,30,0
1713336530332,POLI 153,A00,494168,Staff,33,0,35,2
1713336531360,POLI 160AA,A00,494169,Staff,34,0,40,6
1713336532387,POLI 162,A00,494170,Mignozzetti; Umberto,18,0,25,7
1713336533413,POLI 171,A00,494171,Mignozzetti; Umberto,18,0,25,7
1713336534442,PSYC 1,A00,494172,Staff,95,0,100,5
1713336535468,PSYC 2,A00,494173,Moranton; Nirelia Melbina-,34,0,50,16
1713336536496,PSYC 3,A00,494174,Staff,29,0,30,1
1713336537520,PSYC 6,A00,494175,Staff,17,0,20,3
1713336538549,PSYC 60,A01,494177,Staff,37,0,45,8
1713336539576,PSYC 70,A01,505724,Geller; Emma Harlan,42,0,45,3
1713336540602,PSYC 101,A00,494180,Heyman; Gail D.,84,0,100,16
1713336541632,PSYC 105,A00,494181,Geller; Emma Harlan,51,0,90,39
1713336542662,PSYC 106,A00,494182,Dobkins; Karen R.,26,0,45,19
1713336543747,PSYC 108,A00,494183,Adrian; Julia Anna,89,0,100,11
1713336544773,PSYC 114,A01,494185,Winkielman; Piotr,0,3,30,30
1713336545802,PSYC 122,A00,494186,Moranton; Nirelia Melbina-,27,0,50,23
1713336546828,PSYC 124,A00,494187,Chapman; Eddie Nathaniel,70,0,80,10
1713336547854,PSYC 131,A00,494188,Anagnostaras; Stephan,40,0,80,40
1713336548883,PSYC 144,A00,494189,Staff,1,0,50,49
1713336549908,PSYC 154,A00,494190,Lacefield; Katharine I,106,0,180,74
1713336550934,PSYC 162,A00,494191,Wixted; John T,71,0,100,29
1713336551959,PSYC 172,A00,494192,Gorman; Michael R.,36,0,45,9
1713336552985,PSYC 178,A00,494193,Glaser; Dale,34,0,45,11
1713336554010,PSYC 193,A00,505725,Chapman; Eddie Nathaniel,20,0,20,0
1713336555036,RELI 145GS,A00,519817,Rahimi; Babak,17,0,20,3
1713336556061,SE 101A,A01,490862,Chadha; Mayank,23,0,25,2
1713336557092,SE 101C,A01,490924,Krysl; Petr,15,0,20,5
1713336558122,SE 110A,A01,490928,Staff,19,0,20,1
1713336559153,SE 130A,A00,490929,Morrison; Machel Leigh,54,0,70,16
1713336560184,SIO 1,A01,519325,Staff,39,0,40,1
1713336561212,SIO 30,A01,519327,Staff,38,0,40,2
1713336562238,SIO 40,A00,519328,Staff,39,0,40,1
1713336563267,SIO 46GS,A00,519819,Cook; Geoffrey W,17,0,25,8
1713336564290,SIO 109R,A00,494197,Forman; Fonna,0,3,20,20
1713336565315,SIO 121GS,A00,519827,Cook; Geoffrey W,17,0,25,8
1713336566341,SIO 132,A01,519330,Staff,38,0,40,2
1713336567368,SIO 133,A01,519397,Staff,37,0,40,3
1713336568397,SIO 139,A00,519396,Kacev; David,29,0,40,11
1713336569430,SOCI 1,A01,494199,Thorpe; Charles Robert,21,0,30,9
1713336569430,SOCI 1,A02,494200,Thorpe; Charles Robert,30,0,30,0
1713336569430,SOCI 1,A03,494201,Thorpe; Charles Robert,29,0,30,1
1713336569430,SOCI 1,A04,494202,Thorpe; Charles Robert,29,0,30,1
1713336569430,SOCI 1,A05,494203,Thorpe; Charles Robert,29,0,30,1
1713336569430,SOCI 1,A06,494204,Thorpe; Charles Robert,30,0,30,0
1713336569430,SOCI 1,A07,494205,Thorpe; Charles Robert,28,0,30,2
1713336570456,SOCI 60,A01,494207,Staff,34,0,40,6
1713336570456,SOCI 60,A02,494208,Staff,39,0,40,1
1713336571483,SOCI 100,A01,494210,Payne; Christine Anna,25,0,30,5
1713336571483,SOCI 100,A02,494211,Payne; Christine Anna,26,0,30,4
1713336572513,SOCI 109M,A00,494212,Staff,20,0,20,0
1713336573541,SOCI 110,A00,494213,Staff,34,0,40,6
1713336575597,SOCI 118E,A00,494215,Ng; Kwai,37,0,40,3
1713336576624,SOCI 125,A00,494216,Calderon-Zaks; Michael Aar,40,0,45,5
1713336577650,SOCI 126,A01,494218,Jones; Makeba,3,0,5,2
1713336578681,SOCI 131,A00,494219,Thorpe; Charles Robert,26,0,30,4
1713336580730,SOCI 135,A00,494221,Payne; Christine Anna,28,0,50,22
1713336581757,SOCI 136E,A00,626690,Ruiz; Jonathan Joseph,24,0,25,1
1713336582788,SOCI 138GS,A00,494222,Navon; Daniel,23,0,28,5
1713336584838,SOCI 145,A00,494224,Staff,40,0,45,5
1713336585868,SOCI 153,A00,494225,Staff,28,0,30,2
1713336586894,SOCI 160E,A00,494226,Ng; Kwai,27,0,40,13
1713336587920,SOCI 180,A00,494227,Staff,29,0,30,1
1713336588946,SOCI 189GS,A00,494228,Ribas Norris; Janet Vanesa,11,0,11,0
1713336589970,SOCI 190GS,A00,553232,Ribas Norris; Janet Vanesa,11,0,11,0
1713336590995,SOMI 220,A00,627178,Schneid; Stephen David,30,0,30,0
1713336592021,SYN 2,001,490768,Staff,13,0,15,2
1713336592021,SYN 2,002,490769,Staff,14,0,15,1
1713336592021,SYN 2,004,490775,Staff,0,0,0,0
1713336592021,SYN 2,003,490774,Staff,0,0,0,0
1713336592021,SYN 2,005,490776,Staff,0,0,0,0
1713336593050,SYN 2R,001,490779,Staff,11,0,15,4
1713336593050,SYN 2R,002,514635,Staff,14,0,15,1
1713336594082,SYN 100,A01,490783,Staff,9,0,20,11
1713336594082,SYN 100,B01,490787,Staff,9,0,20,11
1713336594082,SYN 100,C01,490789,Staff,10,0,20,10
1713336595108,SYN 150,A00,490817,Staff,14,0,15,1
1713336595108,SYN 150,B00,514610,Staff,15,0,15,0
1713336596138,TDAC 1,A00,492753,Walsh; Kim C.,19,0,20,1
1713336596138,TDAC 1,B00,492754,Harting; Carla Kelso,19,0,20,1
1713336596138,TDAC 1,C00,513995,Salovey; Todd,15,0,20,5
1713336597162,TDAC 101,A00,492766,Harting; Carla Kelso,17,0,20,3
1713336598188,TDAC 102,A00,492768,Basso; Beatrice,19,0,20,1
1713336599215,TDDE 111,A00,492769,Staff,25,0,25,0
1713336600241,TDDE 131,A00,492770,Staff,15,0,15,0
1713336600241,TDDE 131,B00,492771,Staff,15,0,15,0
1713336601266,TDDE 131GS,A00,523716,Guirguis; Mark C,23,0,28,5
1713336602291,TDGE 1,A01,492756,Salovey; Todd,56,0,60,4
1713336603324,TDGE 5,A01,492758,Staff,23,0,25,2
1713336604348,TDGE 10,A00,492759,Fulton; Julia,203,0,220,17
1713336605375,TDGE 11,A00,492760,Castro; Robert Jess,198,0,200,2
1713336607423,TDGE 124,A00,492772,Fulton; Julia,181,0,220,39
1713336608450,TDGE 125,A00,492773,Meyer; Ursula,38,0,50,12
1713336608450,TDGE 125,B00,492774,Staff,49,0,50,1
1713336608450,TDGE 125,C00,523565,Staff,48,0,50,2
1713336609475,TDGE 125GS,A00,523580,Guirguis; Mark C,23,0,28,5
1713336610499,TDGE 127,A00,492775,Havis; Allan,32,0,50,18
1713336611524,TDHT 101,A00,492776,Staff,34,0,35,1
1713336612555,TDMV 1,A00,492762,Caligagan; Maria T.,29,0,30,1
1713336612555,TDMV 1,B00,492763,Arcidiacono; Kristin,26,0,30,4
1713336613582,TDMV 2,A00,492764,Weinberg; Sadie,28,0,30,2
1713336614610,TDMV 3,A00,492765,Mack; Kara Shanai',37,0,40,3
1713336615636,TDMV 138,A00,492777,Mack; Kara Shanai',33,0,40,7
1713336616663,TDMV 140,A00,492778,Lima; Paulo Henrique,40,0,40,0
1713336617694,TDMV 142,A00,492779,Caligagan; Maria T.,33,0,40,7
1713336617694,TDMV 142,B00,492780,Caligagan; Tony,37,0,40,3
1713336618808,TDMV 143,A00,492781,Fyall; Daunte Edward,39,0,40,1
1713336619841,USP 1,A01,492401,Kwak; Nancy,27,0,35,8
1713336620866,USP 2,A01,492453,Hinds; Juli Beth,35,0,35,0
1713336621896,USP 3,A01,492516,Staff,28,0,35,7
1713336622920,USP 4,A00,492522,McTague; Sarah,16,0,25,9
1713336623947,USP 100,A00,492523,Staff,32,0,35,3
1713336624972,USP 101,A00,492524,Staff,13,0,15,2
1713336625998,USP 105,A00,492525,Staff,21,0,25,4
1713336627023,USP 151,A00,492526,Shenkman; Michael Thomas,32,0,35,3
1713336628047,USP 170,A00,492545,Hinds; Juli Beth,33,0,35,2
1713336629073,USP 171GS,A00,492608,Bussell; Mirle Rabinowitz,24,0,28,4
1713336630098,USP 183GS,A00,492613,Peerson; Susan,24,0,28,4
1713336631131,VIS 30,A01,490693,Yoldas; Pinar,19,0,22,3
1713336631131,VIS 30,A02,490694,Yoldas; Pinar,18,0,22,4
1713336632162,VIS 83,A00,490695,Kester; Grant,63,0,75,12
1713336633186,VIS 105D,A00,490696,Staff,22,0,25,3
1713336634215,VIS 124CN,A00,490699,Rose; Jordan M,65,0,75,10
1713336635238,VIS 125GS,A00,511221,Williams; Alena J,21,0,22,1
1713336636267,VIS 128D,A00,490700,Staff,73,0,75,2
1713336637290,VIS 151,A01,490717,Staff,33,0,34,1
1713336637290,VIS 151,A02,490766,Staff,33,0,34,1
1713336638319,VIS 154GS,A00,511972,Williams; Alena J,21,0,22,1
1713336639342,VIS 160A,A00,490767,Stone; Patricia,7,0,10,3
1713336640367,WCWP 10A,A00,490638,Staff,14,0,15,1
1713336640367,WCWP 10A,B00,490640,Staff,15,0,15,0
1713336641436,WCWP 10B,A00,490641,Staff,0,0,0,0
1713336641436,WCWP 10B,B00,490642,Staff,14,0,15,1
1713336641436,WCWP 10B,C00,490644,Staff,13,0,15,2
1713336641436,WCWP 10B,D00,490647,Staff,0,0,0,0
1713336642461,WCWP 100,A00,490655,Staff,0,0,0,0
1713336642461,WCWP 100,B00,490687,Staff,10,0,15,5
1713336644563,ANAR 153,A00,487222,Braswell; Geoffrey E.,53,0,60,7
1713336645589,ANBI 134,A00,487223,Staff,6,0,20,14
1713336646614,ANBI 143GS,A00,487224,Noel; Geoffroy Pierre Jean,18,0,24,6
1713336647701,ANBI 144GS,A00,519548,Noel; Geoffroy Pierre Jean,18,0,24,6
1713336648728,ANSC 101,A00,487225,Staff,18,0,20,2
1713336649756,ANSC 125,A00,487227,Brenner; Suzanne A,38,0,40,2
1713336651806,ANSC 146,A00,487229,Staff,35,0,40,5
1713336652831,ANSC 148,A00,487230,Olivas Hernandez; Olga Lid,39,0,40,1
1713336653856,ANSC 150,A00,504165,Sloane; Julia Kathryn,18,0,20,2
1713336654882,ANSC 180,A00,487232,Staff,14,0,15,1
1713336655905,ANSC 188,A00,627155,Staff,38,0,40,2
1713336656934,ANTH 5,A00,519529,Semendeferi; Ekaterini,15,0,15,0
1713336657958,ANTH 10,A00,487219,Staff,58,0,60,2
1713336658981,ANTH 23,A01,487221,Staff,17,0,20,3
1713336660009,ANTH 102,A00,487233,Wilder; Linnea Lorene,50,0,60,10
1713336661046,ANTH 103,A00,487234,Varma; Saiba,54,0,60,6
1713336662072,ANTH 105,A00,487235,Stewart; Alexander B,54,0,60,6
1713336663099,BENG 100,A01,516685,Taylor Amos; Alyssa C,26,0,30,4
1713336664125,BIBC 102,A01,491316,Flagg; Matthew Paul,6,0,88,82
1713336664125,BIBC 102,A02,491366,Flagg; Matthew Paul,78,0,88,10
1713336665156,BIBC 103,A01,491486,Boumechache; Miyyada,16,0,24,8
1713336665156,BIBC 103,A02,491487,Boumechache; Miyyada,24,0,24,0
1713336666187,BICD 100,A01,516882,Staff,73,0,75,2
1713336666187,BICD 100,A02,516890,Staff,69,0,75,6
1713336667212,BICD 102GS,A00,491488,Lo; Stanley M.,26,0,28,2
1713336668241,BIEB 136GS,A00,516940,Holway; David A. & Shurin; Jonathan,18,0,24,6
1713336669270,BIEB 137GS,A01,517034,Holway; David A. & Shurin; Jonathan,18,0,24,6
1713336670297,BIEB 138GS,A01,491492,Pirino; Giorgia,21,0,28,7
1713336671323,BILD 1,A01,491296,Staff,60,0,63,3
1713336671323,BILD 1,A02,491297,Staff,63,0,63,0
1713336672353,BILD 4,A01,517099,Gonzalez Gamboa; Ivonne,22,0,24,2
1713336672353,BILD 4,A02,517100,Gonzalez Gamboa; Ivonne,24,0,24,0
1713336673378,BILD 60GS,A00,491309,Lo; Stanley M.,26,0,28,2
1713336674405,BIMM 100,A01,517136,Staff,82,0,100,18
1713336675431,BIMM 110,A01,517182,Staff,53,0,100,47
1713336676457,BIMM 120,A01,517228,Pickett; Brooke Elizabeth,28,0,63,35
1713336676457,BIMM 120,A02,517240,Pickett; Brooke Elizabeth,44,0,63,19
1713336677483,BIMM 132GS,A01,491498,Pirino; Giorgia,21,0,28,7
1713336678511,BIMM 143,A01,491589,Bozinovic; Goran,12,0,40,28
1713336679542,BIPN 100,A01,491594,Armour; Jon Christopher,83,0,100,17
1713336680567,BIPN 140,A01,491602,Marino; Marc J,23,0,50,27
1713336682618,CAT 125,A00,515973,Staff,18,0,20,2
1713336683643,CAT 125GS,A00,515974,Rahimi; Babak,16,0,20,4
1713336684679,CAT 125R,A00,515980,Staff,12,0,20,8
1713336684679,CAT 125R,B00,515981,Tosun; Adriana,19,0,20,1
1713336684679,CAT 125R,C00,515987,Hyland; Tina Mae,0,3,20,20
1713336684679,CAT 125R,D00,515988,Bronstein; Phoebe Malan,16,0,20,4
1713336685715,CENG 15,A01,488699,Drews; Aaron,25,0,25,0
1713336686747,CENG 100,A00,505196,Opatkiewicz; Justin Paul,25,0,25,0
1713336687774,CGS 2A,A01,489598,Staff,33,0,35,2
1713336688799,CGS 112,A00,489599,Staff,15,0,15,0
1713336689826,CGS 119,A00,489603,Staff,10,0,10,0
1713336690856,CGS 120,A00,489604,Staff,13,0,15,2
1713336691881,CGS 150,A00,489607,Staff,15,0,15,0
1713336692906,CHEM 6A,A01,488715,Staff,97,0,100,3
1713336693933,CHEM 6B,A01,488719,Piercy; Marc Anthony,99,0,100,1
1713336694956,CHEM 6C,A01,488723,Albizati; Kim F.,93,0,100,7
1713336695983,CHEM 7L,A01,488728,Schurmeier; Kimberly,18,0,24,6
1713336695983,CHEM 7L,A02,488730,Schurmeier; Kimberly,23,0,24,1
1713336695983,CHEM 7L,A03,488734,Schurmeier; Kimberly,20,0,24,4
1713336695983,CHEM 7L,A04,488763,Schurmeier; Kimberly,23,0,24,1
1713336695983,CHEM 7L,B01,488798,Schurmeier; Kimberly,17,0,24,7
1713336695983,CHEM 7L,B02,488801,Schurmeier; Kimberly,22,0,24,2
1713336695983,CHEM 7L,B03,488808,Schurmeier; Kimberly,22,0,24,2
1713336695983,CHEM 7L,B04,488811,Schurmeier; Kimberly,24,0,24,0
1713336697014,CHEM 11,A01,488897,Stallings; Dontarie M,95,0,100,5
1713336698040,CHEM 40A,A01,488913,Albizati; Kim F.,83,0,100,17
1713336699066,CHEM 40B,A01,488920,Weizman; Haim,43,0,50,7
1713336699066,CHEM 40B,A02,488938,Weizman; Haim,44,0,50,6
1713336700092,CHEM 41A,A01,489029,Klosterman; Jeremy K,57,0,60,3
1713336701123,CHEM 41C,A01,500436,Tor; Yitzhak,55,0,60,5
1713336702148,CHEM 43A,A01,500426,Weizman; Haim,0,1,24,24
1713336702148,CHEM 43A,A02,500430,Weizman; Haim,6,0,24,18
1713336702148,CHEM 43A,B01,514041,Klosterman; Jeremy K,16,0,24,8
1713336702148,CHEM 43A,B02,514047,Klosterman; Jeremy K,23,0,24,1
1713336703174,CHEM 108,A01,489140,Jennings; Patricia A.,7,0,24,17
1713336703174,CHEM 108,A02,489142,Jennings; Patricia A.,14,0,24,10
1713336704199,CHEM 114A,A01,489147,Stallings; Dontarie M,66,0,100,34
1713336705226,CHIN 169A,A00,489171,Wang; Xiao,19,0,20,1
1713336707277,COGS 3,A01,518827,Boyle; Mary E. T.,25,0,40,15
1713336708301,COGS 11,A01,489175,Staff,27,0,30,3
1713336709327,COGS 14A,A01,518829,Staff,51,0,60,9
1713336710356,COGS 14B,A01,489177,Hoffman; Drew Ellen,62,0,75,13
1713336711387,COGS 100,A01,489181,Allen; Michael Gordon,62,0,75,13
1713336712415,COGS 101A,A01,489183,Staff,45,0,60,15
1713336713446,COGS 101B,A01,489185,Allen; Michael Gordon,7,0,30,23
1713336714471,COGS 101C,A01,526786,Staff,23,0,30,7
1713336716529,COGS 107A,A01,489189,Boyle; Mary E. T.,16,0,35,19
1713336717558,COGS 107B,A01,627144,Mooshagian; Eric Frederick,60,0,60,0
1713336718582,COGS 118A,A01,489191,Staff,0,46,40,40
1713336720638,COGS 171GS,A01,489194,Pineda; Jaime A,19,0,28,9
1713336721664,COGS 172,A01,489196,Staff,2,0,30,28
1713336722689,COGS 174GS,A01,489264,Pineda; Jaime A,19,0,28,9
1713336723714,COGS 180,A01,627150,Staff,28,0,30,2
1713336724740,COGS 186,A01,489274,Staff,0,2,30,30
1713336725765,COMM 10,A01,489276,Staff,23,0,25,2
1713336725765,COMM 10,A02,489303,Staff,23,0,25,2
1713336726795,COMM 100A,A01,489312,Staff,14,0,25,11
1713336726795,COMM 100A,A02,489313,Staff,24,0,25,1
1713336727820,COMM 106T,A00,512540,Staff,33,0,35,2
1713336728850,COMM 107,A00,489347,Staff,27,0,35,8
1713336729876,COMM 109P,A00,489358,Staff,31,0,35,4
1713336730906,COMM 132,A00,489361,McKenna; Denise,27,0,30,3
1713336731932,COMM 146,A00,489362,Halm; Gavin Patrick,26,0,30,4
1713336732960,COMM 190,A00,489363,Abuelhiga; Soraya Jill,17,0,23,6
1713336733993,CSE 8A,A50,489366,Staff,21,0,25,4
1713336733993,CSE 8A,A51,489367,Staff,24,0,25,1
1713336745085,CSE 11,A01,489398,Cao; Yingjun,73,0,100,27
1713336746118,CSE 12,A01,489487,Staff,43,0,50,7
1713336747144,CSE 20,A01,489497,Staff,47,0,50,3
1713336748178,CSE 21,A01,489517,Braun; Oliver,42,0,50,8
1713336749207,CSE 101,A01,489524,Braun; Oliver,0,32,50,50
1713336750240,CSE 105,A01,512594,Jones; Miles E,72,0,100,28
1713336750240,CSE 105,B01,512598,Jones; Miles E,52,0,100,48
1713336751269,CSE 140,A01,489538,Staff,41,0,50,9
1713336752299,CSE 141,A01,489550,Eldon; John,67,0,100,33
1713336753323,CSE 141L,A01,489571,Eldon; John,65,0,100,35
1713336754349,CSE 151A,A01,489583,Solares; Edwin A,141,0,200,59
1713336755378,CSE 175,A01,510886,Kumar; Rakesh,30,0,30,0
1713336756407,CSE 190,A00,516828,Dubnov; Shlomo,37,0,49,12
1713336757436,DOC 100D,A00,489667,Pass; Natalye Joann,19,0,25,6
1713336758466,DSC 10,A01,624268,Staff,72,0,75,3
1713336759490,DSC 20,A01,624476,Staff,50,0,50,0
1713336760517,DSC 40A,A01,624608,Staff,39,0,40,1
1713336761597,DSGN 1,A01,489179,Rill; Bryan,32,0,50,18
1713336762621,ECE 17,A01,490489,Sahay; Rajeev,18,0,30,12
1713336763645,ECE 65,A50,490492,Staff,11,0,20,9
1713336763645,ECE 65,A51,490493,Staff,18,0,20,2
1713336764672,ECON 1,A01,489715,Famulari; Melissa,67,0,70,3
1713336765700,ECON 2,A01,489717,Levkoff; Steven B.,67,0,70,3
1713336766729,ECON 3,A01,489948,Staff,70,0,70,0
1713336768786,ECON 5,A01,490103,Staff,27,0,30,3
1713336768786,ECON 5,B01,626281,Dai; Yinlin,45,0,45,0
1713336769810,ECON 100A,A01,490127,Famulari; Melissa,63,0,70,7
1713336770836,ECON 100B,A01,490129,Staff,64,0,70,6
1713336771865,ECON 109,A01,490187,Shishkin; Denis,27,0,35,8
1713336772891,ECON 110A,A01,490190,Levkoff; Steven B.,59,0,70,11
1713336773918,ECON 120A,A01,490245,Dai; Yinlin,60,0,70,10
1713336774947,ECON 120B,A01,490247,Nieto-Barthaburu; Augusto,40,0,70,30
1713336775979,ECON 120C,A01,490253,Sun; Yixiao,30,0,35,5
1713336775979,ECON 120C,B01,490255,Sun; Yixiao,34,0,35,1
1713336777008,ECON 129,A00,490256,Eckert; Fabian Paul,22,0,35,13
1713336778033,ECON 131,A00,490257,Nieto-Barthaburu; Augusto,0,6,35,35
1713336779063,ECON 138,A00,490258,Bharadwaj; Prashant,13,0,35,22
1713336779063,ECON 138,B00,490259,Bharadwaj; Prashant,15,0,35,20
1713336780092,ECON 159,A00,490260,Hendrickson; Gerald M.,0,9,0,0
1713336781124,ECON 178,A01,553995,Zhu; Ying,24,0,35,11
1713336782149,EDS 40,A01,512576,Black; Alison Michelle,20,0,20,0
1713336783179,EDS 107,A01,515848,Staff,30,0,30,0
1713336784205,EDS 110R,A01,490262,Staff,26,0,30,4
1713336785234,EDS 112,A01,490264,Chapman; Thandeka K,40,0,50,10
1713336786258,EDS 113,A00,490266,Staff,26,0,30,4
1713336787282,EDS 118,A00,490267,Warstadt; Melissa Fawn,18,0,30,12
1713336788307,EDS 124BR,A00,490268,Eguchi; Emi,4,0,25,21
1713336788307,EDS 124BR,B00,490269,Eguchi; Emi,23,0,25,2
1713336789921,EDS 126,A01,490271,Jones; Makeba,43,0,50,7
1713336790946,EDS 135,A01,490316,Staff,19,0,20,1
1713336791975,ENVR 142GS,A00,519514,Chang; Edmond Yi-Teh,26,0,28,2
1713336793002,ETHN 103,A00,490504,Staff,25,0,36,11
1713336794032,ETHN 103A,A00,490505,Man; Simeon S,3,0,9,6
1713336795060,ETHN 109,A00,490506,Staff,28,0,30,2
1713336796085,ETHN 118,A00,490507,Staff,35,0,36,1
1713336797111,ETHN 119,A00,490508,Staff,32,0,36,4
1713336798140,ETHN 121R,A00,490518,Choi; Esther Min,21,0,36,15
1713336799163,ETHN 127,A00,490528,Staff,14,0,15,1
1713336800187,ETHN 139,A00,490573,Staff,10,0,10,0
1713336801212,ETHN 150,A00,490575,Staff,15,0,15,0
1713336802238,GLBH 20,A00,491705,Elwardani; Nile Regina,38,0,40,2
1713336803263,GLBH 101,A00,491706,Staff,20,0,20,0
1713336804286,GLBH 111,A01,491708,Burgos; Jose L.,15,0,15,0
1713336805312,GLBH 146,A00,491709,Staff,9,0,20,11
1713336806342,GLBH 148,A00,491710,Olivas Hernandez; Olga Lid,11,0,20,9
1713336807370,GLBH 150,A00,491711,Sloane; Julia Kathryn,19,0,20,1
1713336808400,HIEA 131,A00,491760,Staff,28,0,32,4
1713336809430,HIEA 153,A00,491762,Staff,28,0,30,2
1713336810465,HIEU 124,A00,491811,Staff,26,0,32,6
1713336811497,HIEU 124GS,A00,491812,Markman; Kristina,27,0,28,1
1713336812523,HIEU 147,A00,491813,Staff,30,0,32,2
1713336813554,HIEU 149GS,A00,491816,Caldwell; Michael Alan,28,0,28,0
1713336814578,HILD 2C,A01,491713,Hendrickson; Gerald M.,26,0,30,4
1713336815606,HILD 7B,A01,491715,Kwak; Nancy,0,2,30,30
1713336816630,HILD 10,A01,491717,Staff,9,0,20,11
1713336817655,HILD 30GS,A00,491719,Edington; Claire Ellen,23,0,28,5
1713336818687,HINE 109,A00,491818,Shafir; Nir,27,0,32,5
1713336819716,HINE 128,A00,491821,Shafir; Nir,31,0,32,1
1713336820744,HISC 117,A00,491830,Staff,27,0,32,5
1713336821774,HIUS 103,A00,491834,Man; Simeon S,14,0,23,9
1713336822800,HIUS 108B,A00,491835,Staff,27,0,30,3
1713336823827,HIUS 141,A00,491836,Hendrickson; Gerald M.,28,0,32,4
1713336824851,HIUS 149,A00,491839,Staff,24,0,32,8
1713336825878,HUM 3,A01,512617,Crum; Matthew Stephen,42,0,50,8
1713336825878,HUM 3,A02,512618,Crum; Matthew Stephen,48,0,50,2
1713336826905,HUM 3GS,A00,512663,Markman; Kristina,0,0,0,1
1713336826905,HUM 3GS,B00,512664,Staff,0,0,0,0
1713336827932,HUM 4,A01,512620,West; Geoffrey Scott,25,0,50,25
1713336828959,HUM 4GS,A00,512666,Lyon; Antony J.,0,0,0,5
1713336829990,HUM 4R,A01,512625,Watkins; Eric,49,0,50,1
1713336831020,HUM 5,A01,512649,Zavodny; Tatiana Sophia,20,0,50,30
1713336831020,HUM 5,B01,512661,Zroka; Ryan Edward,48,0,50,2
1713336832050,INTL 190,A00,490577,Segui; Alan S,0,0,0,5
1713336833077,JAPN 20AR,A01,491267,Ross; Kayoko F,7,0,20,13
1713336834102,JAPN 180,A00,491285,Berman; Michael David,33,0,40,7
1713336835129,LATI 50,A01,502536,Kokinis; Troy Andreas,16,0,22,6
1713336835129,LATI 50,A02,502551,Kokinis; Troy Andreas,22,0,22,0
1713336835129,LATI 50,A03,502650,Kokinis; Troy Andreas,22,0,22,0
1713336835129,LATI 50,A04,502909,Kokinis; Troy Andreas,21,0,22,1
1713336836156,LATI 160,A01,502920,Kokinis; Troy Andreas,30,0,30,0
1713336837187,LIFR 1A,A00,490494,Van Moer; Vinciane G,17,0,20,3
1713336838212,LIFR 1AX,A00,490495,Van Moer; Vinciane G,17,0,20,3
1713336839242,LIFR 1B,A00,490496,Van Moer; Vinciane G,17,0,20,3
1713336840274,LIFR 1BX,A00,490497,Van Moer; Vinciane G,17,0,20,3
1713336841307,LIGN 8,A00,505198,McIntosh; Justin Daniel,134,0,150,16
1713336842334,LIGN 9GS,A00,491239,Lott; Margaret S.,18,0,20,2
1713336843358,LIGN 101,A01,505200,McIntosh; Justin Daniel,22,0,30,8
1713336844388,LIGN 120,A01,491244,Staff,22,0,30,8
1713336845413,LIGN 149GS,A00,491245,Lott; Margaret S.,18,0,20,2
1713336846438,LIGN 170,A00,491247,Staff,22,0,30,8
1713336847464,LISP 1D,A00,490498,Munoz Sanchez; Alicia,8,0,14,6
1713336847464,LISP 1D,B00,490499,Munoz Sanchez; Alicia,5,0,14,9
1713336847464,LISP 1D,C00,490500,Munoz Sanchez; Alicia,7,0,14,7
1713336847464,LISP 1D,D00,490501,Munoz Sanchez; Alicia,10,0,14,4
1713336848494,LISP 1DX,A00,490502,Munoz Sanchez; Alicia,12,0,28,16
1713336848494,LISP 1DX,B00,490503,Munoz Sanchez; Alicia,16,0,28,12
1713336850554,LTAM 110,A00,491847,Staff,22,0,25,3
1713336851582,LTCS 119,A00,491848,Staff,11,0,15,4
1713336852606,LTCS 130,A00,491849,Staff,24,0,25,1
1713336854660,LTEA 120C,A00,491852,Staff,32,0,40,8
1713336855689,LTEN 130GS,A00,491853,Lyon; Antony J.,23,0,28,5
1713336856714,LTEN 148,A00,491855,Staff,23,0,25,2
1713336857738,LTEN 159,A00,491856,Staff,20,0,25,5
1713336858764,LTEN 180,A00,491857,Staff,8,0,15,7
1713336860818,LTSP 123GS,A00,505928,Bessett; Ryan Matthew,24,0,28,4
1713336861844,LTSP 174GS,A00,506037,Bessett; Ryan Matthew,24,0,28,4
1713336863900,LTWR 102,A00,491861,Staff,9,0,15,6
1713336864925,LTWR 106,A00,491862,Staff,8,0,15,7
1713336866016,MAE 11,A00,490930,Bahadori; Mohammad Yousef,95,0,100,5
1713336867049,MAE 30A,A00,490931,Qi; Huihui,37,0,40,3
1713336868074,MAE 101A,A00,491036,Sadeghizadeh; Zahra,92,0,100,8
1713336869099,MAE 101C,A00,491037,Seshadri; Kalyanasundaram,64,0,100,36
1713336870128,MAE 113,A00,491040,Seshadri; Kalyanasundaram,65,0,80,15
1713336871158,MAE 131A,A00,491041,Ghazinejad; Maziar,37,0,40,3
1713336872184,MAE 142,A00,491053,Staff,39,0,40,1
1713336873211,MAE 143A,A00,491054,Staff,31,0,50,19
1713336874237,MAE 150,A00,491092,Truong; Phuong Thi Ngoc,23,0,35,12
1713336875263,MATH 3C,A01,494031,Pardo Guerra; Sebastian,30,0,30,0
1713336875263,MATH 3C,A02,494032,Pardo Guerra; Sebastian,29,0,30,1
1713336876297,MATH 10A,A01,494034,Staff,27,0,30,3
1713336876297,MATH 10A,A02,494035,Staff,28,0,30,2
1713336876297,MATH 10A,B01,494037,Staff,27,0,30,3
1713336876297,MATH 10A,B02,494038,Staff,29,0,30,1
1713336877325,MATH 10B,A01,494040,Habib; Yousaf,22,0,30,8
1713336877325,MATH 10B,A02,494041,Habib; Yousaf,28,0,30,2
1713336877325,MATH 10B,A03,494042,Habib; Yousaf,29,0,30,1
1713336877325,MATH 10B,A04,494043,Habib; Yousaf,30,0,30,0
1713336877325,MATH 10B,B01,494045,Habib; Yousaf,25,0,30,5
1713336877325,MATH 10B,B02,494046,Habib; Yousaf,30,0,30,0
1713336877325,MATH 10B,B03,494047,Habib; Yousaf,30,0,30,0
1713336877325,MATH 10B,B04,494048,Habib; Yousaf,30,0,30,0
1713336878357,MATH 18,A01,494050,Kemp; Todd Aahron,25,0,30,5
1713336878357,MATH 18,A02,494051,Kemp; Todd Aahron,29,0,30,1
1713336878357,MATH 18,B01,494054,Kemp; Todd Aahron,25,0,30,5
1713336878357,MATH 18,B02,494055,Kemp; Todd Aahron,29,0,30,1
1713336879387,MATH 20A,A01,494059,Suk; Andrew Hoon,30,0,30,0
1713336880419,MATH 20B,A01,494061,Briones; Jor-el Thomas Caparas,33,0,35,2
1713336880419,MATH 20B,B01,494063,Bach; Quang Tran,34,0,35,1
1713336881444,MATH 20C,A01,494065,Staff,28,0,30,2
1713336881444,MATH 20C,A02,494066,Staff,30,0,30,0
1713336881444,MATH 20C,A03,494067,Staff,30,0,30,0
1713336881444,MATH 20C,A04,494068,Staff,30,0,30,0
1713336881444,MATH 20C,B01,494070,Zhang; Ming,24,0,30,6
1713336881444,MATH 20C,B02,494071,Zhang; Ming,27,0,30,3
1713336881444,MATH 20C,B03,494072,Zhang; Ming,29,0,30,1
1713336881444,MATH 20C,B04,494073,Zhang; Ming,29,0,30,1
1713336882470,MATH 20D,A01,494075,Staff,22,0,30,8
1713336882470,MATH 20D,A02,494076,Staff,29,0,30,1
1713336883497,MATH 20E,A01,494079,Staff,24,0,30,6
1713336883497,MATH 20E,A02,494080,Staff,26,0,30,4
1713336883497,MATH 20E,B01,494082,Staff,25,0,30,5
1713336883497,MATH 20E,B02,494083,Staff,25,0,30,5
1713336884524,MATH 103A,A01,494085,Aliabadi Sr.; Mohsen,12,0,30,18
1713336884524,MATH 103A,A02,494086,Aliabadi Sr.; Mohsen,28,0,30,2
1713336884524,MATH 103A,B01,494088,Aliabadi Sr.; Mohsen,20,0,30,10
1713336884524,MATH 103A,B02,494089,Aliabadi Sr.; Mohsen,27,0,30,3
1713336885551,MATH 109,A01,494091,Staff,30,0,30,0
1713336885551,MATH 109,A02,494092,Staff,29,0,30,1
1713336885551,MATH 109,B01,494094,Staff,27,0,30,3
1713336885551,MATH 109,B02,494095,Staff,29,0,30,1
1713336886578,MATH 142A,A01,494097,Chow; Bennett,13,0,30,17
1713336886578,MATH 142A,A02,494098,Chow; Bennett,23,0,30,7
1713336886578,MATH 142A,B01,494100,Chow; Bennett,19,0,30,11
1713336886578,MATH 142A,B02,494101,Chow; Bennett,29,0,30,1
1713336888634,MATH 168A,A01,516677,Dumitriu; Ioana,16,0,35,19
1713336889663,MATH 170A,A01,516679,Dumitriu; Ioana,18,0,30,12
1713336889663,MATH 170A,A02,516680,Dumitriu; Ioana,28,0,30,2
1713336890695,MATH 193A,A01,494107,Staff,13,0,30,17
1713336890695,MATH 193A,A02,494108,Staff,18,0,30,12
1713336890695,MATH 193A,A03,494109,Staff,29,0,30,1
1713336890695,MATH 193A,A04,494110,Staff,22,0,30,8
1713336893781,MGT 16,A00,491930,McKay; Michael J,92,0,98,6
1713336894808,MGT 18,A00,491992,McKay; Michael J,96,0,98,2
1713336895832,MGT 71,A00,492003,Staff,63,0,98,35
1713336896864,MGT 103,A00,505209,Eberhard; Craig A,80,0,98,18
1713336897887,MGT 131A,A00,505210,Anderson; John Charles,89,0,98,9
1713336899943,MGT 153,A00,492077,Perols; Johan Lars,17,0,90,73
1713336903026,MGT 164,A00,492222,McKay; Mary A,91,0,98,7
1713336904053,MGT 172,A00,492245,Staff,59,0,60,1
1713336904053,MGT 172,B00,505526,Hedges; Kathleen,65,0,98,33
1713336905082,MGT 181,A00,505669,Dunn; Louis Jean,79,0,98,19
1713336906107,MMW 14,A01,494399,Staff,15,0,28,13
1713336906107,MMW 14,A02,494400,Staff,25,0,28,3
1713336906107,MMW 14,A03,494401,Staff,28,0,28,0
1713336906107,MMW 14,A04,494402,Staff,28,0,28,0
1713336906107,MMW 14,B01,494404,Carreras; Maria Victoria,8,0,28,20
1713336906107,MMW 14,B02,494405,Carreras; Maria Victoria,25,0,28,3
1713336906107,MMW 14,B03,494406,Carreras; Maria Victoria,27,0,28,1
1713336906107,MMW 14,B04,494407,Carreras; Maria Victoria,28,0,28,0
1713336907133,MMW 14GS,A00,506250,Chang; Edmond Yi-Teh,0,0,0,0
1713336908161,MMW 121R,A01,494415,Adamiak; Patrick John,10,0,28,18
1713336908161,MMW 121R,A02,494416,Adamiak; Patrick John,24,0,28,4
1713336909193,MUS 1A,A01,494113,Staff,12,0,25,13
1713336909193,MUS 1A,A02,494114,Staff,24,0,25,1
1713336910223,MUS 4,A01,494116,Staff,23,0,25,2
1713336910223,MUS 4,A02,494117,Staff,22,0,25,3
1713336911253,MUS 5R,A01,494236,Dubnov; Shlomo,4,0,25,21
1713336911253,MUS 5R,A02,494237,Dubnov; Shlomo,25,0,25,0
1713336912278,MUS 6,A01,494122,Staff,9,0,25,16
1713336912278,MUS 6,A02,494123,Staff,23,0,25,2
1713336913308,MUS 7,A01,494125,Staff,16,0,25,9
1713336913308,MUS 7,A02,494126,Staff,24,0,25,1
1713336914333,MUS 11,A01,494128,Staff,23,0,25,2
1713336914333,MUS 11,A02,494129,Staff,24,0,25,1
1713336915364,MUS 13,A01,494131,Staff,25,0,25,0
1713336915364,MUS 13,A02,494132,Staff,25,0,25,0
1713336916389,MUS 15,A01,494134,Staff,16,0,25,9
1713336916389,MUS 15,A02,494135,Staff,25,0,25,0
1713336916389,MUS 15,B01,494137,Staff,24,0,25,1
1713336917414,MUS 80,A00,494232,Staff,24,0,25,1
1713336917414,MUS 80,B00,494233,Staff,25,0,25,0
1713336917414,MUS 80,C00,494234,Staff,23,0,25,2
1713336918438,MUS 95C,A00,494141,Staff,69,0,75,6
1713336919559,MUS 114,A00,494142,Staff,40,0,50,10
1713336920592,NANO 15,A01,490636,Drews; Aaron,7,0,7,0
1713336921620,PHIL 1,A00,490578,Grush; Rick Scott,49,0,50,1
1713336922652,PHIL 10,A01,490580,Grush; Rick Scott,33,0,35,2
1713336922652,PHIL 10,A02,490586,Grush; Rick Scott,32,0,35,3
1713336923682,PHIL 27,A01,490591,Staff,22,0,25,3
1713336923682,PHIL 27,A02,490592,Staff,25,0,25,0
1713336923682,PHIL 27,A03,490593,Staff,25,0,25,0
1713336923682,PHIL 27,A04,490598,Staff,25,0,25,0
1713336924708,PHIL 32,A01,490611,Staff,20,0,20,0
1713336924708,PHIL 32,A02,490618,Staff,20,0,20,0
1713336925733,PHIL 90,A00,490624,Staff,40,0,40,0
1713336926766,PHIL 136,A00,490627,Cohen; Jonathan David,37,0,40,3
1713336927802,PHIL 155,A00,490634,Staff,62,0,70,8
1713336928826,PHYS 1A,A00,491610,Staff,245,0,250,5
1713336929851,PHYS 1AL,001,491616,Tsai; Philbert S,27,0,30,3
1713336929851,PHYS 1AL,002,491618,Tsai; Philbert S,30,0,30,0
1713336930879,PHYS 1B,A00,491623,Staff,235,0,250,15
1713336931906,PHYS 1BL,001,491626,Tsai; Philbert S,20,0,30,10
1713336931906,PHYS 1BL,002,491628,Tsai; Philbert S,26,0,30,4
1713336932950,PHYS 1C,A00,491632,Staff,213,0,245,32
1713336933976,PHYS 1CL,001,491635,Tsai; Philbert S,3,0,30,27
1713336933976,PHYS 1CL,002,491643,Tsai; Philbert S,22,0,30,8
1713336935012,PHYS 2AR,A01,491651,Meyertholen; Andrew D.,44,0,50,6
1713336936046,PHYS 2B,A01,491659,Staff,106,0,115,9
1713336937073,PHYS 2BL,A01,491685,Staff,21,0,24,3
1713336937073,PHYS 2BL,A02,491700,Staff,21,0,24,3
1713336938099,PHYS 2C,A01,505161,Staff,101,0,115,14
1713336939125,PHYS 4A,A01,491704,Grinstein; Benjamin,99,0,100,1
1713336940178,POLI 5D,A01,494144,Staff,3,0,5,2
1713336940178,POLI 5D,B01,626283,Dai; Yinlin,5,0,5,0
1713336941203,POLI 12,A00,494145,Staff,43,0,45,2
1713336942233,POLI 13R,A00,494146,Forman; Fonna,45,0,50,5
1713336943257,POLI 27,A01,494148,Staff,54,0,60,6
1713336944288,POLI 30,A00,494149,Staff,49,0,50,1
1713336945312,POLI 100DA,A00,494150,Staff,20,0,25,5
1713336947369,POLI 100I,A00,494152,Staff,27,0,30,3
1713336948398,POLI 104B,A00,494153,Smith; Glenn Chatmas,53,0,55,2
1713336949424,POLI 104F,A00,494154,Staff,28,0,30,2
1713336950450,POLI 104I,A00,494155,Smith; Glenn Chatmas,29,0,30,1
1713336951483,POLI 110C,A00,494156,Ingham; Sean,23,0,25,2
1713336952515,POLI 117R,A00,494157,Forman; Fonna,5,0,20,15
1713336953541,POLI 118,A00,494158,Ingham; Sean,21,0,25,4
1713336954567,POLI 120H,A00,494159,Fisk; David Lee,39,0,45,6
1713336955592,POLI 131CR,A00,494160,Hoston; Germaine,35,0,45,10
1713336956616,POLI 133J,A00,494161,Staff,31,0,35,4
1713336957641,POLI 135,A00,494162,Fisk; David Lee,33,0,35,2
1713336958667,POLI 140A,A00,494164,Staff,19,0,30,11
1713336959696,POLI 142I,A00,494165,Staff,30,0,30,0
1713336960723,POLI 144D,A00,494166,Staff,23,0,25,2
1713336961750,POLI 151,A00,494167,Staff,30,0,30,0
1713336962778,POLI 153,A00,494168,Staff,33,0,35,2
1713336963803,POLI 160AA,A00,494169,Staff,34,0,40,6
1713336964828,POLI 162,A00,494170,Mignozzetti; Umberto,18,0,25,7
1713336965856,POLI 171,A00,494171,Mignozzetti; Umberto,18,0,25,7
1713336966882,PSYC 1,A00,494172,Staff,95,0,100,5
1713336967908,PSYC 2,A00,494173,Moranton; Nirelia Melbina-,34,0,50,16
1713336968937,PSYC 3,A00,494174,Staff,29,0,30,1
1713336970018,PSYC 6,A00,494175,Staff,17,0,20,3
1713336971048,PSYC 60,A01,494177,Staff,37,0,45,8
1713336972074,PSYC 70,A01,505724,Geller; Emma Harlan,42,0,45,3
1713336973099,PSYC 101,A00,494180,Heyman; Gail D.,84,0,100,16
1713336974122,PSYC 105,A00,494181,Geller; Emma Harlan,51,0,90,39
1713336975148,PSYC 106,A00,494182,Dobkins; Karen R.,26,0,45,19
1713336976180,PSYC 108,A00,494183,Adrian; Julia Anna,89,0,100,11
1713336977208,PSYC 114,A01,494185,Winkielman; Piotr,0,3,30,30
1713336978236,PSYC 122,A00,494186,Moranton; Nirelia Melbina-,27,0,50,23
1713336979260,PSYC 124,A00,494187,Chapman; Eddie Nathaniel,70,0,80,10
1713336980287,PSYC 131,A00,494188,Anagnostaras; Stephan,40,0,80,40
1713336981311,PSYC 144,A00,494189,Staff,1,0,50,49
1713336982338,PSYC 154,A00,494190,Lacefield; Katharine I,106,0,180,74
1713336983364,PSYC 162,A00,494191,Wixted; John T,70,0,100,30
1713336984390,PSYC 172,A00,494192,Gorman; Michael R.,36,0,45,9
1713336985420,PSYC 178,A00,494193,Glaser; Dale,34,0,45,11
1713336986446,PSYC 193,A00,505725,Chapman; Eddie Nathaniel,20,0,20,0
1713336987471,RELI 145GS,A00,519817,Rahimi; Babak,17,0,20,3
1713336988498,SE 101A,A01,490862,Chadha; Mayank,23,0,25,2
1713336989528,SE 101C,A01,490924,Krysl; Petr,15,0,20,5
1713336990556,SE 110A,A01,490928,Staff,19,0,20,1
1713336991583,SE 130A,A00,490929,Morrison; Machel Leigh,54,0,70,16
1713336992611,SIO 1,A01,519325,Staff,39,0,40,1
1713336993637,SIO 30,A01,519327,Staff,38,0,40,2
1713336994664,SIO 40,A00,519328,Staff,39,0,40,1
1713336995694,SIO 46GS,A00,519819,Cook; Geoffrey W,17,0,25,8
1713336996718,SIO 109R,A00,494197,Forman; Fonna,0,3,20,20
1713336997744,SIO 121GS,A00,519827,Cook; Geoffrey W,17,0,25,8
1713336998772,SIO 132,A01,519330,Staff,38,0,40,2
1713336999797,SIO 133,A01,519397,Staff,37,0,40,3
1713337000824,SIO 139,A00,519396,Kacev; David,29,0,40,11
1713337001848,SOCI 1,A01,494199,Thorpe; Charles Robert,21,0,30,9
1713337001848,SOCI 1,A02,494200,Thorpe; Charles Robert,30,0,30,0
1713337001848,SOCI 1,A03,494201,Thorpe; Charles Robert,29,0,30,1
1713337001848,SOCI 1,A04,494202,Thorpe; Charles Robert,29,0,30,1
1713337001848,SOCI 1,A05,494203,Thorpe; Charles Robert,29,0,30,1
1713337001848,SOCI 1,A06,494204,Thorpe; Charles Robert,30,0,30,0
1713337001848,SOCI 1,A07,494205,Thorpe; Charles Robert,28,0,30,2
1713337002878,SOCI 60,A01,494207,Staff,33,0,40,7
1713337002878,SOCI 60,A02,494208,Staff,39,0,40,1
1713337003902,SOCI 100,A01,494210,Payne; Christine Anna,25,0,30,5
1713337003902,SOCI 100,A02,494211,Payne; Christine Anna,26,0,30,4
1713337004926,SOCI 109M,A00,494212,Staff,20,0,20,0
1713337005951,SOCI 110,A00,494213,Staff,34,0,40,6
1713337008004,SOCI 118E,A00,494215,Ng; Kwai,37,0,40,3
1713337009030,SOCI 125,A00,494216,Calderon-Zaks; Michael Aar,40,0,45,5
1713337010056,SOCI 126,A01,494218,Jones; Makeba,3,0,5,2
1713337011081,SOCI 131,A00,494219,Thorpe; Charles Robert,26,0,30,4
1713337013134,SOCI 135,A00,494221,Payne; Christine Anna,28,0,50,22
1713337014163,SOCI 136E,A00,626690,Ruiz; Jonathan Joseph,24,0,25,1
1713337015192,SOCI 138GS,A00,494222,Navon; Daniel,23,0,28,5
1713337017247,SOCI 145,A00,494224,Staff,40,0,45,5
1713337018274,SOCI 153,A00,494225,Staff,28,0,30,2
1713337019304,SOCI 160E,A00,494226,Ng; Kwai,27,0,40,13
1713337020332,SOCI 180,A00,494227,Staff,29,0,30,1
1713337021363,SOCI 189GS,A00,494228,Ribas Norris; Janet Vanesa,11,0,11,0
1713337022387,SOCI 190GS,A00,553232,Ribas Norris; Janet Vanesa,11,0,11,0
1713337023419,SOMI 220,A00,627178,Schneid; Stephen David,30,0,30,0
1713337024450,SYN 2,001,490768,Staff,13,0,15,2
1713337024450,SYN 2,002,490769,Staff,14,0,15,1
1713337024450,SYN 2,004,490775,Staff,0,0,0,0
1713337024450,SYN 2,003,490774,Staff,0,0,0,0
1713337024450,SYN 2,005,490776,Staff,0,0,0,0
1713337025477,SYN 2R,001,490779,Staff,11,0,15,4
1713337025477,SYN 2R,002,514635,Staff,14,0,15,1
1713337026506,SYN 100,A01,490783,Staff,8,0,20,12
1713337026506,SYN 100,B01,490787,Staff,10,0,20,10
1713337026506,SYN 100,C01,490789,Staff,10,0,20,10
1713337027531,SYN 150,A00,490817,Staff,14,0,15,1
1713337027531,SYN 150,B00,514610,Staff,15,0,15,0
1713337028559,TDAC 1,A00,492753,Walsh; Kim C.,19,0,20,1
1713337028559,TDAC 1,B00,492754,Harting; Carla Kelso,19,0,20,1
1713337028559,TDAC 1,C00,513995,Salovey; Todd,15,0,20,5
1713337029586,TDAC 101,A00,492766,Harting; Carla Kelso,17,0,20,3
1713337030616,TDAC 102,A00,492768,Basso; Beatrice,19,0,20,1
1713337031661,TDDE 111,A00,492769,Staff,25,0,25,0
1713337032690,TDDE 131,A00,492770,Staff,15,0,15,0
1713337032690,TDDE 131,B00,492771,Staff,15,0,15,0
1713337033717,TDDE 131GS,A00,523716,Guirguis; Mark C,23,0,28,5
1713337034747,TDGE 1,A01,492756,Salovey; Todd,56,0,60,4
1713337035771,TDGE 5,A01,492758,Staff,23,0,25,2
1713337036805,TDGE 10,A00,492759,Fulton; Julia,203,0,220,17
1713337037829,TDGE 11,A00,492760,Castro; Robert Jess,198,0,200,2
1713337039883,TDGE 124,A00,492772,Fulton; Julia,181,0,220,39
1713337040909,TDGE 125,A00,492773,Meyer; Ursula,38,0,50,12
1713337040909,TDGE 125,B00,492774,Staff,49,0,50,1
1713337040909,TDGE 125,C00,523565,Staff,48,0,50,2
1713337041934,TDGE 125GS,A00,523580,Guirguis; Mark C,23,0,28,5
1713337042962,TDGE 127,A00,492775,Havis; Allan,32,0,50,18
1713337043988,TDHT 101,A00,492776,Staff,34,0,35,1
1713337045012,TDMV 1,A00,492762,Caligagan; Maria T.,29,0,30,1
1713337045012,TDMV 1,B00,492763,Arcidiacono; Kristin,26,0,30,4
1713337046039,TDMV 2,A00,492764,Weinberg; Sadie,27,0,30,3
1713337047065,TDMV 3,A00,492765,Mack; Kara Shanai',37,0,40,3
1713337048094,TDMV 138,A00,492777,Mack; Kara Shanai',33,0,40,7
1713337049122,TDMV 140,A00,492778,Lima; Paulo Henrique,40,0,40,0
1713337050152,TDMV 142,A00,492779,Caligagan; Maria T.,33,0,40,7
1713337050152,TDMV 142,B00,492780,Caligagan; Tony,37,0,40,3
1713337051179,TDMV 143,A00,492781,Fyall; Daunte Edward,39,0,40,1
1713337052204,USP 1,A01,492401,Kwak; Nancy,27,0,35,8
1713337053231,USP 2,A01,492453,Hinds; Juli Beth,35,0,35,0
1713337054262,USP 3,A01,492516,Staff,28,0,35,7
1713337055289,USP 4,A00,492522,McTague; Sarah,16,0,25,9
1713337056318,USP 100,A00,492523,Staff,32,0,35,3
1713337057344,USP 101,A00,492524,Staff,13,0,15,2
1713337058375,USP 105,A00,492525,Staff,21,0,25,4
1713337059400,USP 151,A00,492526,Shenkman; Michael Thomas,32,0,35,3
1713337060428,USP 170,A00,492545,Hinds; Juli Beth,33,0,35,2
1713337061457,USP 171GS,A00,492608,Bussell; Mirle Rabinowitz,24,0,28,4
1713337062486,USP 183GS,A00,492613,Peerson; Susan,24,0,28,4
1713337063511,VIS 30,A01,490693,Yoldas; Pinar,19,0,22,3
1713337063511,VIS 30,A02,490694,Yoldas; Pinar,18,0,22,4
1713337064541,VIS 83,A00,490695,Kester; Grant,63,0,75,12
1713337065566,VIS 105D,A00,490696,Staff,22,0,25,3
1713337066634,VIS 124CN,A00,490699,Rose; Jordan M,65,0,75,10
1713337067660,VIS 125GS,A00,511221,Williams; Alena J,21,0,22,1
1713337068688,VIS 128D,A00,490700,Staff,73,0,75,2
1713337069717,VIS 151,A01,490717,Staff,33,0,34,1
1713337069717,VIS 151,A02,490766,Staff,33,0,34,1
1713337070743,VIS 154GS,A00,511972,Williams; Alena J,21,0,22,1
1713337071768,VIS 160A,A00,490767,Stone; Patricia,7,0,10,3
1713337072794,WCWP 10A,A00,490638,Staff,14,0,15,1
1713337072794,WCWP 10A,B00,490640,Staff,15,0,15,0
1713337073874,WCWP 10B,A00,490641,Staff,0,0,0,0
1713337073874,WCWP 10B,B00,490642,Staff,14,0,15,1
1713337073874,WCWP 10B,C00,490644,Staff,13,0,15,2
1713337073874,WCWP 10B,D00,490647,Staff,0,0,0,0
1713337074898,WCWP 100,A00,490655,Staff,0,0,0,0
1713337074898,WCWP 100,B00,490687,Staff,10,0,15,5
1713337076994,ANAR 153,A00,487222,Braswell; Geoffrey E.,53,0,60,7
1713337078018,ANBI 134,A00,487223,Staff,6,0,20,14
1713337079047,ANBI 143GS,A00,487224,Noel; Geoffroy Pierre Jean,18,0,24,6
1713337080072,ANBI 144GS,A00,519548,Noel; Geoffroy Pierre Jean,18,0,24,6
1713337081096,ANSC 101,A00,487225,Staff,18,0,20,2
1713337082122,ANSC 125,A00,487227,Brenner; Suzanne A,38,0,40,2
1713337084179,ANSC 146,A00,487229,Staff,35,0,40,5
1713337085203,ANSC 148,A00,487230,Olivas Hernandez; Olga Lid,39,0,40,1
1713337086234,ANSC 150,A00,504165,Sloane; Julia Kathryn,18,0,20,2
1713337087260,ANSC 180,A00,487232,Staff,14,0,15,1
1713337088286,ANSC 188,A00,627155,Staff,38,0,40,2
1713337089351,ANTH 5,A00,519529,Semendeferi; Ekaterini,15,0,15,0
1713337090377,ANTH 10,A00,487219,Staff,58,0,60,2
1713337091401,ANTH 23,A01,487221,Staff,17,0,20,3
1713337092425,ANTH 102,A00,487233,Wilder; Linnea Lorene,50,0,60,10
1713337093456,ANTH 103,A00,487234,Varma; Saiba,54,0,60,6
1713337094486,ANTH 105,A00,487235,Stewart; Alexander B,54,0,60,6
1713337095514,BENG 100,A01,516685,Taylor Amos; Alyssa C,26,0,30,4
1713337096540,BIBC 102,A01,491316,Flagg; Matthew Paul,7,0,88,81
1713337096540,BIBC 102,A02,491366,Flagg; Matthew Paul,78,0,88,10
1713337097570,BIBC 103,A01,491486,Boumechache; Miyyada,16,0,24,8
1713337097570,BIBC 103,A02,491487,Boumechache; Miyyada,24,0,24,0
1713337098599,BICD 100,A01,516882,Staff,73,0,75,2
1713337098599,BICD 100,A02,516890,Staff,69,0,75,6
1713337099628,BICD 102GS,A00,491488,Lo; Stanley M.,26,0,28,2
1713337100658,BIEB 136GS,A00,516940,Holway; David A. & Shurin; Jonathan,18,0,24,6
1713337101692,BIEB 137GS,A01,517034,Holway; David A. & Shurin; Jonathan,18,0,24,6
1713337102718,BIEB 138GS,A01,491492,Pirino; Giorgia,21,0,28,7
1713337103744,BILD 1,A01,491296,Staff,60,0,63,3
1713337103744,BILD 1,A02,491297,Staff,63,0,63,0
1713337104771,BILD 4,A01,517099,Gonzalez Gamboa; Ivonne,22,0,24,2
1713337104771,BILD 4,A02,517100,Gonzalez Gamboa; Ivonne,24,0,24,0
1713337105799,BILD 60GS,A00,491309,Lo; Stanley M.,26,0,28,2
1713337106829,BIMM 100,A01,517136,Staff,82,0,100,18
1713337107860,BIMM 110,A01,517182,Staff,53,0,100,47
1713337108891,BIMM 120,A01,517228,Pickett; Brooke Elizabeth,28,0,63,35
1713337108891,BIMM 120,A02,517240,Pickett; Brooke Elizabeth,44,0,63,19
1713337109916,BIMM 132GS,A01,491498,Pirino; Giorgia,21,0,28,7
1713337110942,BIMM 143,A01,491589,Bozinovic; Goran,12,0,40,28
1713337111968,BIPN 100,A01,491594,Armour; Jon Christopher,83,0,100,17
1713337112994,BIPN 140,A01,491602,Marino; Marc J,23,0,50,27
1713337115043,CAT 125,A00,515973,Staff,18,0,20,2
1713337116067,CAT 125GS,A00,515974,Rahimi; Babak,16,0,20,4
1713337117095,CAT 125R,A00,515980,Staff,12,0,20,8
1713337117095,CAT 125R,B00,515981,Tosun; Adriana,19,0,20,1
1713337117095,CAT 125R,C00,515987,Hyland; Tina Mae,0,4,20,20
1713337117095,CAT 125R,D00,515988,Bronstein; Phoebe Malan,16,0,20,4
1713337118122,CENG 15,A01,488699,Drews; Aaron,25,0,25,0
1713337119154,CENG 100,A00,505196,Opatkiewicz; Justin Paul,25,0,25,0
1713337120184,CGS 2A,A01,489598,Staff,33,0,35,2
1713337121208,CGS 112,A00,489599,Staff,15,0,15,0
1713337122234,CGS 119,A00,489603,Staff,10,0,10,0
1713337123259,CGS 120,A00,489604,Staff,13,0,15,2
1713337124286,CGS 150,A00,489607,Staff,15,0,15,0
1713337125312,CHEM 6A,A01,488715,Staff,97,0,100,3
1713337126338,CHEM 6B,A01,488719,Piercy; Marc Anthony,99,0,100,1
1713337127365,CHEM 6C,A01,488723,Albizati; Kim F.,93,0,100,7
1713337128394,CHEM 7L,A01,488728,Schurmeier; Kimberly,18,0,24,6
1713337128394,CHEM 7L,A02,488730,Schurmeier; Kimberly,23,0,24,1
1713337128394,CHEM 7L,A03,488734,Schurmeier; Kimberly,20,0,24,4
1713337128394,CHEM 7L,A04,488763,Schurmeier; Kimberly,23,0,24,1
1713337128394,CHEM 7L,B01,488798,Schurmeier; Kimberly,17,0,24,7
1713337128394,CHEM 7L,B02,488801,Schurmeier; Kimberly,22,0,24,2
1713337128394,CHEM 7L,B03,488808,Schurmeier; Kimberly,22,0,24,2
1713337128394,CHEM 7L,B04,488811,Schurmeier; Kimberly,24,0,24,0
1713337129425,CHEM 11,A01,488897,Stallings; Dontarie M,95,0,100,5
1713337130451,CHEM 40A,A01,488913,Albizati; Kim F.,83,0,100,17
1713337131475,CHEM 40B,A01,488920,Weizman; Haim,42,0,50,8
1713337131475,CHEM 40B,A02,488938,Weizman; Haim,44,0,50,6
1713337132504,CHEM 41A,A01,489029,Klosterman; Jeremy K,57,0,60,3
1713337133530,CHEM 41C,A01,500436,Tor; Yitzhak,55,0,60,5
1713337134558,CHEM 43A,A01,500426,Weizman; Haim,0,1,24,24
1713337134558,CHEM 43A,A02,500430,Weizman; Haim,6,0,24,18
1713337134558,CHEM 43A,B01,514041,Klosterman; Jeremy K,16,0,24,8
1713337134558,CHEM 43A,B02,514047,Klosterman; Jeremy K,23,0,24,1
1713337135586,CHEM 108,A01,489140,Jennings; Patricia A.,7,0,24,17
1713337135586,CHEM 108,A02,489142,Jennings; Patricia A.,14,0,24,10
1713337136611,CHEM 114A,A01,489147,Stallings; Dontarie M,65,0,100,35
1713337137636,CHIN 169A,A00,489171,Wang; Xiao,19,0,20,1
1713337139689,COGS 3,A01,518827,Boyle; Mary E. T.,25,0,40,15
1713337140718,COGS 11,A01,489175,Staff,27,0,30,3
1713337141745,COGS 14A,A01,518829,Staff,51,0,60,9
1713337142771,COGS 14B,A01,489177,Hoffman; Drew Ellen,62,0,75,13
1713337143801,COGS 100,A01,489181,Allen; Michael Gordon,62,0,75,13
1713337144832,COGS 101A,A01,489183,Staff,45,0,60,15
1713337145857,COGS 101B,A01,489185,Allen; Michael Gordon,6,0,30,24
1713337147036,COGS 101C,A01,526786,Staff,23,0,30,7
1713337149087,COGS 107A,A01,489189,Boyle; Mary E. T.,16,0,35,19
1713337150120,COGS 107B,A01,627144,Mooshagian; Eric Frederick,60,0,60,0
1713337151145,COGS 118A,A01,489191,Staff,0,46,40,40
1713337153198,COGS 171GS,A01,489194,Pineda; Jaime A,19,0,28,9
1713337154228,COGS 172,A01,489196,Staff,2,0,30,28
1713337155254,COGS 174GS,A01,489264,Pineda; Jaime A,19,0,28,9
1713337156281,COGS 180,A01,627150,Staff,28,0,30,2
1713337157308,COGS 186,A01,489274,Staff,0,2,30,30
1713337158335,COMM 10,A01,489276,Staff,23,0,25,2
1713337158335,COMM 10,A02,489303,Staff,23,0,25,2
1713337159362,COMM 100A,A01,489312,Staff,14,0,25,11
1713337159362,COMM 100A,A02,489313,Staff,24,0,25,1
1713337160388,COMM 106T,A00,512540,Staff,33,0,35,2
1713337161414,COMM 107,A00,489347,Staff,27,0,35,8
1713337162438,COMM 109P,A00,489358,Staff,31,0,35,4
1713337163467,COMM 132,A00,489361,McKenna; Denise,27,0,30,3
1713337164493,COMM 146,A00,489362,Halm; Gavin Patrick,26,0,30,4
1713337165519,COMM 190,A00,489363,Abuelhiga; Soraya Jill,17,0,23,6
1713337166552,CSE 8A,A50,489366,Staff,21,0,25,4
1713337166552,CSE 8A,A51,489367,Staff,24,0,25,1
1713337167576,CSE 11,A01,489398,Cao; Yingjun,73,0,100,27
1713337168603,CSE 12,A01,489487,Staff,43,0,50,7
1713337169628,CSE 20,A01,489497,Staff,47,0,50,3
1713337170654,CSE 21,A01,489517,Braun; Oliver,42,0,50,8
1713337171683,CSE 101,A01,489524,Braun; Oliver,0,32,50,50
1713337172710,CSE 105,A01,512594,Jones; Miles E,72,0,100,28
1713337172710,CSE 105,B01,512598,Jones; Miles E,52,0,100,48
1713337173736,CSE 140,A01,489538,Staff,41,0,50,9
1713337174762,CSE 141,A01,489550,Eldon; John,67,0,100,33
1713337175792,CSE 141L,A01,489571,Eldon; John,65,0,100,35
1713337176823,CSE 151A,A01,489583,Solares; Edwin A,140,0,200,60
1713337177904,CSE 175,A01,510886,Kumar; Rakesh,30,0,30,0
1713337178930,CSE 190,A00,516828,Dubnov; Shlomo,37,0,49,12
1713337179959,DOC 100D,A00,489667,Pass; Natalye Joann,19,0,25,6
1713337180985,DSC 10,A01,624268,Staff,72,0,75,3
1713337182014,DSC 20,A01,624476,Staff,50,0,50,0
1713337183042,DSC 40A,A01,624608,Staff,39,0,40,1
1713337184070,DSGN 1,A01,489179,Rill; Bryan,32,0,50,18
1713337185101,ECE 17,A01,490489,Sahay; Rajeev,18,0,30,12
1713337186127,ECE 65,A50,490492,Staff,11,0,20,9
1713337186127,ECE 65,A51,490493,Staff,18,0,20,2
1713337187154,ECON 1,A01,489715,Famulari; Melissa,67,0,70,3
1713337188183,ECON 2,A01,489717,Levkoff; Steven B.,67,0,70,3
1713337189214,ECON 3,A01,489948,Staff,70,0,70,0
1713337191271,ECON 5,A01,490103,Staff,27,0,30,3
1713337191271,ECON 5,B01,626281,Dai; Yinlin,45,0,45,0
1713337192298,ECON 100A,A01,490127,Famulari; Melissa,63,0,70,7
1713337193326,ECON 100B,A01,490129,Staff,64,0,70,6
1713337194350,ECON 109,A01,490187,Shishkin; Denis,27,0,35,8
1713337195377,ECON 110A,A01,490190,Levkoff; Steven B.,59,0,70,11
1713337196402,ECON 120A,A01,490245,Dai; Yinlin,60,0,70,10
1713337197430,ECON 120B,A01,490247,Nieto-Barthaburu; Augusto,40,0,70,30
1713337198457,ECON 120C,A01,490253,Sun; Yixiao,30,0,35,5
1713337198457,ECON 120C,B01,490255,Sun; Yixiao,34,0,35,1
1713337199484,ECON 129,A00,490256,Eckert; Fabian Paul,22,0,35,13
1713337200510,ECON 131,A00,490257,Nieto-Barthaburu; Augusto,0,6,35,35
1713337201538,ECON 138,A00,490258,Bharadwaj; Prashant,13,0,35,22
1713337201538,ECON 138,B00,490259,Bharadwaj; Prashant,15,0,35,20
1713337202574,ECON 159,A00,490260,Hendrickson; Gerald M.,0,9,0,0
1713337203599,ECON 178,A01,553995,Zhu; Ying,24,0,35,11
1713337204629,EDS 40,A01,512576,Black; Alison Michelle,20,0,20,0
1713337205656,EDS 107,A01,515848,Staff,30,0,30,0
1713337206685,EDS 110R,A01,490262,Staff,26,0,30,4
1713337207712,EDS 112,A01,490264,Chapman; Thandeka K,40,0,50,10
1713337208739,EDS 113,A00,490266,Staff,25,0,30,5
1713337209770,EDS 118,A00,490267,Warstadt; Melissa Fawn,18,0,30,12
1713337210798,EDS 124BR,A00,490268,Eguchi; Emi,4,0,25,21
1713337210798,EDS 124BR,B00,490269,Eguchi; Emi,23,0,25,2
1713337211827,EDS 126,A01,490271,Jones; Makeba,43,0,50,7
1713337212930,EDS 135,A01,490316,Staff,19,0,20,1
1713337213954,ENVR 142GS,A00,519514,Chang; Edmond Yi-Teh,26,0,28,2
1713337214985,ETHN 103,A00,490504,Staff,25,0,36,11
1713337216012,ETHN 103A,A00,490505,Man; Simeon S,3,0,9,6
1713337217038,ETHN 109,A00,490506,Staff,28,0,30,2
1713337218068,ETHN 118,A00,490507,Staff,35,0,36,1
1713337219095,ETHN 119,A00,490508,Staff,32,0,36,4
1713337220122,ETHN 121R,A00,490518,Choi; Esther Min,21,0,36,15
1713337221149,ETHN 127,A00,490528,Staff,14,0,15,1
1713337222174,ETHN 139,A00,490573,Staff,10,0,10,0
1713337223198,ETHN 150,A00,490575,Staff,15,0,15,0
1713337224225,GLBH 20,A00,491705,Elwardani; Nile Regina,38,0,40,2
1713337225251,GLBH 101,A00,491706,Staff,20,0,20,0
1713337226277,GLBH 111,A01,491708,Burgos; Jose L.,15,0,15,0
1713337227303,GLBH 146,A00,491709,Staff,9,0,20,11
1713337228328,GLBH 148,A00,491710,Olivas Hernandez; Olga Lid,11,0,20,9
1713337229357,GLBH 150,A00,491711,Sloane; Julia Kathryn,19,0,20,1
1713337230385,HIEA 131,A00,491760,Staff,28,0,32,4
1713337231411,HIEA 153,A00,491762,Staff,28,0,30,2
1713337232438,HIEU 124,A00,491811,Staff,26,0,32,6
1713337233467,HIEU 124GS,A00,491812,Markman; Kristina,27,0,28,1
1713337234492,HIEU 147,A00,491813,Staff,29,0,32,3
1713337235522,HIEU 149GS,A00,491816,Caldwell; Michael Alan,28,0,28,0
1713337236546,HILD 2C,A01,491713,Hendrickson; Gerald M.,26,0,30,4
1713337237572,HILD 7B,A01,491715,Kwak; Nancy,0,2,30,30
1713337238598,HILD 10,A01,491717,Staff,9,0,20,11
1713337239626,HILD 30GS,A00,491719,Edington; Claire Ellen,23,0,28,5
1713337240653,HINE 109,A00,491818,Shafir; Nir,27,0,32,5
1713337241677,HINE 128,A00,491821,Shafir; Nir,31,0,32,1
1713337242703,HISC 117,A00,491830,Staff,27,0,32,5
1713337243732,HIUS 103,A00,491834,Man; Simeon S,14,0,23,9
1713337244761,HIUS 108B,A00,491835,Staff,27,0,30,3
1713337245787,HIUS 141,A00,491836,Hendrickson; Gerald M.,28,0,32,4
1713337246815,HIUS 149,A00,491839,Staff,24,0,32,8
1713337247846,HUM 3,A01,512617,Crum; Matthew Stephen,42,0,50,8
1713337247846,HUM 3,A02,512618,Crum; Matthew Stephen,48,0,50,2
1713337248872,HUM 3GS,A00,512663,Markman; Kristina,0,0,0,1
1713337248872,HUM 3GS,B00,512664,Staff,0,0,0,0
1713337249898,HUM 4,A01,512620,West; Geoffrey Scott,25,0,50,25
1713337250924,HUM 4GS,A00,512666,Lyon; Antony J.,0,0,0,5
1713337251954,HUM 4R,A01,512625,Watkins; Eric,49,0,50,1
1713337252979,HUM 5,A01,512649,Zavodny; Tatiana Sophia,20,0,50,30
1713337252979,HUM 5,B01,512661,Zroka; Ryan Edward,48,0,50,2
1713337254010,INTL 190,A00,490577,Segui; Alan S,0,0,0,5
1713337255037,JAPN 20AR,A01,491267,Ross; Kayoko F,7,0,20,13
1713337256063,JAPN 180,A00,491285,Berman; Michael David,33,0,40,7
1713337257097,LATI 50,A01,502536,Kokinis; Troy Andreas,16,0,22,6
1713337257097,LATI 50,A02,502551,Kokinis; Troy Andreas,22,0,22,0
1713337257097,LATI 50,A03,502650,Kokinis; Troy Andreas,22,0,22,0
1713337257097,LATI 50,A04,502909,Kokinis; Troy Andreas,21,0,22,1
1713337258125,LATI 160,A01,502920,Kokinis; Troy Andreas,30,0,30,0
1713337259156,LIFR 1A,A00,490494,Van Moer; Vinciane G,17,0,20,3
1713337260207,LIFR 1AX,A00,490495,Van Moer; Vinciane G,17,0,20,3
1713337261233,LIFR 1B,A00,490496,Van Moer; Vinciane G,17,0,20,3
1713337262259,LIFR 1BX,A00,490497,Van Moer; Vinciane G,17,0,20,3
1713337263287,LIGN 8,A00,505198,McIntosh; Justin Daniel,134,0,150,16
1713337264312,LIGN 9GS,A00,491239,Lott; Margaret S.,18,0,20,2
1713337265338,LIGN 101,A01,505200,McIntosh; Justin Daniel,22,0,30,8
1713337266366,LIGN 120,A01,491244,Staff,22,0,30,8
1713337267391,LIGN 149GS,A00,491245,Lott; Margaret S.,18,0,20,2
1713337268415,LIGN 170,A00,491247,Staff,22,0,30,8
1713337269440,LISP 1D,A00,490498,Munoz Sanchez; Alicia,8,0,14,6
1713337269440,LISP 1D,B00,490499,Munoz Sanchez; Alicia,4,0,14,10
1713337269440,LISP 1D,C00,490500,Munoz Sanchez; Alicia,7,0,14,7
1713337269440,LISP 1D,D00,490501,Munoz Sanchez; Alicia,10,0,14,4
1713337270594,LISP 1DX,A00,490502,Munoz Sanchez; Alicia,11,0,28,17
1713337270594,LISP 1DX,B00,490503,Munoz Sanchez; Alicia,16,0,28,12
1713337272646,LTAM 110,A00,491847,Staff,22,0,25,3
1713337273672,LTCS 119,A00,491848,Staff,11,0,15,4
1713337274703,LTCS 130,A00,491849,Staff,24,0,25,1
1713337276765,LTEA 120C,A00,491852,Staff,32,0,40,8
1713337277825,LTEN 130GS,A00,491853,Lyon; Antony J.,23,0,28,5
1713337278891,LTEN 148,A00,491855,Staff,23,0,25,2
1713337279917,LTEN 159,A00,491856,Staff,20,0,25,5
1713337280946,LTEN 180,A00,491857,Staff,8,0,15,7
1713337283074,LTSP 123GS,A00,505928,Bessett; Ryan Matthew,24,0,28,4
1713337284099,LTSP 174GS,A00,506037,Bessett; Ryan Matthew,24,0,28,4
1713337286165,LTWR 102,A00,491861,Staff,9,0,15,6
1713337287195,LTWR 106,A00,491862,Staff,8,0,15,7
1713337288222,MAE 11,A00,490930,Bahadori; Mohammad Yousef,95,0,100,5
1713337289250,MAE 30A,A00,490931,Qi; Huihui,37,0,40,3
1713337290275,MAE 101A,A00,491036,Sadeghizadeh; Zahra,92,0,100,8
1713337291308,MAE 101C,A00,491037,Seshadri; Kalyanasundaram,64,0,100,36
1713337292399,MAE 113,A00,491040,Seshadri; Kalyanasundaram,64,0,80,16
1713337293430,MAE 131A,A00,491041,Ghazinejad; Maziar,37,0,40,3
1713337294459,MAE 142,A00,491053,Staff,39,0,40,1
1713337295497,MAE 143A,A00,491054,Staff,30,0,50,20
1713337296522,MAE 150,A00,491092,Truong; Phuong Thi Ngoc,23,0,35,12
1713337297560,MATH 3C,A01,494031,Pardo Guerra; Sebastian,30,0,30,0
1713337297560,MATH 3C,A02,494032,Pardo Guerra; Sebastian,29,0,30,1
1713337298585,MATH 10A,A01,494034,Staff,27,0,30,3
1713337298585,MATH 10A,A02,494035,Staff,28,0,30,2
1713337298585,MATH 10A,B01,494037,Staff,27,0,30,3
1713337298585,MATH 10A,B02,494038,Staff,29,0,30,1
1713337299629,MATH 10B,A01,494040,Habib; Yousaf,22,0,30,8
1713337299629,MATH 10B,A02,494041,Habib; Yousaf,28,0,30,2
1713337299629,MATH 10B,A03,494042,Habib; Yousaf,29,0,30,1
1713337299629,MATH 10B,A04,494043,Habib; Yousaf,30,0,30,0
1713337299629,MATH 10B,B01,494045,Habib; Yousaf,25,0,30,5
1713337299629,MATH 10B,B02,494046,Habib; Yousaf,30,0,30,0
1713337299629,MATH 10B,B03,494047,Habib; Yousaf,30,0,30,0
1713337299629,MATH 10B,B04,494048,Habib; Yousaf,30,0,30,0
1713337300664,MATH 18,A01,494050,Kemp; Todd Aahron,25,0,30,5
1713337300664,MATH 18,A02,494051,Kemp; Todd Aahron,29,0,30,1
1713337300664,MATH 18,B01,494054,Kemp; Todd Aahron,25,0,30,5
1713337300664,MATH 18,B02,494055,Kemp; Todd Aahron,29,0,30,1
1713337301696,MATH 20A,A01,494059,Suk; Andrew Hoon,30,0,30,0
1713337302739,MATH 20B,A01,494061,Briones; Jor-el Thomas Caparas,33,0,35,2
1713337302739,MATH 20B,B01,494063,Bach; Quang Tran,34,0,35,1
1713337303779,MATH 20C,A01,494065,Staff,28,0,30,2
1713337303779,MATH 20C,A02,494066,Staff,30,0,30,0
1713337303779,MATH 20C,A03,494067,Staff,30,0,30,0
1713337303779,MATH 20C,A04,494068,Staff,30,0,30,0
1713337303779,MATH 20C,B01,494070,Zhang; Ming,24,0,30,6
1713337303779,MATH 20C,B02,494071,Zhang; Ming,27,0,30,3
1713337303779,MATH 20C,B03,494072,Zhang; Ming,29,0,30,1
1713337303779,MATH 20C,B04,494073,Zhang; Ming,29,0,30,1
1713337304812,MATH 20D,A01,494075,Staff,22,0,30,8
1713337304812,MATH 20D,A02,494076,Staff,29,0,30,1
1713337305840,MATH 20E,A01,494079,Staff,24,0,30,6
1713337305840,MATH 20E,A02,494080,Staff,26,0,30,4
1713337305840,MATH 20E,B01,494082,Staff,25,0,30,5
1713337305840,MATH 20E,B02,494083,Staff,25,0,30,5
1713337306874,MATH 103A,A01,494085,Aliabadi Sr.; Mohsen,12,0,30,18
1713337306874,MATH 103A,A02,494086,Aliabadi Sr.; Mohsen,28,0,30,2
1713337306874,MATH 103A,B01,494088,Aliabadi Sr.; Mohsen,20,0,30,10
1713337306874,MATH 103A,B02,494089,Aliabadi Sr.; Mohsen,27,0,30,3
1713337307908,MATH 109,A01,494091,Staff,30,0,30,0
1713337307908,MATH 109,A02,494092,Staff,29,0,30,1
1713337307908,MATH 109,B01,494094,Staff,27,0,30,3
1713337307908,MATH 109,B02,494095,Staff,29,0,30,1
1713337308950,MATH 142A,A01,494097,Chow; Bennett,13,0,30,17
1713337308950,MATH 142A,A02,494098,Chow; Bennett,23,0,30,7
1713337308950,MATH 142A,B01,494100,Chow; Bennett,19,0,30,11
1713337308950,MATH 142A,B02,494101,Chow; Bennett,29,0,30,1
1713337311003,MATH 168A,A01,516677,Dumitriu; Ioana,16,0,35,19
1713337312037,MATH 170A,A01,516679,Dumitriu; Ioana,18,0,30,12
1713337312037,MATH 170A,A02,516680,Dumitriu; Ioana,28,0,30,2
1713337313091,MATH 193A,A01,494107,Staff,12,0,30,18
1713337313091,MATH 193A,A02,494108,Staff,18,0,30,12
1713337313091,MATH 193A,A03,494109,Staff,29,0,30,1
1713337313091,MATH 193A,A04,494110,Staff,22,0,30,8
1713337316202,MGT 16,A00,491930,McKay; Michael J,92,0,98,6
1713337317229,MGT 18,A00,491992,McKay; Michael J,96,0,98,2
1713337318264,MGT 71,A00,492003,Staff,63,0,98,35
1713337319309,MGT 103,A00,505209,Eberhard; Craig A,80,0,98,18
1713337320341,MGT 131A,A00,505210,Anderson; John Charles,89,0,98,9
1713337322402,MGT 153,A00,492077,Perols; Johan Lars,16,0,90,74
1713337325525,MGT 164,A00,492222,McKay; Mary A,91,0,98,7
1713337326551,MGT 172,A00,492245,Staff,59,0,60,1
1713337326551,MGT 172,B00,505526,Hedges; Kathleen,65,0,98,33
1713337327580,MGT 181,A00,505669,Dunn; Louis Jean,79,0,98,19
1713337328615,MMW 14,A01,494399,Staff,15,0,28,13
1713337328615,MMW 14,A02,494400,Staff,25,0,28,3
1713337328615,MMW 14,A03,494401,Staff,28,0,28,0
1713337328615,MMW 14,A04,494402,Staff,28,0,28,0
1713337328615,MMW 14,B01,494404,Carreras; Maria Victoria,8,0,28,20
1713337328615,MMW 14,B02,494405,Carreras; Maria Victoria,25,0,28,3
1713337328615,MMW 14,B03,494406,Carreras; Maria Victoria,27,0,28,1
1713337328615,MMW 14,B04,494407,Carreras; Maria Victoria,28,0,28,0
1713337329663,MMW 14GS,A00,506250,Chang; Edmond Yi-Teh,0,0,0,0
1713337330689,MMW 121R,A01,494415,Adamiak; Patrick John,10,0,28,18
1713337330689,MMW 121R,A02,494416,Adamiak; Patrick John,24,0,28,4
1713337331715,MUS 1A,A01,494113,Staff,12,0,25,13
1713337331715,MUS 1A,A02,494114,Staff,24,0,25,1
1713337332763,MUS 4,A01,494116,Staff,23,0,25,2
1713337332763,MUS 4,A02,494117,Staff,22,0,25,3
1713337333803,MUS 5R,A01,494236,Dubnov; Shlomo,4,0,25,21
1713337333803,MUS 5R,A02,494237,Dubnov; Shlomo,25,0,25,0
1713337334833,MUS 6,A01,494122,Staff,9,0,25,16
1713337334833,MUS 6,A02,494123,Staff,23,0,25,2
1713337335858,MUS 7,A01,494125,Staff,16,0,25,9
1713337335858,MUS 7,A02,494126,Staff,24,0,25,1
1713337336884,MUS 11,A01,494128,Staff,23,0,25,2
1713337336884,MUS 11,A02,494129,Staff,24,0,25,1
1713337337913,MUS 13,A01,494131,Staff,25,0,25,0
1713337337913,MUS 13,A02,494132,Staff,25,0,25,0
1713337338945,MUS 15,A01,494134,Staff,16,0,25,9
1713337338945,MUS 15,A02,494135,Staff,25,0,25,0
1713337338945,MUS 15,B01,494137,Staff,24,0,25,1
1713337339972,MUS 80,A00,494232,Staff,24,0,25,1
1713337339972,MUS 80,B00,494233,Staff,25,0,25,0
1713337339972,MUS 80,C00,494234,Staff,23,0,25,2
1713337341010,MUS 95C,A00,494141,Staff,69,0,75,6
1713337342037,MUS 114,A00,494142,Staff,40,0,50,10
1713337343075,NANO 15,A01,490636,Drews; Aaron,7,0,7,0
1713337344106,PHIL 1,A00,490578,Grush; Rick Scott,49,0,50,1
1713337345133,PHIL 10,A01,490580,Grush; Rick Scott,33,0,35,2
1713337345133,PHIL 10,A02,490586,Grush; Rick Scott,32,0,35,3
1713337346165,PHIL 27,A01,490591,Staff,22,0,25,3
1713337346165,PHIL 27,A02,490592,Staff,25,0,25,0
1713337346165,PHIL 27,A03,490593,Staff,25,0,25,0
1713337346165,PHIL 27,A04,490598,Staff,25,0,25,0
1713337347189,PHIL 32,A01,490611,Staff,20,0,20,0
1713337347189,PHIL 32,A02,490618,Staff,20,0,20,0
1713337348215,PHIL 90,A00,490624,Staff,40,0,40,0
1713337349258,PHIL 136,A00,490627,Cohen; Jonathan David,37,0,40,3
1713337350287,PHIL 155,A00,490634,Staff,62,0,70,8
1713337351321,PHYS 1A,A00,491610,Staff,245,0,250,5
1713337352354,PHYS 1AL,001,491616,Tsai; Philbert S,27,0,30,3
1713337352354,PHYS 1AL,002,491618,Tsai; Philbert S,30,0,30,0
1713337353382,PHYS 1B,A00,491623,Staff,235,0,250,15
1713337354424,PHYS 1BL,001,491626,Tsai; Philbert S,19,0,30,11
1713337354424,PHYS 1BL,002,491628,Tsai; Philbert S,26,0,30,4
1713337355450,PHYS 1C,A00,491632,Staff,213,0,245,32
1713337356558,PHYS 1CL,001,491635,Tsai; Philbert S,3,0,30,27
1713337356558,PHYS 1CL,002,491643,Tsai; Philbert S,22,0,30,8
1713337357584,PHYS 2AR,A01,491651,Meyertholen; Andrew D.,44,0,50,6
1713337358615,PHYS 2B,A01,491659,Staff,105,0,115,10
1713337359650,PHYS 2BL,A01,491685,Staff,21,0,24,3
1713337359650,PHYS 2BL,A02,491700,Staff,21,0,24,3
1713337360759,PHYS 2C,A01,505161,Staff,101,0,115,14
1713337361785,PHYS 4A,A01,491704,Grinstein; Benjamin,99,0,100,1
1713337362823,POLI 5D,A01,494144,Staff,3,0,5,2
1713337362823,POLI 5D,B01,626283,Dai; Yinlin,5,0,5,0
1713337363862,POLI 12,A00,494145,Staff,43,0,45,2
1713337364893,POLI 13R,A00,494146,Forman; Fonna,45,0,50,5
1713337365921,POLI 27,A01,494148,Staff,54,0,60,6
1713337366958,POLI 30,A00,494149,Staff,49,0,50,1
1713337367997,POLI 100DA,A00,494150,Staff,20,0,25,5
1713337370052,POLI 100I,A00,494152,Staff,27,0,30,3
1713337371090,POLI 104B,A00,494153,Smith; Glenn Chatmas,53,0,55,2
1713337372139,POLI 104F,A00,494154,Staff,28,0,30,2
1713337373178,POLI 104I,A00,494155,Smith; Glenn Chatmas,29,0,30,1
1713337374226,POLI 110C,A00,494156,Ingham; Sean,23,0,25,2
1713337375274,POLI 117R,A00,494157,Forman; Fonna,5,0,20,15
1713337376307,POLI 118,A00,494158,Ingham; Sean,21,0,25,4
1713337377337,POLI 120H,A00,494159,Fisk; David Lee,39,0,45,6
1713337378413,POLI 131CR,A00,494160,Hoston; Germaine,35,0,45,10
1713337379451,POLI 133J,A00,494161,Staff,31,0,35,4
1713337380516,POLI 135,A00,494162,Fisk; David Lee,33,0,35,2
1713337381559,POLI 140A,A00,494164,Staff,19,0,30,11
1713337382610,POLI 142I,A00,494165,Staff,30,0,30,0
1713337383648,POLI 144D,A00,494166,Staff,23,0,25,2
1713337384709,POLI 151,A00,494167,Staff,30,0,30,0
1713337385737,POLI 153,A00,494168,Staff,33,0,35,2
1713337386845,POLI 160AA,A00,494169,Staff,34,0,40,6
1713337387872,POLI 162,A00,494170,Mignozzetti; Umberto,18,0,25,7
1713337388981,POLI 171,A00,494171,Mignozzetti; Umberto,18,0,25,7
1713337390026,PSYC 1,A00,494172,Staff,95,0,100,5
1713337391056,PSYC 2,A00,494173,Moranton; Nirelia Melbina-,34,0,50,16
1713337392086,PSYC 3,A00,494174,Staff,29,0,30,1
1713337393111,PSYC 6,A00,494175,Staff,17,0,20,3
1713337394137,PSYC 60,A01,494177,Staff,37,0,45,8
1713337395161,PSYC 70,A01,505724,Geller; Emma Harlan,42,0,45,3
1713337396188,PSYC 101,A00,494180,Heyman; Gail D.,84,0,100,16
1713337397219,PSYC 105,A00,494181,Geller; Emma Harlan,51,0,90,39
1713337398257,PSYC 106,A00,494182,Dobkins; Karen R.,26,0,45,19
1713337399283,PSYC 108,A00,494183,Adrian; Julia Anna,89,0,100,11
1713337400310,PSYC 114,A01,494185,Winkielman; Piotr,0,3,30,30
1713337401347,PSYC 122,A00,494186,Moranton; Nirelia Melbina-,27,0,50,23
1713337402379,PSYC 124,A00,494187,Chapman; Eddie Nathaniel,70,0,80,10
1713337403404,PSYC 131,A00,494188,Anagnostaras; Stephan,40,0,80,40
1713337404440,PSYC 144,A00,494189,Staff,1,0,50,49
1713337405472,PSYC 154,A00,494190,Lacefield; Katharine I,106,0,180,74
1713337406499,PSYC 162,A00,494191,Wixted; John T,70,0,100,30
1713337407533,PSYC 172,A00,494192,Gorman; Michael R.,36,0,45,9
1713337408560,PSYC 178,A00,494193,Glaser; Dale,34,0,45,11
1713337409585,PSYC 193,A00,505725,Chapman; Eddie Nathaniel,20,0,20,0
1713337410623,RELI 145GS,A00,519817,Rahimi; Babak,17,0,20,3
1713337411655,SE 101A,A01,490862,Chadha; Mayank,23,0,25,2
1713337412682,SE 101C,A01,490924,Krysl; Petr,15,0,20,5
1713337413714,SE 110A,A01,490928,Staff,19,0,20,1
1713337414740,SE 130A,A00,490929,Morrison; Machel Leigh,54,0,70,16
1713337415769,SIO 1,A01,519325,Staff,39,0,40,1
1713337416793,SIO 30,A01,519327,Staff,38,0,40,2
1713337417816,SIO 40,A00,519328,Staff,39,0,40,1
1713337418847,SIO 46GS,A00,519819,Cook; Geoffrey W,17,0,25,8
1713337419873,SIO 109R,A00,494197,Forman; Fonna,0,3,20,20
1713337420898,SIO 121GS,A00,519827,Cook; Geoffrey W,17,0,25,8
1713337421929,SIO 132,A01,519330,Staff,38,0,40,2
1713337422955,SIO 133,A01,519397,Staff,37,0,40,3
1713337423981,SIO 139,A00,519396,Kacev; David,29,0,40,11
1713337425012,SOCI 1,A01,494199,Thorpe; Charles Robert,21,0,30,9
1713337425012,SOCI 1,A02,494200,Thorpe; Charles Robert,30,0,30,0
1713337425012,SOCI 1,A03,494201,Thorpe; Charles Robert,29,0,30,1
1713337425012,SOCI 1,A04,494202,Thorpe; Charles Robert,29,0,30,1
1713337425012,SOCI 1,A05,494203,Thorpe; Charles Robert,29,0,30,1
1713337425012,SOCI 1,A06,494204,Thorpe; Charles Robert,30,0,30,0
1713337425012,SOCI 1,A07,494205,Thorpe; Charles Robert,28,0,30,2
1713337426058,SOCI 60,A01,494207,Staff,33,0,40,7
1713337426058,SOCI 60,A02,494208,Staff,39,0,40,1
1713337427090,SOCI 100,A01,494210,Payne; Christine Anna,25,0,30,5
1713337427090,SOCI 100,A02,494211,Payne; Christine Anna,26,0,30,4
1713337428123,SOCI 109M,A00,494212,Staff,20,0,20,0
1713337429156,SOCI 110,A00,494213,Staff,34,0,40,6
1713337431217,SOCI 118E,A00,494215,Ng; Kwai,37,0,40,3
1713337432245,SOCI 125,A00,494216,Calderon-Zaks; Michael Aar,40,0,45,5
1713337433279,SOCI 126,A01,494218,Jones; Makeba,3,0,5,2
1713337434302,SOCI 131,A00,494219,Thorpe; Charles Robert,26,0,30,4
1713337436361,SOCI 135,A00,494221,Payne; Christine Anna,28,0,50,22
1713337437393,SOCI 136E,A00,626690,Ruiz; Jonathan Joseph,24,0,25,1
1713337438418,SOCI 138GS,A00,494222,Navon; Daniel,23,0,28,5
1713337440479,SOCI 145,A00,494224,Staff,40,0,45,5
1713337441505,SOCI 153,A00,494225,Staff,28,0,30,2
1713337442551,SOCI 160E,A00,494226,Ng; Kwai,27,0,40,13
1713337443578,SOCI 180,A00,494227,Staff,29,0,30,1
1713337444621,SOCI 189GS,A00,494228,Ribas Norris; Janet Vanesa,11,0,11,0
1713337445648,SOCI 190GS,A00,553232,Ribas Norris; Janet Vanesa,11,0,11,0
1713337446673,SOMI 220,A00,627178,Schneid; Stephen David,30,0,30,0
1713337447701,SYN 2,001,490768,Staff,13,0,15,2
1713337447701,SYN 2,002,490769,Staff,14,0,15,1
1713337447701,SYN 2,004,490775,Staff,0,0,0,0
1713337447701,SYN 2,003,490774,Staff,0,0,0,0
1713337447701,SYN 2,005,490776,Staff,0,0,0,0
1713337448738,SYN 2R,001,490779,Staff,11,0,15,4
1713337448738,SYN 2R,002,514635,Staff,14,0,15,1
1713337449765,SYN 100,A01,490783,Staff,8,0,20,12
1713337449765,SYN 100,B01,490787,Staff,10,0,20,10
1713337449765,SYN 100,C01,490789,Staff,10,0,20,10
1713337450790,SYN 150,A00,490817,Staff,14,0,15,1
1713337450790,SYN 150,B00,514610,Staff,15,0,15,0
1713337451835,TDAC 1,A00,492753,Walsh; Kim C.,19,0,20,1
1713337451835,TDAC 1,B00,492754,Harting; Carla Kelso,19,0,20,1
1713337451835,TDAC 1,C00,513995,Salovey; Todd,15,0,20,5
1713337452861,TDAC 101,A00,492766,Harting; Carla Kelso,17,0,20,3
1713337453888,TDAC 102,A00,492768,Basso; Beatrice,19,0,20,1
1713337454914,TDDE 111,A00,492769,Staff,25,0,25,0
1713337455940,TDDE 131,A00,492770,Staff,15,0,15,0
1713337455940,TDDE 131,B00,492771,Staff,15,0,15,0
1713337456975,TDDE 131GS,A00,523716,Guirguis; Mark C,23,0,28,5
1713337458004,TDGE 1,A01,492756,Salovey; Todd,56,0,60,4
1713337459035,TDGE 5,A01,492758,Staff,23,0,25,2
1713337460060,TDGE 10,A00,492759,Fulton; Julia,203,0,220,17
1713337461094,TDGE 11,A00,492760,Castro; Robert Jess,198,0,200,2
1713337463153,TDGE 124,A00,492772,Fulton; Julia,181,0,220,39
1713337464189,TDGE 125,A00,492773,Meyer; Ursula,38,0,50,12
1713337464189,TDGE 125,B00,492774,Staff,49,0,50,1
1713337464189,TDGE 125,C00,523565,Staff,48,0,50,2
1713337465221,TDGE 125GS,A00,523580,Guirguis; Mark C,23,0,28,5
1713337466254,TDGE 127,A00,492775,Havis; Allan,32,0,50,18
1713337467284,TDHT 101,A00,492776,Staff,34,0,35,1
1713337468309,TDMV 1,A00,492762,Caligagan; Maria T.,29,0,30,1
1713337468309,TDMV 1,B00,492763,Arcidiacono; Kristin,26,0,30,4
1713337469335,TDMV 2,A00,492764,Weinberg; Sadie,27,0,30,3
1713337470368,TDMV 3,A00,492765,Mack; Kara Shanai',37,0,40,3
1713337471399,TDMV 138,A00,492777,Mack; Kara Shanai',32,0,40,8
1713337472430,TDMV 140,A00,492778,Lima; Paulo Henrique,40,0,40,0
1713337473465,TDMV 142,A00,492779,Caligagan; Maria T.,33,0,40,7
1713337473465,TDMV 142,B00,492780,Caligagan; Tony,37,0,40,3
1713337474495,TDMV 143,A00,492781,Fyall; Daunte Edward,39,0,40,1
1713337475521,USP 1,A01,492401,Kwak; Nancy,27,0,35,8
1713337476554,USP 2,A01,492453,Hinds; Juli Beth,35,0,35,0
1713337477580,USP 3,A01,492516,Staff,28,0,35,7
1713337478614,USP 4,A00,492522,McTague; Sarah,16,0,25,9
1713337479639,USP 100,A00,492523,Staff,32,0,35,3
1713337480665,USP 101,A00,492524,Staff,13,0,15,2
1713337481696,USP 105,A00,492525,Staff,21,0,25,4
1713337482730,USP 151,A00,492526,Shenkman; Michael Thomas,32,0,35,3
1713337483756,USP 170,A00,492545,Hinds; Juli Beth,33,0,35,2
1713337484789,USP 171GS,A00,492608,Bussell; Mirle Rabinowitz,24,0,28,4
1713337485814,USP 183GS,A00,492613,Peerson; Susan,24,0,28,4
1713337486857,VIS 30,A01,490693,Yoldas; Pinar,19,0,22,3
1713337486857,VIS 30,A02,490694,Yoldas; Pinar,18,0,22,4
1713337487884,VIS 83,A00,490695,Kester; Grant,63,0,75,12
1713337488913,VIS 105D,A00,490696,Staff,22,0,25,3
1713337489940,VIS 124CN,A00,490699,Rose; Jordan M,64,0,75,11
1713337491027,VIS 125GS,A00,511221,Williams; Alena J,21,0,22,1
1713337492053,VIS 128D,A00,490700,Staff,73,0,75,2
1713337493079,VIS 151,A01,490717,Staff,33,0,34,1
1713337493079,VIS 151,A02,490766,Staff,33,0,34,1
1713337494105,VIS 154GS,A00,511972,Williams; Alena J,21,0,22,1
1713337495131,VIS 160A,A00,490767,Stone; Patricia,7,0,10,3
1713337496160,WCWP 10A,A00,490638,Staff,14,0,15,1
1713337496160,WCWP 10A,B00,490640,Staff,15,0,15,0
1713337497188,WCWP 10B,A00,490641,Staff,0,0,0,0
1713337497188,WCWP 10B,B00,490642,Staff,14,0,15,1
1713337497188,WCWP 10B,C00,490644,Staff,13,0,15,2
1713337497188,WCWP 10B,D00,490647,Staff,0,0,0,0
1713337498217,WCWP 100,A00,490655,Staff,0,0,0,0
1713337498217,WCWP 100,B00,490687,Staff,10,0,15,5
1713337500367,ANAR 153,A00,487222,Braswell; Geoffrey E.,53,0,60,7
1713337501393,ANBI 134,A00,487223,Staff,6,0,20,14
1713337502423,ANBI 143GS,A00,487224,Noel; Geoffroy Pierre Jean,18,0,24,6
1713337503458,ANBI 144GS,A00,519548,Noel; Geoffroy Pierre Jean,18,0,24,6
1713337504488,ANSC 101,A00,487225,Staff,18,0,20,2
1713337505513,ANSC 125,A00,487227,Brenner; Suzanne A,38,0,40,2
1713337507567,ANSC 146,A00,487229,Staff,35,0,40,5
1713337508599,ANSC 148,A00,487230,Olivas Hernandez; Olga Lid,39,0,40,1
1713337509626,ANSC 150,A00,504165,Sloane; Julia Kathryn,18,0,20,2
1713337510650,ANSC 180,A00,487232,Staff,14,0,15,1
1713337511677,ANSC 188,A00,627155,Staff,38,0,40,2
1713337512703,ANTH 5,A00,519529,Semendeferi; Ekaterini,15,0,15,0
1713337513732,ANTH 10,A00,487219,Staff,58,0,60,2
1713337514757,ANTH 23,A01,487221,Staff,17,0,20,3
1713337515782,ANTH 102,A00,487233,Wilder; Linnea Lorene,50,0,60,10
1713337516808,ANTH 103,A00,487234,Varma; Saiba,54,0,60,6
1713337517834,ANTH 105,A00,487235,Stewart; Alexander B,54,0,60,6
1713337518927,BENG 100,A01,516685,Taylor Amos; Alyssa C,25,0,30,5
1713337519954,BIBC 102,A01,491316,Flagg; Matthew Paul,6,0,88,82
1713337519954,BIBC 102,A02,491366,Flagg; Matthew Paul,78,0,88,10
1713337520988,BIBC 103,A01,491486,Boumechache; Miyyada,16,0,24,8
1713337520988,BIBC 103,A02,491487,Boumechache; Miyyada,24,0,24,0
1713337522014,BICD 100,A01,516882,Staff,73,0,75,2
1713337522014,BICD 100,A02,516890,Staff,69,0,75,6
1713337523038,BICD 102GS,A00,491488,Lo; Stanley M.,26,0,28,2
1713337524072,BIEB 136GS,A00,516940,Holway; David A. & Shurin; Jonathan,18,0,24,6
1713337525106,BIEB 137GS,A01,517034,Holway; David A. & Shurin; Jonathan,18,0,24,6
1713337526140,BIEB 138GS,A01,491492,Pirino; Giorgia,21,0,28,7
1713337527180,BILD 1,A01,491296,Staff,60,0,63,3
1713337527180,BILD 1,A02,491297,Staff,63,0,63,0
1713337528209,BILD 4,A01,517099,Gonzalez Gamboa; Ivonne,22,0,24,2
1713337528209,BILD 4,A02,517100,Gonzalez Gamboa; Ivonne,24,0,24,0
1713337529235,BILD 60GS,A00,491309,Lo; Stanley M.,26,0,28,2
1713337530268,BIMM 100,A01,517136,Staff,82,0,100,18
1713337531305,BIMM 110,A01,517182,Staff,53,0,100,47
1713337532340,BIMM 120,A01,517228,Pickett; Brooke Elizabeth,28,0,63,35
1713337532340,BIMM 120,A02,517240,Pickett; Brooke Elizabeth,44,0,63,19
1713337533373,BIMM 132GS,A01,491498,Pirino; Giorgia,21,0,28,7
1713337534405,BIMM 143,A01,491589,Bozinovic; Goran,12,0,40,28
1713337535432,BIPN 100,A01,491594,Armour; Jon Christopher,83,0,100,17
1713337536458,BIPN 140,A01,491602,Marino; Marc J,23,0,50,27
1713337538519,CAT 125,A00,515973,Staff,18,0,20,2
1713337539547,CAT 125GS,A00,515974,Rahimi; Babak,16,0,20,4
1713337540574,CAT 125R,A00,515980,Staff,12,0,20,8
1713337540574,CAT 125R,B00,515981,Tosun; Adriana,19,0,20,1
1713337540574,CAT 125R,C00,515987,Hyland; Tina Mae,0,5,20,20
1713337540574,CAT 125R,D00,515988,Bronstein; Phoebe Malan,16,0,20,4
1713337541600,CENG 15,A01,488699,Drews; Aaron,25,0,25,0
1713337542646,CENG 100,A00,505196,Opatkiewicz; Justin Paul,25,0,25,0
1713337543674,CGS 2A,A01,489598,Staff,33,0,35,2
1713337544702,CGS 112,A00,489599,Staff,15,0,15,0
1713337545733,CGS 119,A00,489603,Staff,10,0,10,0
1713337546760,CGS 120,A00,489604,Staff,13,0,15,2
1713337547786,CGS 150,A00,489607,Staff,15,0,15,0
1713337548814,CHEM 6A,A01,488715,Staff,97,0,100,3
1713337549841,CHEM 6B,A01,488719,Piercy; Marc Anthony,99,0,100,1
1713337550872,CHEM 6C,A01,488723,Albizati; Kim F.,93,0,100,7
1713337551899,CHEM 7L,A01,488728,Schurmeier; Kimberly,18,0,24,6
1713337551899,CHEM 7L,A02,488730,Schurmeier; Kimberly,23,0,24,1
1713337551899,CHEM 7L,A03,488734,Schurmeier; Kimberly,20,0,24,4
1713337551899,CHEM 7L,A04,488763,Schurmeier; Kimberly,23,0,24,1
1713337551899,CHEM 7L,B01,488798,Schurmeier; Kimberly,17,0,24,7
1713337551899,CHEM 7L,B02,488801,Schurmeier; Kimberly,22,0,24,2
1713337551899,CHEM 7L,B03,488808,Schurmeier; Kimberly,22,0,24,2
1713337551899,CHEM 7L,B04,488811,Schurmeier; Kimberly,24,0,24,0
1713337552929,CHEM 11,A01,488897,Stallings; Dontarie M,95,0,100,5
1713337553959,CHEM 40A,A01,488913,Albizati; Kim F.,83,0,100,17
1713337554988,CHEM 40B,A01,488920,Weizman; Haim,42,0,50,8
1713337554988,CHEM 40B,A02,488938,Weizman; Haim,44,0,50,6
1713337556023,CHEM 41A,A01,489029,Klosterman; Jeremy K,57,0,60,3
1713337557050,CHEM 41C,A01,500436,Tor; Yitzhak,55,0,60,5
1713337558084,CHEM 43A,A01,500426,Weizman; Haim,0,1,24,24
1713337558084,CHEM 43A,A02,500430,Weizman; Haim,4,0,24,20
1713337558084,CHEM 43A,B01,514041,Klosterman; Jeremy K,16,0,24,8
1713337558084,CHEM 43A,B02,514047,Klosterman; Jeremy K,23,0,24,1
1713337559113,CHEM 108,A01,489140,Jennings; Patricia A.,7,0,24,17
1713337559113,CHEM 108,A02,489142,Jennings; Patricia A.,14,0,24,10
1713337560146,CHEM 114A,A01,489147,Stallings; Dontarie M,65,0,100,35
1713337561178,CHIN 169A,A00,489171,Wang; Xiao,19,0,20,1
1713337563245,COGS 3,A01,518827,Boyle; Mary E. T.,25,0,40,15
1713337564270,COGS 11,A01,489175,Staff,27,0,30,3
1713337565305,COGS 14A,A01,518829,Staff,51,0,60,9
1713337566332,COGS 14B,A01,489177,Hoffman; Drew Ellen,62,0,75,13
1713337567365,COGS 100,A01,489181,Allen; Michael Gordon,62,0,75,13
1713337568395,COGS 101A,A01,489183,Staff,45,0,60,15
1713337569428,COGS 101B,A01,489185,Allen; Michael Gordon,6,0,30,24
1713337570459,COGS 101C,A01,526786,Staff,23,0,30,7
1713337572525,COGS 107A,A01,489189,Boyle; Mary E. T.,16,0,35,19
1713337573567,COGS 107B,A01,627144,Mooshagian; Eric Frederick,60,0,60,0
1713337574593,COGS 118A,A01,489191,Staff,0,46,40,40
1713337576641,COGS 171GS,A01,489194,Pineda; Jaime A,19,0,28,9
1713337577673,COGS 172,A01,489196,Staff,2,0,30,28
1713337578705,COGS 174GS,A01,489264,Pineda; Jaime A,19,0,28,9
1713337579734,COGS 180,A01,627150,Staff,28,0,30,2
1713337580770,COGS 186,A01,489274,Staff,0,2,30,30
1713337581799,COMM 10,A01,489276,Staff,23,0,25,2
1713337581799,COMM 10,A02,489303,Staff,23,0,25,2
1713337582824,COMM 100A,A01,489312,Staff,14,0,25,11
1713337582824,COMM 100A,A02,489313,Staff,24,0,25,1
1713337583855,COMM 106T,A00,512540,Staff,33,0,35,2
1713337584881,COMM 107,A00,489347,Staff,27,0,35,8
1713337585914,COMM 109P,A00,489358,Staff,31,0,35,4
1713337586941,COMM 132,A00,489361,McKenna; Denise,27,0,30,3
1713337587969,COMM 146,A00,489362,Halm; Gavin Patrick,26,0,30,4
1713337588995,COMM 190,A00,489363,Abuelhiga; Soraya Jill,17,0,23,6
1713337590120,CSE 8A,A50,489366,Staff,21,0,25,4
1713337590120,CSE 8A,A51,489367,Staff,24,0,25,1
1713337591157,CSE 11,A01,489398,Cao; Yingjun,73,0,100,27
1713337592184,CSE 12,A01,489487,Staff,43,0,50,7
1713337593218,CSE 20,A01,489497,Staff,47,0,50,3
1713337594246,CSE 21,A01,489517,Braun; Oliver,42,0,50,8
1713337595328,CSE 101,A01,489524,Braun; Oliver,0,32,50,50
1713337596361,CSE 105,A01,512594,Jones; Miles E,72,0,100,28
1713337596361,CSE 105,B01,512598,Jones; Miles E,52,0,100,48
1713337597388,CSE 140,A01,489538,Staff,41,0,50,9
1713337598417,CSE 141,A01,489550,Eldon; John,67,0,100,33
1713337599441,CSE 141L,A01,489571,Eldon; John,65,0,100,35
1713337600469,CSE 151A,A01,489583,Solares; Edwin A,140,0,200,60
1713337601494,CSE 175,A01,510886,Kumar; Rakesh,30,0,30,0
1713337602542,CSE 190,A00,516828,Dubnov; Shlomo,37,0,49,12
1713337603579,DOC 100D,A00,489667,Pass; Natalye Joann,19,0,25,6
1713337604605,DSC 10,A01,624268,Staff,72,0,75,3
1713337605629,DSC 20,A01,624476,Staff,50,0,50,0
1713337606655,DSC 40A,A01,624608,Staff,39,0,40,1
1713337607681,DSGN 1,A01,489179,Rill; Bryan,32,0,50,18
1713337608708,ECE 17,A01,490489,Sahay; Rajeev,18,0,30,12
1713337609734,ECE 65,A50,490492,Staff,11,0,20,9
1713337609734,ECE 65,A51,490493,Staff,18,0,20,2
1713337610773,ECON 1,A01,489715,Famulari; Melissa,67,0,70,3
1713337611798,ECON 2,A01,489717,Levkoff; Steven B.,67,0,70,3
1713337612825,ECON 3,A01,489948,Staff,70,0,70,0
1713337614878,ECON 5,A01,490103,Staff,27,0,30,3
1713337614878,ECON 5,B01,626281,Dai; Yinlin,45,0,45,0
1713337615905,ECON 100A,A01,490127,Famulari; Melissa,63,0,70,7
1713337616930,ECON 100B,A01,490129,Staff,64,0,70,6
1713337617956,ECON 109,A01,490187,Shishkin; Denis,27,0,35,8
1713337618981,ECON 110A,A01,490190,Levkoff; Steven B.,59,0,70,11
1713337620013,ECON 120A,A01,490245,Dai; Yinlin,60,0,70,10
1713337621042,ECON 120B,A01,490247,Nieto-Barthaburu; Augusto,40,0,70,30
1713337622078,ECON 120C,A01,490253,Sun; Yixiao,30,0,35,5
1713337622078,ECON 120C,B01,490255,Sun; Yixiao,34,0,35,1
1713337623113,ECON 129,A00,490256,Eckert; Fabian Paul,22,0,35,13
1713337624143,ECON 131,A00,490257,Nieto-Barthaburu; Augusto,0,6,35,35
1713337625170,ECON 138,A00,490258,Bharadwaj; Prashant,13,0,35,22
1713337625170,ECON 138,B00,490259,Bharadwaj; Prashant,15,0,35,20
1713337626195,ECON 159,A00,490260,Hendrickson; Gerald M.,0,9,0,0
1713337627228,ECON 178,A01,553995,Zhu; Ying,24,0,35,11
1713337628256,EDS 40,A01,512576,Black; Alison Michelle,20,0,20,0
1713337629285,EDS 107,A01,515848,Staff,30,0,30,0
1713337630311,EDS 110R,A01,490262,Staff,26,0,30,4
1713337631338,EDS 112,A01,490264,Chapman; Thandeka K,40,0,50,10
1713337632370,EDS 113,A00,490266,Staff,25,0,30,5
1713337633395,EDS 118,A00,490267,Warstadt; Melissa Fawn,18,0,30,12
1713337634424,EDS 124BR,A00,490268,Eguchi; Emi,4,0,25,21
1713337634424,EDS 124BR,B00,490269,Eguchi; Emi,23,0,25,2
1713337635453,EDS 126,A01,490271,Jones; Makeba,43,0,50,7
1713337636482,EDS 135,A01,490316,Staff,19,0,20,1
1713337637515,ENVR 142GS,A00,519514,Chang; Edmond Yi-Teh,26,0,28,2
1713337638540,ETHN 103,A00,490504,Staff,25,0,36,11
1713337639569,ETHN 103A,A00,490505,Man; Simeon S,3,0,9,6
1713337640598,ETHN 109,A00,490506,Staff,28,0,30,2
1713337641621,ETHN 118,A00,490507,Staff,35,0,36,1
1713337642649,ETHN 119,A00,490508,Staff,32,0,36,4
1713337643678,ETHN 121R,A00,490518,Choi; Esther Min,21,0,36,15
1713337644704,ETHN 127,A00,490528,Staff,14,0,15,1
1713337645729,ETHN 139,A00,490573,Staff,10,0,10,0
1713337646755,ETHN 150,A00,490575,Staff,15,0,15,0
1713337647783,GLBH 20,A00,491705,Elwardani; Nile Regina,38,0,40,2
1713337648809,GLBH 101,A00,491706,Staff,20,0,20,0
1713337649837,GLBH 111,A01,491708,Burgos; Jose L.,15,0,15,0
1713337650862,GLBH 146,A00,491709,Staff,9,0,20,11
1713337651888,GLBH 148,A00,491710,Olivas Hernandez; Olga Lid,11,0,20,9
1713337652922,GLBH 150,A00,491711,Sloane; Julia Kathryn,19,0,20,1
1713337653952,HIEA 131,A00,491760,Staff,28,0,32,4
1713337654977,HIEA 153,A00,491762,Staff,28,0,30,2
1713337656002,HIEU 124,A00,491811,Staff,26,0,32,6
1713337657029,HIEU 124GS,A00,491812,Markman; Kristina,27,0,28,1
1713337658057,HIEU 147,A00,491813,Staff,30,0,32,2
1713337659087,HIEU 149GS,A00,491816,Caldwell; Michael Alan,28,0,28,0
1713337660116,HILD 2C,A01,491713,Hendrickson; Gerald M.,26,0,30,4
1713337661148,HILD 7B,A01,491715,Kwak; Nancy,0,2,30,30
1713337662173,HILD 10,A01,491717,Staff,9,0,20,11
1713337663204,HILD 30GS,A00,491719,Edington; Claire Ellen,23,0,28,5
1713337664231,HINE 109,A00,491818,Shafir; Nir,27,0,32,5
1713337665255,HINE 128,A00,491821,Shafir; Nir,31,0,32,1
1713337666281,HISC 117,A00,491830,Staff,27,0,32,5
1713337667309,HIUS 103,A00,491834,Man; Simeon S,14,0,23,9
1713337668339,HIUS 108B,A00,491835,Staff,27,0,30,3
1713337669374,HIUS 141,A00,491836,Hendrickson; Gerald M.,28,0,32,4
1713337670399,HIUS 149,A00,491839,Staff,24,0,32,8
1713337671425,HUM 3,A01,512617,Crum; Matthew Stephen,42,0,50,8
1713337671425,HUM 3,A02,512618,Crum; Matthew Stephen,48,0,50,2
1713337672450,HUM 3GS,A00,512663,Markman; Kristina,0,0,0,1
1713337672450,HUM 3GS,B00,512664,Staff,0,0,0,0
1713337673483,HUM 4,A01,512620,West; Geoffrey Scott,25,0,50,25
1713337674511,HUM 4GS,A00,512666,Lyon; Antony J.,0,0,0,5
1713337675536,HUM 4R,A01,512625,Watkins; Eric,49,0,50,1
1713337676578,HUM 5,A01,512649,Zavodny; Tatiana Sophia,20,0,50,30
1713337676578,HUM 5,B01,512661,Zroka; Ryan Edward,48,0,50,2
1713337677604,INTL 190,A00,490577,Segui; Alan S,0,0,0,5
1713337678630,JAPN 20AR,A01,491267,Ross; Kayoko F,7,0,20,13
1713337679659,JAPN 180,A00,491285,Berman; Michael David,33,0,40,7
1713337680697,LATI 50,A01,502536,Kokinis; Troy Andreas,16,0,22,6
1713337680697,LATI 50,A02,502551,Kokinis; Troy Andreas,22,0,22,0
1713337680697,LATI 50,A03,502650,Kokinis; Troy Andreas,22,0,22,0
1713337680697,LATI 50,A04,502909,Kokinis; Troy Andreas,21,0,22,1
1713337681729,LATI 160,A01,502920,Kokinis; Troy Andreas,30,0,30,0
1713337682754,LIFR 1A,A00,490494,Van Moer; Vinciane G,17,0,20,3
1713337683782,LIFR 1AX,A00,490495,Van Moer; Vinciane G,17,0,20,3
1713337684807,LIFR 1B,A00,490496,Van Moer; Vinciane G,17,0,20,3
1713337685836,LIFR 1BX,A00,490497,Van Moer; Vinciane G,17,0,20,3
1713337686868,LIGN 8,A00,505198,McIntosh; Justin Daniel,134,0,150,16
1713337687898,LIGN 9GS,A00,491239,Lott; Margaret S.,18,0,20,2
1713337688928,LIGN 101,A01,505200,McIntosh; Justin Daniel,22,0,30,8
1713337689953,LIGN 120,A01,491244,Staff,22,0,30,8
1713337690978,LIGN 149GS,A00,491245,Lott; Margaret S.,18,0,20,2
1713337692004,LIGN 170,A00,491247,Staff,22,0,30,8
1713337693030,LISP 1D,A00,490498,Munoz Sanchez; Alicia,8,0,14,6
1713337693030,LISP 1D,B00,490499,Munoz Sanchez; Alicia,4,0,14,10
1713337693030,LISP 1D,C00,490500,Munoz Sanchez; Alicia,7,0,14,7
1713337693030,LISP 1D,D00,490501,Munoz Sanchez; Alicia,10,0,14,4
1713337694057,LISP 1DX,A00,490502,Munoz Sanchez; Alicia,11,0,28,17
1713337694057,LISP 1DX,B00,490503,Munoz Sanchez; Alicia,16,0,28,12
1713337696109,LTAM 110,A00,491847,Staff,22,0,25,3
1713337697134,LTCS 119,A00,491848,Staff,11,0,15,4
1713337698158,LTCS 130,A00,491849,Staff,24,0,25,1
1713337700263,LTEA 120C,A00,491852,Staff,32,0,40,8
1713337701293,LTEN 130GS,A00,491853,Lyon; Antony J.,23,0,28,5
1713337702320,LTEN 148,A00,491855,Staff,23,0,25,2
1713337703350,LTEN 159,A00,491856,Staff,20,0,25,5
1713337704378,LTEN 180,A00,491857,Staff,8,0,15,7
1713337706439,LTSP 123GS,A00,505928,Bessett; Ryan Matthew,24,0,28,4
1713337707464,LTSP 174GS,A00,506037,Bessett; Ryan Matthew,24,0,28,4
1713337709520,LTWR 102,A00,491861,Staff,9,0,15,6
1713337710546,LTWR 106,A00,491862,Staff,8,0,15,7
1713337711575,MAE 11,A00,490930,Bahadori; Mohammad Yousef,95,0,100,5
1713337712600,MAE 30A,A00,490931,Qi; Huihui,37,0,40,3
1713337713627,MAE 101A,A00,491036,Sadeghizadeh; Zahra,92,0,100,8
1713337714657,MAE 101C,A00,491037,Seshadri; Kalyanasundaram,63,0,100,37
1713337715685,MAE 113,A00,491040,Seshadri; Kalyanasundaram,64,0,80,16
1713337716715,MAE 131A,A00,491041,Ghazinejad; Maziar,37,0,40,3
1713337717743,MAE 142,A00,491053,Staff,39,0,40,1
1713337718769,MAE 143A,A00,491054,Staff,30,0,50,20
1713337719796,MAE 150,A00,491092,Truong; Phuong Thi Ngoc,23,0,35,12
1713337720821,MATH 3C,A01,494031,Pardo Guerra; Sebastian,30,0,30,0
1713337720821,MATH 3C,A02,494032,Pardo Guerra; Sebastian,29,0,30,1
1713337721853,MATH 10A,A01,494034,Staff,27,0,30,3
1713337721853,MATH 10A,A02,494035,Staff,28,0,30,2
1713337721853,MATH 10A,B01,494037,Staff,27,0,30,3
1713337721853,MATH 10A,B02,494038,Staff,29,0,30,1
1713337722883,MATH 10B,A01,494040,Habib; Yousaf,22,0,30,8
1713337722883,MATH 10B,A02,494041,Habib; Yousaf,28,0,30,2
1713337722883,MATH 10B,A03,494042,Habib; Yousaf,29,0,30,1
1713337722883,MATH 10B,A04,494043,Habib; Yousaf,30,0,30,0
1713337722883,MATH 10B,B01,494045,Habib; Yousaf,25,0,30,5
1713337722883,MATH 10B,B02,494046,Habib; Yousaf,30,0,30,0
1713337722883,MATH 10B,B03,494047,Habib; Yousaf,30,0,30,0
1713337722883,MATH 10B,B04,494048,Habib; Yousaf,30,0,30,0
1713337723912,MATH 18,A01,494050,Kemp; Todd Aahron,25,0,30,5
1713337723912,MATH 18,A02,494051,Kemp; Todd Aahron,29,0,30,1
1713337723912,MATH 18,B01,494054,Kemp; Todd Aahron,25,0,30,5
1713337723912,MATH 18,B02,494055,Kemp; Todd Aahron,29,0,30,1
1713337724943,MATH 20A,A01,494059,Suk; Andrew Hoon,30,0,30,0
1713337725970,MATH 20B,A01,494061,Briones; Jor-el Thomas Caparas,33,0,35,2
1713337725970,MATH 20B,B01,494063,Bach; Quang Tran,34,0,35,1
1713337727005,MATH 20C,A01,494065,Staff,28,0,30,2
1713337727005,MATH 20C,A02,494066,Staff,30,0,30,0
1713337727005,MATH 20C,A03,494067,Staff,30,0,30,0
1713337727005,MATH 20C,A04,494068,Staff,30,0,30,0
1713337727005,MATH 20C,B01,494070,Zhang; Ming,24,0,30,6
1713337727005,MATH 20C,B02,494071,Zhang; Ming,27,0,30,3
1713337727005,MATH 20C,B03,494072,Zhang; Ming,29,0,30,1
1713337727005,MATH 20C,B04,494073,Zhang; Ming,29,0,30,1
1713337728036,MATH 20D,A01,494075,Staff,22,0,30,8
1713337728036,MATH 20D,A02,494076,Staff,29,0,30,1
1713337729065,MATH 20E,A01,494079,Staff,24,0,30,6
1713337729065,MATH 20E,A02,494080,Staff,26,0,30,4
1713337729065,MATH 20E,B01,494082,Staff,25,0,30,5
1713337729065,MATH 20E,B02,494083,Staff,25,0,30,5
1713337730101,MATH 103A,A01,494085,Aliabadi Sr.; Mohsen,12,0,30,18
1713337730101,MATH 103A,A02,494086,Aliabadi Sr.; Mohsen,28,0,30,2
1713337730101,MATH 103A,B01,494088,Aliabadi Sr.; Mohsen,20,0,30,10
1713337730101,MATH 103A,B02,494089,Aliabadi Sr.; Mohsen,27,0,30,3
1713337731129,MATH 109,A01,494091,Staff,30,0,30,0
1713337731129,MATH 109,A02,494092,Staff,29,0,30,1
1713337731129,MATH 109,B01,494094,Staff,27,0,30,3
1713337731129,MATH 109,B02,494095,Staff,29,0,30,1
1713337732168,MATH 142A,A01,494097,Chow; Bennett,13,0,30,17
1713337732168,MATH 142A,A02,494098,Chow; Bennett,23,0,30,7
1713337732168,MATH 142A,B01,494100,Chow; Bennett,19,0,30,11
1713337732168,MATH 142A,B02,494101,Chow; Bennett,29,0,30,1
1713337734222,MATH 168A,A01,516677,Dumitriu; Ioana,16,0,35,19
1713337735247,MATH 170A,A01,516679,Dumitriu; Ioana,18,0,30,12
1713337735247,MATH 170A,A02,516680,Dumitriu; Ioana,28,0,30,2
1713337736275,MATH 193A,A01,494107,Staff,12,0,30,18
1713337736275,MATH 193A,A02,494108,Staff,18,0,30,12
1713337736275,MATH 193A,A03,494109,Staff,29,0,30,1
1713337736275,MATH 193A,A04,494110,Staff,22,0,30,8
1713337739361,MGT 16,A00,491930,McKay; Michael J,92,0,98,6
1713337740393,MGT 18,A00,491992,McKay; Michael J,96,0,98,2
1713337741418,MGT 71,A00,492003,Staff,63,0,98,35
1713337742452,MGT 103,A00,505209,Eberhard; Craig A,80,0,98,18
1713337743479,MGT 131A,A00,505210,Anderson; John Charles,89,0,98,9
1713337745535,MGT 153,A00,492077,Perols; Johan Lars,16,0,90,74
1713337748612,MGT 164,A00,492222,McKay; Mary A,91,0,98,7
1713337749639,MGT 172,A00,492245,Staff,59,0,60,1
1713337749639,MGT 172,B00,505526,Hedges; Kathleen,65,0,98,33
1713337750665,MGT 181,A00,505669,Dunn; Louis Jean,78,0,98,20
1713337751690,MMW 14,A01,494399,Staff,15,0,28,13
1713337751690,MMW 14,A02,494400,Staff,25,0,28,3
1713337751690,MMW 14,A03,494401,Staff,28,0,28,0
1713337751690,MMW 14,A04,494402,Staff,28,0,28,0
1713337751690,MMW 14,B01,494404,Carreras; Maria Victoria,8,0,28,20
1713337751690,MMW 14,B02,494405,Carreras; Maria Victoria,25,0,28,3
1713337751690,MMW 14,B03,494406,Carreras; Maria Victoria,27,0,28,1
1713337751690,MMW 14,B04,494407,Carreras; Maria Victoria,28,0,28,0
1713337752718,MMW 14GS,A00,506250,Chang; Edmond Yi-Teh,0,0,0,0
1713337753743,MMW 121R,A01,494415,Adamiak; Patrick John,10,0,28,18
1713337753743,MMW 121R,A02,494416,Adamiak; Patrick John,24,0,28,4
1713337754771,MUS 1A,A01,494113,Staff,12,0,25,13
1713337754771,MUS 1A,A02,494114,Staff,24,0,25,1
1713337755804,MUS 4,A01,494116,Staff,23,0,25,2
1713337755804,MUS 4,A02,494117,Staff,22,0,25,3
1713337756831,MUS 5R,A01,494236,Dubnov; Shlomo,4,0,25,21
1713337756831,MUS 5R,A02,494237,Dubnov; Shlomo,25,0,25,0
1713337757859,MUS 6,A01,494122,Staff,9,0,25,16
1713337757859,MUS 6,A02,494123,Staff,23,0,25,2
1713337758886,MUS 7,A01,494125,Staff,16,0,25,9
1713337758886,MUS 7,A02,494126,Staff,24,0,25,1
1713337759914,MUS 11,A01,494128,Staff,23,0,25,2
1713337759914,MUS 11,A02,494129,Staff,24,0,25,1
1713337760947,MUS 13,A01,494131,Staff,25,0,25,0
1713337760947,MUS 13,A02,494132,Staff,25,0,25,0
1713337761977,MUS 15,A01,494134,Staff,16,0,25,9
1713337761977,MUS 15,A02,494135,Staff,25,0,25,0
1713337761977,MUS 15,B01,494137,Staff,24,0,25,1
1713337763002,MUS 80,A00,494232,Staff,24,0,25,1
1713337763002,MUS 80,B00,494233,Staff,25,0,25,0
1713337763002,MUS 80,C00,494234,Staff,23,0,25,2
1713337764030,MUS 95C,A00,494141,Staff,69,0,75,6
1713337765058,MUS 114,A00,494142,Staff,40,0,50,10
1713337766089,NANO 15,A01,490636,Drews; Aaron,7,0,7,0
1713337767116,PHIL 1,A00,490578,Grush; Rick Scott,49,0,50,1
1713337768142,PHIL 10,A01,490580,Grush; Rick Scott,33,0,35,2
1713337768142,PHIL 10,A02,490586,Grush; Rick Scott,32,0,35,3
1713337769170,PHIL 27,A01,490591,Staff,22,0,25,3
1713337769170,PHIL 27,A02,490592,Staff,25,0,25,0
1713337769170,PHIL 27,A03,490593,Staff,25,0,25,0
1713337769170,PHIL 27,A04,490598,Staff,25,0,25,0
1713337770195,PHIL 32,A01,490611,Staff,20,0,20,0
1713337770195,PHIL 32,A02,490618,Staff,20,0,20,0
1713337771220,PHIL 90,A00,490624,Staff,40,0,40,0
1713337772245,PHIL 136,A00,490627,Cohen; Jonathan David,37,0,40,3
1713337773273,PHIL 155,A00,490634,Staff,62,0,70,8
1713337774300,PHYS 1A,A00,491610,Staff,245,0,250,5
1713337775326,PHYS 1AL,001,491616,Tsai; Philbert S,27,0,30,3
1713337775326,PHYS 1AL,002,491618,Tsai; Philbert S,30,0,30,0
1713337776352,PHYS 1B,A00,491623,Staff,235,0,250,15
1713337777379,PHYS 1BL,001,491626,Tsai; Philbert S,19,0,30,11
1713337777379,PHYS 1BL,002,491628,Tsai; Philbert S,26,0,30,4
1713337778404,PHYS 1C,A00,491632,Staff,212,0,245,33
1713337779433,PHYS 1CL,001,491635,Tsai; Philbert S,3,0,30,27
1713337779433,PHYS 1CL,002,491643,Tsai; Philbert S,22,0,30,8
1713337780463,PHYS 2AR,A01,491651,Meyertholen; Andrew D.,44,0,50,6
1713337781488,PHYS 2B,A01,491659,Staff,105,0,115,10
1713337782521,PHYS 2BL,A01,491685,Staff,21,0,24,3
1713337782521,PHYS 2BL,A02,491700,Staff,21,0,24,3
1713337783548,PHYS 2C,A01,505161,Staff,101,0,115,14
1713337784575,PHYS 4A,A01,491704,Grinstein; Benjamin,99,0,100,1
1713337785610,POLI 5D,A01,494144,Staff,3,0,5,2
1713337785610,POLI 5D,B01,626283,Dai; Yinlin,5,0,5,0
1713337786639,POLI 12,A00,494145,Staff,43,0,45,2
1713337787663,POLI 13R,A00,494146,Forman; Fonna,45,0,50,5
1713337788690,POLI 27,A01,494148,Staff,54,0,60,6
1713337789719,POLI 30,A00,494149,Staff,49,0,50,1
1713337790749,POLI 100DA,A00,494150,Staff,20,0,25,5
1713337792801,POLI 100I,A00,494152,Staff,27,0,30,3
1713337793827,POLI 104B,A00,494153,Smith; Glenn Chatmas,53,0,55,2
1713337794853,POLI 104F,A00,494154,Staff,28,0,30,2
1713337795879,POLI 104I,A00,494155,Smith; Glenn Chatmas,29,0,30,1
1713337796910,POLI 110C,A00,494156,Ingham; Sean,23,0,25,2
1713337797940,POLI 117R,A00,494157,Forman; Fonna,5,0,20,15
1713337798982,POLI 118,A00,494158,Ingham; Sean,21,0,25,4
1713337800150,POLI 120H,A00,494159,Fisk; David Lee,39,0,45,6
1713337801176,POLI 131CR,A00,494160,Hoston; Germaine,35,0,45,10
1713337802203,POLI 133J,A00,494161,Staff,31,0,35,4
1713337803308,POLI 135,A00,494162,Fisk; David Lee,33,0,35,2
1713337804342,POLI 140A,A00,494164,Staff,19,0,30,11
1713337805371,POLI 142I,A00,494165,Staff,30,0,30,0
1713337806402,POLI 144D,A00,494166,Staff,23,0,25,2
1713337807434,POLI 151,A00,494167,Staff,30,0,30,0
1713337808460,POLI 153,A00,494168,Staff,33,0,35,2
1713337809487,POLI 160AA,A00,494169,Staff,34,0,40,6
1713337810516,POLI 162,A00,494170,Mignozzetti; Umberto,18,0,25,7
1713337811546,POLI 171,A00,494171,Mignozzetti; Umberto,18,0,25,7
1713337812571,PSYC 1,A00,494172,Staff,95,0,100,5
1713337813600,PSYC 2,A00,494173,Moranton; Nirelia Melbina-,34,0,50,16
1713337814631,PSYC 3,A00,494174,Staff,29,0,30,1
1713337815657,PSYC 6,A00,494175,Staff,17,0,20,3
1713337816682,PSYC 60,A01,494177,Staff,37,0,45,8
1713337817707,PSYC 70,A01,505724,Geller; Emma Harlan,42,0,45,3
1713337818736,PSYC 101,A00,494180,Heyman; Gail D.,84,0,100,16
1713337819761,PSYC 105,A00,494181,Geller; Emma Harlan,51,0,90,39
1713337820790,PSYC 106,A00,494182,Dobkins; Karen R.,26,0,45,19
1713337821816,PSYC 108,A00,494183,Adrian; Julia Anna,89,0,100,11
1713337822843,PSYC 114,A01,494185,Winkielman; Piotr,0,3,30,30
1713337823868,PSYC 122,A00,494186,Moranton; Nirelia Melbina-,27,0,50,23
1713337824906,PSYC 124,A00,494187,Chapman; Eddie Nathaniel,70,0,80,10
1713337825937,PSYC 131,A00,494188,Anagnostaras; Stephan,40,0,80,40
1713337826967,PSYC 144,A00,494189,Staff,1,0,50,49
1713337827996,PSYC 154,A00,494190,Lacefield; Katharine I,106,0,180,74
1713337829019,PSYC 162,A00,494191,Wixted; John T,70,0,100,30
1713337830054,PSYC 172,A00,494192,Gorman; Michael R.,36,0,45,9
1713337831079,PSYC 178,A00,494193,Glaser; Dale,34,0,45,11
1713337832109,PSYC 193,A00,505725,Chapman; Eddie Nathaniel,20,0,20,0
1713337833137,RELI 145GS,A00,519817,Rahimi; Babak,17,0,20,3
1713337834168,SE 101A,A01,490862,Chadha; Mayank,23,0,25,2
1713337835200,SE 101C,A01,490924,Krysl; Petr,15,0,20,5
1713337836231,SE 110A,A01,490928,Staff,19,0,20,1
1713337837264,SE 130A,A00,490929,Morrison; Machel Leigh,54,0,70,16
1713337838288,SIO 1,A01,519325,Staff,39,0,40,1
1713337839315,SIO 30,A01,519327,Staff,38,0,40,2
1713337840340,SIO 40,A00,519328,Staff,39,0,40,1
1713337841366,SIO 46GS,A00,519819,Cook; Geoffrey W,17,0,25,8
1713337842395,SIO 109R,A00,494197,Forman; Fonna,0,3,20,20
1713337843419,SIO 121GS,A00,519827,Cook; Geoffrey W,17,0,25,8
1713337844444,SIO 132,A01,519330,Staff,38,0,40,2
1713337845470,SIO 133,A01,519397,Staff,37,0,40,3
1713337846497,SIO 139,A00,519396,Kacev; David,29,0,40,11
1713337847528,SOCI 1,A01,494199,Thorpe; Charles Robert,21,0,30,9
1713337847528,SOCI 1,A02,494200,Thorpe; Charles Robert,30,0,30,0
1713337847528,SOCI 1,A03,494201,Thorpe; Charles Robert,29,0,30,1
1713337847528,SOCI 1,A04,494202,Thorpe; Charles Robert,29,0,30,1
1713337847528,SOCI 1,A05,494203,Thorpe; Charles Robert,29,0,30,1
1713337847528,SOCI 1,A06,494204,Thorpe; Charles Robert,30,0,30,0
1713337847528,SOCI 1,A07,494205,Thorpe; Charles Robert,28,0,30,2
1713337848559,SOCI 60,A01,494207,Staff,33,0,40,7
1713337848559,SOCI 60,A02,494208,Staff,39,0,40,1
1713337849589,SOCI 100,A01,494210,Payne; Christine Anna,25,0,30,5
1713337849589,SOCI 100,A02,494211,Payne; Christine Anna,26,0,30,4
1713337850617,SOCI 109M,A00,494212,Staff,20,0,20,0
1713337851643,SOCI 110,A00,494213,Staff,34,0,40,6
1713337853694,SOCI 118E,A00,494215,Ng; Kwai,37,0,40,3
1713337854718,SOCI 125,A00,494216,Calderon-Zaks; Michael Aar,39,0,45,6
1713337855744,SOCI 126,A01,494218,Jones; Makeba,3,0,5,2
1713337856774,SOCI 131,A00,494219,Thorpe; Charles Robert,26,0,30,4
1713337858830,SOCI 135,A00,494221,Payne; Christine Anna,28,0,50,22
1713337859856,SOCI 136E,A00,626690,Ruiz; Jonathan Joseph,24,0,25,1
1713337860880,SOCI 138GS,A00,494222,Navon; Daniel,23,0,28,5
1713337862930,SOCI 145,A00,494224,Staff,40,0,45,5
1713337863956,SOCI 153,A00,494225,Staff,28,0,30,2
1713337864983,SOCI 160E,A00,494226,Ng; Kwai,27,0,40,13
1713337866017,SOCI 180,A00,494227,Staff,29,0,30,1
1713337867043,SOCI 189GS,A00,494228,Ribas Norris; Janet Vanesa,11,0,11,0
1713337868069,SOCI 190GS,A00,553232,Ribas Norris; Janet Vanesa,11,0,11,0
1713337869098,SOMI 220,A00,627178,Schneid; Stephen David,30,0,30,0
1713337870128,SYN 2,001,490768,Staff,13,0,15,2
1713337870128,SYN 2,002,490769,Staff,14,0,15,1
1713337870128,SYN 2,004,490775,Staff,0,0,0,0
1713337870128,SYN 2,003,490774,Staff,0,0,0,0
1713337870128,SYN 2,005,490776,Staff,0,0,0,0
1713337871154,SYN 2R,001,490779,Staff,11,0,15,4
1713337871154,SYN 2R,002,514635,Staff,14,0,15,1
1713337872180,SYN 100,A01,490783,Staff,8,0,20,12
1713337872180,SYN 100,B01,490787,Staff,10,0,20,10
1713337872180,SYN 100,C01,490789,Staff,10,0,20,10
1713337873212,SYN 150,A00,490817,Staff,14,0,15,1
1713337873212,SYN 150,B00,514610,Staff,15,0,15,0
1713337874242,TDAC 1,A00,492753,Walsh; Kim C.,19,0,20,1
1713337874242,TDAC 1,B00,492754,Harting; Carla Kelso,18,0,20,2
1713337874242,TDAC 1,C00,513995,Salovey; Todd,15,0,20,5
1713337875267,TDAC 101,A00,492766,Harting; Carla Kelso,17,0,20,3
1713337876293,TDAC 102,A00,492768,Basso; Beatrice,19,0,20,1
1713337877320,TDDE 111,A00,492769,Staff,25,0,25,0
1713337878348,TDDE 131,A00,492770,Staff,15,0,15,0
1713337878348,TDDE 131,B00,492771,Staff,15,0,15,0
1713337879383,TDDE 131GS,A00,523716,Guirguis; Mark C,23,0,28,5
1713337880425,TDGE 1,A01,492756,Salovey; Todd,56,0,60,4
1713337881451,TDGE 5,A01,492758,Staff,23,0,25,2
1713337882485,TDGE 10,A00,492759,Fulton; Julia,203,0,220,17
1713337883511,TDGE 11,A00,492760,Castro; Robert Jess,198,0,200,2
1713337885562,TDGE 124,A00,492772,Fulton; Julia,181,0,220,39
1713337886605,TDGE 125,A00,492773,Meyer; Ursula,38,0,50,12
1713337886605,TDGE 125,B00,492774,Staff,49,0,50,1
1713337886605,TDGE 125,C00,523565,Staff,48,0,50,2
1713337887633,TDGE 125GS,A00,523580,Guirguis; Mark C,23,0,28,5
1713337888660,TDGE 127,A00,492775,Havis; Allan,32,0,50,18
1713337889692,TDHT 101,A00,492776,Staff,34,0,35,1
1713337890730,TDMV 1,A00,492762,Caligagan; Maria T.,29,0,30,1
1713337890730,TDMV 1,B00,492763,Arcidiacono; Kristin,26,0,30,4
1713337891757,TDMV 2,A00,492764,Weinberg; Sadie,27,0,30,3
1713337892783,TDMV 3,A00,492765,Mack; Kara Shanai',37,0,40,3
1713337893808,TDMV 138,A00,492777,Mack; Kara Shanai',32,0,40,8
1713337894847,TDMV 140,A00,492778,Lima; Paulo Henrique,40,0,40,0
1713337895874,TDMV 142,A00,492779,Caligagan; Maria T.,33,0,40,7
1713337895874,TDMV 142,B00,492780,Caligagan; Tony,37,0,40,3
1713337896905,TDMV 143,A00,492781,Fyall; Daunte Edward,39,0,40,1
1713337897931,USP 1,A01,492401,Kwak; Nancy,27,0,35,8
1713337898960,USP 2,A01,492453,Hinds; Juli Beth,35,0,35,0
1713337899991,USP 3,A01,492516,Staff,28,0,35,7
1713337901016,USP 4,A00,492522,McTague; Sarah,16,0,25,9
1713337902042,USP 100,A00,492523,Staff,32,0,35,3
1713337903067,USP 101,A00,492524,Staff,13,0,15,2
1713337904102,USP 105,A00,492525,Staff,21,0,25,4
1713337905129,USP 151,A00,492526,Shenkman; Michael Thomas,32,0,35,3
1713337906159,USP 170,A00,492545,Hinds; Juli Beth,33,0,35,2
1713337907238,USP 171GS,A00,492608,Bussell; Mirle Rabinowitz,24,0,28,4
1713337908273,USP 183GS,A00,492613,Peerson; Susan,24,0,28,4
1713337909315,VIS 30,A01,490693,Yoldas; Pinar,19,0,22,3
1713337909315,VIS 30,A02,490694,Yoldas; Pinar,18,0,22,4
1713337910355,VIS 83,A00,490695,Kester; Grant,63,0,75,12
1713337911380,VIS 105D,A00,490696,Staff,22,0,25,3
1713337912412,VIS 124CN,A00,490699,Rose; Jordan M,64,0,75,11
1713337913438,VIS 125GS,A00,511221,Williams; Alena J,21,0,22,1
1713337914464,VIS 128D,A00,490700,Staff,73,0,75,2
1713337915496,VIS 151,A01,490717,Staff,33,0,34,1
1713337915496,VIS 151,A02,490766,Staff,33,0,34,1
1713337916528,VIS 154GS,A00,511972,Williams; Alena J,21,0,22,1
1713337917584,VIS 160A,A00,490767,Stone; Patricia,7,0,10,3
1713337918610,WCWP 10A,A00,490638,Staff,14,0,15,1
1713337918610,WCWP 10A,B00,490640,Staff,15,0,15,0
1713337919635,WCWP 10B,A00,490641,Staff,0,0,0,0
1713337919635,WCWP 10B,B00,490642,Staff,14,0,15,1
1713337919635,WCWP 10B,C00,490644,Staff,13,0,15,2
1713337919635,WCWP 10B,D00,490647,Staff,0,0,0,0
1713337920677,WCWP 100,A00,490655,Staff,0,0,0,0
1713337920677,WCWP 100,B00,490687,Staff,10,0,15,5
1713337922770,ANAR 153,A00,487222,Braswell; Geoffrey E.,53,0,60,7
1713337923806,ANBI 134,A00,487223,Staff,6,0,20,14
1713337924856,ANBI 143GS,A00,487224,Noel; Geoffroy Pierre Jean,18,0,24,6
1713337925882,ANBI 144GS,A00,519548,Noel; Geoffroy Pierre Jean,18,0,24,6
1713337926917,ANSC 101,A00,487225,Staff,18,0,20,2
1713337927942,ANSC 125,A00,487227,Brenner; Suzanne A,38,0,40,2
1713337930005,ANSC 146,A00,487229,Staff,35,0,40,5
1713337931030,ANSC 148,A00,487230,Olivas Hernandez; Olga Lid,39,0,40,1
1713337932059,ANSC 150,A00,504165,Sloane; Julia Kathryn,18,0,20,2
1713337933086,ANSC 180,A00,487232,Staff,14,0,15,1
1713337934131,ANSC 188,A00,627155,Staff,38,0,40,2
1713337935157,ANTH 5,A00,519529,Semendeferi; Ekaterini,15,0,15,0
1713337936184,ANTH 10,A00,487219,Staff,58,0,60,2
1713337937212,ANTH 23,A01,487221,Staff,17,0,20,3
1713337938243,ANTH 102,A00,487233,Wilder; Linnea Lorene,50,0,60,10
1713337939275,ANTH 103,A00,487234,Varma; Saiba,54,0,60,6
1713337940303,ANTH 105,A00,487235,Stewart; Alexander B,54,0,60,6
1713337941328,BENG 100,A01,516685,Taylor Amos; Alyssa C,25,0,30,5
1713337942365,BIBC 102,A01,491316,Flagg; Matthew Paul,6,0,88,82
1713337942365,BIBC 102,A02,491366,Flagg; Matthew Paul,78,0,88,10
1713337943392,BIBC 103,A01,491486,Boumechache; Miyyada,16,0,24,8
1713337943392,BIBC 103,A02,491487,Boumechache; Miyyada,24,0,24,0
1713337944432,BICD 100,A01,516882,Staff,73,0,75,2
1713337944432,BICD 100,A02,516890,Staff,69,0,75,6
1713337945456,BICD 102GS,A00,491488,Lo; Stanley M.,26,0,28,2
1713337946496,BIEB 136GS,A00,516940,Holway; David A. & Shurin; Jonathan,18,0,24,6
1713337947519,BIEB 137GS,A01,517034,Holway; David A. & Shurin; Jonathan,18,0,24,6
1713337948562,BIEB 138GS,A01,491492,Pirino; Giorgia,21,0,28,7
1713337949590,BILD 1,A01,491296,Staff,60,0,63,3
1713337949590,BILD 1,A02,491297,Staff,63,0,63,0
1713337950639,BILD 4,A01,517099,Gonzalez Gamboa; Ivonne,22,0,24,2
1713337950639,BILD 4,A02,517100,Gonzalez Gamboa; Ivonne,24,0,24,0
1713337951665,BILD 60GS,A00,491309,Lo; Stanley M.,26,0,28,2
1713337952718,BIMM 100,A01,517136,Staff,82,0,100,18
1713337953814,BIMM 110,A01,517182,Staff,53,0,100,47
1713337954845,BIMM 120,A01,517228,Pickett; Brooke Elizabeth,28,0,63,35
1713337954845,BIMM 120,A02,517240,Pickett; Brooke Elizabeth,44,0,63,19
1713337955876,BIMM 132GS,A01,491498,Pirino; Giorgia,21,0,28,7
1713337956912,BIMM 143,A01,491589,Bozinovic; Goran,12,0,40,28
1713337957943,BIPN 100,A01,491594,Armour; Jon Christopher,83,0,100,17
1713337958975,BIPN 140,A01,491602,Marino; Marc J,23,0,50,27
1713337961053,CAT 125,A00,515973,Staff,18,0,20,2
1713337962082,CAT 125GS,A00,515974,Rahimi; Babak,16,0,20,4
1713337963113,CAT 125R,A00,515980,Staff,12,0,20,8
1713337963113,CAT 125R,B00,515981,Tosun; Adriana,19,0,20,1
1713337963113,CAT 125R,C00,515987,Hyland; Tina Mae,0,5,20,20
1713337963113,CAT 125R,D00,515988,Bronstein; Phoebe Malan,16,0,20,4
1713337964153,CENG 15,A01,488699,Drews; Aaron,25,0,25,0
1713337965205,CENG 100,A00,505196,Opatkiewicz; Justin Paul,25,0,25,0
1713337966238,CGS 2A,A01,489598,Staff,33,0,35,2
1713337967266,CGS 112,A00,489599,Staff,15,0,15,0
1713337968297,CGS 119,A00,489603,Staff,10,0,10,0
1713337969325,CGS 120,A00,489604,Staff,13,0,15,2
1713337970355,CGS 150,A00,489607,Staff,15,0,15,0
1713337971396,CHEM 6A,A01,488715,Staff,97,0,100,3
1713337972430,CHEM 6B,A01,488719,Piercy; Marc Anthony,99,0,100,1
1713337973462,CHEM 6C,A01,488723,Albizati; Kim F.,93,0,100,7
1713337974493,CHEM 7L,A01,488728,Schurmeier; Kimberly,18,0,24,6
1713337974493,CHEM 7L,A02,488730,Schurmeier; Kimberly,23,0,24,1
1713337974493,CHEM 7L,A03,488734,Schurmeier; Kimberly,20,0,24,4
1713337974493,CHEM 7L,A04,488763,Schurmeier; Kimberly,23,0,24,1
1713337974493,CHEM 7L,B01,488798,Schurmeier; Kimberly,17,0,24,7
1713337974493,CHEM 7L,B02,488801,Schurmeier; Kimberly,22,0,24,2
1713337974493,CHEM 7L,B03,488808,Schurmeier; Kimberly,22,0,24,2
1713337974493,CHEM 7L,B04,488811,Schurmeier; Kimberly,24,0,24,0
1713337975523,CHEM 11,A01,488897,Stallings; Dontarie M,95,0,100,5
1713337976562,CHEM 40A,A01,488913,Albizati; Kim F.,83,0,100,17
1713337977606,CHEM 40B,A01,488920,Weizman; Haim,42,0,50,8
1713337977606,CHEM 40B,A02,488938,Weizman; Haim,44,0,50,6
1713337978652,CHEM 41A,A01,489029,Klosterman; Jeremy K,57,0,60,3
1713337979683,CHEM 41C,A01,500436,Tor; Yitzhak,55,0,60,5
1713337980719,CHEM 43A,A01,500426,Weizman; Haim,0,1,24,24
1713337980719,CHEM 43A,A02,500430,Weizman; Haim,5,0,24,19
1713337980719,CHEM 43A,B01,514041,Klosterman; Jeremy K,15,0,24,9
1713337980719,CHEM 43A,B02,514047,Klosterman; Jeremy K,23,0,24,1
1713337981752,CHEM 108,A01,489140,Jennings; Patricia A.,7,0,24,17
1713337981752,CHEM 108,A02,489142,Jennings; Patricia A.,14,0,24,10
1713337982799,CHEM 114A,A01,489147,Stallings; Dontarie M,65,0,100,35
1713337983825,CHIN 169A,A00,489171,Wang; Xiao,19,0,20,1
1713337985892,COGS 3,A01,518827,Boyle; Mary E. T.,25,0,40,15
1713337986924,COGS 11,A01,489175,Staff,27,0,30,3
1713337987966,COGS 14A,A01,518829,Staff,51,0,60,9
1713337988993,COGS 14B,A01,489177,Hoffman; Drew Ellen,62,0,75,13
1713337990031,COGS 100,A01,489181,Allen; Michael Gordon,62,0,75,13
1713337991065,COGS 101A,A01,489183,Staff,45,0,60,15
1713337992093,COGS 101B,A01,489185,Allen; Michael Gordon,6,0,30,24
1713337993145,COGS 101C,A01,526786,Staff,23,0,30,7
1713337995202,COGS 107A,A01,489189,Boyle; Mary E. T.,16,0,35,19
1713337996251,COGS 107B,A01,627144,Mooshagian; Eric Frederick,60,0,60,0
1713337997283,COGS 118A,A01,489191,Staff,0,46,40,40
1713337999356,COGS 171GS,A01,489194,Pineda; Jaime A,19,0,28,9
1713338000386,COGS 172,A01,489196,Staff,2,0,30,28
1713338001411,COGS 174GS,A01,489264,Pineda; Jaime A,19,0,28,9
1713338002441,COGS 180,A01,627150,Staff,28,0,30,2
1713338003469,COGS 186,A01,489274,Staff,0,2,30,30
1713338004506,COMM 10,A01,489276,Staff,23,0,25,2
1713338004506,COMM 10,A02,489303,Staff,23,0,25,2
1713338005562,COMM 100A,A01,489312,Staff,14,0,25,11
1713338005562,COMM 100A,A02,489313,Staff,24,0,25,1
1713338006595,COMM 106T,A00,512540,Staff,33,0,35,2
1713338007624,COMM 107,A00,489347,Staff,27,0,35,8
1713338008655,COMM 109P,A00,489358,Staff,31,0,35,4
1713338009684,COMM 132,A00,489361,McKenna; Denise,27,0,30,3
1713338010714,COMM 146,A00,489362,Halm; Gavin Patrick,26,0,30,4
1713338011802,COMM 190,A00,489363,Abuelhiga; Soraya Jill,17,0,23,6
1713338012835,CSE 8A,A50,489366,Staff,21,0,25,4
1713338012835,CSE 8A,A51,489367,Staff,24,0,25,1
1713338013872,CSE 11,A01,489398,Cao; Yingjun,73,0,100,27
1713338014903,CSE 12,A01,489487,Staff,43,0,50,7
1713338015931,CSE 20,A01,489497,Staff,47,0,50,3
1713338016961,CSE 21,A01,489517,Braun; Oliver,42,0,50,8
1713338017989,CSE 101,A01,489524,Braun; Oliver,0,33,50,50
1713338019231,CSE 105,A01,512594,Jones; Miles E,72,0,100,28
1713338019231,CSE 105,B01,512598,Jones; Miles E,52,0,100,48
1713338020262,CSE 140,A01,489538,Staff,41,0,50,9
1713338021290,CSE 141,A01,489550,Eldon; John,67,0,100,33
1713338022331,CSE 141L,A01,489571,Eldon; John,65,0,100,35
1713338023360,CSE 151A,A01,489583,Solares; Edwin A,140,0,200,60
1713338024387,CSE 175,A01,510886,Kumar; Rakesh,30,0,30,0
1713338025414,CSE 190,A00,516828,Dubnov; Shlomo,37,0,49,12
1713338026442,DOC 100D,A00,489667,Pass; Natalye Joann,19,0,25,6
1713338027479,DSC 10,A01,624268,Staff,72,0,75,3
1713338028506,DSC 20,A01,624476,Staff,50,0,50,0
1713338029533,DSC 40A,A01,624608,Staff,39,0,40,1
1713338030571,DSGN 1,A01,489179,Rill; Bryan,32,0,50,18
1713338031602,ECE 17,A01,490489,Sahay; Rajeev,18,0,30,12
1713338032647,ECE 65,A50,490492,Staff,11,0,20,9
1713338032647,ECE 65,A51,490493,Staff,18,0,20,2
1713338033683,ECON 1,A01,489715,Famulari; Melissa,67,0,70,3
1713338034718,ECON 2,A01,489717,Levkoff; Steven B.,67,0,70,3
1713338035746,ECON 3,A01,489948,Staff,70,0,70,0
1713338037810,ECON 5,A01,490103,Staff,27,0,30,3
1713338037810,ECON 5,B01,626281,Dai; Yinlin,45,0,45,0
1713338038847,ECON 100A,A01,490127,Famulari; Melissa,63,0,70,7
1713338039875,ECON 100B,A01,490129,Staff,64,0,70,6
1713338040905,ECON 109,A01,490187,Shishkin; Denis,27,0,35,8
1713338041931,ECON 110A,A01,490190,Levkoff; Steven B.,59,0,70,11
1713338042956,ECON 120A,A01,490245,Dai; Yinlin,60,0,70,10
1713338043983,ECON 120B,A01,490247,Nieto-Barthaburu; Augusto,40,0,70,30
1713338045011,ECON 120C,A01,490253,Sun; Yixiao,30,0,35,5
1713338045011,ECON 120C,B01,490255,Sun; Yixiao,34,0,35,1
1713338046053,ECON 129,A00,490256,Eckert; Fabian Paul,22,0,35,13
1713338047084,ECON 131,A00,490257,Nieto-Barthaburu; Augusto,0,6,35,35
1713338048116,ECON 138,A00,490258,Bharadwaj; Prashant,13,0,35,22
1713338048116,ECON 138,B00,490259,Bharadwaj; Prashant,15,0,35,20
1713338049162,ECON 159,A00,490260,Hendrickson; Gerald M.,0,9,0,0
1713338050210,ECON 178,A01,553995,Zhu; Ying,24,0,35,11
1713338051250,EDS 40,A01,512576,Black; Alison Michelle,20,0,20,0
1713338052277,EDS 107,A01,515848,Staff,30,0,30,0
1713338053316,EDS 110R,A01,490262,Staff,26,0,30,4
1713338054350,EDS 112,A01,490264,Chapman; Thandeka K,40,0,50,10
1713338055388,EDS 113,A00,490266,Staff,25,0,30,5
1713338056424,EDS 118,A00,490267,Warstadt; Melissa Fawn,18,0,30,12
1713338057453,EDS 124BR,A00,490268,Eguchi; Emi,4,0,25,21
1713338057453,EDS 124BR,B00,490269,Eguchi; Emi,23,0,25,2
1713338058482,EDS 126,A01,490271,Jones; Makeba,43,0,50,7
1713338059515,EDS 135,A01,490316,Staff,19,0,20,1
1713338060557,ENVR 142GS,A00,519514,Chang; Edmond Yi-Teh,26,0,28,2
1713338061594,ETHN 103,A00,490504,Staff,25,0,36,11
1713338062630,ETHN 103A,A00,490505,Man; Simeon S,3,0,9,6
1713338063658,ETHN 109,A00,490506,Staff,28,0,30,2
1713338064686,ETHN 118,A00,490507,Staff,35,0,36,1
1713338065712,ETHN 119,A00,490508,Staff,32,0,36,4
1713338066746,ETHN 121R,A00,490518,Choi; Esther Min,21,0,36,15
1713338067780,ETHN 127,A00,490528,Staff,14,0,15,1
1713338068806,ETHN 139,A00,490573,Staff,10,0,10,0
1713338069841,ETHN 150,A00,490575,Staff,15,0,15,0
1713338070880,GLBH 20,A00,491705,Elwardani; Nile Regina,38,0,40,2
1713338071907,GLBH 101,A00,491706,Staff,20,0,20,0
1713338072939,GLBH 111,A01,491708,Burgos; Jose L.,15,0,15,0
1713338073975,GLBH 146,A00,491709,Staff,9,0,20,11
1713338075003,GLBH 148,A00,491710,Olivas Hernandez; Olga Lid,11,0,20,9
1713338076029,GLBH 150,A00,491711,Sloane; Julia Kathryn,19,0,20,1
1713338077053,HIEA 131,A00,491760,Staff,28,0,32,4
1713338078081,HIEA 153,A00,491762,Staff,28,0,30,2
1713338079115,HIEU 124,A00,491811,Staff,26,0,32,6
1713338080141,HIEU 124GS,A00,491812,Markman; Kristina,27,0,28,1
1713338081177,HIEU 147,A00,491813,Staff,30,0,32,2
1713338082204,HIEU 149GS,A00,491816,Caldwell; Michael Alan,28,0,28,0
1713338083233,HILD 2C,A01,491713,Hendrickson; Gerald M.,26,0,30,4
1713338084278,HILD 7B,A01,491715,Kwak; Nancy,0,2,30,30
1713338085311,HILD 10,A01,491717,Staff,9,0,20,11
1713338086340,HILD 30GS,A00,491719,Edington; Claire Ellen,23,0,28,5
1713338087370,HINE 109,A00,491818,Shafir; Nir,27,0,32,5
1713338088396,HINE 128,A00,491821,Shafir; Nir,31,0,32,1
1713338089423,HISC 117,A00,491830,Staff,27,0,32,5
1713338090450,HIUS 103,A00,491834,Man; Simeon S,14,0,23,9
1713338091476,HIUS 108B,A00,491835,Staff,27,0,30,3
1713338092506,HIUS 141,A00,491836,Hendrickson; Gerald M.,28,0,32,4
1713338093531,HIUS 149,A00,491839,Staff,24,0,32,8
1713338094560,HUM 3,A01,512617,Crum; Matthew Stephen,42,0,50,8
1713338094560,HUM 3,A02,512618,Crum; Matthew Stephen,48,0,50,2
1713338095598,HUM 3GS,A00,512663,Markman; Kristina,0,0,0,1
1713338095598,HUM 3GS,B00,512664,Staff,0,0,0,0
1713338096624,HUM 4,A01,512620,West; Geoffrey Scott,25,0,50,25
1713338097653,HUM 4GS,A00,512666,Lyon; Antony J.,0,0,0,5
1713338098686,HUM 4R,A01,512625,Watkins; Eric,49,0,50,1
1713338099714,HUM 5,A01,512649,Zavodny; Tatiana Sophia,20,0,50,30
1713338099714,HUM 5,B01,512661,Zroka; Ryan Edward,48,0,50,2
1713338100742,INTL 190,A00,490577,Segui; Alan S,0,0,0,5
1713338101774,JAPN 20AR,A01,491267,Ross; Kayoko F,7,0,20,13
1713338102806,JAPN 180,A00,491285,Berman; Michael David,33,0,40,7
1713338103833,LATI 50,A01,502536,Kokinis; Troy Andreas,16,0,22,6
1713338103833,LATI 50,A02,502551,Kokinis; Troy Andreas,22,0,22,0
1713338103833,LATI 50,A03,502650,Kokinis; Troy Andreas,22,0,22,0
1713338103833,LATI 50,A04,502909,Kokinis; Troy Andreas,21,0,22,1
1713338104858,LATI 160,A01,502920,Kokinis; Troy Andreas,30,0,30,0
1713338105890,LIFR 1A,A00,490494,Van Moer; Vinciane G,17,0,20,3
1713338107308,LIFR 1AX,A00,490495,Van Moer; Vinciane G,17,0,20,3
1713338108335,LIFR 1B,A00,490496,Van Moer; Vinciane G,17,0,20,3
1713338109368,LIFR 1BX,A00,490497,Van Moer; Vinciane G,17,0,20,3
1713338110406,LIGN 8,A00,505198,McIntosh; Justin Daniel,134,0,150,16
1713338111437,LIGN 9GS,A00,491239,Lott; Margaret S.,18,0,20,2
1713338112465,LIGN 101,A01,505200,McIntosh; Justin Daniel,22,0,30,8
1713338113491,LIGN 120,A01,491244,Staff,22,0,30,8
1713338114518,LIGN 149GS,A00,491245,Lott; Margaret S.,18,0,20,2
1713338115548,LIGN 170,A00,491247,Staff,22,0,30,8
1713338116640,LISP 1D,A00,490498,Munoz Sanchez; Alicia,8,0,14,6
1713338116640,LISP 1D,B00,490499,Munoz Sanchez; Alicia,4,0,14,10
1713338116640,LISP 1D,C00,490500,Munoz Sanchez; Alicia,7,0,14,7
1713338116640,LISP 1D,D00,490501,Munoz Sanchez; Alicia,10,0,14,4
1713338117673,LISP 1DX,A00,490502,Munoz Sanchez; Alicia,11,0,28,17
1713338117673,LISP 1DX,B00,490503,Munoz Sanchez; Alicia,16,0,28,12
1713338119737,LTAM 110,A00,491847,Staff,22,0,25,3
1713338120768,LTCS 119,A00,491848,Staff,11,0,15,4
1713338121800,LTCS 130,A00,491849,Staff,24,0,25,1
1713338123861,LTEA 120C,A00,491852,Staff,32,0,40,8
1713338124885,LTEN 130GS,A00,491853,Lyon; Antony J.,23,0,28,5
1713338125908,LTEN 148,A00,491855,Staff,23,0,25,2
1713338126934,LTEN 159,A00,491856,Staff,20,0,25,5
1713338127960,LTEN 180,A00,491857,Staff,8,0,15,7
1713338130039,LTSP 123GS,A00,505928,Bessett; Ryan Matthew,24,0,28,4
1713338131074,LTSP 174GS,A00,506037,Bessett; Ryan Matthew,24,0,28,4
1713338133125,LTWR 102,A00,491861,Staff,9,0,15,6
1713338134158,LTWR 106,A00,491862,Staff,8,0,15,7
1713338135193,MAE 11,A00,490930,Bahadori; Mohammad Yousef,95,0,100,5
1713338136234,MAE 30A,A00,490931,Qi; Huihui,37,0,40,3
1713338137262,MAE 101A,A00,491036,Sadeghizadeh; Zahra,92,0,100,8
1713338138293,MAE 101C,A00,491037,Seshadri; Kalyanasundaram,63,0,100,37
1713338139317,MAE 113,A00,491040,Seshadri; Kalyanasundaram,64,0,80,16
1713338140361,MAE 131A,A00,491041,Ghazinejad; Maziar,37,0,40,3
1713338141389,MAE 142,A00,491053,Staff,39,0,40,1
1713338142441,MAE 143A,A00,491054,Staff,30,0,50,20
1713338143469,MAE 150,A00,491092,Truong; Phuong Thi Ngoc,23,0,35,12
1713338144500,MATH 3C,A01,494031,Pardo Guerra; Sebastian,30,0,30,0
1713338144500,MATH 3C,A02,494032,Pardo Guerra; Sebastian,29,0,30,1
1713338145527,MATH 10A,A01,494034,Staff,27,0,30,3
1713338145527,MATH 10A,A02,494035,Staff,28,0,30,2
1713338145527,MATH 10A,B01,494037,Staff,27,0,30,3
1713338145527,MATH 10A,B02,494038,Staff,29,0,30,1
1713338146578,MATH 10B,A01,494040,Habib; Yousaf,22,0,30,8
1713338146578,MATH 10B,A02,494041,Habib; Yousaf,28,0,30,2
1713338146578,MATH 10B,A03,494042,Habib; Yousaf,29,0,30,1
1713338146578,MATH 10B,A04,494043,Habib; Yousaf,30,0,30,0
1713338146578,MATH 10B,B01,494045,Habib; Yousaf,25,0,30,5
1713338146578,MATH 10B,B02,494046,Habib; Yousaf,30,0,30,0
1713338146578,MATH 10B,B03,494047,Habib; Yousaf,30,0,30,0
1713338146578,MATH 10B,B04,494048,Habib; Yousaf,30,0,30,0
1713338147622,MATH 18,A01,494050,Kemp; Todd Aahron,25,0,30,5
1713338147622,MATH 18,A02,494051,Kemp; Todd Aahron,29,0,30,1
1713338147622,MATH 18,B01,494054,Kemp; Todd Aahron,25,0,30,5
1713338147622,MATH 18,B02,494055,Kemp; Todd Aahron,29,0,30,1
1713338148662,MATH 20A,A01,494059,Suk; Andrew Hoon,30,0,30,0
1713338149700,MATH 20B,A01,494061,Briones; Jor-el Thomas Caparas,33,0,35,2
1713338149700,MATH 20B,B01,494063,Bach; Quang Tran,34,0,35,1
1713338150733,MATH 20C,A01,494065,Staff,28,0,30,2
1713338150733,MATH 20C,A02,494066,Staff,30,0,30,0
1713338150733,MATH 20C,A03,494067,Staff,30,0,30,0
1713338150733,MATH 20C,A04,494068,Staff,30,0,30,0
1713338150733,MATH 20C,B01,494070,Zhang; Ming,24,0,30,6
1713338150733,MATH 20C,B02,494071,Zhang; Ming,27,0,30,3
1713338150733,MATH 20C,B03,494072,Zhang; Ming,29,0,30,1
1713338150733,MATH 20C,B04,494073,Zhang; Ming,29,0,30,1
1713338151762,MATH 20D,A01,494075,Staff,22,0,30,8
1713338151762,MATH 20D,A02,494076,Staff,29,0,30,1
1713338152790,MATH 20E,A01,494079,Staff,24,0,30,6
1713338152790,MATH 20E,A02,494080,Staff,26,0,30,4
1713338152790,MATH 20E,B01,494082,Staff,25,0,30,5
1713338152790,MATH 20E,B02,494083,Staff,25,0,30,5
1713338153816,MATH 103A,A01,494085,Aliabadi Sr.; Mohsen,12,0,30,18
1713338153816,MATH 103A,A02,494086,Aliabadi Sr.; Mohsen,28,0,30,2
1713338153816,MATH 103A,B01,494088,Aliabadi Sr.; Mohsen,20,0,30,10
1713338153816,MATH 103A,B02,494089,Aliabadi Sr.; Mohsen,27,0,30,3
1713338154850,MATH 109,A01,494091,Staff,30,0,30,0
1713338154850,MATH 109,A02,494092,Staff,29,0,30,1
1713338154850,MATH 109,B01,494094,Staff,27,0,30,3
1713338154850,MATH 109,B02,494095,Staff,29,0,30,1
1713338155884,MATH 142A,A01,494097,Chow; Bennett,13,0,30,17
1713338155884,MATH 142A,A02,494098,Chow; Bennett,23,0,30,7
1713338155884,MATH 142A,B01,494100,Chow; Bennett,19,0,30,11
1713338155884,MATH 142A,B02,494101,Chow; Bennett,29,0,30,1
1713338157943,MATH 168A,A01,516677,Dumitriu; Ioana,16,0,35,19
1713338158969,MATH 170A,A01,516679,Dumitriu; Ioana,18,0,30,12
1713338158969,MATH 170A,A02,516680,Dumitriu; Ioana,28,0,30,2
1713338159997,MATH 193A,A01,494107,Staff,12,0,30,18
1713338159997,MATH 193A,A02,494108,Staff,18,0,30,12
1713338159997,MATH 193A,A03,494109,Staff,29,0,30,1
1713338159997,MATH 193A,A04,494110,Staff,22,0,30,8
1713338163090,MGT 16,A00,491930,McKay; Michael J,92,0,98,6
1713338164118,MGT 18,A00,491992,McKay; Michael J,96,0,98,2
1713338165158,MGT 71,A00,492003,Staff,63,0,98,35
1713338166191,MGT 103,A00,505209,Eberhard; Craig A,80,0,98,18
1713338167218,MGT 131A,A00,505210,Anderson; John Charles,89,0,98,9
1713338169272,MGT 153,A00,492077,Perols; Johan Lars,16,0,90,74
1713338172370,MGT 164,A00,492222,McKay; Mary A,91,0,98,7
1713338173398,MGT 172,A00,492245,Staff,59,0,60,1
1713338173398,MGT 172,B00,505526,Hedges; Kathleen,65,0,98,33
1713338174426,MGT 181,A00,505669,Dunn; Louis Jean,78,0,98,20
1713338175459,MMW 14,A01,494399,Staff,15,0,28,13
1713338175459,MMW 14,A02,494400,Staff,25,0,28,3
1713338175459,MMW 14,A03,494401,Staff,28,0,28,0
1713338175459,MMW 14,A04,494402,Staff,28,0,28,0
1713338175459,MMW 14,B01,494404,Carreras; Maria Victoria,8,0,28,20
1713338175459,MMW 14,B02,494405,Carreras; Maria Victoria,25,0,28,3
1713338175459,MMW 14,B03,494406,Carreras; Maria Victoria,27,0,28,1
1713338175459,MMW 14,B04,494407,Carreras; Maria Victoria,28,0,28,0
1713338176488,MMW 14GS,A00,506250,Chang; Edmond Yi-Teh,0,0,0,0
1713338177515,MMW 121R,A01,494415,Adamiak; Patrick John,10,0,28,18
1713338177515,MMW 121R,A02,494416,Adamiak; Patrick John,24,0,28,4
1713338178541,MUS 1A,A01,494113,Staff,12,0,25,13
1713338178541,MUS 1A,A02,494114,Staff,24,0,25,1
1713338179578,MUS 4,A01,494116,Staff,23,0,25,2
1713338179578,MUS 4,A02,494117,Staff,22,0,25,3
1713338180613,MUS 5R,A01,494236,Dubnov; Shlomo,4,0,25,21
1713338180613,MUS 5R,A02,494237,Dubnov; Shlomo,25,0,25,0
1713338181640,MUS 6,A01,494122,Staff,9,0,25,16
1713338181640,MUS 6,A02,494123,Staff,23,0,25,2
1713338182673,MUS 7,A01,494125,Staff,16,0,25,9
1713338182673,MUS 7,A02,494126,Staff,24,0,25,1
1713338183705,MUS 11,A01,494128,Staff,23,0,25,2
1713338183705,MUS 11,A02,494129,Staff,24,0,25,1
1713338184731,MUS 13,A01,494131,Staff,25,0,25,0
1713338184731,MUS 13,A02,494132,Staff,25,0,25,0
1713338185758,MUS 15,A01,494134,Staff,16,0,25,9
1713338185758,MUS 15,A02,494135,Staff,25,0,25,0
1713338185758,MUS 15,B01,494137,Staff,24,0,25,1
1713338186791,MUS 80,A00,494232,Staff,24,0,25,1
1713338186791,MUS 80,B00,494233,Staff,25,0,25,0
1713338186791,MUS 80,C00,494234,Staff,23,0,25,2
1713338187817,MUS 95C,A00,494141,Staff,69,0,75,6
1713338188843,MUS 114,A00,494142,Staff,39,0,50,11
1713338189907,NANO 15,A01,490636,Drews; Aaron,7,0,7,0
1713338190933,PHIL 1,A00,490578,Grush; Rick Scott,49,0,50,1
1713338191963,PHIL 10,A01,490580,Grush; Rick Scott,33,0,35,2
1713338191963,PHIL 10,A02,490586,Grush; Rick Scott,32,0,35,3
1713338192991,PHIL 27,A01,490591,Staff,22,0,25,3
1713338192991,PHIL 27,A02,490592,Staff,25,0,25,0
1713338192991,PHIL 27,A03,490593,Staff,25,0,25,0
1713338192991,PHIL 27,A04,490598,Staff,25,0,25,0
1713338194019,PHIL 32,A01,490611,Staff,20,0,20,0
1713338194019,PHIL 32,A02,490618,Staff,20,0,20,0
1713338195050,PHIL 90,A00,490624,Staff,40,0,40,0
1713338196087,PHIL 136,A00,490627,Cohen; Jonathan David,37,0,40,3
1713338197112,PHIL 155,A00,490634,Staff,62,0,70,8
1713338198145,PHYS 1A,A00,491610,Staff,245,0,250,5
1713338199172,PHYS 1AL,001,491616,Tsai; Philbert S,27,0,30,3
1713338199172,PHYS 1AL,002,491618,Tsai; Philbert S,30,0,30,0
1713338200201,PHYS 1B,A00,491623,Staff,235,0,250,15
1713338201230,PHYS 1BL,001,491626,Tsai; Philbert S,19,0,30,11
1713338201230,PHYS 1BL,002,491628,Tsai; Philbert S,26,0,30,4
1713338202261,PHYS 1C,A00,491632,Staff,212,0,245,33
1713338203299,PHYS 1CL,001,491635,Tsai; Philbert S,3,0,30,27
1713338203299,PHYS 1CL,002,491643,Tsai; Philbert S,22,0,30,8
1713338204327,PHYS 2AR,A01,491651,Meyertholen; Andrew D.,44,0,50,6
1713338205355,PHYS 2B,A01,491659,Staff,105,0,115,10
1713338206383,PHYS 2BL,A01,491685,Staff,21,0,24,3
1713338206383,PHYS 2BL,A02,491700,Staff,21,0,24,3
1713338207409,PHYS 2C,A01,505161,Staff,101,0,115,14
1713338208437,PHYS 4A,A01,491704,Grinstein; Benjamin,99,0,100,1
1713338209466,POLI 5D,A01,494144,Staff,3,0,5,2
1713338209466,POLI 5D,B01,626283,Dai; Yinlin,5,0,5,0
1713338210492,POLI 12,A00,494145,Staff,43,0,45,2
1713338211522,POLI 13R,A00,494146,Forman; Fonna,45,0,50,5
1713338212549,POLI 27,A01,494148,Staff,54,0,60,6
1713338213575,POLI 30,A00,494149,Staff,49,0,50,1
1713338214600,POLI 100DA,A00,494150,Staff,20,0,25,5
1713338216657,POLI 100I,A00,494152,Staff,27,0,30,3
1713338217685,POLI 104B,A00,494153,Smith; Glenn Chatmas,53,0,55,2
1713338218709,POLI 104F,A00,494154,Staff,28,0,30,2
1713338219736,POLI 104I,A00,494155,Smith; Glenn Chatmas,29,0,30,1
1713338220817,POLI 110C,A00,494156,Ingham; Sean,23,0,25,2
1713338221849,POLI 117R,A00,494157,Forman; Fonna,5,0,20,15
1713338222876,POLI 118,A00,494158,Ingham; Sean,21,0,25,4
1713338223910,POLI 120H,A00,494159,Fisk; David Lee,39,0,45,6
1713338224942,POLI 131CR,A00,494160,Hoston; Germaine,35,0,45,10
1713338225967,POLI 133J,A00,494161,Staff,31,0,35,4
1713338227005,POLI 135,A00,494162,Fisk; David Lee,33,0,35,2
1713338228034,POLI 140A,A00,494164,Staff,18,0,30,12
1713338229063,POLI 142I,A00,494165,Staff,30,0,30,0
1713338230099,POLI 144D,A00,494166,Staff,22,0,25,3
1713338231126,POLI 151,A00,494167,Staff,30,0,30,0
1713338232151,POLI 153,A00,494168,Staff,33,0,35,2
1713338233185,POLI 160AA,A00,494169,Staff,34,0,40,6
1713338234213,POLI 162,A00,494170,Mignozzetti; Umberto,18,0,25,7
1713338235240,POLI 171,A00,494171,Mignozzetti; Umberto,18,0,25,7
1713338236266,PSYC 1,A00,494172,Staff,95,0,100,5
1713338237294,PSYC 2,A00,494173,Moranton; Nirelia Melbina-,34,0,50,16
1713338238323,PSYC 3,A00,494174,Staff,29,0,30,1
1713338239352,PSYC 6,A00,494175,Staff,17,0,20,3
1713338240394,PSYC 60,A01,494177,Staff,37,0,45,8
1713338241438,PSYC 70,A01,505724,Geller; Emma Harlan,42,0,45,3
1713338242469,PSYC 101,A00,494180,Heyman; Gail D.,84,0,100,16
1713338243508,PSYC 105,A00,494181,Geller; Emma Harlan,51,0,90,39
1713338244536,PSYC 106,A00,494182,Dobkins; Karen R.,26,0,45,19
1713338245578,PSYC 108,A00,494183,Adrian; Julia Anna,89,0,100,11
1713338246623,PSYC 114,A01,494185,Winkielman; Piotr,0,3,30,30
1713338247651,PSYC 122,A00,494186,Moranton; Nirelia Melbina-,27,0,50,23
1713338248679,PSYC 124,A00,494187,Chapman; Eddie Nathaniel,69,0,80,11
1713338249713,PSYC 131,A00,494188,Anagnostaras; Stephan,40,0,80,40
1713338250743,PSYC 144,A00,494189,Staff,1,0,50,49
1713338251769,PSYC 154,A00,494190,Lacefield; Katharine I,105,0,180,75
1713338252809,PSYC 162,A00,494191,Wixted; John T,70,0,100,30
1713338253833,PSYC 172,A00,494192,Gorman; Michael R.,36,0,45,9
1713338254866,PSYC 178,A00,494193,Glaser; Dale,34,0,45,11
1713338255896,PSYC 193,A00,505725,Chapman; Eddie Nathaniel,20,0,20,0
1713338256921,RELI 145GS,A00,519817,Rahimi; Babak,17,0,20,3
1713338257952,SE 101A,A01,490862,Chadha; Mayank,23,0,25,2
1713338258977,SE 101C,A01,490924,Krysl; Petr,15,0,20,5
1713338260007,SE 110A,A01,490928,Staff,19,0,20,1
1713338261046,SE 130A,A00,490929,Morrison; Machel Leigh,54,0,70,16
1713338262080,SIO 1,A01,519325,Staff,39,0,40,1
1713338263107,SIO 30,A01,519327,Staff,38,0,40,2
1713338264140,SIO 40,A00,519328,Staff,39,0,40,1
1713338265171,SIO 46GS,A00,519819,Cook; Geoffrey W,17,0,25,8
1713338266204,SIO 109R,A00,494197,Forman; Fonna,0,3,20,20
1713338267232,SIO 121GS,A00,519827,Cook; Geoffrey W,17,0,25,8
1713338268260,SIO 132,A01,519330,Staff,38,0,40,2
1713338269297,SIO 133,A01,519397,Staff,37,0,40,3
1713338270324,SIO 139,A00,519396,Kacev; David,29,0,40,11
1713338271354,SOCI 1,A01,494199,Thorpe; Charles Robert,21,0,30,9
1713338271354,SOCI 1,A02,494200,Thorpe; Charles Robert,30,0,30,0
1713338271354,SOCI 1,A03,494201,Thorpe; Charles Robert,29,0,30,1
1713338271354,SOCI 1,A04,494202,Thorpe; Charles Robert,29,0,30,1
1713338271354,SOCI 1,A05,494203,Thorpe; Charles Robert,29,0,30,1
1713338271354,SOCI 1,A06,494204,Thorpe; Charles Robert,30,0,30,0
1713338271354,SOCI 1,A07,494205,Thorpe; Charles Robert,28,0,30,2
1713338272386,SOCI 60,A01,494207,Staff,33,0,40,7
1713338272386,SOCI 60,A02,494208,Staff,39,0,40,1
1713338273414,SOCI 100,A01,494210,Payne; Christine Anna,25,0,30,5
1713338273414,SOCI 100,A02,494211,Payne; Christine Anna,26,0,30,4
1713338274440,SOCI 109M,A00,494212,Staff,20,0,20,0
1713338275474,SOCI 110,A00,494213,Staff,34,0,40,6
1713338277527,SOCI 118E,A00,494215,Ng; Kwai,37,0,40,3
1713338278557,SOCI 125,A00,494216,Calderon-Zaks; Michael Aar,39,0,45,6
1713338279585,SOCI 126,A01,494218,Jones; Makeba,3,0,5,2
1713338280633,SOCI 131,A00,494219,Thorpe; Charles Robert,26,0,30,4
1713338282688,SOCI 135,A00,494221,Payne; Christine Anna,28,0,50,22
1713338283715,SOCI 136E,A00,626690,Ruiz; Jonathan Joseph,24,0,25,1
1713338284860,SOCI 138GS,A00,494222,Navon; Daniel,23,0,28,5
1713338286919,SOCI 145,A00,494224,Staff,40,0,45,5
1713338287945,SOCI 153,A00,494225,Staff,28,0,30,2
1713338288971,SOCI 160E,A00,494226,Ng; Kwai,27,0,40,13
1713338290004,SOCI 180,A00,494227,Staff,29,0,30,1
1713338291031,SOCI 189GS,A00,494228,Ribas Norris; Janet Vanesa,11,0,11,0
1713338292058,SOCI 190GS,A00,553232,Ribas Norris; Janet Vanesa,11,0,11,0
1713338293106,SOMI 220,A00,627178,Schneid; Stephen David,30,0,30,0
1713338294134,SYN 2,001,490768,Staff,13,0,15,2
1713338294134,SYN 2,002,490769,Staff,14,0,15,1
1713338294134,SYN 2,004,490775,Staff,0,0,0,0
1713338294134,SYN 2,003,490774,Staff,0,0,0,0
1713338294134,SYN 2,005,490776,Staff,0,0,0,0
1713338295172,SYN 2R,001,490779,Staff,11,0,15,4
1713338295172,SYN 2R,002,514635,Staff,14,0,15,1
1713338296215,SYN 100,A01,490783,Staff,8,0,20,12
1713338296215,SYN 100,B01,490787,Staff,10,0,20,10
1713338296215,SYN 100,C01,490789,Staff,10,0,20,10
1713338297245,SYN 150,A00,490817,Staff,14,0,15,1
1713338297245,SYN 150,B00,514610,Staff,15,0,15,0
1713338298315,TDAC 1,A00,492753,Walsh; Kim C.,19,0,20,1
1713338298315,TDAC 1,B00,492754,Harting; Carla Kelso,18,0,20,2
1713338298315,TDAC 1,C00,513995,Salovey; Todd,15,0,20,5
1713338299342,TDAC 101,A00,492766,Harting; Carla Kelso,17,0,20,3
1713338300369,TDAC 102,A00,492768,Basso; Beatrice,19,0,20,1
1713338301395,TDDE 111,A00,492769,Staff,25,0,25,0
1713338302431,TDDE 131,A00,492770,Staff,15,0,15,0
1713338302431,TDDE 131,B00,492771,Staff,15,0,15,0
1713338303462,TDDE 131GS,A00,523716,Guirguis; Mark C,23,0,28,5
1713338304494,TDGE 1,A01,492756,Salovey; Todd,56,0,60,4
1713338305521,TDGE 5,A01,492758,Staff,23,0,25,2
1713338306554,TDGE 10,A00,492759,Fulton; Julia,203,0,220,17
1713338307581,TDGE 11,A00,492760,Castro; Robert Jess,198,0,200,2
1713338309633,TDGE 124,A00,492772,Fulton; Julia,181,0,220,39
1713338310661,TDGE 125,A00,492773,Meyer; Ursula,38,0,50,12
1713338310661,TDGE 125,B00,492774,Staff,49,0,50,1
1713338310661,TDGE 125,C00,523565,Staff,48,0,50,2
1713338311689,TDGE 125GS,A00,523580,Guirguis; Mark C,23,0,28,5
1713338312714,TDGE 127,A00,492775,Havis; Allan,32,0,50,18
1713338313743,TDHT 101,A00,492776,Staff,34,0,35,1
1713338314772,TDMV 1,A00,492762,Caligagan; Maria T.,29,0,30,1
1713338314772,TDMV 1,B00,492763,Arcidiacono; Kristin,26,0,30,4
1713338315800,TDMV 2,A00,492764,Weinberg; Sadie,27,0,30,3
1713338316829,TDMV 3,A00,492765,Mack; Kara Shanai',37,0,40,3
1713338317867,TDMV 138,A00,492777,Mack; Kara Shanai',32,0,40,8
1713338318895,TDMV 140,A00,492778,Lima; Paulo Henrique,40,0,40,0
1713338319923,TDMV 142,A00,492779,Caligagan; Maria T.,33,0,40,7
1713338319923,TDMV 142,B00,492780,Caligagan; Tony,37,0,40,3
1713338320953,TDMV 143,A00,492781,Fyall; Daunte Edward,39,0,40,1
1713338321982,USP 1,A01,492401,Kwak; Nancy,27,0,35,8
1713338323025,USP 2,A01,492453,Hinds; Juli Beth,35,0,35,0
1713338324056,USP 3,A01,492516,Staff,28,0,35,7
1713338325136,USP 4,A00,492522,McTague; Sarah,16,0,25,9
1713338326165,USP 100,A00,492523,Staff,32,0,35,3
1713338327195,USP 101,A00,492524,Staff,13,0,15,2
1713338328220,USP 105,A00,492525,Staff,21,0,25,4
1713338329248,USP 151,A00,492526,Shenkman; Michael Thomas,32,0,35,3
1713338330278,USP 170,A00,492545,Hinds; Juli Beth,33,0,35,2
1713338331311,USP 171GS,A00,492608,Bussell; Mirle Rabinowitz,24,0,28,4
1713338332339,USP 183GS,A00,492613,Peerson; Susan,24,0,28,4
1713338333378,VIS 30,A01,490693,Yoldas; Pinar,19,0,22,3
1713338333378,VIS 30,A02,490694,Yoldas; Pinar,18,0,22,4
1713338334411,VIS 83,A00,490695,Kester; Grant,63,0,75,12
1713338335437,VIS 105D,A00,490696,Staff,22,0,25,3
1713338336463,VIS 124CN,A00,490699,Rose; Jordan M,64,0,75,11
1713338337494,VIS 125GS,A00,511221,Williams; Alena J,21,0,22,1
1713338338520,VIS 128D,A00,490700,Staff,73,0,75,2
1713338339549,VIS 151,A01,490717,Staff,33,0,34,1
1713338339549,VIS 151,A02,490766,Staff,33,0,34,1
1713338340590,VIS 154GS,A00,511972,Williams; Alena J,21,0,22,1
1713338341617,VIS 160A,A00,490767,Stone; Patricia,7,0,10,3
1713338342769,WCWP 10A,A00,490638,Staff,14,0,15,1
1713338342769,WCWP 10A,B00,490640,Staff,15,0,15,0
1713338343809,WCWP 10B,A00,490641,Staff,0,0,0,0
1713338343809,WCWP 10B,B00,490642,Staff,14,0,15,1
1713338343809,WCWP 10B,C00,490644,Staff,13,0,15,2
1713338343809,WCWP 10B,D00,490647,Staff,0,0,0,0
1713338344846,WCWP 100,A00,490655,Staff,0,0,0,0
1713338344846,WCWP 100,B00,490687,Staff,10,0,15,5
1713338347015,ANAR 153,A00,487222,Braswell; Geoffrey E.,53,0,60,7
1713338348044,ANBI 134,A00,487223,Staff,6,0,20,14
1713338349072,ANBI 143GS,A00,487224,Noel; Geoffroy Pierre Jean,18,0,24,6
1713338350108,ANBI 144GS,A00,519548,Noel; Geoffroy Pierre Jean,18,0,24,6
1713338351137,ANSC 101,A00,487225,Staff,18,0,20,2
1713338352173,ANSC 125,A00,487227,Brenner; Suzanne A,38,0,40,2
1713338354231,ANSC 146,A00,487229,Staff,35,0,40,5
1713338355262,ANSC 148,A00,487230,Olivas Hernandez; Olga Lid,39,0,40,1
1713338356304,ANSC 150,A00,504165,Sloane; Julia Kathryn,18,0,20,2
1713338357331,ANSC 180,A00,487232,Staff,14,0,15,1
1713338358358,ANSC 188,A00,627155,Staff,38,0,40,2
1713338359386,ANTH 5,A00,519529,Semendeferi; Ekaterini,15,0,15,0
1713338360416,ANTH 10,A00,487219,Staff,58,0,60,2
1713338361446,ANTH 23,A01,487221,Staff,17,0,20,3
1713338362481,ANTH 102,A00,487233,Wilder; Linnea Lorene,50,0,60,10
1713338363513,ANTH 103,A00,487234,Varma; Saiba,54,0,60,6
1713338364539,ANTH 105,A00,487235,Stewart; Alexander B,54,0,60,6
1713338365565,BENG 100,A01,516685,Taylor Amos; Alyssa C,25,0,30,5
1713338366602,BIBC 102,A01,491316,Flagg; Matthew Paul,6,0,88,82
1713338366602,BIBC 102,A02,491366,Flagg; Matthew Paul,78,0,88,10
1713338367628,BIBC 103,A01,491486,Boumechache; Miyyada,16,0,24,8
1713338367628,BIBC 103,A02,491487,Boumechache; Miyyada,24,0,24,0
1713338368731,BICD 100,A01,516882,Staff,73,0,75,2
1713338368731,BICD 100,A02,516890,Staff,69,0,75,6
1713338369763,BICD 102GS,A00,491488,Lo; Stanley M.,26,0,28,2
1713338370790,BIEB 136GS,A00,516940,Holway; David A. & Shurin; Jonathan,18,0,24,6
1713338371819,BIEB 137GS,A01,517034,Holway; David A. & Shurin; Jonathan,18,0,24,6
1713338372852,BIEB 138GS,A01,491492,Pirino; Giorgia,21,0,28,7
1713338373892,BILD 1,A01,491296,Staff,60,0,63,3
1713338373892,BILD 1,A02,491297,Staff,63,0,63,0
1713338374923,BILD 4,A01,517099,Gonzalez Gamboa; Ivonne,22,0,24,2
1713338374923,BILD 4,A02,517100,Gonzalez Gamboa; Ivonne,24,0,24,0
1713338375949,BILD 60GS,A00,491309,Lo; Stanley M.,26,0,28,2
1713338376985,BIMM 100,A01,517136,Staff,82,0,100,18
1713338378011,BIMM 110,A01,517182,Staff,53,0,100,47
1713338379040,BIMM 120,A01,517228,Pickett; Brooke Elizabeth,28,0,63,35
1713338379040,BIMM 120,A02,517240,Pickett; Brooke Elizabeth,44,0,63,19
1713338380073,BIMM 132GS,A01,491498,Pirino; Giorgia,21,0,28,7
1713338381108,BIMM 143,A01,491589,Bozinovic; Goran,12,0,40,28
1713338382135,BIPN 100,A01,491594,Armour; Jon Christopher,83,0,100,17
1713338383321,BIPN 140,A01,491602,Marino; Marc J,23,0,50,27
1713338385381,CAT 125,A00,515973,Staff,18,0,20,2
1713338386410,CAT 125GS,A00,515974,Rahimi; Babak,16,0,20,4
1713338387454,CAT 125R,A00,515980,Staff,12,0,20,8
1713338387454,CAT 125R,B00,515981,Tosun; Adriana,19,0,20,1
1713338387454,CAT 125R,C00,515987,Hyland; Tina Mae,0,5,20,20
1713338387454,CAT 125R,D00,515988,Bronstein; Phoebe Malan,16,0,20,4
1713338388484,CENG 15,A01,488699,Drews; Aaron,25,0,25,0
1713338389514,CENG 100,A00,505196,Opatkiewicz; Justin Paul,25,0,25,0
1713338390551,CGS 2A,A01,489598,Staff,33,0,35,2
1713338391581,CGS 112,A00,489599,Staff,15,0,15,0
1713338392612,CGS 119,A00,489603,Staff,10,0,10,0
1713338393650,CGS 120,A00,489604,Staff,13,0,15,2
1713338394676,CGS 150,A00,489607,Staff,15,0,15,0
1713338395706,CHEM 6A,A01,488715,Staff,97,0,100,3
1713338396739,CHEM 6B,A01,488719,Piercy; Marc Anthony,99,0,100,1
1713338397766,CHEM 6C,A01,488723,Albizati; Kim F.,93,0,100,7
1713338398796,CHEM 7L,A01,488728,Schurmeier; Kimberly,18,0,24,6
1713338398796,CHEM 7L,A02,488730,Schurmeier; Kimberly,23,0,24,1
1713338398796,CHEM 7L,A03,488734,Schurmeier; Kimberly,20,0,24,4
1713338398796,CHEM 7L,A04,488763,Schurmeier; Kimberly,23,0,24,1
1713338398796,CHEM 7L,B01,488798,Schurmeier; Kimberly,17,0,24,7
1713338398796,CHEM 7L,B02,488801,Schurmeier; Kimberly,22,0,24,2
1713338398796,CHEM 7L,B03,488808,Schurmeier; Kimberly,22,0,24,2
1713338398796,CHEM 7L,B04,488811,Schurmeier; Kimberly,24,0,24,0
1713338399822,CHEM 11,A01,488897,Stallings; Dontarie M,95,0,100,5
1713338400859,CHEM 40A,A01,488913,Albizati; Kim F.,83,0,100,17
1713338401885,CHEM 40B,A01,488920,Weizman; Haim,42,0,50,8
1713338401885,CHEM 40B,A02,488938,Weizman; Haim,43,0,50,7
1713338402912,CHEM 41A,A01,489029,Klosterman; Jeremy K,57,0,60,3
1713338403949,CHEM 41C,A01,500436,Tor; Yitzhak,55,0,60,5
1713338404976,CHEM 43A,A01,500426,Weizman; Haim,0,1,24,24
1713338404976,CHEM 43A,A02,500430,Weizman; Haim,5,0,24,19
1713338404976,CHEM 43A,B01,514041,Klosterman; Jeremy K,15,0,24,9
1713338404976,CHEM 43A,B02,514047,Klosterman; Jeremy K,23,0,24,1
1713338406009,CHEM 108,A01,489140,Jennings; Patricia A.,7,0,24,17
1713338406009,CHEM 108,A02,489142,Jennings; Patricia A.,14,0,24,10
1713338407040,CHEM 114A,A01,489147,Stallings; Dontarie M,65,0,100,35
1713338408066,CHIN 169A,A00,489171,Wang; Xiao,19,0,20,1
1713338410129,COGS 3,A01,518827,Boyle; Mary E. T.,25,0,40,15
1713338411162,COGS 11,A01,489175,Staff,27,0,30,3
1713338412191,COGS 14A,A01,518829,Staff,51,0,60,9
1713338413237,COGS 14B,A01,489177,Hoffman; Drew Ellen,62,0,75,13
1713338414264,COGS 100,A01,489181,Allen; Michael Gordon,62,0,75,13
1713338415292,COGS 101A,A01,489183,Staff,45,0,60,15
1713338416322,COGS 101B,A01,489185,Allen; Michael Gordon,6,0,30,24
1713338417358,COGS 101C,A01,526786,Staff,23,0,30,7
1713338419416,COGS 107A,A01,489189,Boyle; Mary E. T.,16,0,35,19
1713338420445,COGS 107B,A01,627144,Mooshagian; Eric Frederick,60,0,60,0
1713338421472,COGS 118A,A01,489191,Staff,0,46,40,40
1713338423526,COGS 171GS,A01,489194,Pineda; Jaime A,19,0,28,9
1713338424552,COGS 172,A01,489196,Staff,2,0,30,28
1713338425581,COGS 174GS,A01,489264,Pineda; Jaime A,19,0,28,9
1713338426613,COGS 180,A01,627150,Staff,28,0,30,2
1713338427641,COGS 186,A01,489274,Staff,0,2,30,30
1713338428673,COMM 10,A01,489276,Staff,23,0,25,2
1713338428673,COMM 10,A02,489303,Staff,23,0,25,2
1713338429753,COMM 100A,A01,489312,Staff,14,0,25,11
1713338429753,COMM 100A,A02,489313,Staff,24,0,25,1
1713338430785,COMM 106T,A00,512540,Staff,33,0,35,2
1713338431814,COMM 107,A00,489347,Staff,27,0,35,8
1713338432840,COMM 109P,A00,489358,Staff,31,0,35,4
1713338433867,COMM 132,A00,489361,McKenna; Denise,27,0,30,3
1713338434899,COMM 146,A00,489362,Halm; Gavin Patrick,26,0,30,4
1713338435925,COMM 190,A00,489363,Abuelhiga; Soraya Jill,17,0,23,6
1713338436952,CSE 8A,A50,489366,Staff,21,0,25,4
1713338436952,CSE 8A,A51,489367,Staff,24,0,25,1
1713338437981,CSE 11,A01,489398,Cao; Yingjun,73,0,100,27
1713338439015,CSE 12,A01,489487,Staff,43,0,50,7
1713338440043,CSE 20,A01,489497,Staff,47,0,50,3
1713338441069,CSE 21,A01,489517,Braun; Oliver,42,0,50,8
1713338442100,CSE 101,A01,489524,Braun; Oliver,0,33,50,50
1713338443125,CSE 105,A01,512594,Jones; Miles E,72,0,100,28
1713338443125,CSE 105,B01,512598,Jones; Miles E,52,0,100,48
1713338444157,CSE 140,A01,489538,Staff,41,0,50,9
1713338445185,CSE 141,A01,489550,Eldon; John,67,0,100,33
1713338446212,CSE 141L,A01,489571,Eldon; John,65,0,100,35
1713338447243,CSE 151A,A01,489583,Solares; Edwin A,140,0,200,60
1713338448266,CSE 175,A01,510886,Kumar; Rakesh,30,0,30,0
1713338449297,CSE 190,A00,516828,Dubnov; Shlomo,37,0,49,12
1713338450323,DOC 100D,A00,489667,Pass; Natalye Joann,19,0,25,6
1713338451352,DSC 10,A01,624268,Staff,72,0,75,3
1713338452377,DSC 20,A01,624476,Staff,50,0,50,0
1713338453407,DSC 40A,A01,624608,Staff,39,0,40,1
1713338454441,DSGN 1,A01,489179,Rill; Bryan,32,0,50,18
1713338455467,ECE 17,A01,490489,Sahay; Rajeev,18,0,30,12
1713338456498,ECE 65,A50,490492,Staff,11,0,20,9
1713338456498,ECE 65,A51,490493,Staff,18,0,20,2
1713338457524,ECON 1,A01,489715,Famulari; Melissa,67,0,70,3
1713338458554,ECON 2,A01,489717,Levkoff; Steven B.,67,0,70,3
1713338459580,ECON 3,A01,489948,Staff,70,0,70,0
1713338461644,ECON 5,A01,490103,Staff,27,0,30,3
1713338461644,ECON 5,B01,626281,Dai; Yinlin,45,0,45,0
1713338462670,ECON 100A,A01,490127,Famulari; Melissa,63,0,70,7
1713338463700,ECON 100B,A01,490129,Staff,64,0,70,6
1713338464726,ECON 109,A01,490187,Shishkin; Denis,27,0,35,8
1713338465757,ECON 110A,A01,490190,Levkoff; Steven B.,59,0,70,11
1713338466787,ECON 120A,A01,490245,Dai; Yinlin,60,0,70,10
1713338467819,ECON 120B,A01,490247,Nieto-Barthaburu; Augusto,40,0,70,30
1713338468853,ECON 120C,A01,490253,Sun; Yixiao,30,0,35,5
1713338468853,ECON 120C,B01,490255,Sun; Yixiao,34,0,35,1
1713338469880,ECON 129,A00,490256,Eckert; Fabian Paul,22,0,35,13
1713338470906,ECON 131,A00,490257,Nieto-Barthaburu; Augusto,0,6,35,35
1713338471933,ECON 138,A00,490258,Bharadwaj; Prashant,13,0,35,22
1713338471933,ECON 138,B00,490259,Bharadwaj; Prashant,15,0,35,20
1713338472966,ECON 159,A00,490260,Hendrickson; Gerald M.,0,9,0,0
1713338474008,ECON 178,A01,553995,Zhu; Ying,24,0,35,11
1713338475035,EDS 40,A01,512576,Black; Alison Michelle,20,0,20,0
1713338476064,EDS 107,A01,515848,Staff,30,0,30,0
1713338477096,EDS 110R,A01,490262,Staff,26,0,30,4
1713338478121,EDS 112,A01,490264,Chapman; Thandeka K,40,0,50,10
1713338479152,EDS 113,A00,490266,Staff,25,0,30,5
1713338480187,EDS 118,A00,490267,Warstadt; Melissa Fawn,18,0,30,12
1713338481223,EDS 124BR,A00,490268,Eguchi; Emi,4,0,25,21
1713338481223,EDS 124BR,B00,490269,Eguchi; Emi,23,0,25,2
1713338482252,EDS 126,A01,490271,Jones; Makeba,43,0,50,7
1713338483280,EDS 135,A01,490316,Staff,19,0,20,1
1713338484306,ENVR 142GS,A00,519514,Chang; Edmond Yi-Teh,26,0,28,2
1713338485332,ETHN 103,A00,490504,Staff,25,0,36,11
1713338486365,ETHN 103A,A00,490505,Man; Simeon S,3,0,9,6
1713338487391,ETHN 109,A00,490506,Staff,28,0,30,2
1713338488416,ETHN 118,A00,490507,Staff,35,0,36,1
1713338489453,ETHN 119,A00,490508,Staff,32,0,36,4
1713338490478,ETHN 121R,A00,490518,Choi; Esther Min,21,0,36,15
1713338491505,ETHN 127,A00,490528,Staff,14,0,15,1
1713338492531,ETHN 139,A00,490573,Staff,10,0,10,0
1713338493555,ETHN 150,A00,490575,Staff,15,0,15,0
1713338494587,GLBH 20,A00,491705,Elwardani; Nile Regina,38,0,40,2
1713338495613,GLBH 101,A00,491706,Staff,20,0,20,0
1713338496646,GLBH 111,A01,491708,Burgos; Jose L.,15,0,15,0
1713338497672,GLBH 146,A00,491709,Staff,9,0,20,11
1713338498698,GLBH 148,A00,491710,Olivas Hernandez; Olga Lid,11,0,20,9
1713338499732,GLBH 150,A00,491711,Sloane; Julia Kathryn,19,0,20,1
1713338500759,HIEA 131,A00,491760,Staff,28,0,32,4
1713338501784,HIEA 153,A00,491762,Staff,28,0,30,2
1713338502816,HIEU 124,A00,491811,Staff,26,0,32,6
1713338503850,HIEU 124GS,A00,491812,Markman; Kristina,27,0,28,1
1713338504881,HIEU 147,A00,491813,Staff,30,0,32,2
1713338505908,HIEU 149GS,A00,491816,Caldwell; Michael Alan,28,0,28,0
1713338506935,HILD 2C,A01,491713,Hendrickson; Gerald M.,26,0,30,4
1713338507960,HILD 7B,A01,491715,Kwak; Nancy,0,2,30,30
1713338508986,HILD 10,A01,491717,Staff,9,0,20,11
1713338510021,HILD 30GS,A00,491719,Edington; Claire Ellen,23,0,28,5
1713338511056,HINE 109,A00,491818,Shafir; Nir,27,0,32,5
1713338512093,HINE 128,A00,491821,Shafir; Nir,30,0,32,2
1713338513121,HISC 117,A00,491830,Staff,27,0,32,5
1713338514150,HIUS 103,A00,491834,Man; Simeon S,14,0,23,9
1713338515179,HIUS 108B,A00,491835,Staff,27,0,30,3
1713338516211,HIUS 141,A00,491836,Hendrickson; Gerald M.,28,0,32,4
1713338517247,HIUS 149,A00,491839,Staff,24,0,32,8
1713338518286,HUM 3,A01,512617,Crum; Matthew Stephen,42,0,50,8
1713338518286,HUM 3,A02,512618,Crum; Matthew Stephen,48,0,50,2
1713338519325,HUM 3GS,A00,512663,Markman; Kristina,0,0,0,1
1713338519325,HUM 3GS,B00,512664,Staff,0,0,0,0
1713338520360,HUM 4,A01,512620,West; Geoffrey Scott,25,0,50,25
1713338521387,HUM 4GS,A00,512666,Lyon; Antony J.,0,0,0,5
1713338522416,HUM 4R,A01,512625,Watkins; Eric,49,0,50,1
1713338523455,HUM 5,A01,512649,Zavodny; Tatiana Sophia,20,0,50,30
1713338523455,HUM 5,B01,512661,Zroka; Ryan Edward,48,0,50,2
1713338524480,INTL 190,A00,490577,Segui; Alan S,0,0,0,5
1713338525509,JAPN 20AR,A01,491267,Ross; Kayoko F,7,0,20,13
1713338526542,JAPN 180,A00,491285,Berman; Michael David,33,0,40,7
1713338527572,LATI 50,A01,502536,Kokinis; Troy Andreas,16,0,22,6
1713338527572,LATI 50,A02,502551,Kokinis; Troy Andreas,22,0,22,0
1713338527572,LATI 50,A03,502650,Kokinis; Troy Andreas,22,0,22,0
1713338527572,LATI 50,A04,502909,Kokinis; Troy Andreas,21,0,22,1
1713338528598,LATI 160,A01,502920,Kokinis; Troy Andreas,30,0,30,0
1713338529624,LIFR 1A,A00,490494,Van Moer; Vinciane G,17,0,20,3
1713338530660,LIFR 1AX,A00,490495,Van Moer; Vinciane G,17,0,20,3
1713338531688,LIFR 1B,A00,490496,Van Moer; Vinciane G,17,0,20,3
1713338532728,LIFR 1BX,A00,490497,Van Moer; Vinciane G,17,0,20,3
1713338533828,LIGN 8,A00,505198,McIntosh; Justin Daniel,134,0,150,16
1713338534852,LIGN 9GS,A00,491239,Lott; Margaret S.,18,0,20,2
1713338535883,LIGN 101,A01,505200,McIntosh; Justin Daniel,22,0,30,8
1713338536917,LIGN 120,A01,491244,Staff,22,0,30,8
1713338537943,LIGN 149GS,A00,491245,Lott; Margaret S.,18,0,20,2
1713338538973,LIGN 170,A00,491247,Staff,22,0,30,8
1713338540010,LISP 1D,A00,490498,Munoz Sanchez; Alicia,8,0,14,6
1713338540010,LISP 1D,B00,490499,Munoz Sanchez; Alicia,4,0,14,10
1713338540010,LISP 1D,C00,490500,Munoz Sanchez; Alicia,7,0,14,7
1713338540010,LISP 1D,D00,490501,Munoz Sanchez; Alicia,10,0,14,4
1713338541046,LISP 1DX,A00,490502,Munoz Sanchez; Alicia,11,0,28,17
1713338541046,LISP 1DX,B00,490503,Munoz Sanchez; Alicia,16,0,28,12
1713338543109,LTAM 110,A00,491847,Staff,22,0,25,3
1713338544139,LTCS 119,A00,491848,Staff,11,0,15,4
1713338545170,LTCS 130,A00,491849,Staff,24,0,25,1
1713338547225,LTEA 120C,A00,491852,Staff,32,0,40,8
1713338548255,LTEN 130GS,A00,491853,Lyon; Antony J.,23,0,28,5
1713338549286,LTEN 148,A00,491855,Staff,23,0,25,2
1713338550313,LTEN 159,A00,491856,Staff,20,0,25,5
1713338551338,LTEN 180,A00,491857,Staff,8,0,15,7
1713338553390,LTSP 123GS,A00,505928,Bessett; Ryan Matthew,24,0,28,4
1713338554419,LTSP 174GS,A00,506037,Bessett; Ryan Matthew,24,0,28,4
1713338556474,LTWR 102,A00,491861,Staff,9,0,15,6
1713338557499,LTWR 106,A00,491862,Staff,8,0,15,7
1713338558537,MAE 11,A00,490930,Bahadori; Mohammad Yousef,95,0,100,5
1713338559569,MAE 30A,A00,490931,Qi; Huihui,37,0,40,3
1713338560598,MAE 101A,A00,491036,Sadeghizadeh; Zahra,92,0,100,8
1713338561627,MAE 101C,A00,491037,Seshadri; Kalyanasundaram,63,0,100,37
1713338562659,MAE 113,A00,491040,Seshadri; Kalyanasundaram,64,0,80,16
1713338563687,MAE 131A,A00,491041,Ghazinejad; Maziar,37,0,40,3
1713338564715,MAE 142,A00,491053,Staff,39,0,40,1
1713338565743,MAE 143A,A00,491054,Staff,30,0,50,20
1713338566769,MAE 150,A00,491092,Truong; Phuong Thi Ngoc,23,0,35,12
1713338567804,MATH 3C,A01,494031,Pardo Guerra; Sebastian,30,0,30,0
1713338567804,MATH 3C,A02,494032,Pardo Guerra; Sebastian,29,0,30,1
1713338568832,MATH 10A,A01,494034,Staff,27,0,30,3
1713338568832,MATH 10A,A02,494035,Staff,28,0,30,2
1713338568832,MATH 10A,B01,494037,Staff,27,0,30,3
1713338568832,MATH 10A,B02,494038,Staff,29,0,30,1
1713338569863,MATH 10B,A01,494040,Habib; Yousaf,22,0,30,8
1713338569863,MATH 10B,A02,494041,Habib; Yousaf,28,0,30,2
1713338569863,MATH 10B,A03,494042,Habib; Yousaf,29,0,30,1
1713338569863,MATH 10B,A04,494043,Habib; Yousaf,30,0,30,0
1713338569863,MATH 10B,B01,494045,Habib; Yousaf,25,0,30,5
1713338569863,MATH 10B,B02,494046,Habib; Yousaf,30,0,30,0
1713338569863,MATH 10B,B03,494047,Habib; Yousaf,30,0,30,0
1713338569863,MATH 10B,B04,494048,Habib; Yousaf,30,0,30,0
1713338570891,MATH 18,A01,494050,Kemp; Todd Aahron,25,0,30,5
1713338570891,MATH 18,A02,494051,Kemp; Todd Aahron,29,0,30,1
1713338570891,MATH 18,B01,494054,Kemp; Todd Aahron,25,0,30,5
1713338570891,MATH 18,B02,494055,Kemp; Todd Aahron,29,0,30,1
1713338571945,MATH 20A,A01,494059,Suk; Andrew Hoon,30,0,30,0
1713338572973,MATH 20B,A01,494061,Briones; Jor-el Thomas Caparas,33,0,35,2
1713338572973,MATH 20B,B01,494063,Bach; Quang Tran,34,0,35,1
1713338574003,MATH 20C,A01,494065,Staff,28,0,30,2
1713338574003,MATH 20C,A02,494066,Staff,30,0,30,0
1713338574003,MATH 20C,A03,494067,Staff,30,0,30,0
1713338574003,MATH 20C,A04,494068,Staff,30,0,30,0
1713338574003,MATH 20C,B01,494070,Zhang; Ming,24,0,30,6
1713338574003,MATH 20C,B02,494071,Zhang; Ming,27,0,30,3
1713338574003,MATH 20C,B03,494072,Zhang; Ming,29,0,30,1
1713338574003,MATH 20C,B04,494073,Zhang; Ming,29,0,30,1
1713338575029,MATH 20D,A01,494075,Staff,22,0,30,8
1713338575029,MATH 20D,A02,494076,Staff,29,0,30,1
1713338576060,MATH 20E,A01,494079,Staff,24,0,30,6
1713338576060,MATH 20E,A02,494080,Staff,26,0,30,4
1713338576060,MATH 20E,B01,494082,Staff,25,0,30,5
1713338576060,MATH 20E,B02,494083,Staff,25,0,30,5
1713338577089,MATH 103A,A01,494085,Aliabadi Sr.; Mohsen,12,0,30,18
1713338577089,MATH 103A,A02,494086,Aliabadi Sr.; Mohsen,28,0,30,2
1713338577089,MATH 103A,B01,494088,Aliabadi Sr.; Mohsen,20,0,30,10
1713338577089,MATH 103A,B02,494089,Aliabadi Sr.; Mohsen,27,0,30,3
1713338578116,MATH 109,A01,494091,Staff,30,0,30,0
1713338578116,MATH 109,A02,494092,Staff,29,0,30,1
1713338578116,MATH 109,B01,494094,Staff,27,0,30,3
1713338578116,MATH 109,B02,494095,Staff,29,0,30,1
1713338579145,MATH 142A,A01,494097,Chow; Bennett,13,0,30,17
1713338579145,MATH 142A,A02,494098,Chow; Bennett,23,0,30,7
1713338579145,MATH 142A,B01,494100,Chow; Bennett,19,0,30,11
1713338579145,MATH 142A,B02,494101,Chow; Bennett,29,0,30,1
1713338581198,MATH 168A,A01,516677,Dumitriu; Ioana,16,0,35,19
1713338582232,MATH 170A,A01,516679,Dumitriu; Ioana,18,0,30,12
1713338582232,MATH 170A,A02,516680,Dumitriu; Ioana,28,0,30,2
1713338583262,MATH 193A,A01,494107,Staff,12,0,30,18
1713338583262,MATH 193A,A02,494108,Staff,18,0,30,12
1713338583262,MATH 193A,A03,494109,Staff,29,0,30,1
1713338583262,MATH 193A,A04,494110,Staff,22,0,30,8
1713338586339,MGT 16,A00,491930,McKay; Michael J,92,0,98,6
1713338587369,MGT 18,A00,491992,McKay; Michael J,96,0,98,2
1713338588397,MGT 71,A00,492003,Staff,63,0,98,35
1713338589424,MGT 103,A00,505209,Eberhard; Craig A,80,0,98,18
1713338590451,MGT 131A,A00,505210,Anderson; John Charles,89,0,98,9
1713338592508,MGT 153,A00,492077,Perols; Johan Lars,16,0,90,74
1713338595589,MGT 164,A00,492222,McKay; Mary A,91,0,98,7
1713338596616,MGT 172,A00,492245,Staff,59,0,60,1
1713338596616,MGT 172,B00,505526,Hedges; Kathleen,65,0,98,33
1713338597672,MGT 181,A00,505669,Dunn; Louis Jean,78,0,98,20
1713338598702,MMW 14,A01,494399,Staff,15,0,28,13
1713338598702,MMW 14,A02,494400,Staff,25,0,28,3
1713338598702,MMW 14,A03,494401,Staff,28,0,28,0
1713338598702,MMW 14,A04,494402,Staff,28,0,28,0
1713338598702,MMW 14,B01,494404,Carreras; Maria Victoria,8,0,28,20
1713338598702,MMW 14,B02,494405,Carreras; Maria Victoria,25,0,28,3
1713338598702,MMW 14,B03,494406,Carreras; Maria Victoria,27,0,28,1
1713338598702,MMW 14,B04,494407,Carreras; Maria Victoria,28,0,28,0
1713338599730,MMW 14GS,A00,506250,Chang; Edmond Yi-Teh,0,0,0,0
1713338600765,MMW 121R,A01,494415,Adamiak; Patrick John,10,0,28,18
1713338600765,MMW 121R,A02,494416,Adamiak; Patrick John,24,0,28,4
1713338601792,MUS 1A,A01,494113,Staff,12,0,25,13
1713338601792,MUS 1A,A02,494114,Staff,24,0,25,1
1713338602817,MUS 4,A01,494116,Staff,23,0,25,2
1713338602817,MUS 4,A02,494117,Staff,22,0,25,3
1713338603849,MUS 5R,A01,494236,Dubnov; Shlomo,4,0,25,21
1713338603849,MUS 5R,A02,494237,Dubnov; Shlomo,25,0,25,0
1713338604875,MUS 6,A01,494122,Staff,9,0,25,16
1713338604875,MUS 6,A02,494123,Staff,23,0,25,2
1713338605915,MUS 7,A01,494125,Staff,16,0,25,9
1713338605915,MUS 7,A02,494126,Staff,24,0,25,1
1713338606950,MUS 11,A01,494128,Staff,23,0,25,2
1713338606950,MUS 11,A02,494129,Staff,24,0,25,1
1713338607979,MUS 13,A01,494131,Staff,25,0,25,0
1713338607979,MUS 13,A02,494132,Staff,25,0,25,0
1713338609011,MUS 15,A01,494134,Staff,16,0,25,9
1713338609011,MUS 15,A02,494135,Staff,25,0,25,0
1713338609011,MUS 15,B01,494137,Staff,24,0,25,1
1713338610051,MUS 80,A00,494232,Staff,24,0,25,1
1713338610051,MUS 80,B00,494233,Staff,25,0,25,0
1713338610051,MUS 80,C00,494234,Staff,23,0,25,2
1713338611078,MUS 95C,A00,494141,Staff,69,0,75,6
1713338612110,MUS 114,A00,494142,Staff,39,0,50,11
1713338613142,NANO 15,A01,490636,Drews; Aaron,7,0,7,0
1713338614185,PHIL 1,A00,490578,Grush; Rick Scott,49,0,50,1
1713338615219,PHIL 10,A01,490580,Grush; Rick Scott,33,0,35,2
1713338615219,PHIL 10,A02,490586,Grush; Rick Scott,32,0,35,3
1713338616248,PHIL 27,A01,490591,Staff,22,0,25,3
1713338616248,PHIL 27,A02,490592,Staff,25,0,25,0
1713338616248,PHIL 27,A03,490593,Staff,25,0,25,0
1713338616248,PHIL 27,A04,490598,Staff,25,0,25,0
1713338617281,PHIL 32,A01,490611,Staff,20,0,20,0
1713338617281,PHIL 32,A02,490618,Staff,20,0,20,0
1713338618306,PHIL 90,A00,490624,Staff,40,0,40,0
1713338619331,PHIL 136,A00,490627,Cohen; Jonathan David,37,0,40,3
1713338620359,PHIL 155,A00,490634,Staff,62,0,70,8
1713338621396,PHYS 1A,A00,491610,Staff,245,0,250,5
1713338622425,PHYS 1AL,001,491616,Tsai; Philbert S,27,0,30,3
1713338622425,PHYS 1AL,002,491618,Tsai; Philbert S,30,0,30,0
1713338623450,PHYS 1B,A00,491623,Staff,235,0,250,15
1713338624476,PHYS 1BL,001,491626,Tsai; Philbert S,19,0,30,11
1713338624476,PHYS 1BL,002,491628,Tsai; Philbert S,26,0,30,4
1713338625501,PHYS 1C,A00,491632,Staff,212,0,245,33
1713338626526,PHYS 1CL,001,491635,Tsai; Philbert S,3,0,30,27
1713338626526,PHYS 1CL,002,491643,Tsai; Philbert S,22,0,30,8
1713338627554,PHYS 2AR,A01,491651,Meyertholen; Andrew D.,44,0,50,6
1713338628586,PHYS 2B,A01,491659,Staff,105,0,115,10
1713338629613,PHYS 2BL,A01,491685,Staff,21,0,24,3
1713338629613,PHYS 2BL,A02,491700,Staff,21,0,24,3
1713338630640,PHYS 2C,A01,505161,Staff,101,0,115,14
1713338631671,PHYS 4A,A01,491704,Grinstein; Benjamin,99,0,100,1
1713338632697,POLI 5D,A01,494144,Staff,3,0,5,2
1713338632697,POLI 5D,B01,626283,Dai; Yinlin,5,0,5,0
1713338633726,POLI 12,A00,494145,Staff,43,0,45,2
1713338634765,POLI 13R,A00,494146,Forman; Fonna,45,0,50,5
1713338635790,POLI 27,A01,494148,Staff,54,0,60,6
1713338636821,POLI 30,A00,494149,Staff,49,0,50,1
1713338637900,POLI 100DA,A00,494150,Staff,20,0,25,5
1713338639957,POLI 100I,A00,494152,Staff,27,0,30,3
1713338640982,POLI 104B,A00,494153,Smith; Glenn Chatmas,53,0,55,2
1713338642008,POLI 104F,A00,494154,Staff,28,0,30,2
1713338643049,POLI 104I,A00,494155,Smith; Glenn Chatmas,29,0,30,1
1713338644076,POLI 110C,A00,494156,Ingham; Sean,23,0,25,2
1713338645108,POLI 117R,A00,494157,Forman; Fonna,5,0,20,15
1713338646139,POLI 118,A00,494158,Ingham; Sean,21,0,25,4
1713338647166,POLI 120H,A00,494159,Fisk; David Lee,39,0,45,6
1713338648199,POLI 131CR,A00,494160,Hoston; Germaine,35,0,45,10
1713338649225,POLI 133J,A00,494161,Staff,31,0,35,4
1713338650251,POLI 135,A00,494162,Fisk; David Lee,33,0,35,2
1713338651285,POLI 140A,A00,494164,Staff,18,0,30,12
1713338652311,POLI 142I,A00,494165,Staff,30,0,30,0
1713338653337,POLI 144D,A00,494166,Staff,22,0,25,3
1713338654363,POLI 151,A00,494167,Staff,30,0,30,0
1713338655393,POLI 153,A00,494168,Staff,33,0,35,2
1713338656417,POLI 160AA,A00,494169,Staff,33,0,40,7
1713338657444,POLI 162,A00,494170,Mignozzetti; Umberto,18,0,25,7
1713338658469,POLI 171,A00,494171,Mignozzetti; Umberto,18,0,25,7
1713338659497,PSYC 1,A00,494172,Staff,95,0,100,5
1713338660522,PSYC 2,A00,494173,Moranton; Nirelia Melbina-,34,0,50,16
1713338661550,PSYC 3,A00,494174,Staff,29,0,30,1
1713338662581,PSYC 6,A00,494175,Staff,17,0,20,3
1713338663609,PSYC 60,A01,494177,Staff,37,0,45,8
1713338664637,PSYC 70,A01,505724,Geller; Emma Harlan,42,0,45,3
1713338665664,PSYC 101,A00,494180,Heyman; Gail D.,84,0,100,16
1713338666690,PSYC 105,A00,494181,Geller; Emma Harlan,51,0,90,39
1713338667718,PSYC 106,A00,494182,Dobkins; Karen R.,26,0,45,19
1713338668745,PSYC 108,A00,494183,Adrian; Julia Anna,89,0,100,11
1713338669773,PSYC 114,A01,494185,Winkielman; Piotr,0,3,30,30
1713338670801,PSYC 122,A00,494186,Moranton; Nirelia Melbina-,27,0,50,23
1713338671838,PSYC 124,A00,494187,Chapman; Eddie Nathaniel,69,0,80,11
1713338672866,PSYC 131,A00,494188,Anagnostaras; Stephan,40,0,80,40
1713338673907,PSYC 144,A00,494189,Staff,1,0,50,49
1713338674933,PSYC 154,A00,494190,Lacefield; Katharine I,105,0,180,75
1713338675960,PSYC 162,A00,494191,Wixted; John T,70,0,100,30
1713338676985,PSYC 172,A00,494192,Gorman; Michael R.,36,0,45,9
1713338678012,PSYC 178,A00,494193,Glaser; Dale,34,0,45,11
1713338679042,PSYC 193,A00,505725,Chapman; Eddie Nathaniel,20,0,20,0
1713338680075,RELI 145GS,A00,519817,Rahimi; Babak,17,0,20,3
1713338681103,SE 101A,A01,490862,Chadha; Mayank,23,0,25,2
1713338682153,SE 101C,A01,490924,Krysl; Petr,15,0,20,5
1713338683179,SE 110A,A01,490928,Staff,19,0,20,1
1713338684206,SE 130A,A00,490929,Morrison; Machel Leigh,54,0,70,16
1713338685251,SIO 1,A01,519325,Staff,39,0,40,1
1713338686282,SIO 30,A01,519327,Staff,38,0,40,2
1713338687311,SIO 40,A00,519328,Staff,39,0,40,1
1713338688337,SIO 46GS,A00,519819,Cook; Geoffrey W,17,0,25,8
1713338689366,SIO 109R,A00,494197,Forman; Fonna,0,3,20,20
1713338690393,SIO 121GS,A00,519827,Cook; Geoffrey W,17,0,25,8
1713338691477,SIO 132,A01,519330,Staff,38,0,40,2
1713338692505,SIO 133,A01,519397,Staff,37,0,40,3
1713338693536,SIO 139,A00,519396,Kacev; David,29,0,40,11
1713338694596,SOCI 1,A01,494199,Thorpe; Charles Robert,21,0,30,9
1713338694596,SOCI 1,A02,494200,Thorpe; Charles Robert,30,0,30,0
1713338694596,SOCI 1,A03,494201,Thorpe; Charles Robert,29,0,30,1
1713338694596,SOCI 1,A04,494202,Thorpe; Charles Robert,29,0,30,1
1713338694596,SOCI 1,A05,494203,Thorpe; Charles Robert,29,0,30,1
1713338694596,SOCI 1,A06,494204,Thorpe; Charles Robert,30,0,30,0
1713338694596,SOCI 1,A07,494205,Thorpe; Charles Robert,28,0,30,2
1713338695623,SOCI 60,A01,494207,Staff,33,0,40,7
1713338695623,SOCI 60,A02,494208,Staff,39,0,40,1
1713338696650,SOCI 100,A01,494210,Payne; Christine Anna,25,0,30,5
1713338696650,SOCI 100,A02,494211,Payne; Christine Anna,26,0,30,4
1713338697706,SOCI 109M,A00,494212,Staff,20,0,20,0
1713338698738,SOCI 110,A00,494213,Staff,34,0,40,6
1713338700793,SOCI 118E,A00,494215,Ng; Kwai,37,0,40,3
1713338701823,SOCI 125,A00,494216,Calderon-Zaks; Michael Aar,39,0,45,6
1713338702850,SOCI 126,A01,494218,Jones; Makeba,3,0,5,2
1713338703912,SOCI 131,A00,494219,Thorpe; Charles Robert,26,0,30,4
1713338705987,SOCI 135,A00,494221,Payne; Christine Anna,28,0,50,22
1713338707016,SOCI 136E,A00,626690,Ruiz; Jonathan Joseph,24,0,25,1
1713338708041,SOCI 138GS,A00,494222,Navon; Daniel,23,0,28,5
1713338710099,SOCI 145,A00,494224,Staff,40,0,45,5
1713338711125,SOCI 153,A00,494225,Staff,28,0,30,2
1713338712155,SOCI 160E,A00,494226,Ng; Kwai,27,0,40,13
1713338713183,SOCI 180,A00,494227,Staff,29,0,30,1
1713338714213,SOCI 189GS,A00,494228,Ribas Norris; Janet Vanesa,11,0,11,0
1713338715242,SOCI 190GS,A00,553232,Ribas Norris; Janet Vanesa,11,0,11,0
1713338716276,SOMI 220,A00,627178,Schneid; Stephen David,30,0,30,0
1713338717304,SYN 2,001,490768,Staff,13,0,15,2
1713338717304,SYN 2,002,490769,Staff,14,0,15,1
1713338717304,SYN 2,004,490775,Staff,0,0,0,0
1713338717304,SYN 2,003,490774,Staff,0,0,0,0
1713338717304,SYN 2,005,490776,Staff,0,0,0,0
1713338718332,SYN 2R,001,490779,Staff,11,0,15,4
1713338718332,SYN 2R,002,514635,Staff,14,0,15,1
1713338719361,SYN 100,A01,490783,Staff,8,0,20,12
1713338719361,SYN 100,B01,490787,Staff,10,0,20,10
1713338719361,SYN 100,C01,490789,Staff,10,0,20,10
1713338720387,SYN 150,A00,490817,Staff,14,0,15,1
1713338720387,SYN 150,B00,514610,Staff,15,0,15,0
1713338721423,TDAC 1,A00,492753,Walsh; Kim C.,19,0,20,1
1713338721423,TDAC 1,B00,492754,Harting; Carla Kelso,18,0,20,2
1713338721423,TDAC 1,C00,513995,Salovey; Todd,15,0,20,5
1713338722456,TDAC 101,A00,492766,Harting; Carla Kelso,17,0,20,3
1713338723489,TDAC 102,A00,492768,Basso; Beatrice,19,0,20,1
1713338724521,TDDE 111,A00,492769,Staff,25,0,25,0
1713338725547,TDDE 131,A00,492770,Staff,15,0,15,0
1713338725547,TDDE 131,B00,492771,Staff,15,0,15,0
1713338726578,TDDE 131GS,A00,523716,Guirguis; Mark C,23,0,28,5
1713338727613,TDGE 1,A01,492756,Salovey; Todd,56,0,60,4
1713338728639,TDGE 5,A01,492758,Staff,23,0,25,2
1713338729665,TDGE 10,A00,492759,Fulton; Julia,203,0,220,17
1713338730697,TDGE 11,A00,492760,Castro; Robert Jess,198,0,200,2
1713338732747,TDGE 124,A00,492772,Fulton; Julia,181,0,220,39
1713338733775,TDGE 125,A00,492773,Meyer; Ursula,38,0,50,12
1713338733775,TDGE 125,B00,492774,Staff,49,0,50,1
1713338733775,TDGE 125,C00,523565,Staff,48,0,50,2
1713338734807,TDGE 125GS,A00,523580,Guirguis; Mark C,23,0,28,5
1713338735836,TDGE 127,A00,492775,Havis; Allan,32,0,50,18
1713338736860,TDHT 101,A00,492776,Staff,34,0,35,1
1713338737889,TDMV 1,A00,492762,Caligagan; Maria T.,29,0,30,1
1713338737889,TDMV 1,B00,492763,Arcidiacono; Kristin,26,0,30,4
1713338738932,TDMV 2,A00,492764,Weinberg; Sadie,27,0,30,3
1713338739958,TDMV 3,A00,492765,Mack; Kara Shanai',37,0,40,3
1713338740986,TDMV 138,A00,492777,Mack; Kara Shanai',32,0,40,8
1713338742073,TDMV 140,A00,492778,Lima; Paulo Henrique,40,0,40,0
1713338743101,TDMV 142,A00,492779,Caligagan; Maria T.,33,0,40,7
1713338743101,TDMV 142,B00,492780,Caligagan; Tony,37,0,40,3
1713338744135,TDMV 143,A00,492781,Fyall; Daunte Edward,39,0,40,1
1713338745162,USP 1,A01,492401,Kwak; Nancy,27,0,35,8
1713338746201,USP 2,A01,492453,Hinds; Juli Beth,35,0,35,0
1713338747226,USP 3,A01,492516,Staff,28,0,35,7
1713338748262,USP 4,A00,492522,McTague; Sarah,16,0,25,9
1713338749290,USP 100,A00,492523,Staff,32,0,35,3
1713338750316,USP 101,A00,492524,Staff,13,0,15,2
1713338751342,USP 105,A00,492525,Staff,21,0,25,4
1713338752382,USP 151,A00,492526,Shenkman; Michael Thomas,32,0,35,3
1713338753409,USP 170,A00,492545,Hinds; Juli Beth,33,0,35,2
1713338754440,USP 171GS,A00,492608,Bussell; Mirle Rabinowitz,24,0,28,4
1713338755472,USP 183GS,A00,492613,Peerson; Susan,24,0,28,4
1713338756508,VIS 30,A01,490693,Yoldas; Pinar,19,0,22,3
1713338756508,VIS 30,A02,490694,Yoldas; Pinar,18,0,22,4
1713338757534,VIS 83,A00,490695,Kester; Grant,63,0,75,12
1713338758561,VIS 105D,A00,490696,Staff,22,0,25,3
1713338759591,VIS 124CN,A00,490699,Rose; Jordan M,64,0,75,11
1713338760620,VIS 125GS,A00,511221,Williams; Alena J,21,0,22,1
1713338761654,VIS 128D,A00,490700,Staff,73,0,75,2
1713338762683,VIS 151,A01,490717,Staff,33,0,34,1
1713338762683,VIS 151,A02,490766,Staff,33,0,34,1
1713338763708,VIS 154GS,A00,511972,Williams; Alena J,21,0,22,1
1713338764742,VIS 160A,A00,490767,Stone; Patricia,7,0,10,3
1713338765771,WCWP 10A,A00,490638,Staff,14,0,15,1
1713338765771,WCWP 10A,B00,490640,Staff,15,0,15,0
1713338766804,WCWP 10B,A00,490641,Staff,0,0,0,0
1713338766804,WCWP 10B,B00,490642,Staff,14,0,15,1
1713338766804,WCWP 10B,C00,490644,Staff,13,0,15,2
1713338766804,WCWP 10B,D00,490647,Staff,0,0,0,0
1713338767833,WCWP 100,A00,490655,Staff,0,0,0,0
1713338767833,WCWP 100,B00,490687,Staff,10,0,15,5
1713338769983,ANAR 153,A00,487222,Braswell; Geoffrey E.,53,0,60,7
1713338771013,ANBI 134,A00,487223,Staff,6,0,20,14
1713338772049,ANBI 143GS,A00,487224,Noel; Geoffroy Pierre Jean,18,0,24,6
1713338773081,ANBI 144GS,A00,519548,Noel; Geoffroy Pierre Jean,18,0,24,6
1713338774107,ANSC 101,A00,487225,Staff,17,0,20,3
1713338775138,ANSC 125,A00,487227,Brenner; Suzanne A,38,0,40,2
1713338777195,ANSC 146,A00,487229,Staff,35,0,40,5
1713338778222,ANSC 148,A00,487230,Olivas Hernandez; Olga Lid,39,0,40,1
1713338779254,ANSC 150,A00,504165,Sloane; Julia Kathryn,18,0,20,2
1713338780292,ANSC 180,A00,487232,Staff,14,0,15,1
1713338781317,ANSC 188,A00,627155,Staff,38,0,40,2
1713338782342,ANTH 5,A00,519529,Semendeferi; Ekaterini,15,0,15,0
1713338783368,ANTH 10,A00,487219,Staff,58,0,60,2
1713338784397,ANTH 23,A01,487221,Staff,17,0,20,3
1713338785422,ANTH 102,A00,487233,Wilder; Linnea Lorene,50,0,60,10
1713338786448,ANTH 103,A00,487234,Varma; Saiba,54,0,60,6
1713338787473,ANTH 105,A00,487235,Stewart; Alexander B,54,0,60,6
1713338788500,BENG 100,A01,516685,Taylor Amos; Alyssa C,25,0,30,5
1713338789527,BIBC 102,A01,491316,Flagg; Matthew Paul,6,0,88,82
1713338789527,BIBC 102,A02,491366,Flagg; Matthew Paul,78,0,88,10
1713338790554,BIBC 103,A01,491486,Boumechache; Miyyada,16,0,24,8
1713338790554,BIBC 103,A02,491487,Boumechache; Miyyada,24,0,24,0
1713338791583,BICD 100,A01,516882,Staff,73,0,75,2
1713338791583,BICD 100,A02,516890,Staff,69,0,75,6
1713338792612,BICD 102GS,A00,491488,Lo; Stanley M.,26,0,28,2
1713338793638,BIEB 136GS,A00,516940,Holway; David A. & Shurin; Jonathan,18,0,24,6
1713338794663,BIEB 137GS,A01,517034,Holway; David A. & Shurin; Jonathan,18,0,24,6
1713338795693,BIEB 138GS,A01,491492,Pirino; Giorgia,21,0,28,7
1713338796720,BILD 1,A01,491296,Staff,60,0,63,3
1713338796720,BILD 1,A02,491297,Staff,63,0,63,0
1713338797753,BILD 4,A01,517099,Gonzalez Gamboa; Ivonne,22,0,24,2
1713338797753,BILD 4,A02,517100,Gonzalez Gamboa; Ivonne,24,0,24,0
1713338798778,BILD 60GS,A00,491309,Lo; Stanley M.,26,0,28,2
1713338799811,BIMM 100,A01,517136,Staff,82,0,100,18
1713338800842,BIMM 110,A01,517182,Staff,53,0,100,47
1713338801870,BIMM 120,A01,517228,Pickett; Brooke Elizabeth,28,0,63,35
1713338801870,BIMM 120,A02,517240,Pickett; Brooke Elizabeth,44,0,63,19
1713338802896,BIMM 132GS,A01,491498,Pirino; Giorgia,21,0,28,7
1713338803933,BIMM 143,A01,491589,Bozinovic; Goran,12,0,40,28
1713338804960,BIPN 100,A01,491594,Armour; Jon Christopher,83,0,100,17
1713338805987,BIPN 140,A01,491602,Marino; Marc J,23,0,50,27
1713338808051,CAT 125,A00,515973,Staff,18,0,20,2
1713338809078,CAT 125GS,A00,515974,Rahimi; Babak,16,0,20,4
1713338810112,CAT 125R,A00,515980,Staff,12,0,20,8
1713338810112,CAT 125R,B00,515981,Tosun; Adriana,19,0,20,1
1713338810112,CAT 125R,C00,515987,Hyland; Tina Mae,0,5,20,20
1713338810112,CAT 125R,D00,515988,Bronstein; Phoebe Malan,16,0,20,4
1713338811144,CENG 15,A01,488699,Drews; Aaron,25,0,25,0
1713338812171,CENG 100,A00,505196,Opatkiewicz; Justin Paul,25,0,25,0
1713338813199,CGS 2A,A01,489598,Staff,33,0,35,2
1713338814230,CGS 112,A00,489599,Staff,15,0,15,0
1713338815258,CGS 119,A00,489603,Staff,10,0,10,0
1713338816285,CGS 120,A00,489604,Staff,13,0,15,2
1713338817318,CGS 150,A00,489607,Staff,15,0,15,0
1713338818354,CHEM 6A,A01,488715,Staff,97,0,100,3
1713338819390,CHEM 6B,A01,488719,Piercy; Marc Anthony,99,0,100,1
1713338820417,CHEM 6C,A01,488723,Albizati; Kim F.,93,0,100,7
1713338821446,CHEM 7L,A01,488728,Schurmeier; Kimberly,18,0,24,6
1713338821446,CHEM 7L,A02,488730,Schurmeier; Kimberly,23,0,24,1
1713338821446,CHEM 7L,A03,488734,Schurmeier; Kimberly,20,0,24,4
1713338821446,CHEM 7L,A04,488763,Schurmeier; Kimberly,23,0,24,1
1713338821446,CHEM 7L,B01,488798,Schurmeier; Kimberly,16,0,24,8
1713338821446,CHEM 7L,B02,488801,Schurmeier; Kimberly,22,0,24,2
1713338821446,CHEM 7L,B03,488808,Schurmeier; Kimberly,22,0,24,2
1713338821446,CHEM 7L,B04,488811,Schurmeier; Kimberly,24,0,24,0
1713338822473,CHEM 11,A01,488897,Stallings; Dontarie M,95,0,100,5
1713338823499,CHEM 40A,A01,488913,Albizati; Kim F.,83,0,100,17
1713338824534,CHEM 40B,A01,488920,Weizman; Haim,42,0,50,8
1713338824534,CHEM 40B,A02,488938,Weizman; Haim,43,0,50,7
1713338825562,CHEM 41A,A01,489029,Klosterman; Jeremy K,57,0,60,3
1713338826589,CHEM 41C,A01,500436,Tor; Yitzhak,55,0,60,5
1713338827618,CHEM 43A,A01,500426,Weizman; Haim,0,1,24,24
1713338827618,CHEM 43A,A02,500430,Weizman; Haim,5,0,24,19
1713338827618,CHEM 43A,B01,514041,Klosterman; Jeremy K,15,0,24,9
1713338827618,CHEM 43A,B02,514047,Klosterman; Jeremy K,23,0,24,1
1713338828651,CHEM 108,A01,489140,Jennings; Patricia A.,7,0,24,17
1713338828651,CHEM 108,A02,489142,Jennings; Patricia A.,14,0,24,10
1713338829678,CHEM 114A,A01,489147,Stallings; Dontarie M,65,0,100,35
1713338830704,CHIN 169A,A00,489171,Wang; Xiao,19,0,20,1
1713338832767,COGS 3,A01,518827,Boyle; Mary E. T.,25,0,40,15
1713338833795,COGS 11,A01,489175,Staff,27,0,30,3
1713338834832,COGS 14A,A01,518829,Staff,50,0,60,10
1713338835860,COGS 14B,A01,489177,Hoffman; Drew Ellen,62,0,75,13
1713338836890,COGS 100,A01,489181,Allen; Michael Gordon,62,0,75,13
1713338837917,COGS 101A,A01,489183,Staff,45,0,60,15
1713338838951,COGS 101B,A01,489185,Allen; Michael Gordon,6,0,30,24
1713338839979,COGS 101C,A01,526786,Staff,23,0,30,7
1713338842031,COGS 107A,A01,489189,Boyle; Mary E. T.,16,0,35,19
1713338843062,COGS 107B,A01,627144,Mooshagian; Eric Frederick,60,0,60,0
1713338844093,COGS 118A,A01,489191,Staff,0,46,40,40
1713338846205,COGS 171GS,A01,489194,Pineda; Jaime A,19,0,28,9
1713338847237,COGS 172,A01,489196,Staff,2,0,30,28
1713338848262,COGS 174GS,A01,489264,Pineda; Jaime A,19,0,28,9
1713338849296,COGS 180,A01,627150,Staff,28,0,30,2
1713338850322,COGS 186,A01,489274,Staff,0,2,30,30
1713338851347,COMM 10,A01,489276,Staff,23,0,25,2
1713338851347,COMM 10,A02,489303,Staff,23,0,25,2
1713338852376,COMM 100A,A01,489312,Staff,14,0,25,11
1713338852376,COMM 100A,A02,489313,Staff,24,0,25,1
1713338853403,COMM 106T,A00,512540,Staff,33,0,35,2
1713338854430,COMM 107,A00,489347,Staff,27,0,35,8
1713338855457,COMM 109P,A00,489358,Staff,31,0,35,4
1713338856489,COMM 132,A00,489361,McKenna; Denise,27,0,30,3
1713338857522,COMM 146,A00,489362,Halm; Gavin Patrick,26,0,30,4
1713338858554,COMM 190,A00,489363,Abuelhiga; Soraya Jill,17,0,23,6
1713338859587,CSE 8A,A50,489366,Staff,21,0,25,4
1713338859587,CSE 8A,A51,489367,Staff,24,0,25,1
1713338860623,CSE 11,A01,489398,Cao; Yingjun,73,0,100,27
1713338861651,CSE 12,A01,489487,Staff,43,0,50,7
1713338862678,CSE 20,A01,489497,Staff,47,0,50,3
1713338863709,CSE 21,A01,489517,Braun; Oliver,42,0,50,8
1713338864734,CSE 101,A01,489524,Braun; Oliver,0,33,50,50
1713338865767,CSE 105,A01,512594,Jones; Miles E,72,0,100,28
1713338865767,CSE 105,B01,512598,Jones; Miles E,52,0,100,48
1713338866794,CSE 140,A01,489538,Staff,41,0,50,9
1713338867823,CSE 141,A01,489550,Eldon; John,67,0,100,33
1713338868847,CSE 141L,A01,489571,Eldon; John,65,0,100,35
1713338869881,CSE 151A,A01,489583,Solares; Edwin A,140,0,200,60
1713338870907,CSE 175,A01,510886,Kumar; Rakesh,30,0,30,0
1713338871934,CSE 190,A00,516828,Dubnov; Shlomo,37,0,49,12
1713338872961,DOC 100D,A00,489667,Pass; Natalye Joann,19,0,25,6
1713338873994,DSC 10,A01,624268,Staff,72,0,75,3
1713338875018,DSC 20,A01,624476,Staff,50,0,50,0
1713338876044,DSC 40A,A01,624608,Staff,39,0,40,1
1713338877069,DSGN 1,A01,489179,Rill; Bryan,32,0,50,18
1713338878094,ECE 17,A01,490489,Sahay; Rajeev,18,0,30,12
1713338879121,ECE 65,A50,490492,Staff,11,0,20,9
1713338879121,ECE 65,A51,490493,Staff,18,0,20,2
1713338880147,ECON 1,A01,489715,Famulari; Melissa,67,0,70,3
1713338881176,ECON 2,A01,489717,Levkoff; Steven B.,67,0,70,3
1713338882201,ECON 3,A01,489948,Staff,70,0,70,0
1713338884253,ECON 5,A01,490103,Staff,27,0,30,3
1713338884253,ECON 5,B01,626281,Dai; Yinlin,45,0,45,0
1713338885280,ECON 100A,A01,490127,Famulari; Melissa,63,0,70,7
1713338886305,ECON 100B,A01,490129,Staff,64,0,70,6
1713338887335,ECON 109,A01,490187,Shishkin; Denis,27,0,35,8
1713338888364,ECON 110A,A01,490190,Levkoff; Steven B.,59,0,70,11
1713338889388,ECON 120A,A01,490245,Dai; Yinlin,60,0,70,10
1713338890419,ECON 120B,A01,490247,Nieto-Barthaburu; Augusto,40,0,70,30
1713338891445,ECON 120C,A01,490253,Sun; Yixiao,30,0,35,5
1713338891445,ECON 120C,B01,490255,Sun; Yixiao,34,0,35,1
1713338892472,ECON 129,A00,490256,Eckert; Fabian Paul,22,0,35,13
1713338893503,ECON 131,A00,490257,Nieto-Barthaburu; Augusto,0,6,35,35
1713338894531,ECON 138,A00,490258,Bharadwaj; Prashant,13,0,35,22
1713338894531,ECON 138,B00,490259,Bharadwaj; Prashant,15,0,35,20
1713338895560,ECON 159,A00,490260,Hendrickson; Gerald M.,0,9,0,0
1713338896588,ECON 178,A01,553995,Zhu; Ying,24,0,35,11
1713338897617,EDS 40,A01,512576,Black; Alison Michelle,20,0,20,0
1713338898643,EDS 107,A01,515848,Staff,30,0,30,0
1713338899671,EDS 110R,A01,490262,Staff,26,0,30,4
1713338900699,EDS 112,A01,490264,Chapman; Thandeka K,40,0,50,10
1713338901757,EDS 113,A00,490266,Staff,25,0,30,5
1713338902791,EDS 118,A00,490267,Warstadt; Melissa Fawn,18,0,30,12
1713338903825,EDS 124BR,A00,490268,Eguchi; Emi,4,0,25,21
1713338903825,EDS 124BR,B00,490269,Eguchi; Emi,23,0,25,2
1713338904859,EDS 126,A01,490271,Jones; Makeba,43,0,50,7
1713338905886,EDS 135,A01,490316,Staff,19,0,20,1
1713338906911,ENVR 142GS,A00,519514,Chang; Edmond Yi-Teh,26,0,28,2
1713338907936,ETHN 103,A00,490504,Staff,25,0,36,11
1713338908968,ETHN 103A,A00,490505,Man; Simeon S,3,0,9,6
1713338909994,ETHN 109,A00,490506,Staff,28,0,30,2
1713338911023,ETHN 118,A00,490507,Staff,35,0,36,1
1713338912050,ETHN 119,A00,490508,Staff,32,0,36,4
1713338913080,ETHN 121R,A00,490518,Choi; Esther Min,21,0,36,15
1713338914110,ETHN 127,A00,490528,Staff,14,0,15,1
1713338915135,ETHN 139,A00,490573,Staff,10,0,10,0
1713338916161,ETHN 150,A00,490575,Staff,15,0,15,0
1713338917188,GLBH 20,A00,491705,Elwardani; Nile Regina,38,0,40,2
1713338918213,GLBH 101,A00,491706,Staff,20,0,20,0
1713338919238,GLBH 111,A01,491708,Burgos; Jose L.,15,0,15,0
1713338920263,GLBH 146,A00,491709,Staff,9,0,20,11
1713338921292,GLBH 148,A00,491710,Olivas Hernandez; Olga Lid,11,0,20,9
1713338922316,GLBH 150,A00,491711,Sloane; Julia Kathryn,19,0,20,1
1713338923347,HIEA 131,A00,491760,Staff,28,0,32,4
1713338924377,HIEA 153,A00,491762,Staff,28,0,30,2
1713338925403,HIEU 124,A00,491811,Staff,26,0,32,6
1713338926429,HIEU 124GS,A00,491812,Markman; Kristina,27,0,28,1
1713338927459,HIEU 147,A00,491813,Staff,30,0,32,2
1713338928486,HIEU 149GS,A00,491816,Caldwell; Michael Alan,28,0,28,0
1713338929523,HILD 2C,A01,491713,Hendrickson; Gerald M.,26,0,30,4
1713338930547,HILD 7B,A01,491715,Kwak; Nancy,0,2,30,30
1713338931572,HILD 10,A01,491717,Staff,9,0,20,11
1713338932603,HILD 30GS,A00,491719,Edington; Claire Ellen,23,0,28,5
1713338933632,HINE 109,A00,491818,Shafir; Nir,27,0,32,5
1713338934661,HINE 128,A00,491821,Shafir; Nir,30,0,32,2
1713338935687,HISC 117,A00,491830,Staff,27,0,32,5
1713338936714,HIUS 103,A00,491834,Man; Simeon S,14,0,23,9
1713338937743,HIUS 108B,A00,491835,Staff,27,0,30,3
1713338938771,HIUS 141,A00,491836,Hendrickson; Gerald M.,28,0,32,4
1713338939796,HIUS 149,A00,491839,Staff,24,0,32,8
1713338940825,HUM 3,A01,512617,Crum; Matthew Stephen,42,0,50,8
1713338940825,HUM 3,A02,512618,Crum; Matthew Stephen,48,0,50,2
1713338941864,HUM 3GS,A00,512663,Markman; Kristina,0,0,0,1
1713338941864,HUM 3GS,B00,512664,Staff,0,0,0,0
1713338942891,HUM 4,A01,512620,West; Geoffrey Scott,25,0,50,25
1713338943921,HUM 4GS,A00,512666,Lyon; Antony J.,0,0,0,5
1713338944947,HUM 4R,A01,512625,Watkins; Eric,49,0,50,1
1713338945977,HUM 5,A01,512649,Zavodny; Tatiana Sophia,20,0,50,30
1713338945977,HUM 5,B01,512661,Zroka; Ryan Edward,48,0,50,2
1713338947009,INTL 190,A00,490577,Segui; Alan S,0,0,0,5
1713338948044,JAPN 20AR,A01,491267,Ross; Kayoko F,7,0,20,13
1713338949071,JAPN 180,A00,491285,Berman; Michael David,33,0,40,7
1713338950153,LATI 50,A01,502536,Kokinis; Troy Andreas,16,0,22,6
1713338950153,LATI 50,A02,502551,Kokinis; Troy Andreas,22,0,22,0
1713338950153,LATI 50,A03,502650,Kokinis; Troy Andreas,22,0,22,0
1713338950153,LATI 50,A04,502909,Kokinis; Troy Andreas,21,0,22,1
1713338951186,LATI 160,A01,502920,Kokinis; Troy Andreas,30,0,30,0
1713338952217,LIFR 1A,A00,490494,Van Moer; Vinciane G,17,0,20,3
1713338953247,LIFR 1AX,A00,490495,Van Moer; Vinciane G,17,0,20,3
1713338954271,LIFR 1B,A00,490496,Van Moer; Vinciane G,17,0,20,3
1713338955301,LIFR 1BX,A00,490497,Van Moer; Vinciane G,17,0,20,3
1713338956329,LIGN 8,A00,505198,McIntosh; Justin Daniel,134,0,150,16
1713338957355,LIGN 9GS,A00,491239,Lott; Margaret S.,18,0,20,2
1713338958385,LIGN 101,A01,505200,McIntosh; Justin Daniel,22,0,30,8
1713338959414,LIGN 120,A01,491244,Staff,22,0,30,8
1713338960441,LIGN 149GS,A00,491245,Lott; Margaret S.,18,0,20,2
1713338961479,LIGN 170,A00,491247,Staff,22,0,30,8
1713338962510,LISP 1D,A00,490498,Munoz Sanchez; Alicia,8,0,14,6
1713338962510,LISP 1D,B00,490499,Munoz Sanchez; Alicia,4,0,14,10
1713338962510,LISP 1D,C00,490500,Munoz Sanchez; Alicia,7,0,14,7
1713338962510,LISP 1D,D00,490501,Munoz Sanchez; Alicia,10,0,14,4
1713338963566,LISP 1DX,A00,490502,Munoz Sanchez; Alicia,11,0,28,17
1713338963566,LISP 1DX,B00,490503,Munoz Sanchez; Alicia,16,0,28,12
1713338965628,LTAM 110,A00,491847,Staff,22,0,25,3
1713338966655,LTCS 119,A00,491848,Staff,11,0,15,4
1713338967682,LTCS 130,A00,491849,Staff,24,0,25,1
1713338969735,LTEA 120C,A00,491852,Staff,32,0,40,8
1713338970761,LTEN 130GS,A00,491853,Lyon; Antony J.,23,0,28,5
1713338971786,LTEN 148,A00,491855,Staff,23,0,25,2
1713338972810,LTEN 159,A00,491856,Staff,20,0,25,5
1713338973835,LTEN 180,A00,491857,Staff,8,0,15,7
1713338975891,LTSP 123GS,A00,505928,Bessett; Ryan Matthew,24,0,28,4
1713338976922,LTSP 174GS,A00,506037,Bessett; Ryan Matthew,24,0,28,4
1713338978974,LTWR 102,A00,491861,Staff,9,0,15,6
1713338980000,LTWR 106,A00,491862,Staff,8,0,15,7
1713338981028,MAE 11,A00,490930,Bahadori; Mohammad Yousef,95,0,100,5
1713338982054,MAE 30A,A00,490931,Qi; Huihui,37,0,40,3
1713338983082,MAE 101A,A00,491036,Sadeghizadeh; Zahra,92,0,100,8
1713338984113,MAE 101C,A00,491037,Seshadri; Kalyanasundaram,63,0,100,37
1713338985138,MAE 113,A00,491040,Seshadri; Kalyanasundaram,64,0,80,16
1713338986164,MAE 131A,A00,491041,Ghazinejad; Maziar,37,0,40,3
1713338987191,MAE 142,A00,491053,Staff,39,0,40,1
1713338988220,MAE 143A,A00,491054,Staff,30,0,50,20
1713338989249,MAE 150,A00,491092,Truong; Phuong Thi Ngoc,23,0,35,12
1713338990284,MATH 3C,A01,494031,Pardo Guerra; Sebastian,30,0,30,0
1713338990284,MATH 3C,A02,494032,Pardo Guerra; Sebastian,29,0,30,1
1713338991321,MATH 10A,A01,494034,Staff,27,0,30,3
1713338991321,MATH 10A,A02,494035,Staff,28,0,30,2
1713338991321,MATH 10A,B01,494037,Staff,27,0,30,3
1713338991321,MATH 10A,B02,494038,Staff,29,0,30,1
1713338992350,MATH 10B,A01,494040,Habib; Yousaf,22,0,30,8
1713338992350,MATH 10B,A02,494041,Habib; Yousaf,28,0,30,2
1713338992350,MATH 10B,A03,494042,Habib; Yousaf,29,0,30,1
1713338992350,MATH 10B,A04,494043,Habib; Yousaf,30,0,30,0
1713338992350,MATH 10B,B01,494045,Habib; Yousaf,25,0,30,5
1713338992350,MATH 10B,B02,494046,Habib; Yousaf,30,0,30,0
1713338992350,MATH 10B,B03,494047,Habib; Yousaf,30,0,30,0
1713338992350,MATH 10B,B04,494048,Habib; Yousaf,30,0,30,0
1713338993380,MATH 18,A01,494050,Kemp; Todd Aahron,25,0,30,5
1713338993380,MATH 18,A02,494051,Kemp; Todd Aahron,29,0,30,1
1713338993380,MATH 18,B01,494054,Kemp; Todd Aahron,25,0,30,5
1713338993380,MATH 18,B02,494055,Kemp; Todd Aahron,29,0,30,1
1713338994405,MATH 20A,A01,494059,Suk; Andrew Hoon,30,0,30,0
1713338995436,MATH 20B,A01,494061,Briones; Jor-el Thomas Caparas,33,0,35,2
1713338995436,MATH 20B,B01,494063,Bach; Quang Tran,34,0,35,1
1713338996465,MATH 20C,A01,494065,Staff,28,0,30,2
1713338996465,MATH 20C,A02,494066,Staff,30,0,30,0
1713338996465,MATH 20C,A03,494067,Staff,30,0,30,0
1713338996465,MATH 20C,A04,494068,Staff,30,0,30,0
1713338996465,MATH 20C,B01,494070,Zhang; Ming,24,0,30,6
1713338996465,MATH 20C,B02,494071,Zhang; Ming,27,0,30,3
1713338996465,MATH 20C,B03,494072,Zhang; Ming,29,0,30,1
1713338996465,MATH 20C,B04,494073,Zhang; Ming,29,0,30,1
1713338997491,MATH 20D,A01,494075,Staff,22,0,30,8
1713338997491,MATH 20D,A02,494076,Staff,29,0,30,1
1713338998524,MATH 20E,A01,494079,Staff,24,0,30,6
1713338998524,MATH 20E,A02,494080,Staff,26,0,30,4
1713338998524,MATH 20E,B01,494082,Staff,25,0,30,5
1713338998524,MATH 20E,B02,494083,Staff,25,0,30,5
1713338999558,MATH 103A,A01,494085,Aliabadi Sr.; Mohsen,12,0,30,18
1713338999558,MATH 103A,A02,494086,Aliabadi Sr.; Mohsen,28,0,30,2
1713338999558,MATH 103A,B01,494088,Aliabadi Sr.; Mohsen,20,0,30,10
1713338999558,MATH 103A,B02,494089,Aliabadi Sr.; Mohsen,27,0,30,3
1713339000590,MATH 109,A01,494091,Staff,30,0,30,0
1713339000590,MATH 109,A02,494092,Staff,29,0,30,1
1713339000590,MATH 109,B01,494094,Staff,27,0,30,3
1713339000590,MATH 109,B02,494095,Staff,29,0,30,1
1713339001623,MATH 142A,A01,494097,Chow; Bennett,13,0,30,17
1713339001623,MATH 142A,A02,494098,Chow; Bennett,23,0,30,7
1713339001623,MATH 142A,B01,494100,Chow; Bennett,19,0,30,11
1713339001623,MATH 142A,B02,494101,Chow; Bennett,29,0,30,1
1713339003672,MATH 168A,A01,516677,Dumitriu; Ioana,16,0,35,19
1713339004697,MATH 170A,A01,516679,Dumitriu; Ioana,18,0,30,12
1713339004697,MATH 170A,A02,516680,Dumitriu; Ioana,28,0,30,2
1713339005722,MATH 193A,A01,494107,Staff,12,0,30,18
1713339005722,MATH 193A,A02,494108,Staff,18,0,30,12
1713339005722,MATH 193A,A03,494109,Staff,29,0,30,1
1713339005722,MATH 193A,A04,494110,Staff,22,0,30,8
1713339008803,MGT 16,A00,491930,McKay; Michael J,92,0,98,6
1713339009830,MGT 18,A00,491992,McKay; Michael J,96,0,98,2
1713339010858,MGT 71,A00,492003,Staff,63,0,98,35
1713339011885,MGT 103,A00,505209,Eberhard; Craig A,80,0,98,18
1713339012912,MGT 131A,A00,505210,Anderson; John Charles,89,0,98,9
1713339014973,MGT 153,A00,492077,Perols; Johan Lars,16,0,90,74
1713339018051,MGT 164,A00,492222,McKay; Mary A,91,0,98,7
1713339019078,MGT 172,A00,492245,Staff,59,0,60,1
1713339019078,MGT 172,B00,505526,Hedges; Kathleen,65,0,98,33
1713339020110,MGT 181,A00,505669,Dunn; Louis Jean,78,0,98,20
1713339021140,MMW 14,A01,494399,Staff,15,0,28,13
1713339021140,MMW 14,A02,494400,Staff,25,0,28,3
1713339021140,MMW 14,A03,494401,Staff,28,0,28,0
1713339021140,MMW 14,A04,494402,Staff,28,0,28,0
1713339021140,MMW 14,B01,494404,Carreras; Maria Victoria,8,0,28,20
1713339021140,MMW 14,B02,494405,Carreras; Maria Victoria,25,0,28,3
1713339021140,MMW 14,B03,494406,Carreras; Maria Victoria,27,0,28,1
1713339021140,MMW 14,B04,494407,Carreras; Maria Victoria,28,0,28,0
1713339022167,MMW 14GS,A00,506250,Chang; Edmond Yi-Teh,0,0,0,0
1713339023191,MMW 121R,A01,494415,Adamiak; Patrick John,10,0,28,18
1713339023191,MMW 121R,A02,494416,Adamiak; Patrick John,24,0,28,4
1713339024219,MUS 1A,A01,494113,Staff,12,0,25,13
1713339024219,MUS 1A,A02,494114,Staff,24,0,25,1
1713339025244,MUS 4,A01,494116,Staff,23,0,25,2
1713339025244,MUS 4,A02,494117,Staff,22,0,25,3
1713339026270,MUS 5R,A01,494236,Dubnov; Shlomo,4,0,25,21
1713339026270,MUS 5R,A02,494237,Dubnov; Shlomo,25,0,25,0
1713339027296,MUS 6,A01,494122,Staff,9,0,25,16
1713339027296,MUS 6,A02,494123,Staff,23,0,25,2
1713339028323,MUS 7,A01,494125,Staff,16,0,25,9
1713339028323,MUS 7,A02,494126,Staff,24,0,25,1
1713339029353,MUS 11,A01,494128,Staff,23,0,25,2
1713339029353,MUS 11,A02,494129,Staff,24,0,25,1
1713339030380,MUS 13,A01,494131,Staff,25,0,25,0
1713339030380,MUS 13,A02,494132,Staff,25,0,25,0
1713339031408,MUS 15,A01,494134,Staff,16,0,25,9
1713339031408,MUS 15,A02,494135,Staff,25,0,25,0
1713339031408,MUS 15,B01,494137,Staff,24,0,25,1
1713339032437,MUS 80,A00,494232,Staff,24,0,25,1
1713339032437,MUS 80,B00,494233,Staff,25,0,25,0
1713339032437,MUS 80,C00,494234,Staff,23,0,25,2
1713339033461,MUS 95C,A00,494141,Staff,69,0,75,6
1713339034486,MUS 114,A00,494142,Staff,39,0,50,11
1713339035512,NANO 15,A01,490636,Drews; Aaron,7,0,7,0
1713339036543,PHIL 1,A00,490578,Grush; Rick Scott,49,0,50,1
1713339037571,PHIL 10,A01,490580,Grush; Rick Scott,33,0,35,2
1713339037571,PHIL 10,A02,490586,Grush; Rick Scott,32,0,35,3
1713339038597,PHIL 27,A01,490591,Staff,22,0,25,3
1713339038597,PHIL 27,A02,490592,Staff,25,0,25,0
1713339038597,PHIL 27,A03,490593,Staff,25,0,25,0
1713339038597,PHIL 27,A04,490598,Staff,25,0,25,0
1713339039628,PHIL 32,A01,490611,Staff,20,0,20,0
1713339039628,PHIL 32,A02,490618,Staff,20,0,20,0
1713339040652,PHIL 90,A00,490624,Staff,40,0,40,0
1713339041679,PHIL 136,A00,490627,Cohen; Jonathan David,37,0,40,3
1713339042710,PHIL 155,A00,490634,Staff,62,0,70,8
1713339043736,PHYS 1A,A00,491610,Staff,245,0,250,5
1713339044761,PHYS 1AL,001,491616,Tsai; Philbert S,27,0,30,3
1713339044761,PHYS 1AL,002,491618,Tsai; Philbert S,30,0,30,0
1713339045786,PHYS 1B,A00,491623,Staff,235,0,250,15
1713339046809,PHYS 1BL,001,491626,Tsai; Philbert S,19,0,30,11
1713339046809,PHYS 1BL,002,491628,Tsai; Philbert S,26,0,30,4
1713339047836,PHYS 1C,A00,491632,Staff,212,0,245,33
1713339048884,PHYS 1CL,001,491635,Tsai; Philbert S,3,0,30,27
1713339048884,PHYS 1CL,002,491643,Tsai; Philbert S,22,0,30,8
1713339049912,PHYS 2AR,A01,491651,Meyertholen; Andrew D.,44,0,50,6
1713339050943,PHYS 2B,A01,491659,Staff,105,0,115,10
1713339051972,PHYS 2BL,A01,491685,Staff,21,0,24,3
1713339051972,PHYS 2BL,A02,491700,Staff,21,0,24,3
1713339053007,PHYS 2C,A01,505161,Staff,101,0,115,14
1713339054096,PHYS 4A,A01,491704,Grinstein; Benjamin,99,0,100,1
1713339055124,POLI 5D,A01,494144,Staff,3,0,5,2
1713339055124,POLI 5D,B01,626283,Dai; Yinlin,5,0,5,0
1713339056152,POLI 12,A00,494145,Staff,43,0,45,2
1713339057178,POLI 13R,A00,494146,Forman; Fonna,45,0,50,5
1713339058206,POLI 27,A01,494148,Staff,54,0,60,6
1713339059235,POLI 30,A00,494149,Staff,49,0,50,1
1713339060261,POLI 100DA,A00,494150,Staff,20,0,25,5
1713339062315,POLI 100I,A00,494152,Staff,27,0,30,3
1713339063345,POLI 104B,A00,494153,Smith; Glenn Chatmas,53,0,55,2
1713339064371,POLI 104F,A00,494154,Staff,28,0,30,2
1713339065400,POLI 104I,A00,494155,Smith; Glenn Chatmas,29,0,30,1
1713339066429,POLI 110C,A00,494156,Ingham; Sean,23,0,25,2
1713339067459,POLI 117R,A00,494157,Forman; Fonna,5,0,20,15
1713339068485,POLI 118,A00,494158,Ingham; Sean,21,0,25,4
1713339069510,POLI 120H,A00,494159,Fisk; David Lee,39,0,45,6
1713339070536,POLI 131CR,A00,494160,Hoston; Germaine,35,0,45,10
1713339071566,POLI 133J,A00,494161,Staff,31,0,35,4
1713339072596,POLI 135,A00,494162,Fisk; David Lee,33,0,35,2
1713339073625,POLI 140A,A00,494164,Staff,18,0,30,12
1713339074651,POLI 142I,A00,494165,Staff,30,0,30,0
1713339075682,POLI 144D,A00,494166,Staff,22,0,25,3
1713339076709,POLI 151,A00,494167,Staff,30,0,30,0
1713339077745,POLI 153,A00,494168,Staff,33,0,35,2
1713339078775,POLI 160AA,A00,494169,Staff,33,0,40,7
1713339079809,POLI 162,A00,494170,Mignozzetti; Umberto,18,0,25,7
1713339080842,POLI 171,A00,494171,Mignozzetti; Umberto,18,0,25,7
1713339081868,PSYC 1,A00,494172,Staff,95,0,100,5
1713339082901,PSYC 2,A00,494173,Moranton; Nirelia Melbina-,34,0,50,16
1713339083931,PSYC 3,A00,494174,Staff,29,0,30,1
1713339084958,PSYC 6,A00,494175,Staff,17,0,20,3
1713339085992,PSYC 60,A01,494177,Staff,37,0,45,8
1713339087020,PSYC 70,A01,505724,Geller; Emma Harlan,42,0,45,3
1713339088048,PSYC 101,A00,494180,Heyman; Gail D.,84,0,100,16
1713339089075,PSYC 105,A00,494181,Geller; Emma Harlan,51,0,90,39
1713339090101,PSYC 106,A00,494182,Dobkins; Karen R.,26,0,45,19
1713339091129,PSYC 108,A00,494183,Adrian; Julia Anna,89,0,100,11
1713339092157,PSYC 114,A01,494185,Winkielman; Piotr,0,3,30,30
1713339093186,PSYC 122,A00,494186,Moranton; Nirelia Melbina-,27,0,50,23
1713339094221,PSYC 124,A00,494187,Chapman; Eddie Nathaniel,69,0,80,11
1713339095253,PSYC 131,A00,494188,Anagnostaras; Stephan,40,0,80,40
1713339096283,PSYC 144,A00,494189,Staff,1,0,50,49
1713339097317,PSYC 154,A00,494190,Lacefield; Katharine I,105,0,180,75
1713339098343,PSYC 162,A00,494191,Wixted; John T,70,0,100,30
1713339099372,PSYC 172,A00,494192,Gorman; Michael R.,36,0,45,9
1713339100398,PSYC 178,A00,494193,Glaser; Dale,34,0,45,11
1713339101433,PSYC 193,A00,505725,Chapman; Eddie Nathaniel,20,0,20,0
1713339102461,RELI 145GS,A00,519817,Rahimi; Babak,17,0,20,3
1713339103491,SE 101A,A01,490862,Chadha; Mayank,23,0,25,2
1713339104529,SE 101C,A01,490924,Krysl; Petr,15,0,20,5
1713339105559,SE 110A,A01,490928,Staff,19,0,20,1
1713339106589,SE 130A,A00,490929,Morrison; Machel Leigh,54,0,70,16
1713339107617,SIO 1,A01,519325,Staff,39,0,40,1
1713339108650,SIO 30,A01,519327,Staff,38,0,40,2
1713339109679,SIO 40,A00,519328,Staff,39,0,40,1
1713339110718,SIO 46GS,A00,519819,Cook; Geoffrey W,16,0,25,9
1713339111744,SIO 109R,A00,494197,Forman; Fonna,0,3,20,20
1713339112778,SIO 121GS,A00,519827,Cook; Geoffrey W,16,0,25,9
1713339113809,SIO 132,A01,519330,Staff,38,0,40,2
1713339114835,SIO 133,A01,519397,Staff,37,0,40,3
1713339115863,SIO 139,A00,519396,Kacev; David,29,0,40,11
1713339116892,SOCI 1,A01,494199,Thorpe; Charles Robert,21,0,30,9
1713339116892,SOCI 1,A02,494200,Thorpe; Charles Robert,30,0,30,0
1713339116892,SOCI 1,A03,494201,Thorpe; Charles Robert,29,0,30,1
1713339116892,SOCI 1,A04,494202,Thorpe; Charles Robert,29,0,30,1
1713339116892,SOCI 1,A05,494203,Thorpe; Charles Robert,29,0,30,1
1713339116892,SOCI 1,A06,494204,Thorpe; Charles Robert,30,0,30,0
1713339116892,SOCI 1,A07,494205,Thorpe; Charles Robert,28,0,30,2
1713339117926,SOCI 60,A01,494207,Staff,33,0,40,7
1713339117926,SOCI 60,A02,494208,Staff,39,0,40,1
1713339118955,SOCI 100,A01,494210,Payne; Christine Anna,25,0,30,5
1713339118955,SOCI 100,A02,494211,Payne; Christine Anna,26,0,30,4
1713339119982,SOCI 109M,A00,494212,Staff,20,0,20,0
1713339121009,SOCI 110,A00,494213,Staff,34,0,40,6
1713339123087,SOCI 118E,A00,494215,Ng; Kwai,37,0,40,3
1713339124120,SOCI 125,A00,494216,Calderon-Zaks; Michael Aar,39,0,45,6
1713339125149,SOCI 126,A01,494218,Jones; Makeba,3,0,5,2
1713339126182,SOCI 131,A00,494219,Thorpe; Charles Robert,26,0,30,4
1713339128239,SOCI 135,A00,494221,Payne; Christine Anna,28,0,50,22
1713339129266,SOCI 136E,A00,626690,Ruiz; Jonathan Joseph,24,0,25,1
1713339130291,SOCI 138GS,A00,494222,Navon; Daniel,23,0,28,5
1713339132341,SOCI 145,A00,494224,Staff,40,0,45,5
1713339133368,SOCI 153,A00,494225,Staff,28,0,30,2
1713339134400,SOCI 160E,A00,494226,Ng; Kwai,27,0,40,13
1713339135428,SOCI 180,A00,494227,Staff,29,0,30,1
1713339136454,SOCI 189GS,A00,494228,Ribas Norris; Janet Vanesa,11,0,11,0
1713339137481,SOCI 190GS,A00,553232,Ribas Norris; Janet Vanesa,11,0,11,0
1713339138510,SOMI 220,A00,627178,Schneid; Stephen David,30,0,30,0
1713339139542,SYN 2,001,490768,Staff,13,0,15,2
1713339139542,SYN 2,002,490769,Staff,14,0,15,1
1713339139542,SYN 2,004,490775,Staff,0,0,0,0
1713339139542,SYN 2,003,490774,Staff,0,0,0,0
1713339139542,SYN 2,005,490776,Staff,0,0,0,0
1713339140575,SYN 2R,001,490779,Staff,11,0,15,4
1713339140575,SYN 2R,002,514635,Staff,14,0,15,1
1713339141607,SYN 100,A01,490783,Staff,8,0,20,12
1713339141607,SYN 100,B01,490787,Staff,10,0,20,10
1713339141607,SYN 100,C01,490789,Staff,10,0,20,10
1713339142633,SYN 150,A00,490817,Staff,14,0,15,1
1713339142633,SYN 150,B00,514610,Staff,15,0,15,0
1713339143662,TDAC 1,A00,492753,Walsh; Kim C.,19,0,20,1
1713339143662,TDAC 1,B00,492754,Harting; Carla Kelso,18,0,20,2
1713339143662,TDAC 1,C00,513995,Salovey; Todd,15,0,20,5
1713339144695,TDAC 101,A00,492766,Harting; Carla Kelso,17,0,20,3
1713339145723,TDAC 102,A00,492768,Basso; Beatrice,19,0,20,1
1713339146753,TDDE 111,A00,492769,Staff,25,0,25,0
1713339147780,TDDE 131,A00,492770,Staff,15,0,15,0
1713339147780,TDDE 131,B00,492771,Staff,15,0,15,0
1713339148808,TDDE 131GS,A00,523716,Guirguis; Mark C,23,0,28,5
1713339149843,TDGE 1,A01,492756,Salovey; Todd,56,0,60,4
1713339150868,TDGE 5,A01,492758,Staff,23,0,25,2
1713339151894,TDGE 10,A00,492759,Fulton; Julia,203,0,220,17
1713339152921,TDGE 11,A00,492760,Castro; Robert Jess,198,0,200,2
1713339154978,TDGE 124,A00,492772,Fulton; Julia,181,0,220,39
1713339156013,TDGE 125,A00,492773,Meyer; Ursula,38,0,50,12
1713339156013,TDGE 125,B00,492774,Staff,49,0,50,1
1713339156013,TDGE 125,C00,523565,Staff,48,0,50,2
1713339157043,TDGE 125GS,A00,523580,Guirguis; Mark C,23,0,28,5
1713339158126,TDGE 127,A00,492775,Havis; Allan,32,0,50,18
1713339159151,TDHT 101,A00,492776,Staff,34,0,35,1
1713339160183,TDMV 1,A00,492762,Caligagan; Maria T.,29,0,30,1
1713339160183,TDMV 1,B00,492763,Arcidiacono; Kristin,26,0,30,4
1713339161219,TDMV 2,A00,492764,Weinberg; Sadie,27,0,30,3
1713339162249,TDMV 3,A00,492765,Mack; Kara Shanai',37,0,40,3
1713339163275,TDMV 138,A00,492777,Mack; Kara Shanai',32,0,40,8
1713339164308,TDMV 140,A00,492778,Lima; Paulo Henrique,40,0,40,0
1713339165334,TDMV 142,A00,492779,Caligagan; Maria T.,33,0,40,7
1713339165334,TDMV 142,B00,492780,Caligagan; Tony,37,0,40,3
1713339166360,TDMV 143,A00,492781,Fyall; Daunte Edward,39,0,40,1
1713339167387,USP 1,A01,492401,Kwak; Nancy,27,0,35,8
1713339168416,USP 2,A01,492453,Hinds; Juli Beth,35,0,35,0
1713339169440,USP 3,A01,492516,Staff,28,0,35,7
1713339170467,USP 4,A00,492522,McTague; Sarah,16,0,25,9
1713339171498,USP 100,A00,492523,Staff,32,0,35,3
1713339172523,USP 101,A00,492524,Staff,13,0,15,2
1713339173549,USP 105,A00,492525,Staff,21,0,25,4
1713339174579,USP 151,A00,492526,Shenkman; Michael Thomas,32,0,35,3
1713339175607,USP 170,A00,492545,Hinds; Juli Beth,33,0,35,2
1713339176634,USP 171GS,A00,492608,Bussell; Mirle Rabinowitz,24,0,28,4
1713339177662,USP 183GS,A00,492613,Peerson; Susan,24,0,28,4
1713339178690,VIS 30,A01,490693,Yoldas; Pinar,19,0,22,3
1713339178690,VIS 30,A02,490694,Yoldas; Pinar,18,0,22,4
1713339179720,VIS 83,A00,490695,Kester; Grant,63,0,75,12
1713339180747,VIS 105D,A00,490696,Staff,22,0,25,3
1713339181774,VIS 124CN,A00,490699,Rose; Jordan M,64,0,75,11
1713339182800,VIS 125GS,A00,511221,Williams; Alena J,21,0,22,1
1713339183832,VIS 128D,A00,490700,Staff,73,0,75,2
1713339184857,VIS 151,A01,490717,Staff,33,0,34,1
1713339184857,VIS 151,A02,490766,Staff,33,0,34,1
1713339185882,VIS 154GS,A00,511972,Williams; Alena J,21,0,22,1
1713339186913,VIS 160A,A00,490767,Stone; Patricia,7,0,10,3
1713339187947,WCWP 10A,A00,490638,Staff,14,0,15,1
1713339187947,WCWP 10A,B00,490640,Staff,15,0,15,0
1713339188973,WCWP 10B,A00,490641,Staff,0,0,0,0
1713339188973,WCWP 10B,B00,490642,Staff,14,0,15,1
1713339188973,WCWP 10B,C00,490644,Staff,13,0,15,2
1713339188973,WCWP 10B,D00,490647,Staff,0,0,0,0
1713339189999,WCWP 100,A00,490655,Staff,0,0,0,0
1713339189999,WCWP 100,B00,490687,Staff,10,0,15,5
1713339192119,ANAR 153,A00,487222,Braswell; Geoffrey E.,53,0,60,7
1713339193152,ANBI 134,A00,487223,Staff,6,0,20,14
1713339194181,ANBI 143GS,A00,487224,Noel; Geoffroy Pierre Jean,18,0,24,6
1713339195207,ANBI 144GS,A00,519548,Noel; Geoffroy Pierre Jean,18,0,24,6
1713339196233,ANSC 101,A00,487225,Staff,17,0,20,3
1713339197265,ANSC 125,A00,487227,Brenner; Suzanne A,38,0,40,2
1713339199321,ANSC 146,A00,487229,Staff,35,0,40,5
1713339200352,ANSC 148,A00,487230,Olivas Hernandez; Olga Lid,39,0,40,1
1713339201379,ANSC 150,A00,504165,Sloane; Julia Kathryn,18,0,20,2
1713339202407,ANSC 180,A00,487232,Staff,14,0,15,1
1713339203432,ANSC 188,A00,627155,Staff,38,0,40,2
1713339204458,ANTH 5,A00,519529,Semendeferi; Ekaterini,15,0,15,0
1713339205489,ANTH 10,A00,487219,Staff,58,0,60,2
1713339206515,ANTH 23,A01,487221,Staff,17,0,20,3
1713339207543,ANTH 102,A00,487233,Wilder; Linnea Lorene,50,0,60,10
1713339208578,ANTH 103,A00,487234,Varma; Saiba,54,0,60,6
1713339209605,ANTH 105,A00,487235,Stewart; Alexander B,54,0,60,6
1713339210641,BENG 100,A01,516685,Taylor Amos; Alyssa C,25,0,30,5
1713339211668,BIBC 102,A01,491316,Flagg; Matthew Paul,6,0,88,82
1713339211668,BIBC 102,A02,491366,Flagg; Matthew Paul,78,0,88,10
1713339212699,BIBC 103,A01,491486,Boumechache; Miyyada,16,0,24,8
1713339212699,BIBC 103,A02,491487,Boumechache; Miyyada,24,0,24,0
1713339213734,BICD 100,A01,516882,Staff,73,0,75,2
1713339213734,BICD 100,A02,516890,Staff,69,0,75,6
1713339214761,BICD 102GS,A00,491488,Lo; Stanley M.,26,0,28,2
1713339215792,BIEB 136GS,A00,516940,Holway; David A. & Shurin; Jonathan,18,0,24,6
1713339216819,BIEB 137GS,A01,517034,Holway; David A. & Shurin; Jonathan,18,0,24,6
1713339217849,BIEB 138GS,A01,491492,Pirino; Giorgia,21,0,28,7
1713339218881,BILD 1,A01,491296,Staff,60,0,63,3
1713339218881,BILD 1,A02,491297,Staff,63,0,63,0
1713339219909,BILD 4,A01,517099,Gonzalez Gamboa; Ivonne,22,0,24,2
1713339219909,BILD 4,A02,517100,Gonzalez Gamboa; Ivonne,24,0,24,0
1713339220938,BILD 60GS,A00,491309,Lo; Stanley M.,26,0,28,2
1713339221965,BIMM 100,A01,517136,Staff,82,0,100,18
1713339222993,BIMM 110,A01,517182,Staff,53,0,100,47
1713339224021,BIMM 120,A01,517228,Pickett; Brooke Elizabeth,28,0,63,35
1713339224021,BIMM 120,A02,517240,Pickett; Brooke Elizabeth,44,0,63,19
1713339225051,BIMM 132GS,A01,491498,Pirino; Giorgia,21,0,28,7
1713339226085,BIMM 143,A01,491589,Bozinovic; Goran,12,0,40,28
1713339227116,BIPN 100,A01,491594,Armour; Jon Christopher,83,0,100,17
1713339228142,BIPN 140,A01,491602,Marino; Marc J,23,0,50,27
1713339230199,CAT 125,A00,515973,Staff,18,0,20,2
1713339231231,CAT 125GS,A00,515974,Rahimi; Babak,16,0,20,4
1713339232282,CAT 125R,A00,515980,Staff,12,0,20,8
1713339232282,CAT 125R,B00,515981,Tosun; Adriana,19,0,20,1
1713339232282,CAT 125R,C00,515987,Hyland; Tina Mae,0,5,20,20
1713339232282,CAT 125R,D00,515988,Bronstein; Phoebe Malan,16,0,20,4
1713339233330,CENG 15,A01,488699,Drews; Aaron,25,0,25,0
1713339234358,CENG 100,A00,505196,Opatkiewicz; Justin Paul,25,0,25,0
1713339235386,CGS 2A,A01,489598,Staff,33,0,35,2
1713339236415,CGS 112,A00,489599,Staff,15,0,15,0
1713339237441,CGS 119,A00,489603,Staff,10,0,10,0
1713339238469,CGS 120,A00,489604,Staff,13,0,15,2
1713339239495,CGS 150,A00,489607,Staff,15,0,15,0
1713339240521,CHEM 6A,A01,488715,Staff,97,0,100,3
1713339241555,CHEM 6B,A01,488719,Piercy; Marc Anthony,99,0,100,1
1713339242587,CHEM 6C,A01,488723,Albizati; Kim F.,93,0,100,7
1713339243628,CHEM 7L,A01,488728,Schurmeier; Kimberly,18,0,24,6
1713339243628,CHEM 7L,A02,488730,Schurmeier; Kimberly,23,0,24,1
1713339243628,CHEM 7L,A03,488734,Schurmeier; Kimberly,20,0,24,4
1713339243628,CHEM 7L,A04,488763,Schurmeier; Kimberly,23,0,24,1
1713339243628,CHEM 7L,B01,488798,Schurmeier; Kimberly,16,0,24,8
1713339243628,CHEM 7L,B02,488801,Schurmeier; Kimberly,22,0,24,2
1713339243628,CHEM 7L,B03,488808,Schurmeier; Kimberly,22,0,24,2
1713339243628,CHEM 7L,B04,488811,Schurmeier; Kimberly,24,0,24,0
1713339244653,CHEM 11,A01,488897,Stallings; Dontarie M,95,0,100,5
1713339245682,CHEM 40A,A01,488913,Albizati; Kim F.,83,0,100,17
1713339246709,CHEM 40B,A01,488920,Weizman; Haim,42,0,50,8
1713339246709,CHEM 40B,A02,488938,Weizman; Haim,43,0,50,7
1713339247744,CHEM 41A,A01,489029,Klosterman; Jeremy K,57,0,60,3
1713339248812,CHEM 41C,A01,500436,Tor; Yitzhak,55,0,60,5
1713339249842,CHEM 43A,A01,500426,Weizman; Haim,0,1,24,24
1713339249842,CHEM 43A,A02,500430,Weizman; Haim,5,0,24,19
1713339249842,CHEM 43A,B01,514041,Klosterman; Jeremy K,15,0,24,9
1713339249842,CHEM 43A,B02,514047,Klosterman; Jeremy K,23,0,24,1
1713339250869,CHEM 108,A01,489140,Jennings; Patricia A.,7,0,24,17
1713339250869,CHEM 108,A02,489142,Jennings; Patricia A.,14,0,24,10
1713339251901,CHEM 114A,A01,489147,Stallings; Dontarie M,65,0,100,35
1713339252933,CHIN 169A,A00,489171,Wang; Xiao,19,0,20,1
1713339255028,COGS 3,A01,518827,Boyle; Mary E. T.,25,0,40,15
1713339256055,COGS 11,A01,489175,Staff,27,0,30,3
1713339257082,COGS 14A,A01,518829,Staff,50,0,60,10
1713339258111,COGS 14B,A01,489177,Hoffman; Drew Ellen,62,0,75,13
1713339259140,COGS 100,A01,489181,Allen; Michael Gordon,62,0,75,13
1713339260167,COGS 101A,A01,489183,Staff,45,0,60,15
1713339261193,COGS 101B,A01,489185,Allen; Michael Gordon,6,0,30,24
1713339262275,COGS 101C,A01,526786,Staff,23,0,30,7
1713339264333,COGS 107A,A01,489189,Boyle; Mary E. T.,16,0,35,19
1713339265365,COGS 107B,A01,627144,Mooshagian; Eric Frederick,60,0,60,0
1713339266390,COGS 118A,A01,489191,Staff,0,46,40,40
1713339268446,COGS 171GS,A01,489194,Pineda; Jaime A,19,0,28,9
1713339269473,COGS 172,A01,489196,Staff,2,0,30,28
1713339270499,COGS 174GS,A01,489264,Pineda; Jaime A,19,0,28,9
1713339271527,COGS 180,A01,627150,Staff,28,0,30,2
1713339272552,COGS 186,A01,489274,Staff,0,2,30,30
1713339273579,COMM 10,A01,489276,Staff,23,0,25,2
1713339273579,COMM 10,A02,489303,Staff,23,0,25,2
1713339274606,COMM 100A,A01,489312,Staff,14,0,25,11
1713339274606,COMM 100A,A02,489313,Staff,24,0,25,1
1713339275635,COMM 106T,A00,512540,Staff,33,0,35,2
1713339276662,COMM 107,A00,489347,Staff,27,0,35,8
1713339277689,COMM 109P,A00,489358,Staff,31,0,35,4
1713339278715,COMM 132,A00,489361,McKenna; Denise,27,0,30,3
1713339279741,COMM 146,A00,489362,Halm; Gavin Patrick,26,0,30,4
1713339280767,COMM 190,A00,489363,Abuelhiga; Soraya Jill,17,0,23,6
1713339281797,CSE 8A,A50,489366,Staff,21,0,25,4
1713339281797,CSE 8A,A51,489367,Staff,24,0,25,1
1713339282828,CSE 11,A01,489398,Cao; Yingjun,73,0,100,27
1713339283870,CSE 12,A01,489487,Staff,43,0,50,7
1713339284900,CSE 20,A01,489497,Staff,47,0,50,3
1713339285930,CSE 21,A01,489517,Braun; Oliver,42,0,50,8
1713339286958,CSE 101,A01,489524,Braun; Oliver,0,33,50,50
1713339287986,CSE 105,A01,512594,Jones; Miles E,72,0,100,28
1713339287986,CSE 105,B01,512598,Jones; Miles E,51,0,100,49
1713339289014,CSE 140,A01,489538,Staff,41,0,50,9
1713339290041,CSE 141,A01,489550,Eldon; John,67,0,100,33
1713339291072,CSE 141L,A01,489571,Eldon; John,65,0,100,35
1713339292098,CSE 151A,A01,489583,Solares; Edwin A,140,0,200,60
1713339293126,CSE 175,A01,510886,Kumar; Rakesh,30,0,30,0
1713339294158,CSE 190,A00,516828,Dubnov; Shlomo,37,0,49,12
1713339295193,DOC 100D,A00,489667,Pass; Natalye Joann,19,0,25,6
1713339296220,DSC 10,A01,624268,Staff,72,0,75,3
1713339297246,DSC 20,A01,624476,Staff,50,0,50,0
1713339298273,DSC 40A,A01,624608,Staff,39,0,40,1
1713339299302,DSGN 1,A01,489179,Rill; Bryan,32,0,50,18
1713339300339,ECE 17,A01,490489,Sahay; Rajeev,18,0,30,12
1713339301366,ECE 65,A50,490492,Staff,11,0,20,9
1713339301366,ECE 65,A51,490493,Staff,18,0,20,2
1713339302392,ECON 1,A01,489715,Famulari; Melissa,67,0,70,3
1713339303424,ECON 2,A01,489717,Levkoff; Steven B.,67,0,70,3
1713339304452,ECON 3,A01,489948,Staff,70,0,70,0
1713339306510,ECON 5,A01,490103,Staff,27,0,30,3
1713339306510,ECON 5,B01,626281,Dai; Yinlin,45,0,45,0
1713339307540,ECON 100A,A01,490127,Famulari; Melissa,63,0,70,7
1713339308569,ECON 100B,A01,490129,Staff,64,0,70,6
1713339309603,ECON 109,A01,490187,Shishkin; Denis,27,0,35,8
1713339310633,ECON 110A,A01,490190,Levkoff; Steven B.,59,0,70,11
1713339311660,ECON 120A,A01,490245,Dai; Yinlin,60,0,70,10
1713339312692,ECON 120B,A01,490247,Nieto-Barthaburu; Augusto,40,0,70,30
1713339313755,ECON 120C,A01,490253,Sun; Yixiao,30,0,35,5
1713339313755,ECON 120C,B01,490255,Sun; Yixiao,34,0,35,1
1713339314790,ECON 129,A00,490256,Eckert; Fabian Paul,22,0,35,13
1713339315822,ECON 131,A00,490257,Nieto-Barthaburu; Augusto,0,6,35,35
1713339316853,ECON 138,A00,490258,Bharadwaj; Prashant,13,0,35,22
1713339316853,ECON 138,B00,490259,Bharadwaj; Prashant,15,0,35,20
1713339317894,ECON 159,A00,490260,Hendrickson; Gerald M.,0,9,0,0
1713339318941,ECON 178,A01,553995,Zhu; Ying,24,0,35,11
1713339319970,EDS 40,A01,512576,Black; Alison Michelle,20,0,20,0
1713339321003,EDS 107,A01,515848,Staff,30,0,30,0
1713339322032,EDS 110R,A01,490262,Staff,26,0,30,4
1713339323065,EDS 112,A01,490264,Chapman; Thandeka K,40,0,50,10
1713339324096,EDS 113,A00,490266,Staff,25,0,30,5
1713339325122,EDS 118,A00,490267,Warstadt; Melissa Fawn,18,0,30,12
1713339326152,EDS 124BR,A00,490268,Eguchi; Emi,4,0,25,21
1713339326152,EDS 124BR,B00,490269,Eguchi; Emi,23,0,25,2
1713339327194,EDS 126,A01,490271,Jones; Makeba,43,0,50,7
1713339328225,EDS 135,A01,490316,Staff,19,0,20,1
1713339329257,ENVR 142GS,A00,519514,Chang; Edmond Yi-Teh,26,0,28,2
1713339330286,ETHN 103,A00,490504,Staff,25,0,36,11
1713339331316,ETHN 103A,A00,490505,Man; Simeon S,3,0,9,6
1713339332342,ETHN 109,A00,490506,Staff,28,0,30,2
1713339333368,ETHN 118,A00,490507,Staff,35,0,36,1
1713339334397,ETHN 119,A00,490508,Staff,32,0,36,4
1713339335426,ETHN 121R,A00,490518,Choi; Esther Min,21,0,36,15
1713339336456,ETHN 127,A00,490528,Staff,14,0,15,1
1713339337486,ETHN 139,A00,490573,Staff,10,0,10,0
1713339338513,ETHN 150,A00,490575,Staff,15,0,15,0
1713339339542,GLBH 20,A00,491705,Elwardani; Nile Regina,38,0,40,2
1713339340572,GLBH 101,A00,491706,Staff,20,0,20,0
1713339341598,GLBH 111,A01,491708,Burgos; Jose L.,15,0,15,0
1713339342625,GLBH 146,A00,491709,Staff,8,0,20,12
1713339343652,GLBH 148,A00,491710,Olivas Hernandez; Olga Lid,10,0,20,10
1713339344680,GLBH 150,A00,491711,Sloane; Julia Kathryn,19,0,20,1
1713339345709,HIEA 131,A00,491760,Staff,28,0,32,4
1713339346736,HIEA 153,A00,491762,Staff,28,0,30,2
1713339347761,HIEU 124,A00,491811,Staff,26,0,32,6
1713339348793,HIEU 124GS,A00,491812,Markman; Kristina,27,0,28,1
1713339349819,HIEU 147,A00,491813,Staff,30,0,32,2
1713339350850,HIEU 149GS,A00,491816,Caldwell; Michael Alan,28,0,28,0
1713339351876,HILD 2C,A01,491713,Hendrickson; Gerald M.,26,0,30,4
1713339352902,HILD 7B,A01,491715,Kwak; Nancy,0,2,30,30
1713339353938,HILD 10,A01,491717,Staff,9,0,20,11
1713339354965,HILD 30GS,A00,491719,Edington; Claire Ellen,23,0,28,5
1713339355991,HINE 109,A00,491818,Shafir; Nir,27,0,32,5
1713339357022,HINE 128,A00,491821,Shafir; Nir,30,0,32,2
1713339358051,HISC 117,A00,491830,Staff,27,0,32,5
1713339359084,HIUS 103,A00,491834,Man; Simeon S,14,0,23,9
1713339360116,HIUS 108B,A00,491835,Staff,27,0,30,3
1713339361145,HIUS 141,A00,491836,Hendrickson; Gerald M.,28,0,32,4
1713339362179,HIUS 149,A00,491839,Staff,24,0,32,8
1713339363210,HUM 3,A01,512617,Crum; Matthew Stephen,42,0,50,8
1713339363210,HUM 3,A02,512618,Crum; Matthew Stephen,48,0,50,2
1713339364261,HUM 3GS,A00,512663,Markman; Kristina,0,0,0,1
1713339364261,HUM 3GS,B00,512664,Staff,0,0,0,0
1713339365290,HUM 4,A01,512620,West; Geoffrey Scott,25,0,50,25
1713339366375,HUM 4GS,A00,512666,Lyon; Antony J.,0,0,0,5
1713339367406,HUM 4R,A01,512625,Watkins; Eric,49,0,50,1
1713339368440,HUM 5,A01,512649,Zavodny; Tatiana Sophia,20,0,50,30
1713339368440,HUM 5,B01,512661,Zroka; Ryan Edward,48,0,50,2
1713339369471,INTL 190,A00,490577,Segui; Alan S,0,0,0,5
1713339370503,JAPN 20AR,A01,491267,Ross; Kayoko F,7,0,20,13
1713339371534,JAPN 180,A00,491285,Berman; Michael David,33,0,40,7
1713339372569,LATI 50,A01,502536,Kokinis; Troy Andreas,16,0,22,6
1713339372569,LATI 50,A02,502551,Kokinis; Troy Andreas,22,0,22,0
1713339372569,LATI 50,A03,502650,Kokinis; Troy Andreas,22,0,22,0
1713339372569,LATI 50,A04,502909,Kokinis; Troy Andreas,21,0,22,1
1713339373599,LATI 160,A01,502920,Kokinis; Troy Andreas,30,0,30,0
1713339374631,LIFR 1A,A00,490494,Van Moer; Vinciane G,17,0,20,3
1713339375665,LIFR 1AX,A00,490495,Van Moer; Vinciane G,17,0,20,3
1713339376694,LIFR 1B,A00,490496,Van Moer; Vinciane G,17,0,20,3
1713339377726,LIFR 1BX,A00,490497,Van Moer; Vinciane G,17,0,20,3
1713339378755,LIGN 8,A00,505198,McIntosh; Justin Daniel,134,0,150,16
1713339379782,LIGN 9GS,A00,491239,Lott; Margaret S.,18,0,20,2
1713339380809,LIGN 101,A01,505200,McIntosh; Justin Daniel,22,0,30,8
1713339381840,LIGN 120,A01,491244,Staff,22,0,30,8
1713339382868,LIGN 149GS,A00,491245,Lott; Margaret S.,18,0,20,2
1713339383896,LIGN 170,A00,491247,Staff,22,0,30,8
1713339384924,LISP 1D,A00,490498,Munoz Sanchez; Alicia,8,0,14,6
1713339384924,LISP 1D,B00,490499,Munoz Sanchez; Alicia,4,0,14,10
1713339384924,LISP 1D,C00,490500,Munoz Sanchez; Alicia,7,0,14,7
1713339384924,LISP 1D,D00,490501,Munoz Sanchez; Alicia,10,0,14,4
1713339385953,LISP 1DX,A00,490502,Munoz Sanchez; Alicia,11,0,28,17
1713339385953,LISP 1DX,B00,490503,Munoz Sanchez; Alicia,16,0,28,12
1713339388014,LTAM 110,A00,491847,Staff,22,0,25,3
1713339389044,LTCS 119,A00,491848,Staff,11,0,15,4
1713339390073,LTCS 130,A00,491849,Staff,24,0,25,1
1713339392132,LTEA 120C,A00,491852,Staff,32,0,40,8
1713339393163,LTEN 130GS,A00,491853,Lyon; Antony J.,23,0,28,5
1713339394196,LTEN 148,A00,491855,Staff,23,0,25,2
1713339395223,LTEN 159,A00,491856,Staff,20,0,25,5
1713339396250,LTEN 180,A00,491857,Staff,8,0,15,7
1713339398308,LTSP 123GS,A00,505928,Bessett; Ryan Matthew,24,0,28,4
1713339399334,LTSP 174GS,A00,506037,Bessett; Ryan Matthew,24,0,28,4
1713339401392,LTWR 102,A00,491861,Staff,9,0,15,6
1713339402422,LTWR 106,A00,491862,Staff,8,0,15,7
1713339403456,MAE 11,A00,490930,Bahadori; Mohammad Yousef,94,0,100,6
1713339404482,MAE 30A,A00,490931,Qi; Huihui,37,0,40,3
1713339405514,MAE 101A,A00,491036,Sadeghizadeh; Zahra,91,0,100,9
1713339406543,MAE 101C,A00,491037,Seshadri; Kalyanasundaram,63,0,100,37
1713339407572,MAE 113,A00,491040,Seshadri; Kalyanasundaram,64,0,80,16
1713339408602,MAE 131A,A00,491041,Ghazinejad; Maziar,37,0,40,3
1713339409627,MAE 142,A00,491053,Staff,39,0,40,1
1713339410661,MAE 143A,A00,491054,Staff,29,0,50,21
1713339411691,MAE 150,A00,491092,Truong; Phuong Thi Ngoc,23,0,35,12
1713339412731,MATH 3C,A01,494031,Pardo Guerra; Sebastian,30,0,30,0
1713339412731,MATH 3C,A02,494032,Pardo Guerra; Sebastian,29,0,30,1
1713339413761,MATH 10A,A01,494034,Staff,27,0,30,3
1713339413761,MATH 10A,A02,494035,Staff,28,0,30,2
1713339413761,MATH 10A,B01,494037,Staff,27,0,30,3
1713339413761,MATH 10A,B02,494038,Staff,29,0,30,1
1713339414811,MATH 10B,A01,494040,Habib; Yousaf,22,0,30,8
1713339414811,MATH 10B,A02,494041,Habib; Yousaf,28,0,30,2
1713339414811,MATH 10B,A03,494042,Habib; Yousaf,29,0,30,1
1713339414811,MATH 10B,A04,494043,Habib; Yousaf,30,0,30,0
1713339414811,MATH 10B,B01,494045,Habib; Yousaf,25,0,30,5
1713339414811,MATH 10B,B02,494046,Habib; Yousaf,30,0,30,0
1713339414811,MATH 10B,B03,494047,Habib; Yousaf,30,0,30,0
1713339414811,MATH 10B,B04,494048,Habib; Yousaf,30,0,30,0
1713339415847,MATH 18,A01,494050,Kemp; Todd Aahron,25,0,30,5
1713339415847,MATH 18,A02,494051,Kemp; Todd Aahron,29,0,30,1
1713339415847,MATH 18,B01,494054,Kemp; Todd Aahron,25,0,30,5
1713339415847,MATH 18,B02,494055,Kemp; Todd Aahron,29,0,30,1
1713339416874,MATH 20A,A01,494059,Suk; Andrew Hoon,30,0,30,0
1713339417903,MATH 20B,A01,494061,Briones; Jor-el Thomas Caparas,33,0,35,2
1713339417903,MATH 20B,B01,494063,Bach; Quang Tran,34,0,35,1
1713339418940,MATH 20C,A01,494065,Staff,28,0,30,2
1713339418940,MATH 20C,A02,494066,Staff,30,0,30,0
1713339418940,MATH 20C,A03,494067,Staff,30,0,30,0
1713339418940,MATH 20C,A04,494068,Staff,30,0,30,0
1713339418940,MATH 20C,B01,494070,Zhang; Ming,24,0,30,6
1713339418940,MATH 20C,B02,494071,Zhang; Ming,27,0,30,3
1713339418940,MATH 20C,B03,494072,Zhang; Ming,29,0,30,1
1713339418940,MATH 20C,B04,494073,Zhang; Ming,29,0,30,1
1713339419973,MATH 20D,A01,494075,Staff,22,0,30,8
1713339419973,MATH 20D,A02,494076,Staff,29,0,30,1
1713339421008,MATH 20E,A01,494079,Staff,24,0,30,6
1713339421008,MATH 20E,A02,494080,Staff,26,0,30,4
1713339421008,MATH 20E,B01,494082,Staff,25,0,30,5
1713339421008,MATH 20E,B02,494083,Staff,25,0,30,5
1713339422036,MATH 103A,A01,494085,Aliabadi Sr.; Mohsen,12,0,30,18
1713339422036,MATH 103A,A02,494086,Aliabadi Sr.; Mohsen,28,0,30,2
1713339422036,MATH 103A,B01,494088,Aliabadi Sr.; Mohsen,20,0,30,10
1713339422036,MATH 103A,B02,494089,Aliabadi Sr.; Mohsen,27,0,30,3
1713339423066,MATH 109,A01,494091,Staff,30,0,30,0
1713339423066,MATH 109,A02,494092,Staff,29,0,30,1
1713339423066,MATH 109,B01,494094,Staff,27,0,30,3
1713339423066,MATH 109,B02,494095,Staff,29,0,30,1
1713339424094,MATH 142A,A01,494097,Chow; Bennett,13,0,30,17
1713339424094,MATH 142A,A02,494098,Chow; Bennett,23,0,30,7
1713339424094,MATH 142A,B01,494100,Chow; Bennett,19,0,30,11
1713339424094,MATH 142A,B02,494101,Chow; Bennett,29,0,30,1
1713339426154,MATH 168A,A01,516677,Dumitriu; Ioana,16,0,35,19
1713339427181,MATH 170A,A01,516679,Dumitriu; Ioana,18,0,30,12
1713339427181,MATH 170A,A02,516680,Dumitriu; Ioana,28,0,30,2
1713339428211,MATH 193A,A01,494107,Staff,12,0,30,18
1713339428211,MATH 193A,A02,494108,Staff,18,0,30,12
1713339428211,MATH 193A,A03,494109,Staff,29,0,30,1
1713339428211,MATH 193A,A04,494110,Staff,22,0,30,8
1713339431324,MGT 16,A00,491930,McKay; Michael J,92,0,98,6
1713339432350,MGT 18,A00,491992,McKay; Michael J,96,0,98,2
1713339433379,MGT 71,A00,492003,Staff,63,0,98,35
1713339434405,MGT 103,A00,505209,Eberhard; Craig A,80,0,98,18
1713339435434,MGT 131A,A00,505210,Anderson; John Charles,89,0,98,9
1713339437488,MGT 153,A00,492077,Perols; Johan Lars,16,0,90,74
1713339440567,MGT 164,A00,492222,McKay; Mary A,91,0,98,7
1713339441595,MGT 172,A00,492245,Staff,59,0,60,1
1713339441595,MGT 172,B00,505526,Hedges; Kathleen,65,0,98,33
1713339442627,MGT 181,A00,505669,Dunn; Louis Jean,78,0,98,20
1713339443660,MMW 14,A01,494399,Staff,15,0,28,13
1713339443660,MMW 14,A02,494400,Staff,25,0,28,3
1713339443660,MMW 14,A03,494401,Staff,28,0,28,0
1713339443660,MMW 14,A04,494402,Staff,28,0,28,0
1713339443660,MMW 14,B01,494404,Carreras; Maria Victoria,8,0,28,20
1713339443660,MMW 14,B02,494405,Carreras; Maria Victoria,25,0,28,3
1713339443660,MMW 14,B03,494406,Carreras; Maria Victoria,27,0,28,1
1713339443660,MMW 14,B04,494407,Carreras; Maria Victoria,28,0,28,0
1713339444692,MMW 14GS,A00,506250,Chang; Edmond Yi-Teh,0,0,0,0
1713339445722,MMW 121R,A01,494415,Adamiak; Patrick John,10,0,28,18
1713339445722,MMW 121R,A02,494416,Adamiak; Patrick John,24,0,28,4
1713339446749,MUS 1A,A01,494113,Staff,12,0,25,13
1713339446749,MUS 1A,A02,494114,Staff,24,0,25,1
1713339447781,MUS 4,A01,494116,Staff,23,0,25,2
1713339447781,MUS 4,A02,494117,Staff,22,0,25,3
1713339448809,MUS 5R,A01,494236,Dubnov; Shlomo,4,0,25,21
1713339448809,MUS 5R,A02,494237,Dubnov; Shlomo,25,0,25,0
1713339449835,MUS 6,A01,494122,Staff,9,0,25,16
1713339449835,MUS 6,A02,494123,Staff,23,0,25,2
1713339450867,MUS 7,A01,494125,Staff,16,0,25,9
1713339450867,MUS 7,A02,494126,Staff,24,0,25,1
1713339451894,MUS 11,A01,494128,Staff,23,0,25,2
1713339451894,MUS 11,A02,494129,Staff,24,0,25,1
1713339452921,MUS 13,A01,494131,Staff,25,0,25,0
1713339452921,MUS 13,A02,494132,Staff,25,0,25,0
1713339453952,MUS 15,A01,494134,Staff,16,0,25,9
1713339453952,MUS 15,A02,494135,Staff,25,0,25,0
1713339453952,MUS 15,B01,494137,Staff,24,0,25,1
1713339454979,MUS 80,A00,494232,Staff,24,0,25,1
1713339454979,MUS 80,B00,494233,Staff,25,0,25,0
1713339454979,MUS 80,C00,494234,Staff,23,0,25,2
1713339456020,MUS 95C,A00,494141,Staff,69,0,75,6
1713339457049,MUS 114,A00,494142,Staff,39,0,50,11
1713339458087,NANO 15,A01,490636,Drews; Aaron,7,0,7,0
1713339459115,PHIL 1,A00,490578,Grush; Rick Scott,49,0,50,1
1713339460149,PHIL 10,A01,490580,Grush; Rick Scott,33,0,35,2
1713339460149,PHIL 10,A02,490586,Grush; Rick Scott,32,0,35,3
1713339461175,PHIL 27,A01,490591,Staff,22,0,25,3
1713339461175,PHIL 27,A02,490592,Staff,25,0,25,0
1713339461175,PHIL 27,A03,490593,Staff,25,0,25,0
1713339461175,PHIL 27,A04,490598,Staff,25,0,25,0
1713339462203,PHIL 32,A01,490611,Staff,20,0,20,0
1713339462203,PHIL 32,A02,490618,Staff,20,0,20,0
1713339463229,PHIL 90,A00,490624,Staff,40,0,40,0
1713339464256,PHIL 136,A00,490627,Cohen; Jonathan David,37,0,40,3
1713339465281,PHIL 155,A00,490634,Staff,62,0,70,8
1713339466314,PHYS 1A,A00,491610,Staff,245,0,250,5
1713339467344,PHYS 1AL,001,491616,Tsai; Philbert S,27,0,30,3
1713339467344,PHYS 1AL,002,491618,Tsai; Philbert S,30,0,30,0
1713339468373,PHYS 1B,A00,491623,Staff,235,0,250,15
1713339469401,PHYS 1BL,001,491626,Tsai; Philbert S,19,0,30,11
1713339469401,PHYS 1BL,002,491628,Tsai; Philbert S,26,0,30,4
1713339470497,PHYS 1C,A00,491632,Staff,212,0,245,33
1713339471523,PHYS 1CL,001,491635,Tsai; Philbert S,3,0,30,27
1713339471523,PHYS 1CL,002,491643,Tsai; Philbert S,22,0,30,8
1713339472549,PHYS 2AR,A01,491651,Meyertholen; Andrew D.,44,0,50,6
1713339473604,PHYS 2B,A01,491659,Staff,105,0,115,10
1713339474629,PHYS 2BL,A01,491685,Staff,21,0,24,3
1713339474629,PHYS 2BL,A02,491700,Staff,21,0,24,3
1713339475658,PHYS 2C,A01,505161,Staff,101,0,115,14
1713339476691,PHYS 4A,A01,491704,Grinstein; Benjamin,99,0,100,1
1713339477723,POLI 5D,A01,494144,Staff,3,0,5,2
1713339477723,POLI 5D,B01,626283,Dai; Yinlin,5,0,5,0
1713339478772,POLI 12,A00,494145,Staff,43,0,45,2
1713339479799,POLI 13R,A00,494146,Forman; Fonna,45,0,50,5
1713339480828,POLI 27,A01,494148,Staff,54,0,60,6
1713339481857,POLI 30,A00,494149,Staff,49,0,50,1
1713339482888,POLI 100DA,A00,494150,Staff,20,0,25,5
1713339484941,POLI 100I,A00,494152,Staff,27,0,30,3
1713339485966,POLI 104B,A00,494153,Smith; Glenn Chatmas,53,0,55,2
1713339486992,POLI 104F,A00,494154,Staff,28,0,30,2
1713339488022,POLI 104I,A00,494155,Smith; Glenn Chatmas,29,0,30,1
1713339489056,POLI 110C,A00,494156,Ingham; Sean,23,0,25,2
1713339490085,POLI 117R,A00,494157,Forman; Fonna,5,0,20,15
1713339491116,POLI 118,A00,494158,Ingham; Sean,21,0,25,4
1713339492141,POLI 120H,A00,494159,Fisk; David Lee,39,0,45,6
1713339493169,POLI 131CR,A00,494160,Hoston; Germaine,35,0,45,10
1713339494200,POLI 133J,A00,494161,Staff,31,0,35,4
1713339495234,POLI 135,A00,494162,Fisk; David Lee,33,0,35,2
1713339496261,POLI 140A,A00,494164,Staff,18,0,30,12
1713339497287,POLI 142I,A00,494165,Staff,30,0,30,0
1713339498316,POLI 144D,A00,494166,Staff,22,0,25,3
1713339499342,POLI 151,A00,494167,Staff,30,0,30,0
1713339500369,POLI 153,A00,494168,Staff,33,0,35,2
1713339501397,POLI 160AA,A00,494169,Staff,33,0,40,7
1713339502425,POLI 162,A00,494170,Mignozzetti; Umberto,18,0,25,7
1713339503455,POLI 171,A00,494171,Mignozzetti; Umberto,18,0,25,7
1713339504484,PSYC 1,A00,494172,Staff,95,0,100,5
1713339505520,PSYC 2,A00,494173,Moranton; Nirelia Melbina-,34,0,50,16
1713339506547,PSYC 3,A00,494174,Staff,29,0,30,1
1713339507577,PSYC 6,A00,494175,Staff,17,0,20,3
1713339508607,PSYC 60,A01,494177,Staff,37,0,45,8
1713339509639,PSYC 70,A01,505724,Geller; Emma Harlan,42,0,45,3
1713339510665,PSYC 101,A00,494180,Heyman; Gail D.,84,0,100,16
1713339511694,PSYC 105,A00,494181,Geller; Emma Harlan,51,0,90,39
1713339512723,PSYC 106,A00,494182,Dobkins; Karen R.,26,0,45,19
1713339513750,PSYC 108,A00,494183,Adrian; Julia Anna,89,0,100,11
1713339514777,PSYC 114,A01,494185,Winkielman; Piotr,0,3,30,30
1713339515803,PSYC 122,A00,494186,Moranton; Nirelia Melbina-,27,0,50,23
1713339516829,PSYC 124,A00,494187,Chapman; Eddie Nathaniel,69,0,80,11
1713339517856,PSYC 131,A00,494188,Anagnostaras; Stephan,40,0,80,40
1713339518886,PSYC 144,A00,494189,Staff,1,0,50,49
1713339519916,PSYC 154,A00,494190,Lacefield; Katharine I,105,0,180,75
1713339520948,PSYC 162,A00,494191,Wixted; John T,70,0,100,30
1713339521974,PSYC 172,A00,494192,Gorman; Michael R.,36,0,45,9
1713339523001,PSYC 178,A00,494193,Glaser; Dale,34,0,45,11
1713339524028,PSYC 193,A00,505725,Chapman; Eddie Nathaniel,20,0,20,0
1713339525054,RELI 145GS,A00,519817,Rahimi; Babak,17,0,20,3
1713339526084,SE 101A,A01,490862,Chadha; Mayank,23,0,25,2
1713339527112,SE 101C,A01,490924,Krysl; Petr,15,0,20,5
1713339528139,SE 110A,A01,490928,Staff,19,0,20,1
1713339529172,SE 130A,A00,490929,Morrison; Machel Leigh,54,0,70,16
1713339530216,SIO 1,A01,519325,Staff,39,0,40,1
1713339531242,SIO 30,A01,519327,Staff,38,0,40,2
1713339532268,SIO 40,A00,519328,Staff,39,0,40,1
1713339533294,SIO 46GS,A00,519819,Cook; Geoffrey W,15,0,25,10
1713339534321,SIO 109R,A00,494197,Forman; Fonna,0,3,20,20
1713339535349,SIO 121GS,A00,519827,Cook; Geoffrey W,15,0,25,10
1713339536379,SIO 132,A01,519330,Staff,38,0,40,2
1713339537405,SIO 133,A01,519397,Staff,37,0,40,3
1713339538431,SIO 139,A00,519396,Kacev; David,29,0,40,11
1713339539459,SOCI 1,A01,494199,Thorpe; Charles Robert,21,0,30,9
1713339539459,SOCI 1,A02,494200,Thorpe; Charles Robert,30,0,30,0
1713339539459,SOCI 1,A03,494201,Thorpe; Charles Robert,29,0,30,1
1713339539459,SOCI 1,A04,494202,Thorpe; Charles Robert,29,0,30,1
1713339539459,SOCI 1,A05,494203,Thorpe; Charles Robert,29,0,30,1
1713339539459,SOCI 1,A06,494204,Thorpe; Charles Robert,30,0,30,0
1713339539459,SOCI 1,A07,494205,Thorpe; Charles Robert,28,0,30,2
1713339540484,SOCI 60,A01,494207,Staff,33,0,40,7
1713339540484,SOCI 60,A02,494208,Staff,39,0,40,1
1713339541524,SOCI 100,A01,494210,Payne; Christine Anna,25,0,30,5
1713339541524,SOCI 100,A02,494211,Payne; Christine Anna,26,0,30,4
1713339542549,SOCI 109M,A00,494212,Staff,20,0,20,0
1713339543575,SOCI 110,A00,494213,Staff,34,0,40,6
1713339545635,SOCI 118E,A00,494215,Ng; Kwai,37,0,40,3
1713339546662,SOCI 125,A00,494216,Calderon-Zaks; Michael Aar,39,0,45,6
1713339547693,SOCI 126,A01,494218,Jones; Makeba,3,0,5,2
1713339548722,SOCI 131,A00,494219,Thorpe; Charles Robert,26,0,30,4
1713339550791,SOCI 135,A00,494221,Payne; Christine Anna,28,0,50,22
1713339551826,SOCI 136E,A00,626690,Ruiz; Jonathan Joseph,24,0,25,1
1713339552858,SOCI 138GS,A00,494222,Navon; Daniel,23,0,28,5
1713339554938,SOCI 145,A00,494224,Staff,40,0,45,5
1713339555965,SOCI 153,A00,494225,Staff,28,0,30,2
1713339556997,SOCI 160E,A00,494226,Ng; Kwai,27,0,40,13
1713339558027,SOCI 180,A00,494227,Staff,29,0,30,1
1713339559052,SOCI 189GS,A00,494228,Ribas Norris; Janet Vanesa,11,0,11,0
1713339560082,SOCI 190GS,A00,553232,Ribas Norris; Janet Vanesa,11,0,11,0
1713339561109,SOMI 220,A00,627178,Schneid; Stephen David,30,0,30,0
1713339562141,SYN 2,001,490768,Staff,13,0,15,2
1713339562141,SYN 2,002,490769,Staff,14,0,15,1
1713339562141,SYN 2,004,490775,Staff,0,0,0,0
1713339562141,SYN 2,003,490774,Staff,0,0,0,0
1713339562141,SYN 2,005,490776,Staff,0,0,0,0
1713339563169,SYN 2R,001,490779,Staff,11,0,15,4
1713339563169,SYN 2R,002,514635,Staff,14,0,15,1
1713339564197,SYN 100,A01,490783,Staff,8,0,20,12
1713339564197,SYN 100,B01,490787,Staff,10,0,20,10
1713339564197,SYN 100,C01,490789,Staff,10,0,20,10
1713339565222,SYN 150,A00,490817,Staff,14,0,15,1
1713339565222,SYN 150,B00,514610,Staff,15,0,15,0
1713339566261,TDAC 1,A00,492753,Walsh; Kim C.,19,0,20,1
1713339566261,TDAC 1,B00,492754,Harting; Carla Kelso,18,0,20,2
1713339566261,TDAC 1,C00,513995,Salovey; Todd,15,0,20,5
1713339567288,TDAC 101,A00,492766,Harting; Carla Kelso,17,0,20,3
1713339568313,TDAC 102,A00,492768,Basso; Beatrice,19,0,20,1
1713339569339,TDDE 111,A00,492769,Staff,25,0,25,0
1713339570371,TDDE 131,A00,492770,Staff,15,0,15,0
1713339570371,TDDE 131,B00,492771,Staff,15,0,15,0
1713339571399,TDDE 131GS,A00,523716,Guirguis; Mark C,23,0,28,5
1713339572432,TDGE 1,A01,492756,Salovey; Todd,56,0,60,4
1713339573461,TDGE 5,A01,492758,Staff,23,0,25,2
1713339574545,TDGE 10,A00,492759,Fulton; Julia,203,0,220,17
1713339575571,TDGE 11,A00,492760,Castro; Robert Jess,198,0,200,2
1713339577622,TDGE 124,A00,492772,Fulton; Julia,181,0,220,39
1713339578660,TDGE 125,A00,492773,Meyer; Ursula,38,0,50,12
1713339578660,TDGE 125,B00,492774,Staff,49,0,50,1
1713339578660,TDGE 125,C00,523565,Staff,48,0,50,2
1713339579688,TDGE 125GS,A00,523580,Guirguis; Mark C,23,0,28,5
1713339580721,TDGE 127,A00,492775,Havis; Allan,32,0,50,18
1713339581753,TDHT 101,A00,492776,Staff,34,0,35,1
1713339582786,TDMV 1,A00,492762,Caligagan; Maria T.,29,0,30,1
1713339582786,TDMV 1,B00,492763,Arcidiacono; Kristin,26,0,30,4
1713339583812,TDMV 2,A00,492764,Weinberg; Sadie,27,0,30,3
1713339584847,TDMV 3,A00,492765,Mack; Kara Shanai',37,0,40,3
1713339585878,TDMV 138,A00,492777,Mack; Kara Shanai',32,0,40,8
1713339586905,TDMV 140,A00,492778,Lima; Paulo Henrique,40,0,40,0
1713339587937,TDMV 142,A00,492779,Caligagan; Maria T.,33,0,40,7
1713339587937,TDMV 142,B00,492780,Caligagan; Tony,37,0,40,3
1713339588967,TDMV 143,A00,492781,Fyall; Daunte Edward,39,0,40,1
1713339589998,USP 1,A01,492401,Kwak; Nancy,27,0,35,8
1713339591029,USP 2,A01,492453,Hinds; Juli Beth,35,0,35,0
1713339592055,USP 3,A01,492516,Staff,28,0,35,7
1713339593081,USP 4,A00,492522,McTague; Sarah,16,0,25,9
1713339594109,USP 100,A00,492523,Staff,32,0,35,3
1713339595136,USP 101,A00,492524,Staff,13,0,15,2
1713339596163,USP 105,A00,492525,Staff,21,0,25,4
1713339597189,USP 151,A00,492526,Shenkman; Michael Thomas,32,0,35,3
1713339598222,USP 170,A00,492545,Hinds; Juli Beth,33,0,35,2
1713339599251,USP 171GS,A00,492608,Bussell; Mirle Rabinowitz,24,0,28,4
1713339600278,USP 183GS,A00,492613,Peerson; Susan,24,0,28,4
1713339601317,VIS 30,A01,490693,Yoldas; Pinar,19,0,22,3
1713339601317,VIS 30,A02,490694,Yoldas; Pinar,18,0,22,4
1713339602345,VIS 83,A00,490695,Kester; Grant,63,0,75,12
1713339603371,VIS 105D,A00,490696,Staff,22,0,25,3
1713339604398,VIS 124CN,A00,490699,Rose; Jordan M,64,0,75,11
1713339605429,VIS 125GS,A00,511221,Williams; Alena J,21,0,22,1
1713339606457,VIS 128D,A00,490700,Staff,73,0,75,2
1713339607486,VIS 151,A01,490717,Staff,33,0,34,1
1713339607486,VIS 151,A02,490766,Staff,33,0,34,1
1713339608516,VIS 154GS,A00,511972,Williams; Alena J,21,0,22,1
1713339609559,VIS 160A,A00,490767,Stone; Patricia,7,0,10,3
1713339610589,WCWP 10A,A00,490638,Staff,14,0,15,1
1713339610589,WCWP 10A,B00,490640,Staff,15,0,15,0
1713339611619,WCWP 10B,A00,490641,Staff,0,0,0,0
1713339611619,WCWP 10B,B00,490642,Staff,14,0,15,1
1713339611619,WCWP 10B,C00,490644,Staff,13,0,15,2
1713339611619,WCWP 10B,D00,490647,Staff,0,0,0,0
1713339612646,WCWP 100,A00,490655,Staff,0,0,0,0
1713339612646,WCWP 100,B00,490687,Staff,10,0,15,5
1713339614864,ANAR 153,A00,487222,Braswell; Geoffrey E.,53,0,60,7
1713339615893,ANBI 134,A00,487223,Staff,6,0,20,14
1713339616922,ANBI 143GS,A00,487224,Noel; Geoffroy Pierre Jean,18,0,24,6
1713339617952,ANBI 144GS,A00,519548,Noel; Geoffroy Pierre Jean,18,0,24,6
1713339618982,ANSC 101,A00,487225,Staff,17,0,20,3
1713339620008,ANSC 125,A00,487227,Brenner; Suzanne A,38,0,40,2
1713339622063,ANSC 146,A00,487229,Staff,35,0,40,5
1713339623090,ANSC 148,A00,487230,Olivas Hernandez; Olga Lid,39,0,40,1
1713339624116,ANSC 150,A00,504165,Sloane; Julia Kathryn,18,0,20,2
1713339625143,ANSC 180,A00,487232,Staff,14,0,15,1
1713339626170,ANSC 188,A00,627155,Staff,38,0,40,2
1713339627197,ANTH 5,A00,519529,Semendeferi; Ekaterini,15,0,15,0
1713339628222,ANTH 10,A00,487219,Staff,58,0,60,2
1713339629248,ANTH 23,A01,487221,Staff,17,0,20,3
1713339630276,ANTH 102,A00,487233,Wilder; Linnea Lorene,50,0,60,10
1713339631302,ANTH 103,A00,487234,Varma; Saiba,54,0,60,6
1713339632334,ANTH 105,A00,487235,Stewart; Alexander B,54,0,60,6
1713339633457,BENG 100,A01,516685,Taylor Amos; Alyssa C,25,0,30,5
1713339634488,BIBC 102,A01,491316,Flagg; Matthew Paul,6,0,88,82
1713339634488,BIBC 102,A02,491366,Flagg; Matthew Paul,78,0,88,10
1713339635516,BIBC 103,A01,491486,Boumechache; Miyyada,16,0,24,8
1713339635516,BIBC 103,A02,491487,Boumechache; Miyyada,24,0,24,0
1713339636651,BICD 100,A01,516882,Staff,73,0,75,2
1713339636651,BICD 100,A02,516890,Staff,69,0,75,6
1713339637676,BICD 102GS,A00,491488,Lo; Stanley M.,26,0,28,2
1713339638710,BIEB 136GS,A00,516940,Holway; David A. & Shurin; Jonathan,18,0,24,6
1713339639735,BIEB 137GS,A01,517034,Holway; David A. & Shurin; Jonathan,18,0,24,6
1713339640766,BIEB 138GS,A01,491492,Pirino; Giorgia,21,0,28,7
1713339641797,BILD 1,A01,491296,Staff,60,0,63,3
1713339641797,BILD 1,A02,491297,Staff,63,0,63,0
1713339642824,BILD 4,A01,517099,Gonzalez Gamboa; Ivonne,22,0,24,2
1713339642824,BILD 4,A02,517100,Gonzalez Gamboa; Ivonne,24,0,24,0
1713339643854,BILD 60GS,A00,491309,Lo; Stanley M.,26,0,28,2
1713339644881,BIMM 100,A01,517136,Staff,82,0,100,18
1713339645938,BIMM 110,A01,517182,Staff,53,0,100,47
1713339646967,BIMM 120,A01,517228,Pickett; Brooke Elizabeth,28,0,63,35
1713339646967,BIMM 120,A02,517240,Pickett; Brooke Elizabeth,44,0,63,19
1713339647994,BIMM 132GS,A01,491498,Pirino; Giorgia,21,0,28,7
1713339649213,BIMM 143,A01,491589,Bozinovic; Goran,12,0,40,28
1713339650241,BIPN 100,A01,491594,Armour; Jon Christopher,83,0,100,17
1713339651273,BIPN 140,A01,491602,Marino; Marc J,23,0,50,27
1713339653331,CAT 125,A00,515973,Staff,18,0,20,2
1713339654358,CAT 125GS,A00,515974,Rahimi; Babak,16,0,20,4
1713339655393,CAT 125R,A00,515980,Staff,12,0,20,8
1713339655393,CAT 125R,B00,515981,Tosun; Adriana,19,0,20,1
1713339655393,CAT 125R,C00,515987,Hyland; Tina Mae,0,5,20,20
1713339655393,CAT 125R,D00,515988,Bronstein; Phoebe Malan,16,0,20,4
1713339656427,CENG 15,A01,488699,Drews; Aaron,25,0,25,0
1713339657518,CENG 100,A00,505196,Opatkiewicz; Justin Paul,25,0,25,0
1713339658548,CGS 2A,A01,489598,Staff,32,0,35,3
1713339659577,CGS 112,A00,489599,Staff,15,0,15,0
1713339660608,CGS 119,A00,489603,Staff,10,0,10,0
1713339661633,CGS 120,A00,489604,Staff,13,0,15,2
1713339662659,CGS 150,A00,489607,Staff,15,0,15,0
1713339663689,CHEM 6A,A01,488715,Staff,97,0,100,3
1713339664725,CHEM 6B,A01,488719,Piercy; Marc Anthony,99,0,100,1
1713339665757,CHEM 6C,A01,488723,Albizati; Kim F.,93,0,100,7
1713339666796,CHEM 7L,A01,488728,Schurmeier; Kimberly,18,0,24,6
1713339666796,CHEM 7L,A02,488730,Schurmeier; Kimberly,23,0,24,1
1713339666796,CHEM 7L,A03,488734,Schurmeier; Kimberly,20,0,24,4
1713339666796,CHEM 7L,A04,488763,Schurmeier; Kimberly,23,0,24,1
1713339666796,CHEM 7L,B01,488798,Schurmeier; Kimberly,16,0,24,8
1713339666796,CHEM 7L,B02,488801,Schurmeier; Kimberly,22,0,24,2
1713339666796,CHEM 7L,B03,488808,Schurmeier; Kimberly,22,0,24,2
1713339666796,CHEM 7L,B04,488811,Schurmeier; Kimberly,24,0,24,0
1713339667826,CHEM 11,A01,488897,Stallings; Dontarie M,95,0,100,5
1713339668856,CHEM 40A,A01,488913,Albizati; Kim F.,83,0,100,17
1713339669883,CHEM 40B,A01,488920,Weizman; Haim,42,0,50,8
1713339669883,CHEM 40B,A02,488938,Weizman; Haim,43,0,50,7
1713339670912,CHEM 41A,A01,489029,Klosterman; Jeremy K,57,0,60,3
1713339671939,CHEM 41C,A01,500436,Tor; Yitzhak,55,0,60,5
1713339672977,CHEM 43A,A01,500426,Weizman; Haim,0,1,24,24
1713339672977,CHEM 43A,A02,500430,Weizman; Haim,5,0,24,19
1713339672977,CHEM 43A,B01,514041,Klosterman; Jeremy K,15,0,24,9
1713339672977,CHEM 43A,B02,514047,Klosterman; Jeremy K,23,0,24,1
1713339674009,CHEM 108,A01,489140,Jennings; Patricia A.,7,0,24,17
1713339674009,CHEM 108,A02,489142,Jennings; Patricia A.,14,0,24,10
1713339675036,CHEM 114A,A01,489147,Stallings; Dontarie M,65,0,100,35
1713339676063,CHIN 169A,A00,489171,Wang; Xiao,19,0,20,1
1713339678115,COGS 3,A01,518827,Boyle; Mary E. T.,25,0,40,15
1713339679202,COGS 11,A01,489175,Staff,27,0,30,3
1713339680233,COGS 14A,A01,518829,Staff,50,0,60,10
1713339681267,COGS 14B,A01,489177,Hoffman; Drew Ellen,62,0,75,13
1713339682302,COGS 100,A01,489181,Allen; Michael Gordon,62,0,75,13
1713339683327,COGS 101A,A01,489183,Staff,45,0,60,15
1713339684353,COGS 101B,A01,489185,Allen; Michael Gordon,6,0,30,24
1713339685379,COGS 101C,A01,526786,Staff,23,0,30,7
1713339687433,COGS 107A,A01,489189,Boyle; Mary E. T.,16,0,35,19
1713339688498,COGS 107B,A01,627144,Mooshagian; Eric Frederick,60,0,60,0
1713339689525,COGS 118A,A01,489191,Staff,0,46,40,40
1713339691581,COGS 171GS,A01,489194,Pineda; Jaime A,19,0,28,9
1713339692608,COGS 172,A01,489196,Staff,2,0,30,28
1713339693637,COGS 174GS,A01,489264,Pineda; Jaime A,19,0,28,9
1713339694661,COGS 180,A01,627150,Staff,28,0,30,2
1713339695688,COGS 186,A01,489274,Staff,0,2,30,30
1713339696717,COMM 10,A01,489276,Staff,23,0,25,2
1713339696717,COMM 10,A02,489303,Staff,23,0,25,2
1713339697749,COMM 100A,A01,489312,Staff,14,0,25,11
1713339697749,COMM 100A,A02,489313,Staff,24,0,25,1
1713339698778,COMM 106T,A00,512540,Staff,33,0,35,2
1713339699807,COMM 107,A00,489347,Staff,27,0,35,8
1713339700834,COMM 109P,A00,489358,Staff,31,0,35,4
1713339701862,COMM 132,A00,489361,McKenna; Denise,27,0,30,3
1713339702890,COMM 146,A00,489362,Halm; Gavin Patrick,26,0,30,4
1713339703916,COMM 190,A00,489363,Abuelhiga; Soraya Jill,17,0,23,6
1713339704945,CSE 8A,A50,489366,Staff,21,0,25,4
1713339704945,CSE 8A,A51,489367,Staff,24,0,25,1
1713339705980,CSE 11,A01,489398,Cao; Yingjun,73,0,100,27
1713339707008,CSE 12,A01,489487,Staff,43,0,50,7
1713339708034,CSE 20,A01,489497,Staff,47,0,50,3
1713339709067,CSE 21,A01,489517,Braun; Oliver,42,0,50,8
1713339710093,CSE 101,A01,489524,Braun; Oliver,0,33,50,50
1713339711126,CSE 105,A01,512594,Jones; Miles E,72,0,100,28
1713339711126,CSE 105,B01,512598,Jones; Miles E,51,0,100,49
1713339712152,CSE 140,A01,489538,Staff,41,0,50,9
1713339713186,CSE 141,A01,489550,Eldon; John,67,0,100,33
1713339714217,CSE 141L,A01,489571,Eldon; John,65,0,100,35
1713339715243,CSE 151A,A01,489583,Solares; Edwin A,140,0,200,60
1713339716271,CSE 175,A01,510886,Kumar; Rakesh,30,0,30,0
1713339717299,CSE 190,A00,516828,Dubnov; Shlomo,37,0,49,12
1713339718325,DOC 100D,A00,489667,Pass; Natalye Joann,19,0,25,6
1713339719355,DSC 10,A01,624268,Staff,72,0,75,3
1713339720382,DSC 20,A01,624476,Staff,50,0,50,0
1713339721413,DSC 40A,A01,624608,Staff,39,0,40,1
1713339722445,DSGN 1,A01,489179,Rill; Bryan,32,0,50,18
1713339723477,ECE 17,A01,490489,Sahay; Rajeev,18,0,30,12
1713339724503,ECE 65,A50,490492,Staff,11,0,20,9
1713339724503,ECE 65,A51,490493,Staff,18,0,20,2
1713339725531,ECON 1,A01,489715,Famulari; Melissa,67,0,70,3
1713339726563,ECON 2,A01,489717,Levkoff; Steven B.,67,0,70,3
1713339727593,ECON 3,A01,489948,Staff,70,0,70,0
1713339729651,ECON 5,A01,490103,Staff,27,0,30,3
1713339729651,ECON 5,B01,626281,Dai; Yinlin,45,0,45,0
1713339730679,ECON 100A,A01,490127,Famulari; Melissa,63,0,70,7
1713339731709,ECON 100B,A01,490129,Staff,64,0,70,6
1713339732741,ECON 109,A01,490187,Shishkin; Denis,27,0,35,8
1713339733844,ECON 110A,A01,490190,Levkoff; Steven B.,59,0,70,11
1713339734871,ECON 120A,A01,490245,Dai; Yinlin,60,0,70,10
1713339735896,ECON 120B,A01,490247,Nieto-Barthaburu; Augusto,40,0,70,30
1713339736928,ECON 120C,A01,490253,Sun; Yixiao,30,0,35,5
1713339736928,ECON 120C,B01,490255,Sun; Yixiao,34,0,35,1
1713339737960,ECON 129,A00,490256,Eckert; Fabian Paul,22,0,35,13
1713339738988,ECON 131,A00,490257,Nieto-Barthaburu; Augusto,0,6,35,35
1713339740016,ECON 138,A00,490258,Bharadwaj; Prashant,13,0,35,22
1713339740016,ECON 138,B00,490259,Bharadwaj; Prashant,15,0,35,20
1713339741042,ECON 159,A00,490260,Hendrickson; Gerald M.,0,9,0,0
1713339742069,ECON 178,A01,553995,Zhu; Ying,24,0,35,11
1713339743099,EDS 40,A01,512576,Black; Alison Michelle,20,0,20,0
1713339744140,EDS 107,A01,515848,Staff,30,0,30,0
1713339745171,EDS 110R,A01,490262,Staff,26,0,30,4
1713339746200,EDS 112,A01,490264,Chapman; Thandeka K,40,0,50,10
1713339747226,EDS 113,A00,490266,Staff,25,0,30,5
1713339748255,EDS 118,A00,490267,Warstadt; Melissa Fawn,18,0,30,12
1713339749283,EDS 124BR,A00,490268,Eguchi; Emi,4,0,25,21
1713339749283,EDS 124BR,B00,490269,Eguchi; Emi,23,0,25,2
1713339750309,EDS 126,A01,490271,Jones; Makeba,43,0,50,7
1713339751359,EDS 135,A01,490316,Staff,19,0,20,1
1713339752385,ENVR 142GS,A00,519514,Chang; Edmond Yi-Teh,26,0,28,2
1713339753416,ETHN 103,A00,490504,Staff,25,0,36,11
1713339754489,ETHN 103A,A00,490505,Man; Simeon S,3,0,9,6
1713339755516,ETHN 109,A00,490506,Staff,28,0,30,2
1713339756542,ETHN 118,A00,490507,Staff,35,0,36,1
1713339757569,ETHN 119,A00,490508,Staff,32,0,36,4
1713339758598,ETHN 121R,A00,490518,Choi; Esther Min,21,0,36,15
1713339759626,ETHN 127,A00,490528,Staff,14,0,15,1
1713339760655,ETHN 139,A00,490573,Staff,10,0,10,0
1713339761686,ETHN 150,A00,490575,Staff,15,0,15,0
1713339762722,GLBH 20,A00,491705,Elwardani; Nile Regina,38,0,40,2
1713339763748,GLBH 101,A00,491706,Staff,20,0,20,0
1713339764775,GLBH 111,A01,491708,Burgos; Jose L.,15,0,15,0
1713339765801,GLBH 146,A00,491709,Staff,8,0,20,12
1713339766828,GLBH 148,A00,491710,Olivas Hernandez; Olga Lid,10,0,20,10
1713339767857,GLBH 150,A00,491711,Sloane; Julia Kathryn,19,0,20,1
1713339768885,HIEA 131,A00,491760,Staff,28,0,32,4
1713339769912,HIEA 153,A00,491762,Staff,28,0,30,2
1713339770937,HIEU 124,A00,491811,Staff,26,0,32,6
1713339771966,HIEU 124GS,A00,491812,Markman; Kristina,27,0,28,1
1713339772992,HIEU 147,A00,491813,Staff,30,0,32,2
1713339774019,HIEU 149GS,A00,491816,Caldwell; Michael Alan,28,0,28,0
1713339775047,HILD 2C,A01,491713,Hendrickson; Gerald M.,26,0,30,4
1713339776073,HILD 7B,A01,491715,Kwak; Nancy,0,2,30,30
1713339777103,HILD 10,A01,491717,Staff,9,0,20,11
1713339778132,HILD 30GS,A00,491719,Edington; Claire Ellen,23,0,28,5
1713339779164,HINE 109,A00,491818,Shafir; Nir,27,0,32,5
1713339780188,HINE 128,A00,491821,Shafir; Nir,30,0,32,2
1713339781218,HISC 117,A00,491830,Staff,27,0,32,5
1713339782250,HIUS 103,A00,491834,Man; Simeon S,14,0,23,9
1713339783331,HIUS 108B,A00,491835,Staff,27,0,30,3
1713339784361,HIUS 141,A00,491836,Hendrickson; Gerald M.,28,0,32,4
1713339785390,HIUS 149,A00,491839,Staff,24,0,32,8
1713339786420,HUM 3,A01,512617,Crum; Matthew Stephen,42,0,50,8
1713339786420,HUM 3,A02,512618,Crum; Matthew Stephen,48,0,50,2
1713339787447,HUM 3GS,A00,512663,Markman; Kristina,0,0,0,1
1713339787447,HUM 3GS,B00,512664,Staff,0,0,0,0
1713339788478,HUM 4,A01,512620,West; Geoffrey Scott,25,0,50,25
1713339789502,HUM 4GS,A00,512666,Lyon; Antony J.,0,0,0,5
1713339790529,HUM 4R,A01,512625,Watkins; Eric,49,0,50,1
1713339791574,HUM 5,A01,512649,Zavodny; Tatiana Sophia,20,0,50,30
1713339791574,HUM 5,B01,512661,Zroka; Ryan Edward,48,0,50,2
1713339792603,INTL 190,A00,490577,Segui; Alan S,0,0,0,5
1713339793633,JAPN 20AR,A01,491267,Ross; Kayoko F,7,0,20,13
1713339794660,JAPN 180,A00,491285,Berman; Michael David,33,0,40,7
1713339795698,LATI 50,A01,502536,Kokinis; Troy Andreas,16,0,22,6
1713339795698,LATI 50,A02,502551,Kokinis; Troy Andreas,22,0,22,0
1713339795698,LATI 50,A03,502650,Kokinis; Troy Andreas,22,0,22,0
1713339795698,LATI 50,A04,502909,Kokinis; Troy Andreas,21,0,22,1
1713339796723,LATI 160,A01,502920,Kokinis; Troy Andreas,30,0,30,0
1713339797751,LIFR 1A,A00,490494,Van Moer; Vinciane G,17,0,20,3
1713339798782,LIFR 1AX,A00,490495,Van Moer; Vinciane G,17,0,20,3
1713339799806,LIFR 1B,A00,490496,Van Moer; Vinciane G,17,0,20,3
1713339800833,LIFR 1BX,A00,490497,Van Moer; Vinciane G,17,0,20,3
1713339801861,LIGN 8,A00,505198,McIntosh; Justin Daniel,134,0,150,16
1713339802887,LIGN 9GS,A00,491239,Lott; Margaret S.,18,0,20,2
1713339803913,LIGN 101,A01,505200,McIntosh; Justin Daniel,22,0,30,8
1713339804944,LIGN 120,A01,491244,Staff,22,0,30,8
1713339805970,LIGN 149GS,A00,491245,Lott; Margaret S.,18,0,20,2
1713339807000,LIGN 170,A00,491247,Staff,22,0,30,8
1713339808027,LISP 1D,A00,490498,Munoz Sanchez; Alicia,8,0,14,6
1713339808027,LISP 1D,B00,490499,Munoz Sanchez; Alicia,4,0,14,10
1713339808027,LISP 1D,C00,490500,Munoz Sanchez; Alicia,7,0,14,7
1713339808027,LISP 1D,D00,490501,Munoz Sanchez; Alicia,10,0,14,4
1713339809059,LISP 1DX,A00,490502,Munoz Sanchez; Alicia,11,0,28,17
1713339809059,LISP 1DX,B00,490503,Munoz Sanchez; Alicia,16,0,28,12
1713339811117,LTAM 110,A00,491847,Staff,22,0,25,3
1713339812144,LTCS 119,A00,491848,Staff,11,0,15,4
1713339813172,LTCS 130,A00,491849,Staff,24,0,25,1
1713339815229,LTEA 120C,A00,491852,Staff,32,0,40,8
1713339816260,LTEN 130GS,A00,491853,Lyon; Antony J.,23,0,28,5
1713339817286,LTEN 148,A00,491855,Staff,23,0,25,2
1713339818313,LTEN 159,A00,491856,Staff,20,0,25,5
1713339819337,LTEN 180,A00,491857,Staff,8,0,15,7
1713339821389,LTSP 123GS,A00,505928,Bessett; Ryan Matthew,24,0,28,4
1713339822413,LTSP 174GS,A00,506037,Bessett; Ryan Matthew,24,0,28,4
1713339824468,LTWR 102,A00,491861,Staff,9,0,15,6
1713339825498,LTWR 106,A00,491862,Staff,8,0,15,7
1713339826527,MAE 11,A00,490930,Bahadori; Mohammad Yousef,94,0,100,6
1713339827569,MAE 30A,A00,490931,Qi; Huihui,37,0,40,3
1713339828597,MAE 101A,A00,491036,Sadeghizadeh; Zahra,91,0,100,9
1713339829637,MAE 101C,A00,491037,Seshadri; Kalyanasundaram,63,0,100,37
1713339830665,MAE 113,A00,491040,Seshadri; Kalyanasundaram,64,0,80,16
1713339831692,MAE 131A,A00,491041,Ghazinejad; Maziar,37,0,40,3
1713339832720,MAE 142,A00,491053,Staff,39,0,40,1
1713339833747,MAE 143A,A00,491054,Staff,29,0,50,21
1713339834840,MAE 150,A00,491092,Truong; Phuong Thi Ngoc,23,0,35,12
1713339835873,MATH 3C,A01,494031,Pardo Guerra; Sebastian,30,0,30,0
1713339835873,MATH 3C,A02,494032,Pardo Guerra; Sebastian,29,0,30,1
1713339836899,MATH 10A,A01,494034,Staff,27,0,30,3
1713339836899,MATH 10A,A02,494035,Staff,28,0,30,2
1713339836899,MATH 10A,B01,494037,Staff,27,0,30,3
1713339836899,MATH 10A,B02,494038,Staff,29,0,30,1
1713339837929,MATH 10B,A01,494040,Habib; Yousaf,22,0,30,8
1713339837929,MATH 10B,A02,494041,Habib; Yousaf,28,0,30,2
1713339837929,MATH 10B,A03,494042,Habib; Yousaf,29,0,30,1
1713339837929,MATH 10B,A04,494043,Habib; Yousaf,30,0,30,0
1713339837929,MATH 10B,B01,494045,Habib; Yousaf,25,0,30,5
1713339837929,MATH 10B,B02,494046,Habib; Yousaf,30,0,30,0
1713339837929,MATH 10B,B03,494047,Habib; Yousaf,30,0,30,0
1713339837929,MATH 10B,B04,494048,Habib; Yousaf,30,0,30,0
1713339838963,MATH 18,A01,494050,Kemp; Todd Aahron,25,0,30,5
1713339838963,MATH 18,A02,494051,Kemp; Todd Aahron,29,0,30,1
1713339838963,MATH 18,B01,494054,Kemp; Todd Aahron,25,0,30,5
1713339838963,MATH 18,B02,494055,Kemp; Todd Aahron,29,0,30,1
1713339840020,MATH 20A,A01,494059,Suk; Andrew Hoon,30,0,30,0
1713339841049,MATH 20B,A01,494061,Briones; Jor-el Thomas Caparas,33,0,35,2
1713339841049,MATH 20B,B01,494063,Bach; Quang Tran,34,0,35,1
1713339842084,MATH 20C,A01,494065,Staff,28,0,30,2
1713339842084,MATH 20C,A02,494066,Staff,30,0,30,0
1713339842084,MATH 20C,A03,494067,Staff,30,0,30,0
1713339842084,MATH 20C,A04,494068,Staff,30,0,30,0
1713339842084,MATH 20C,B01,494070,Zhang; Ming,24,0,30,6
1713339842084,MATH 20C,B02,494071,Zhang; Ming,27,0,30,3
1713339842084,MATH 20C,B03,494072,Zhang; Ming,29,0,30,1
1713339842084,MATH 20C,B04,494073,Zhang; Ming,29,0,30,1
1713339843115,MATH 20D,A01,494075,Staff,22,0,30,8
1713339843115,MATH 20D,A02,494076,Staff,29,0,30,1
1713339844144,MATH 20E,A01,494079,Staff,24,0,30,6
1713339844144,MATH 20E,A02,494080,Staff,26,0,30,4
1713339844144,MATH 20E,B01,494082,Staff,25,0,30,5
1713339844144,MATH 20E,B02,494083,Staff,25,0,30,5
1713339845170,MATH 103A,A01,494085,Aliabadi Sr.; Mohsen,12,0,30,18
1713339845170,MATH 103A,A02,494086,Aliabadi Sr.; Mohsen,28,0,30,2
1713339845170,MATH 103A,B01,494088,Aliabadi Sr.; Mohsen,20,0,30,10
1713339845170,MATH 103A,B02,494089,Aliabadi Sr.; Mohsen,27,0,30,3
1713339846277,MATH 109,A01,494091,Staff,30,0,30,0
1713339846277,MATH 109,A02,494092,Staff,29,0,30,1
1713339846277,MATH 109,B01,494094,Staff,27,0,30,3
1713339846277,MATH 109,B02,494095,Staff,29,0,30,1
1713339847313,MATH 142A,A01,494097,Chow; Bennett,13,0,30,17
1713339847313,MATH 142A,A02,494098,Chow; Bennett,23,0,30,7
1713339847313,MATH 142A,B01,494100,Chow; Bennett,19,0,30,11
1713339847313,MATH 142A,B02,494101,Chow; Bennett,29,0,30,1
1713339849368,MATH 168A,A01,516677,Dumitriu; Ioana,16,0,35,19
1713339850400,MATH 170A,A01,516679,Dumitriu; Ioana,18,0,30,12
1713339850400,MATH 170A,A02,516680,Dumitriu; Ioana,28,0,30,2
1713339851426,MATH 193A,A01,494107,Staff,12,0,30,18
1713339851426,MATH 193A,A02,494108,Staff,18,0,30,12
1713339851426,MATH 193A,A03,494109,Staff,29,0,30,1
1713339851426,MATH 193A,A04,494110,Staff,22,0,30,8
1713339854510,MGT 16,A00,491930,McKay; Michael J,92,0,98,6
1713339855535,MGT 18,A00,491992,McKay; Michael J,96,0,98,2
1713339856563,MGT 71,A00,492003,Staff,63,0,98,35
1713339857591,MGT 103,A00,505209,Eberhard; Craig A,80,0,98,18
1713339858623,MGT 131A,A00,505210,Anderson; John Charles,89,0,98,9
1713339860674,MGT 153,A00,492077,Perols; Johan Lars,16,0,90,74
1713339863757,MGT 164,A00,492222,McKay; Mary A,91,0,98,7
1713339864787,MGT 172,A00,492245,Staff,59,0,60,1
1713339864787,MGT 172,B00,505526,Hedges; Kathleen,65,0,98,33
1713339865816,MGT 181,A00,505669,Dunn; Louis Jean,78,0,98,20
1713339866853,MMW 14,A01,494399,Staff,15,0,28,13
1713339866853,MMW 14,A02,494400,Staff,25,0,28,3
1713339866853,MMW 14,A03,494401,Staff,28,0,28,0
1713339866853,MMW 14,A04,494402,Staff,28,0,28,0
1713339866853,MMW 14,B01,494404,Carreras; Maria Victoria,8,0,28,20
1713339866853,MMW 14,B02,494405,Carreras; Maria Victoria,25,0,28,3
1713339866853,MMW 14,B03,494406,Carreras; Maria Victoria,27,0,28,1
1713339866853,MMW 14,B04,494407,Carreras; Maria Victoria,28,0,28,0
1713339867883,MMW 14GS,A00,506250,Chang; Edmond Yi-Teh,0,0,0,0
1713339868912,MMW 121R,A01,494415,Adamiak; Patrick John,10,0,28,18
1713339868912,MMW 121R,A02,494416,Adamiak; Patrick John,24,0,28,4
1713339869942,MUS 1A,A01,494113,Staff,12,0,25,13
1713339869942,MUS 1A,A02,494114,Staff,24,0,25,1
1713339870967,MUS 4,A01,494116,Staff,23,0,25,2
1713339870967,MUS 4,A02,494117,Staff,22,0,25,3
1713339871997,MUS 5R,A01,494236,Dubnov; Shlomo,4,0,25,21
1713339871997,MUS 5R,A02,494237,Dubnov; Shlomo,25,0,25,0
1713339873027,MUS 6,A01,494122,Staff,9,0,25,16
1713339873027,MUS 6,A02,494123,Staff,23,0,25,2
1713339874053,MUS 7,A01,494125,Staff,16,0,25,9
1713339874053,MUS 7,A02,494126,Staff,24,0,25,1
1713339875080,MUS 11,A01,494128,Staff,23,0,25,2
1713339875080,MUS 11,A02,494129,Staff,24,0,25,1
1713339876106,MUS 13,A01,494131,Staff,25,0,25,0
1713339876106,MUS 13,A02,494132,Staff,25,0,25,0
1713339877133,MUS 15,A01,494134,Staff,16,0,25,9
1713339877133,MUS 15,A02,494135,Staff,25,0,25,0
1713339877133,MUS 15,B01,494137,Staff,24,0,25,1
1713339878160,MUS 80,A00,494232,Staff,24,0,25,1
1713339878160,MUS 80,B00,494233,Staff,25,0,25,0
1713339878160,MUS 80,C00,494234,Staff,23,0,25,2
1713339879184,MUS 95C,A00,494141,Staff,69,0,75,6
1713339880210,MUS 114,A00,494142,Staff,39,0,50,11
1713339881245,NANO 15,A01,490636,Drews; Aaron,7,0,7,0
1713339882272,PHIL 1,A00,490578,Grush; Rick Scott,49,0,50,1
1713339883304,PHIL 10,A01,490580,Grush; Rick Scott,33,0,35,2
1713339883304,PHIL 10,A02,490586,Grush; Rick Scott,32,0,35,3
1713339884335,PHIL 27,A01,490591,Staff,22,0,25,3
1713339884335,PHIL 27,A02,490592,Staff,25,0,25,0
1713339884335,PHIL 27,A03,490593,Staff,25,0,25,0
1713339884335,PHIL 27,A04,490598,Staff,25,0,25,0
1713339885376,PHIL 32,A01,490611,Staff,20,0,20,0
1713339885376,PHIL 32,A02,490618,Staff,20,0,20,0
1713339886420,PHIL 90,A00,490624,Staff,40,0,40,0
1713339887501,PHIL 136,A00,490627,Cohen; Jonathan David,37,0,40,3
1713339888527,PHIL 155,A00,490634,Staff,62,0,70,8
1713339889560,PHYS 1A,A00,491610,Staff,245,0,250,5
1713339890591,PHYS 1AL,001,491616,Tsai; Philbert S,27,0,30,3
1713339890591,PHYS 1AL,002,491618,Tsai; Philbert S,30,0,30,0
1713339891619,PHYS 1B,A00,491623,Staff,235,0,250,15
1713339892646,PHYS 1BL,001,491626,Tsai; Philbert S,19,0,30,11
1713339892646,PHYS 1BL,002,491628,Tsai; Philbert S,26,0,30,4
1713339893671,PHYS 1C,A00,491632,Staff,212,0,245,33
1713339894697,PHYS 1CL,001,491635,Tsai; Philbert S,3,0,30,27
1713339894697,PHYS 1CL,002,491643,Tsai; Philbert S,22,0,30,8
1713339895728,PHYS 2AR,A01,491651,Meyertholen; Andrew D.,44,0,50,6
1713339896865,PHYS 2B,A01,491659,Staff,105,0,115,10
1713339897894,PHYS 2BL,A01,491685,Staff,21,0,24,3
1713339897894,PHYS 2BL,A02,491700,Staff,21,0,24,3
1713339898927,PHYS 2C,A01,505161,Staff,101,0,115,14
1713339899955,PHYS 4A,A01,491704,Grinstein; Benjamin,99,0,100,1
1713339900984,POLI 5D,A01,494144,Staff,3,0,5,2
1713339900984,POLI 5D,B01,626283,Dai; Yinlin,5,0,5,0
1713339902010,POLI 12,A00,494145,Staff,43,0,45,2
1713339903037,POLI 13R,A00,494146,Forman; Fonna,45,0,50,5
1713339904066,POLI 27,A01,494148,Staff,54,0,60,6
1713339905092,POLI 30,A00,494149,Staff,49,0,50,1
1713339906118,POLI 100DA,A00,494150,Staff,20,0,25,5
1713339908171,POLI 100I,A00,494152,Staff,27,0,30,3
1713339909227,POLI 104B,A00,494153,Smith; Glenn Chatmas,53,0,55,2
1713339910254,POLI 104F,A00,494154,Staff,28,0,30,2
1713339911280,POLI 104I,A00,494155,Smith; Glenn Chatmas,29,0,30,1
1713339912307,POLI 110C,A00,494156,Ingham; Sean,23,0,25,2
1713339913339,POLI 117R,A00,494157,Forman; Fonna,5,0,20,15
1713339914484,POLI 118,A00,494158,Ingham; Sean,21,0,25,4
1713339915514,POLI 120H,A00,494159,Fisk; David Lee,39,0,45,6
1713339916543,POLI 131CR,A00,494160,Hoston; Germaine,35,0,45,10
1713339917570,POLI 133J,A00,494161,Staff,31,0,35,4
1713339918599,POLI 135,A00,494162,Fisk; David Lee,33,0,35,2
1713339919624,POLI 140A,A00,494164,Staff,18,0,30,12
1713339920650,POLI 142I,A00,494165,Staff,30,0,30,0
1713339921677,POLI 144D,A00,494166,Staff,22,0,25,3
1713339922707,POLI 151,A00,494167,Staff,30,0,30,0
1713339923738,POLI 153,A00,494168,Staff,33,0,35,2
1713339924768,POLI 160AA,A00,494169,Staff,33,0,40,7
1713339925796,POLI 162,A00,494170,Mignozzetti; Umberto,18,0,25,7
1713339926823,POLI 171,A00,494171,Mignozzetti; Umberto,18,0,25,7
1713339927980,PSYC 1,A00,494172,Staff,95,0,100,5
1713339929005,PSYC 2,A00,494173,Moranton; Nirelia Melbina-,34,0,50,16
1713339930034,PSYC 3,A00,494174,Staff,29,0,30,1
1713339931066,PSYC 6,A00,494175,Staff,17,0,20,3
1713339932093,PSYC 60,A01,494177,Staff,37,0,45,8
1713339933120,PSYC 70,A01,505724,Geller; Emma Harlan,42,0,45,3
1713339934148,PSYC 101,A00,494180,Heyman; Gail D.,84,0,100,16
1713339935178,PSYC 105,A00,494181,Geller; Emma Harlan,51,0,90,39
1713339936204,PSYC 106,A00,494182,Dobkins; Karen R.,26,0,45,19
1713339937232,PSYC 108,A00,494183,Adrian; Julia Anna,89,0,100,11
1713339938266,PSYC 114,A01,494185,Winkielman; Piotr,0,3,30,30
1713339939289,PSYC 122,A00,494186,Moranton; Nirelia Melbina-,27,0,50,23
1713339940320,PSYC 124,A00,494187,Chapman; Eddie Nathaniel,69,0,80,11
1713339941349,PSYC 131,A00,494188,Anagnostaras; Stephan,40,0,80,40
1713339942374,PSYC 144,A00,494189,Staff,0,0,50,50
1713339943408,PSYC 154,A00,494190,Lacefield; Katharine I,105,0,180,75
1713339944434,PSYC 162,A00,494191,Wixted; John T,70,0,100,30
1713339945462,PSYC 172,A00,494192,Gorman; Michael R.,36,0,45,9
1713339946492,PSYC 178,A00,494193,Glaser; Dale,34,0,45,11
1713339947525,PSYC 193,A00,505725,Chapman; Eddie Nathaniel,20,0,20,0
1713339948552,RELI 145GS,A00,519817,Rahimi; Babak,17,0,20,3
1713339949580,SE 101A,A01,490862,Chadha; Mayank,23,0,25,2
1713339950606,SE 101C,A01,490924,Krysl; Petr,15,0,20,5
1713339951637,SE 110A,A01,490928,Staff,19,0,20,1
1713339952671,SE 130A,A00,490929,Morrison; Machel Leigh,54,0,70,16
1713339953701,SIO 1,A01,519325,Staff,39,0,40,1
1713339954730,SIO 30,A01,519327,Staff,38,0,40,2
1713339955758,SIO 40,A00,519328,Staff,39,0,40,1
1713339956788,SIO 46GS,A00,519819,Cook; Geoffrey W,15,0,25,10
1713339957815,SIO 109R,A00,494197,Forman; Fonna,0,3,20,20
1713339958840,SIO 121GS,A00,519827,Cook; Geoffrey W,15,0,25,10
1713339959865,SIO 132,A01,519330,Staff,38,0,40,2
1713339960893,SIO 133,A01,519397,Staff,37,0,40,3
1713339961921,SIO 139,A00,519396,Kacev; David,29,0,40,11
1713339963029,SOCI 1,A01,494199,Thorpe; Charles Robert,21,0,30,9
1713339963029,SOCI 1,A02,494200,Thorpe; Charles Robert,30,0,30,0
1713339963029,SOCI 1,A03,494201,Thorpe; Charles Robert,29,0,30,1
1713339963029,SOCI 1,A04,494202,Thorpe; Charles Robert,29,0,30,1
1713339963029,SOCI 1,A05,494203,Thorpe; Charles Robert,29,0,30,1
1713339963029,SOCI 1,A06,494204,Thorpe; Charles Robert,30,0,30,0
1713339963029,SOCI 1,A07,494205,Thorpe; Charles Robert,28,0,30,2
1713339964055,SOCI 60,A01,494207,Staff,33,0,40,7
1713339964055,SOCI 60,A02,494208,Staff,39,0,40,1
1713339965085,SOCI 100,A01,494210,Payne; Christine Anna,25,0,30,5
1713339965085,SOCI 100,A02,494211,Payne; Christine Anna,26,0,30,4
1713339966110,SOCI 109M,A00,494212,Staff,20,0,20,0
1713339967141,SOCI 110,A00,494213,Staff,34,0,40,6
1713339969213,SOCI 118E,A00,494215,Ng; Kwai,37,0,40,3
1713339970240,SOCI 125,A00,494216,Calderon-Zaks; Michael Aar,39,0,45,6
1713339971270,SOCI 126,A01,494218,Jones; Makeba,3,0,5,2
1713339972297,SOCI 131,A00,494219,Thorpe; Charles Robert,26,0,30,4
1713339974352,SOCI 135,A00,494221,Payne; Christine Anna,28,0,50,22
1713339975381,SOCI 136E,A00,626690,Ruiz; Jonathan Joseph,24,0,25,1
1713339976409,SOCI 138GS,A00,494222,Navon; Daniel,23,0,28,5
1713339978460,SOCI 145,A00,494224,Staff,40,0,45,5
1713339979489,SOCI 153,A00,494225,Staff,28,0,30,2
1713339980520,SOCI 160E,A00,494226,Ng; Kwai,27,0,40,13
1713339981548,SOCI 180,A00,494227,Staff,29,0,30,1
1713339982575,SOCI 189GS,A00,494228,Ribas Norris; Janet Vanesa,11,0,11,0
1713339983613,SOCI 190GS,A00,553232,Ribas Norris; Janet Vanesa,11,0,11,0
1713339984639,SOMI 220,A00,627178,Schneid; Stephen David,30,0,30,0
1713339985666,SYN 2,001,490768,Staff,13,0,15,2
1713339985666,SYN 2,002,490769,Staff,14,0,15,1
1713339985666,SYN 2,004,490775,Staff,0,0,0,0
1713339985666,SYN 2,003,490774,Staff,0,0,0,0
1713339985666,SYN 2,005,490776,Staff,0,0,0,0
1713339986802,SYN 2R,001,490779,Staff,11,0,15,4
1713339986802,SYN 2R,002,514635,Staff,14,0,15,1
1713339987829,SYN 100,A01,490783,Staff,8,0,20,12
1713339987829,SYN 100,B01,490787,Staff,10,0,20,10
1713339987829,SYN 100,C01,490789,Staff,10,0,20,10
1713339988861,SYN 150,A00,490817,Staff,14,0,15,1
1713339988861,SYN 150,B00,514610,Staff,15,0,15,0
1713339989890,TDAC 1,A00,492753,Walsh; Kim C.,19,0,20,1
1713339989890,TDAC 1,B00,492754,Harting; Carla Kelso,18,0,20,2
1713339989890,TDAC 1,C00,513995,Salovey; Todd,15,0,20,5
1713339990917,TDAC 101,A00,492766,Harting; Carla Kelso,17,0,20,3
1713339991998,TDAC 102,A00,492768,Basso; Beatrice,19,0,20,1
1713339993028,TDDE 111,A00,492769,Staff,25,0,25,0
1713339994057,TDDE 131,A00,492770,Staff,15,0,15,0
1713339994057,TDDE 131,B00,492771,Staff,15,0,15,0
1713339995084,TDDE 131GS,A00,523716,Guirguis; Mark C,23,0,28,5
1713339996109,TDGE 1,A01,492756,Salovey; Todd,56,0,60,4
1713339997145,TDGE 5,A01,492758,Staff,23,0,25,2
1713339998171,TDGE 10,A00,492759,Fulton; Julia,203,0,220,17
1713339999201,TDGE 11,A00,492760,Castro; Robert Jess,198,0,200,2
1713340001256,TDGE 124,A00,492772,Fulton; Julia,181,0,220,39
1713340002357,TDGE 125,A00,492773,Meyer; Ursula,38,0,50,12
1713340002357,TDGE 125,B00,492774,Staff,49,0,50,1
1713340002357,TDGE 125,C00,523565,Staff,48,0,50,2
1713340003381,TDGE 125GS,A00,523580,Guirguis; Mark C,23,0,28,5
1713340004458,TDGE 127,A00,492775,Havis; Allan,32,0,50,18
1713340005484,TDHT 101,A00,492776,Staff,34,0,35,1
1713340006522,TDMV 1,A00,492762,Caligagan; Maria T.,29,0,30,1
1713340006522,TDMV 1,B00,492763,Arcidiacono; Kristin,26,0,30,4
1713340007550,TDMV 2,A00,492764,Weinberg; Sadie,27,0,30,3
1713340008576,TDMV 3,A00,492765,Mack; Kara Shanai',37,0,40,3
1713340009600,TDMV 138,A00,492777,Mack; Kara Shanai',32,0,40,8
1713340010627,TDMV 140,A00,492778,Lima; Paulo Henrique,40,0,40,0
1713340011687,TDMV 142,A00,492779,Caligagan; Maria T.,33,0,40,7
1713340011687,TDMV 142,B00,492780,Caligagan; Tony,37,0,40,3
1713340012715,TDMV 143,A00,492781,Fyall; Daunte Edward,39,0,40,1
1713340013749,USP 1,A01,492401,Kwak; Nancy,27,0,35,8
1713340014781,USP 2,A01,492453,Hinds; Juli Beth,35,0,35,0
1713340015807,USP 3,A01,492516,Staff,28,0,35,7
1713340016834,USP 4,A00,492522,McTague; Sarah,16,0,25,9
1713340017861,USP 100,A00,492523,Staff,32,0,35,3
1713340018890,USP 101,A00,492524,Staff,13,0,15,2
1713340019916,USP 105,A00,492525,Staff,21,0,25,4
1713340020943,USP 151,A00,492526,Shenkman; Michael Thomas,32,0,35,3
1713340021976,USP 170,A00,492545,Hinds; Juli Beth,33,0,35,2
1713340023006,USP 171GS,A00,492608,Bussell; Mirle Rabinowitz,24,0,28,4
1713340024030,USP 183GS,A00,492613,Peerson; Susan,24,0,28,4
1713340025062,VIS 30,A01,490693,Yoldas; Pinar,19,0,22,3
1713340025062,VIS 30,A02,490694,Yoldas; Pinar,18,0,22,4
1713340026088,VIS 83,A00,490695,Kester; Grant,63,0,75,12
1713340027113,VIS 105D,A00,490696,Staff,22,0,25,3
1713340028143,VIS 124CN,A00,490699,Rose; Jordan M,64,0,75,11
1713340029169,VIS 125GS,A00,511221,Williams; Alena J,21,0,22,1
1713340030203,VIS 128D,A00,490700,Staff,73,0,75,2
1713340031234,VIS 151,A01,490717,Staff,33,0,34,1
1713340031234,VIS 151,A02,490766,Staff,33,0,34,1
1713340032260,VIS 154GS,A00,511972,Williams; Alena J,21,0,22,1
1713340033290,VIS 160A,A00,490767,Stone; Patricia,7,0,10,3
1713340034317,WCWP 10A,A00,490638,Staff,14,0,15,1
1713340034317,WCWP 10A,B00,490640,Staff,15,0,15,0
1713340035346,WCWP 10B,A00,490641,Staff,0,0,0,0
1713340035346,WCWP 10B,B00,490642,Staff,14,0,15,1
1713340035346,WCWP 10B,C00,490644,Staff,13,0,15,2
1713340035346,WCWP 10B,D00,490647,Staff,0,0,0,0
1713340036373,WCWP 100,A00,490655,Staff,0,0,0,0
1713340036373,WCWP 100,B00,490687,Staff,10,0,15,5
1713340038594,ANAR 153,A00,487222,Braswell; Geoffrey E.,53,0,60,7
1713340039642,ANBI 134,A00,487223,Staff,6,0,20,14
1713340040674,ANBI 143GS,A00,487224,Noel; Geoffroy Pierre Jean,18,0,24,6
1713340041700,ANBI 144GS,A00,519548,Noel; Geoffroy Pierre Jean,18,0,24,6
1713340042730,ANSC 101,A00,487225,Staff,17,0,20,3
1713340043760,ANSC 125,A00,487227,Brenner; Suzanne A,38,0,40,2
1713340045817,ANSC 146,A00,487229,Staff,35,0,40,5
1713340046846,ANSC 148,A00,487230,Olivas Hernandez; Olga Lid,39,0,40,1
1713340047879,ANSC 150,A00,504165,Sloane; Julia Kathryn,18,0,20,2
1713340048912,ANSC 180,A00,487232,Staff,14,0,15,1
1713340049939,ANSC 188,A00,627155,Staff,37,0,40,3
1713340050970,ANTH 5,A00,519529,Semendeferi; Ekaterini,15,0,15,0
1713340051996,ANTH 10,A00,487219,Staff,58,0,60,2
1713340053025,ANTH 23,A01,487221,Staff,17,0,20,3
1713340054053,ANTH 102,A00,487233,Wilder; Linnea Lorene,50,0,60,10
1713340055079,ANTH 103,A00,487234,Varma; Saiba,54,0,60,6
1713340056109,ANTH 105,A00,487235,Stewart; Alexander B,54,0,60,6
1713340057142,BENG 100,A01,516685,Taylor Amos; Alyssa C,25,0,30,5
1713340058176,BIBC 102,A01,491316,Flagg; Matthew Paul,6,0,88,82
1713340058176,BIBC 102,A02,491366,Flagg; Matthew Paul,78,0,88,10
1713340059201,BIBC 103,A01,491486,Boumechache; Miyyada,16,0,24,8
1713340059201,BIBC 103,A02,491487,Boumechache; Miyyada,24,0,24,0
1713340060229,BICD 100,A01,516882,Staff,73,0,75,2
1713340060229,BICD 100,A02,516890,Staff,69,0,75,6
1713340061260,BICD 102GS,A00,491488,Lo; Stanley M.,26,0,28,2
1713340062286,BIEB 136GS,A00,516940,Holway; David A. & Shurin; Jonathan,18,0,24,6
1713340063317,BIEB 137GS,A01,517034,Holway; David A. & Shurin; Jonathan,18,0,24,6
1713340064342,BIEB 138GS,A01,491492,Pirino; Giorgia,21,0,28,7
1713340065374,BILD 1,A01,491296,Staff,60,0,63,3
1713340065374,BILD 1,A02,491297,Staff,63,0,63,0
1713340066404,BILD 4,A01,517099,Gonzalez Gamboa; Ivonne,22,0,24,2
1713340066404,BILD 4,A02,517100,Gonzalez Gamboa; Ivonne,24,0,24,0
1713340067432,BILD 60GS,A00,491309,Lo; Stanley M.,26,0,28,2
1713340068457,BIMM 100,A01,517136,Staff,82,0,100,18
1713340069488,BIMM 110,A01,517182,Staff,53,0,100,47
1713340070520,BIMM 120,A01,517228,Pickett; Brooke Elizabeth,28,0,63,35
1713340070520,BIMM 120,A02,517240,Pickett; Brooke Elizabeth,44,0,63,19
1713340071551,BIMM 132GS,A01,491498,Pirino; Giorgia,21,0,28,7
1713340072584,BIMM 143,A01,491589,Bozinovic; Goran,12,0,40,28
1713340073647,BIPN 100,A01,491594,Armour; Jon Christopher,83,0,100,17
1713340074675,BIPN 140,A01,491602,Marino; Marc J,23,0,50,27
1713340076870,CAT 125,A00,515973,Staff,18,0,20,2
1713340077901,CAT 125GS,A00,515974,Rahimi; Babak,16,0,20,4
1713340078930,CAT 125R,A00,515980,Staff,12,0,20,8
1713340078930,CAT 125R,B00,515981,Tosun; Adriana,19,0,20,1
1713340078930,CAT 125R,C00,515987,Hyland; Tina Mae,0,5,20,20
1713340078930,CAT 125R,D00,515988,Bronstein; Phoebe Malan,16,0,20,4
1713340079957,CENG 15,A01,488699,Drews; Aaron,25,0,25,0
1713340080992,CENG 100,A00,505196,Opatkiewicz; Justin Paul,25,0,25,0
1713340082020,CGS 2A,A01,489598,Staff,32,0,35,3
1713340083053,CGS 112,A00,489599,Staff,15,0,15,0
1713340084079,CGS 119,A00,489603,Staff,10,0,10,0
1713340085108,CGS 120,A00,489604,Staff,13,0,15,2
1713340086133,CGS 150,A00,489607,Staff,15,0,15,0
1713340087165,CHEM 6A,A01,488715,Staff,97,0,100,3
1713340088193,CHEM 6B,A01,488719,Piercy; Marc Anthony,99,0,100,1
1713340089220,CHEM 6C,A01,488723,Albizati; Kim F.,93,0,100,7
1713340090246,CHEM 7L,A01,488728,Schurmeier; Kimberly,18,0,24,6
1713340090246,CHEM 7L,A02,488730,Schurmeier; Kimberly,23,0,24,1
1713340090246,CHEM 7L,A03,488734,Schurmeier; Kimberly,20,0,24,4
1713340090246,CHEM 7L,A04,488763,Schurmeier; Kimberly,23,0,24,1
1713340090246,CHEM 7L,B01,488798,Schurmeier; Kimberly,16,0,24,8
1713340090246,CHEM 7L,B02,488801,Schurmeier; Kimberly,22,0,24,2
1713340090246,CHEM 7L,B03,488808,Schurmeier; Kimberly,22,0,24,2
1713340090246,CHEM 7L,B04,488811,Schurmeier; Kimberly,24,0,24,0
1713340091273,CHEM 11,A01,488897,Stallings; Dontarie M,94,0,100,6
1713340092303,CHEM 40A,A01,488913,Albizati; Kim F.,83,0,100,17
1713340093327,CHEM 40B,A01,488920,Weizman; Haim,42,0,50,8
1713340093327,CHEM 40B,A02,488938,Weizman; Haim,43,0,50,7
1713340094354,CHEM 41A,A01,489029,Klosterman; Jeremy K,57,0,60,3
1713340095382,CHEM 41C,A01,500436,Tor; Yitzhak,55,0,60,5
1713340096472,CHEM 43A,A01,500426,Weizman; Haim,0,1,24,24
1713340096472,CHEM 43A,A02,500430,Weizman; Haim,5,0,24,19
1713340096472,CHEM 43A,B01,514041,Klosterman; Jeremy K,15,0,24,9
1713340096472,CHEM 43A,B02,514047,Klosterman; Jeremy K,23,0,24,1
1713340097501,CHEM 108,A01,489140,Jennings; Patricia A.,7,0,24,17
1713340097501,CHEM 108,A02,489142,Jennings; Patricia A.,14,0,24,10
1713340098530,CHEM 114A,A01,489147,Stallings; Dontarie M,65,0,100,35
1713340099563,CHIN 169A,A00,489171,Wang; Xiao,19,0,20,1
1713340101618,COGS 3,A01,518827,Boyle; Mary E. T.,25,0,40,15
1713340102644,COGS 11,A01,489175,Staff,27,0,30,3
1713340103672,COGS 14A,A01,518829,Staff,50,0,60,10
1713340104698,COGS 14B,A01,489177,Hoffman; Drew Ellen,62,0,75,13
1713340105728,COGS 100,A01,489181,Allen; Michael Gordon,62,0,75,13
1713340106771,COGS 101A,A01,489183,Staff,45,0,60,15
1713340107797,COGS 101B,A01,489185,Allen; Michael Gordon,6,0,30,24
1713340108823,COGS 101C,A01,526786,Staff,23,0,30,7
1713340110882,COGS 107A,A01,489189,Boyle; Mary E. T.,16,0,35,19
1713340111915,COGS 107B,A01,627144,Mooshagian; Eric Frederick,60,0,60,0
1713340112941,COGS 118A,A01,489191,Staff,0,46,40,40
1713340114995,COGS 171GS,A01,489194,Pineda; Jaime A,19,0,28,9
1713340116019,COGS 172,A01,489196,Staff,2,0,30,28
1713340117047,COGS 174GS,A01,489264,Pineda; Jaime A,19,0,28,9
1713340118075,COGS 180,A01,627150,Staff,28,0,30,2
1713340119101,COGS 186,A01,489274,Staff,0,2,30,30
1713340120128,COMM 10,A01,489276,Staff,23,0,25,2
1713340120128,COMM 10,A02,489303,Staff,23,0,25,2
1713340121154,COMM 100A,A01,489312,Staff,14,0,25,11
1713340121154,COMM 100A,A02,489313,Staff,24,0,25,1
1713340122185,COMM 106T,A00,512540,Staff,33,0,35,2
1713340123215,COMM 107,A00,489347,Staff,27,0,35,8
1713340124241,COMM 109P,A00,489358,Staff,31,0,35,4
1713340125271,COMM 132,A00,489361,McKenna; Denise,27,0,30,3
1713340126298,COMM 146,A00,489362,Halm; Gavin Patrick,26,0,30,4
1713340127322,COMM 190,A00,489363,Abuelhiga; Soraya Jill,17,0,23,6
1713340128351,CSE 8A,A50,489366,Staff,21,0,25,4
1713340128351,CSE 8A,A51,489367,Staff,24,0,25,1
1713340129381,CSE 11,A01,489398,Cao; Yingjun,73,0,100,27
1713340130407,CSE 12,A01,489487,Staff,43,0,50,7
1713340131439,CSE 20,A01,489497,Staff,47,0,50,3
1713340132489,CSE 21,A01,489517,Braun; Oliver,42,0,50,8
1713340133518,CSE 101,A01,489524,Braun; Oliver,0,33,50,50
1713340134554,CSE 105,A01,512594,Jones; Miles E,72,0,100,28
1713340134554,CSE 105,B01,512598,Jones; Miles E,51,0,100,49
1713340135585,CSE 140,A01,489538,Staff,41,0,50,9
1713340136613,CSE 141,A01,489550,Eldon; John,67,0,100,33
1713340137642,CSE 141L,A01,489571,Eldon; John,65,0,100,35
1713340138669,CSE 151A,A01,489583,Solares; Edwin A,140,0,200,60
1713340139697,CSE 175,A01,510886,Kumar; Rakesh,30,0,30,0
1713340140725,CSE 190,A00,516828,Dubnov; Shlomo,37,0,49,12
1713340141753,DOC 100D,A00,489667,Pass; Natalye Joann,19,0,25,6
1713340142785,DSC 10,A01,624268,Staff,72,0,75,3
1713340143813,DSC 20,A01,624476,Staff,50,0,50,0
1713340144836,DSC 40A,A01,624608,Staff,39,0,40,1
1713340145864,DSGN 1,A01,489179,Rill; Bryan,32,0,50,18
1713340146893,ECE 17,A01,490489,Sahay; Rajeev,18,0,30,12
1713340147920,ECE 65,A50,490492,Staff,11,0,20,9
1713340147920,ECE 65,A51,490493,Staff,18,0,20,2
1713340148948,ECON 1,A01,489715,Famulari; Melissa,67,0,70,3
1713340149976,ECON 2,A01,489717,Levkoff; Steven B.,67,0,70,3
1713340151003,ECON 3,A01,489948,Staff,70,0,70,0
1713340153056,ECON 5,A01,490103,Staff,27,0,30,3
1713340153056,ECON 5,B01,626281,Dai; Yinlin,45,0,45,0
1713340154083,ECON 100A,A01,490127,Famulari; Melissa,63,0,70,7
1713340155115,ECON 100B,A01,490129,Staff,64,0,70,6
1713340156143,ECON 109,A01,490187,Shishkin; Denis,27,0,35,8
1713340157170,ECON 110A,A01,490190,Levkoff; Steven B.,59,0,70,11
1713340158200,ECON 120A,A01,490245,Dai; Yinlin,60,0,70,10
1713340159286,ECON 120B,A01,490247,Nieto-Barthaburu; Augusto,40,0,70,30
1713340160315,ECON 120C,A01,490253,Sun; Yixiao,30,0,35,5
1713340160315,ECON 120C,B01,490255,Sun; Yixiao,34,0,35,1
1713340161342,ECON 129,A00,490256,Eckert; Fabian Paul,22,0,35,13
1713340162369,ECON 131,A00,490257,Nieto-Barthaburu; Augusto,0,6,35,35
1713340163395,ECON 138,A00,490258,Bharadwaj; Prashant,13,0,35,22
1713340163395,ECON 138,B00,490259,Bharadwaj; Prashant,15,0,35,20
1713340164422,ECON 159,A00,490260,Hendrickson; Gerald M.,0,9,0,0
1713340165456,ECON 178,A01,553995,Zhu; Ying,24,0,35,11
1713340166511,EDS 40,A01,512576,Black; Alison Michelle,20,0,20,0
1713340167545,EDS 107,A01,515848,Staff,30,0,30,0
1713340168571,EDS 110R,A01,490262,Staff,26,0,30,4
1713340169626,EDS 112,A01,490264,Chapman; Thandeka K,40,0,50,10
1713340170652,EDS 113,A00,490266,Staff,25,0,30,5
1713340171678,EDS 118,A00,490267,Warstadt; Melissa Fawn,18,0,30,12
1713340172703,EDS 124BR,A00,490268,Eguchi; Emi,4,0,25,21
1713340172703,EDS 124BR,B00,490269,Eguchi; Emi,23,0,25,2
1713340173731,EDS 126,A01,490271,Jones; Makeba,43,0,50,7
1713340174757,EDS 135,A01,490316,Staff,19,0,20,1
1713340175789,ENVR 142GS,A00,519514,Chang; Edmond Yi-Teh,26,0,28,2
1713340176818,ETHN 103,A00,490504,Staff,25,0,36,11
1713340177886,ETHN 103A,A00,490505,Man; Simeon S,3,0,9,6
1713340178912,ETHN 109,A00,490506,Staff,28,0,30,2
1713340179938,ETHN 118,A00,490507,Staff,35,0,36,1
1713340180966,ETHN 119,A00,490508,Staff,32,0,36,4
1713340181992,ETHN 121R,A00,490518,Choi; Esther Min,21,0,36,15
1713340183018,ETHN 127,A00,490528,Staff,14,0,15,1
1713340184044,ETHN 139,A00,490573,Staff,10,0,10,0
1713340185072,ETHN 150,A00,490575,Staff,15,0,15,0
1713340186109,GLBH 20,A00,491705,Elwardani; Nile Regina,38,0,40,2
1713340187136,GLBH 101,A00,491706,Staff,20,0,20,0
1713340188166,GLBH 111,A01,491708,Burgos; Jose L.,15,0,15,0
1713340189191,GLBH 146,A00,491709,Staff,8,0,20,12
1713340190219,GLBH 148,A00,491710,Olivas Hernandez; Olga Lid,10,0,20,10
1713340191248,GLBH 150,A00,491711,Sloane; Julia Kathryn,19,0,20,1
1713340192276,HIEA 131,A00,491760,Staff,28,0,32,4
1713340193305,HIEA 153,A00,491762,Staff,28,0,30,2
1713340194333,HIEU 124,A00,491811,Staff,26,0,32,6
1713340195359,HIEU 124GS,A00,491812,Markman; Kristina,27,0,28,1
1713340196385,HIEU 147,A00,491813,Staff,30,0,32,2
1713340197412,HIEU 149GS,A00,491816,Caldwell; Michael Alan,28,0,28,0
1713340198443,HILD 2C,A01,491713,Hendrickson; Gerald M.,26,0,30,4
1713340199470,HILD 7B,A01,491715,Kwak; Nancy,0,2,30,30
1713340200569,HILD 10,A01,491717,Staff,9,0,20,11
1713340201599,HILD 30GS,A00,491719,Edington; Claire Ellen,23,0,28,5
1713340202630,HINE 109,A00,491818,Shafir; Nir,27,0,32,5
1713340203656,HINE 128,A00,491821,Shafir; Nir,30,0,32,2
1713340204688,HISC 117,A00,491830,Staff,27,0,32,5
1713340205717,HIUS 103,A00,491834,Man; Simeon S,14,0,23,9
1713340206744,HIUS 108B,A00,491835,Staff,27,0,30,3
1713340207774,HIUS 141,A00,491836,Hendrickson; Gerald M.,28,0,32,4
1713340208803,HIUS 149,A00,491839,Staff,24,0,32,8
1713340209831,HUM 3,A01,512617,Crum; Matthew Stephen,42,0,50,8
1713340209831,HUM 3,A02,512618,Crum; Matthew Stephen,48,0,50,2
1713340210860,HUM 3GS,A00,512663,Markman; Kristina,0,0,0,1
1713340210860,HUM 3GS,B00,512664,Staff,0,0,0,0
1713340211892,HUM 4,A01,512620,West; Geoffrey Scott,25,0,50,25
1713340212918,HUM 4GS,A00,512666,Lyon; Antony J.,0,0,0,5
1713340213949,HUM 4R,A01,512625,Watkins; Eric,49,0,50,1
1713340214977,HUM 5,A01,512649,Zavodny; Tatiana Sophia,20,0,50,30
1713340214977,HUM 5,B01,512661,Zroka; Ryan Edward,48,0,50,2
1713340216004,INTL 190,A00,490577,Segui; Alan S,0,0,0,5
1713340217031,JAPN 20AR,A01,491267,Ross; Kayoko F,7,0,20,13
1713340218057,JAPN 180,A00,491285,Berman; Michael David,33,0,40,7
1713340219094,LATI 50,A01,502536,Kokinis; Troy Andreas,16,0,22,6
1713340219094,LATI 50,A02,502551,Kokinis; Troy Andreas,22,0,22,0
1713340219094,LATI 50,A03,502650,Kokinis; Troy Andreas,22,0,22,0
1713340219094,LATI 50,A04,502909,Kokinis; Troy Andreas,21,0,22,1
1713340220122,LATI 160,A01,502920,Kokinis; Troy Andreas,30,0,30,0
1713340221155,LIFR 1A,A00,490494,Van Moer; Vinciane G,17,0,20,3
1713340222180,LIFR 1AX,A00,490495,Van Moer; Vinciane G,17,0,20,3
1713340223221,LIFR 1B,A00,490496,Van Moer; Vinciane G,17,0,20,3
1713340224253,LIFR 1BX,A00,490497,Van Moer; Vinciane G,17,0,20,3
1713340225280,LIGN 8,A00,505198,McIntosh; Justin Daniel,134,0,150,16
1713340226311,LIGN 9GS,A00,491239,Lott; Margaret S.,18,0,20,2
1713340227342,LIGN 101,A01,505200,McIntosh; Justin Daniel,22,0,30,8
1713340228367,LIGN 120,A01,491244,Staff,22,0,30,8
1713340229395,LIGN 149GS,A00,491245,Lott; Margaret S.,18,0,20,2
1713340230422,LIGN 170,A00,491247,Staff,22,0,30,8
1713340231451,LISP 1D,A00,490498,Munoz Sanchez; Alicia,8,0,14,6
1713340231451,LISP 1D,B00,490499,Munoz Sanchez; Alicia,4,0,14,10
1713340231451,LISP 1D,C00,490500,Munoz Sanchez; Alicia,7,0,14,7
1713340231451,LISP 1D,D00,490501,Munoz Sanchez; Alicia,10,0,14,4
1713340232478,LISP 1DX,A00,490502,Munoz Sanchez; Alicia,11,0,28,17
1713340232478,LISP 1DX,B00,490503,Munoz Sanchez; Alicia,16,0,28,12
1713340234529,LTAM 110,A00,491847,Staff,22,0,25,3
1713340235556,LTCS 119,A00,491848,Staff,11,0,15,4
1713340236583,LTCS 130,A00,491849,Staff,24,0,25,1
1713340238638,LTEA 120C,A00,491852,Staff,32,0,40,8
1713340239667,LTEN 130GS,A00,491853,Lyon; Antony J.,23,0,28,5
1713340240705,LTEN 148,A00,491855,Staff,23,0,25,2
1713340241735,LTEN 159,A00,491856,Staff,20,0,25,5
1713340242764,LTEN 180,A00,491857,Staff,8,0,15,7
1713340244820,LTSP 123GS,A00,505928,Bessett; Ryan Matthew,24,0,28,4
1713340245850,LTSP 174GS,A00,506037,Bessett; Ryan Matthew,24,0,28,4
1713340247900,LTWR 102,A00,491861,Staff,9,0,15,6
1713340248927,LTWR 106,A00,491862,Staff,8,0,15,7
1713340249960,MAE 11,A00,490930,Bahadori; Mohammad Yousef,94,0,100,6
1713340250994,MAE 30A,A00,490931,Qi; Huihui,37,0,40,3
1713340252020,MAE 101A,A00,491036,Sadeghizadeh; Zahra,91,0,100,9
1713340253056,MAE 101C,A00,491037,Seshadri; Kalyanasundaram,63,0,100,37
1713340254087,MAE 113,A00,491040,Seshadri; Kalyanasundaram,64,0,80,16
1713340255111,MAE 131A,A00,491041,Ghazinejad; Maziar,37,0,40,3
1713340256137,MAE 142,A00,491053,Staff,39,0,40,1
1713340257167,MAE 143A,A00,491054,Staff,29,0,50,21
1713340258199,MAE 150,A00,491092,Truong; Phuong Thi Ngoc,23,0,35,12
1713340259229,MATH 3C,A01,494031,Pardo Guerra; Sebastian,30,0,30,0
1713340259229,MATH 3C,A02,494032,Pardo Guerra; Sebastian,29,0,30,1
1713340260269,MATH 10A,A01,494034,Staff,27,0,30,3
1713340260269,MATH 10A,A02,494035,Staff,28,0,30,2
1713340260269,MATH 10A,B01,494037,Staff,27,0,30,3
1713340260269,MATH 10A,B02,494038,Staff,29,0,30,1
1713340261305,MATH 10B,A01,494040,Habib; Yousaf,22,0,30,8
1713340261305,MATH 10B,A02,494041,Habib; Yousaf,28,0,30,2
1713340261305,MATH 10B,A03,494042,Habib; Yousaf,29,0,30,1
1713340261305,MATH 10B,A04,494043,Habib; Yousaf,30,0,30,0
1713340261305,MATH 10B,B01,494045,Habib; Yousaf,25,0,30,5
1713340261305,MATH 10B,B02,494046,Habib; Yousaf,30,0,30,0
1713340261305,MATH 10B,B03,494047,Habib; Yousaf,30,0,30,0
1713340261305,MATH 10B,B04,494048,Habib; Yousaf,30,0,30,0
1713340262334,MATH 18,A01,494050,Kemp; Todd Aahron,25,0,30,5
1713340262334,MATH 18,A02,494051,Kemp; Todd Aahron,29,0,30,1
1713340262334,MATH 18,B01,494054,Kemp; Todd Aahron,25,0,30,5
1713340262334,MATH 18,B02,494055,Kemp; Todd Aahron,29,0,30,1
1713340263367,MATH 20A,A01,494059,Suk; Andrew Hoon,30,0,30,0
1713340264397,MATH 20B,A01,494061,Briones; Jor-el Thomas Caparas,33,0,35,2
1713340264397,MATH 20B,B01,494063,Bach; Quang Tran,34,0,35,1
1713340265434,MATH 20C,A01,494065,Staff,28,0,30,2
1713340265434,MATH 20C,A02,494066,Staff,30,0,30,0
1713340265434,MATH 20C,A03,494067,Staff,30,0,30,0
1713340265434,MATH 20C,A04,494068,Staff,30,0,30,0
1713340265434,MATH 20C,B01,494070,Zhang; Ming,24,0,30,6
1713340265434,MATH 20C,B02,494071,Zhang; Ming,27,0,30,3
1713340265434,MATH 20C,B03,494072,Zhang; Ming,29,0,30,1
1713340265434,MATH 20C,B04,494073,Zhang; Ming,29,0,30,1
1713340266458,MATH 20D,A01,494075,Staff,22,0,30,8
1713340266458,MATH 20D,A02,494076,Staff,29,0,30,1
1713340267484,MATH 20E,A01,494079,Staff,24,0,30,6
1713340267484,MATH 20E,A02,494080,Staff,26,0,30,4
1713340267484,MATH 20E,B01,494082,Staff,25,0,30,5
1713340267484,MATH 20E,B02,494083,Staff,25,0,30,5
1713340268512,MATH 103A,A01,494085,Aliabadi Sr.; Mohsen,12,0,30,18
1713340268512,MATH 103A,A02,494086,Aliabadi Sr.; Mohsen,28,0,30,2
1713340268512,MATH 103A,B01,494088,Aliabadi Sr.; Mohsen,20,0,30,10
1713340268512,MATH 103A,B02,494089,Aliabadi Sr.; Mohsen,27,0,30,3
1713340269543,MATH 109,A01,494091,Staff,30,0,30,0
1713340269543,MATH 109,A02,494092,Staff,29,0,30,1
1713340269543,MATH 109,B01,494094,Staff,27,0,30,3
1713340269543,MATH 109,B02,494095,Staff,29,0,30,1
1713340270572,MATH 142A,A01,494097,Chow; Bennett,13,0,30,17
1713340270572,MATH 142A,A02,494098,Chow; Bennett,23,0,30,7
1713340270572,MATH 142A,B01,494100,Chow; Bennett,19,0,30,11
1713340270572,MATH 142A,B02,494101,Chow; Bennett,29,0,30,1
1713340272622,MATH 168A,A01,516677,Dumitriu; Ioana,16,0,35,19
1713340273653,MATH 170A,A01,516679,Dumitriu; Ioana,18,0,30,12
1713340273653,MATH 170A,A02,516680,Dumitriu; Ioana,28,0,30,2
1713340274685,MATH 193A,A01,494107,Staff,12,0,30,18
1713340274685,MATH 193A,A02,494108,Staff,18,0,30,12
1713340274685,MATH 193A,A03,494109,Staff,29,0,30,1
1713340274685,MATH 193A,A04,494110,Staff,22,0,30,8
1713340277770,MGT 16,A00,491930,McKay; Michael J,92,0,98,6
1713340278797,MGT 18,A00,491992,McKay; Michael J,96,0,98,2
1713340279828,MGT 71,A00,492003,Staff,63,0,98,35
1713340280854,MGT 103,A00,505209,Eberhard; Craig A,80,0,98,18
1713340281886,MGT 131A,A00,505210,Anderson; John Charles,89,0,98,9
1713340283947,MGT 153,A00,492077,Perols; Johan Lars,16,0,90,74
1713340287031,MGT 164,A00,492222,McKay; Mary A,91,0,98,7
1713340288066,MGT 172,A00,492245,Staff,59,0,60,1
1713340288066,MGT 172,B00,505526,Hedges; Kathleen,65,0,98,33
1713340289093,MGT 181,A00,505669,Dunn; Louis Jean,78,0,98,20
1713340290120,MMW 14,A01,494399,Staff,15,0,28,13
1713340290120,MMW 14,A02,494400,Staff,25,0,28,3
1713340290120,MMW 14,A03,494401,Staff,28,0,28,0
1713340290120,MMW 14,A04,494402,Staff,28,0,28,0
1713340290120,MMW 14,B01,494404,Carreras; Maria Victoria,8,0,28,20
1713340290120,MMW 14,B02,494405,Carreras; Maria Victoria,25,0,28,3
1713340290120,MMW 14,B03,494406,Carreras; Maria Victoria,27,0,28,1
1713340290120,MMW 14,B04,494407,Carreras; Maria Victoria,28,0,28,0
1713340291151,MMW 14GS,A00,506250,Chang; Edmond Yi-Teh,0,0,0,0
1713340292177,MMW 121R,A01,494415,Adamiak; Patrick John,10,0,28,18
1713340292177,MMW 121R,A02,494416,Adamiak; Patrick John,24,0,28,4
1713340293201,MUS 1A,A01,494113,Staff,12,0,25,13
1713340293201,MUS 1A,A02,494114,Staff,24,0,25,1
1713340294227,MUS 4,A01,494116,Staff,23,0,25,2
1713340294227,MUS 4,A02,494117,Staff,22,0,25,3
1713340295261,MUS 5R,A01,494236,Dubnov; Shlomo,4,0,25,21
1713340295261,MUS 5R,A02,494237,Dubnov; Shlomo,25,0,25,0
1713340296284,MUS 6,A01,494122,Staff,9,0,25,16
1713340296284,MUS 6,A02,494123,Staff,23,0,25,2
1713340297313,MUS 7,A01,494125,Staff,16,0,25,9
1713340297313,MUS 7,A02,494126,Staff,24,0,25,1
1713340298338,MUS 11,A01,494128,Staff,23,0,25,2
1713340298338,MUS 11,A02,494129,Staff,24,0,25,1
1713340299364,MUS 13,A01,494131,Staff,25,0,25,0
1713340299364,MUS 13,A02,494132,Staff,25,0,25,0
1713340300391,MUS 15,A01,494134,Staff,16,0,25,9
1713340300391,MUS 15,A02,494135,Staff,25,0,25,0
1713340300391,MUS 15,B01,494137,Staff,24,0,25,1
1713340301425,MUS 80,A00,494232,Staff,24,0,25,1
1713340301425,MUS 80,B00,494233,Staff,25,0,25,0
1713340301425,MUS 80,C00,494234,Staff,23,0,25,2
1713340302453,MUS 95C,A00,494141,Staff,69,0,75,6
1713340303480,MUS 114,A00,494142,Staff,39,0,50,11
1713340304563,NANO 15,A01,490636,Drews; Aaron,7,0,7,0
1713340305593,PHIL 1,A00,490578,Grush; Rick Scott,49,0,50,1
1713340306619,PHIL 10,A01,490580,Grush; Rick Scott,33,0,35,2
1713340306619,PHIL 10,A02,490586,Grush; Rick Scott,32,0,35,3
1713340307647,PHIL 27,A01,490591,Staff,22,0,25,3
1713340307647,PHIL 27,A02,490592,Staff,25,0,25,0
1713340307647,PHIL 27,A03,490593,Staff,25,0,25,0
1713340307647,PHIL 27,A04,490598,Staff,25,0,25,0
1713340308672,PHIL 32,A01,490611,Staff,20,0,20,0
1713340308672,PHIL 32,A02,490618,Staff,20,0,20,0
1713340309704,PHIL 90,A00,490624,Staff,40,0,40,0
1713340310734,PHIL 136,A00,490627,Cohen; Jonathan David,37,0,40,3
1713340311762,PHIL 155,A00,490634,Staff,62,0,70,8
1713340312801,PHYS 1A,A00,491610,Staff,245,0,250,5
1713340313830,PHYS 1AL,001,491616,Tsai; Philbert S,27,0,30,3
1713340313830,PHYS 1AL,002,491618,Tsai; Philbert S,30,0,30,0
1713340314859,PHYS 1B,A00,491623,Staff,235,0,250,15
1713340315885,PHYS 1BL,001,491626,Tsai; Philbert S,19,0,30,11
1713340315885,PHYS 1BL,002,491628,Tsai; Philbert S,26,0,30,4
1713340316914,PHYS 1C,A00,491632,Staff,212,0,245,33
1713340317940,PHYS 1CL,001,491635,Tsai; Philbert S,3,0,30,27
1713340317940,PHYS 1CL,002,491643,Tsai; Philbert S,22,0,30,8
1713340318968,PHYS 2AR,A01,491651,Meyertholen; Andrew D.,44,0,50,6
1713340320013,PHYS 2B,A01,491659,Staff,105,0,115,10
1713340321043,PHYS 2BL,A01,491685,Staff,21,0,24,3
1713340321043,PHYS 2BL,A02,491700,Staff,21,0,24,3
1713340322071,PHYS 2C,A01,505161,Staff,101,0,115,14
1713340323098,PHYS 4A,A01,491704,Grinstein; Benjamin,99,0,100,1
1713340324127,POLI 5D,A01,494144,Staff,3,0,5,2
1713340324127,POLI 5D,B01,626283,Dai; Yinlin,5,0,5,0
1713340325154,POLI 12,A00,494145,Staff,43,0,45,2
1713340326184,POLI 13R,A00,494146,Forman; Fonna,45,0,50,5
1713340327210,POLI 27,A01,494148,Staff,54,0,60,6
1713340328240,POLI 30,A00,494149,Staff,49,0,50,1
1713340329265,POLI 100DA,A00,494150,Staff,20,0,25,5
1713340331319,POLI 100I,A00,494152,Staff,27,0,30,3
1713340332348,POLI 104B,A00,494153,Smith; Glenn Chatmas,53,0,55,2
1713340333378,POLI 104F,A00,494154,Staff,28,0,30,2
1713340334401,POLI 104I,A00,494155,Smith; Glenn Chatmas,29,0,30,1
1713340335427,POLI 110C,A00,494156,Ingham; Sean,23,0,25,2
1713340336454,POLI 117R,A00,494157,Forman; Fonna,5,0,20,15
1713340337479,POLI 118,A00,494158,Ingham; Sean,21,0,25,4
1713340338508,POLI 120H,A00,494159,Fisk; David Lee,39,0,45,6
1713340339543,POLI 131CR,A00,494160,Hoston; Germaine,35,0,45,10
1713340340573,POLI 133J,A00,494161,Staff,31,0,35,4
1713340341599,POLI 135,A00,494162,Fisk; David Lee,33,0,35,2
1713340342628,POLI 140A,A00,494164,Staff,18,0,30,12
1713340343654,POLI 142I,A00,494165,Staff,30,0,30,0
1713340344679,POLI 144D,A00,494166,Staff,22,0,25,3
1713340345711,POLI 151,A00,494167,Staff,30,0,30,0
1713340346743,POLI 153,A00,494168,Staff,33,0,35,2
1713340347771,POLI 160AA,A00,494169,Staff,33,0,40,7
1713340348800,POLI 162,A00,494170,Mignozzetti; Umberto,18,0,25,7
1713340349824,POLI 171,A00,494171,Mignozzetti; Umberto,18,0,25,7
1713340350851,PSYC 1,A00,494172,Staff,95,0,100,5
1713340351882,PSYC 2,A00,494173,Moranton; Nirelia Melbina-,34,0,50,16
1713340352909,PSYC 3,A00,494174,Staff,29,0,30,1
1713340353939,PSYC 6,A00,494175,Staff,17,0,20,3
1713340354964,PSYC 60,A01,494177,Staff,37,0,45,8
1713340355990,PSYC 70,A01,505724,Geller; Emma Harlan,42,0,45,3
1713340357016,PSYC 101,A00,494180,Heyman; Gail D.,84,0,100,16
1713340358044,PSYC 105,A00,494181,Geller; Emma Harlan,51,0,90,39
1713340359074,PSYC 106,A00,494182,Dobkins; Karen R.,26,0,45,19
1713340360105,PSYC 108,A00,494183,Adrian; Julia Anna,89,0,100,11
1713340361133,PSYC 114,A01,494185,Winkielman; Piotr,0,3,30,30
1713340362159,PSYC 122,A00,494186,Moranton; Nirelia Melbina-,27,0,50,23
1713340363184,PSYC 124,A00,494187,Chapman; Eddie Nathaniel,69,0,80,11
1713340364216,PSYC 131,A00,494188,Anagnostaras; Stephan,40,0,80,40
1713340365242,PSYC 144,A00,494189,Staff,0,0,50,50
1713340366269,PSYC 154,A00,494190,Lacefield; Katharine I,105,0,180,75
1713340367297,PSYC 162,A00,494191,Wixted; John T,70,0,100,30
1713340368327,PSYC 172,A00,494192,Gorman; Michael R.,36,0,45,9
1713340369357,PSYC 178,A00,494193,Glaser; Dale,34,0,45,11
1713340370389,PSYC 193,A00,505725,Chapman; Eddie Nathaniel,20,0,20,0
1713340371416,RELI 145GS,A00,519817,Rahimi; Babak,17,0,20,3
1713340372445,SE 101A,A01,490862,Chadha; Mayank,23,0,25,2
1713340373474,SE 101C,A01,490924,Krysl; Petr,15,0,20,5
1713340374499,SE 110A,A01,490928,Staff,19,0,20,1
1713340375530,SE 130A,A00,490929,Morrison; Machel Leigh,54,0,70,16
1713340376557,SIO 1,A01,519325,Staff,39,0,40,1
1713340377581,SIO 30,A01,519327,Staff,38,0,40,2
1713340378610,SIO 40,A00,519328,Staff,39,0,40,1
1713340379636,SIO 46GS,A00,519819,Cook; Geoffrey W,15,0,25,10
1713340380667,SIO 109R,A00,494197,Forman; Fonna,0,3,20,20
1713340381695,SIO 121GS,A00,519827,Cook; Geoffrey W,15,0,25,10
1713340382721,SIO 132,A01,519330,Staff,38,0,40,2
1713340383749,SIO 133,A01,519397,Staff,37,0,40,3
1713340384778,SIO 139,A00,519396,Kacev; David,29,0,40,11
1713340385821,SOCI 1,A01,494199,Thorpe; Charles Robert,21,0,30,9
1713340385821,SOCI 1,A02,494200,Thorpe; Charles Robert,30,0,30,0
1713340385821,SOCI 1,A03,494201,Thorpe; Charles Robert,29,0,30,1
1713340385821,SOCI 1,A04,494202,Thorpe; Charles Robert,29,0,30,1
1713340385821,SOCI 1,A05,494203,Thorpe; Charles Robert,29,0,30,1
1713340385821,SOCI 1,A06,494204,Thorpe; Charles Robert,30,0,30,0
1713340385821,SOCI 1,A07,494205,Thorpe; Charles Robert,28,0,30,2
1713340386848,SOCI 60,A01,494207,Staff,33,0,40,7
1713340386848,SOCI 60,A02,494208,Staff,39,0,40,1
1713340387874,SOCI 100,A01,494210,Payne; Christine Anna,25,0,30,5
1713340387874,SOCI 100,A02,494211,Payne; Christine Anna,26,0,30,4
1713340388899,SOCI 109M,A00,494212,Staff,20,0,20,0
1713340389925,SOCI 110,A00,494213,Staff,34,0,40,6
1713340391988,SOCI 118E,A00,494215,Ng; Kwai,37,0,40,3
1713340393019,SOCI 125,A00,494216,Calderon-Zaks; Michael Aar,39,0,45,6
1713340394049,SOCI 126,A01,494218,Jones; Makeba,3,0,5,2
1713340395076,SOCI 131,A00,494219,Thorpe; Charles Robert,26,0,30,4
1713340397129,SOCI 135,A00,494221,Payne; Christine Anna,28,0,50,22
1713340398155,SOCI 136E,A00,626690,Ruiz; Jonathan Joseph,24,0,25,1
1713340399185,SOCI 138GS,A00,494222,Navon; Daniel,23,0,28,5
1713340401240,SOCI 145,A00,494224,Staff,40,0,45,5
1713340402269,SOCI 153,A00,494225,Staff,28,0,30,2
1713340403299,SOCI 160E,A00,494226,Ng; Kwai,27,0,40,13
1713340404323,SOCI 180,A00,494227,Staff,29,0,30,1
1713340405352,SOCI 189GS,A00,494228,Ribas Norris; Janet Vanesa,11,0,11,0
1713340406378,SOCI 190GS,A00,553232,Ribas Norris; Janet Vanesa,11,0,11,0
1713340407407,SOMI 220,A00,627178,Schneid; Stephen David,30,0,30,0
1713340408490,SYN 2,001,490768,Staff,13,0,15,2
1713340408490,SYN 2,002,490769,Staff,14,0,15,1
1713340408490,SYN 2,004,490775,Staff,0,0,0,0
1713340408490,SYN 2,003,490774,Staff,0,0,0,0
1713340408490,SYN 2,005,490776,Staff,0,0,0,0
1713340409519,SYN 2R,001,490779,Staff,11,0,15,4
1713340409519,SYN 2R,002,514635,Staff,14,0,15,1
1713340410546,SYN 100,A01,490783,Staff,8,0,20,12
1713340410546,SYN 100,B01,490787,Staff,10,0,20,10
1713340410546,SYN 100,C01,490789,Staff,10,0,20,10
1713340411572,SYN 150,A00,490817,Staff,14,0,15,1
1713340411572,SYN 150,B00,514610,Staff,15,0,15,0
1713340412611,TDAC 1,A00,492753,Walsh; Kim C.,19,0,20,1
1713340412611,TDAC 1,B00,492754,Harting; Carla Kelso,18,0,20,2
1713340412611,TDAC 1,C00,513995,Salovey; Todd,15,0,20,5
1713340413642,TDAC 101,A00,492766,Harting; Carla Kelso,17,0,20,3
1713340414673,TDAC 102,A00,492768,Basso; Beatrice,19,0,20,1
1713340415701,TDDE 111,A00,492769,Staff,25,0,25,0
1713340416733,TDDE 131,A00,492770,Staff,15,0,15,0
1713340416733,TDDE 131,B00,492771,Staff,15,0,15,0
1713340417760,TDDE 131GS,A00,523716,Guirguis; Mark C,23,0,28,5
1713340418793,TDGE 1,A01,492756,Salovey; Todd,56,0,60,4
1713340419818,TDGE 5,A01,492758,Staff,23,0,25,2
1713340420843,TDGE 10,A00,492759,Fulton; Julia,203,0,220,17
1713340421871,TDGE 11,A00,492760,Castro; Robert Jess,198,0,200,2
1713340423926,TDGE 124,A00,492772,Fulton; Julia,181,0,220,39
1713340424954,TDGE 125,A00,492773,Meyer; Ursula,38,0,50,12
1713340424954,TDGE 125,B00,492774,Staff,49,0,50,1
1713340424954,TDGE 125,C00,523565,Staff,48,0,50,2
1713340425982,TDGE 125GS,A00,523580,Guirguis; Mark C,23,0,28,5
1713340427009,TDGE 127,A00,492775,Havis; Allan,32,0,50,18
1713340428039,TDHT 101,A00,492776,Staff,34,0,35,1
1713340429071,TDMV 1,A00,492762,Caligagan; Maria T.,29,0,30,1
1713340429071,TDMV 1,B00,492763,Arcidiacono; Kristin,26,0,30,4
1713340430101,TDMV 2,A00,492764,Weinberg; Sadie,27,0,30,3
1713340431132,TDMV 3,A00,492765,Mack; Kara Shanai',37,0,40,3
1713340432163,TDMV 138,A00,492777,Mack; Kara Shanai',32,0,40,8
1713340433191,TDMV 140,A00,492778,Lima; Paulo Henrique,40,0,40,0
1713340434220,TDMV 142,A00,492779,Caligagan; Maria T.,33,0,40,7
1713340434220,TDMV 142,B00,492780,Caligagan; Tony,37,0,40,3
1713340435251,TDMV 143,A00,492781,Fyall; Daunte Edward,39,0,40,1
1713340436282,USP 1,A01,492401,Kwak; Nancy,27,0,35,8
1713340437310,USP 2,A01,492453,Hinds; Juli Beth,35,0,35,0
1713340438338,USP 3,A01,492516,Staff,28,0,35,7
1713340439365,USP 4,A00,492522,McTague; Sarah,16,0,25,9
1713340440392,USP 100,A00,492523,Staff,32,0,35,3
1713340441418,USP 101,A00,492524,Staff,13,0,15,2
1713340442444,USP 105,A00,492525,Staff,21,0,25,4
1713340443473,USP 151,A00,492526,Shenkman; Michael Thomas,32,0,35,3
1713340444499,USP 170,A00,492545,Hinds; Juli Beth,33,0,35,2
1713340445530,USP 171GS,A00,492608,Bussell; Mirle Rabinowitz,24,0,28,4
1713340446554,USP 183GS,A00,492613,Peerson; Susan,24,0,28,4
1713340447579,VIS 30,A01,490693,Yoldas; Pinar,19,0,22,3
1713340447579,VIS 30,A02,490694,Yoldas; Pinar,18,0,22,4
1713340448610,VIS 83,A00,490695,Kester; Grant,63,0,75,12
1713340449636,VIS 105D,A00,490696,Staff,22,0,25,3
1713340450662,VIS 124CN,A00,490699,Rose; Jordan M,64,0,75,11
1713340451688,VIS 125GS,A00,511221,Williams; Alena J,21,0,22,1
1713340452719,VIS 128D,A00,490700,Staff,73,0,75,2
1713340453748,VIS 151,A01,490717,Staff,33,0,34,1
1713340453748,VIS 151,A02,490766,Staff,33,0,34,1
1713340454774,VIS 154GS,A00,511972,Williams; Alena J,21,0,22,1
1713340455804,VIS 160A,A00,490767,Stone; Patricia,7,0,10,3
1713340456832,WCWP 10A,A00,490638,Staff,14,0,15,1
1713340456832,WCWP 10A,B00,490640,Staff,15,0,15,0
1713340457859,WCWP 10B,A00,490641,Staff,0,0,0,0
1713340457859,WCWP 10B,B00,490642,Staff,14,0,15,1
1713340457859,WCWP 10B,C00,490644,Staff,13,0,15,2
1713340457859,WCWP 10B,D00,490647,Staff,0,0,0,0
1713340458886,WCWP 100,A00,490655,Staff,0,0,0,0
1713340458886,WCWP 100,B00,490687,Staff,10,0,15,5
1713340461049,ANAR 153,A00,487222,Braswell; Geoffrey E.,53,0,60,7
1713340462074,ANBI 134,A00,487223,Staff,5,0,20,15
1713340463105,ANBI 143GS,A00,487224,Noel; Geoffroy Pierre Jean,18,0,24,6
1713340464133,ANBI 144GS,A00,519548,Noel; Geoffroy Pierre Jean,18,0,24,6
1713340465159,ANSC 101,A00,487225,Staff,17,0,20,3
1713340466192,ANSC 125,A00,487227,Brenner; Suzanne A,38,0,40,2
1713340468251,ANSC 146,A00,487229,Staff,35,0,40,5
1713340469281,ANSC 148,A00,487230,Olivas Hernandez; Olga Lid,39,0,40,1
1713340470316,ANSC 150,A00,504165,Sloane; Julia Kathryn,18,0,20,2
1713340471343,ANSC 180,A00,487232,Staff,14,0,15,1
1713340472370,ANSC 188,A00,627155,Staff,37,0,40,3
1713340473401,ANTH 5,A00,519529,Semendeferi; Ekaterini,15,0,15,0
1713340474431,ANTH 10,A00,487219,Staff,58,0,60,2
1713340475456,ANTH 23,A01,487221,Staff,17,0,20,3
1713340476483,ANTH 102,A00,487233,Wilder; Linnea Lorene,50,0,60,10
1713340477516,ANTH 103,A00,487234,Varma; Saiba,54,0,60,6
1713340478541,ANTH 105,A00,487235,Stewart; Alexander B,54,0,60,6
1713340479574,BENG 100,A01,516685,Taylor Amos; Alyssa C,25,0,30,5
1713340480603,BIBC 102,A01,491316,Flagg; Matthew Paul,5,0,88,83
1713340480603,BIBC 102,A02,491366,Flagg; Matthew Paul,78,0,88,10
1713340481634,BIBC 103,A01,491486,Boumechache; Miyyada,16,0,24,8
1713340481634,BIBC 103,A02,491487,Boumechache; Miyyada,24,0,24,0
1713340482662,BICD 100,A01,516882,Staff,73,0,75,2
1713340482662,BICD 100,A02,516890,Staff,69,0,75,6
1713340483692,BICD 102GS,A00,491488,Lo; Stanley M.,26,0,28,2
1713340484722,BIEB 136GS,A00,516940,Holway; David A. & Shurin; Jonathan,18,0,24,6
1713340485748,BIEB 137GS,A01,517034,Holway; David A. & Shurin; Jonathan,18,0,24,6
1713340486774,BIEB 138GS,A01,491492,Pirino; Giorgia,21,0,28,7
1713340487801,BILD 1,A01,491296,Staff,60,0,63,3
1713340487801,BILD 1,A02,491297,Staff,63,0,63,0
1713340488828,BILD 4,A01,517099,Gonzalez Gamboa; Ivonne,22,0,24,2
1713340488828,BILD 4,A02,517100,Gonzalez Gamboa; Ivonne,24,0,24,0
1713340489857,BILD 60GS,A00,491309,Lo; Stanley M.,26,0,28,2
1713340490886,BIMM 100,A01,517136,Staff,82,0,100,18
1713340491913,BIMM 110,A01,517182,Staff,53,0,100,47
1713340492940,BIMM 120,A01,517228,Pickett; Brooke Elizabeth,28,0,63,35
1713340492940,BIMM 120,A02,517240,Pickett; Brooke Elizabeth,44,0,63,19
1713340493965,BIMM 132GS,A01,491498,Pirino; Giorgia,21,0,28,7
1713340494993,BIMM 143,A01,491589,Bozinovic; Goran,12,0,40,28
1713340496024,BIPN 100,A01,491594,Armour; Jon Christopher,83,0,100,17
1713340497051,BIPN 140,A01,491602,Marino; Marc J,23,0,50,27
1713340499109,CAT 125,A00,515973,Staff,18,0,20,2
1713340500139,CAT 125GS,A00,515974,Rahimi; Babak,16,0,20,4
1713340501169,CAT 125R,A00,515980,Staff,12,0,20,8
1713340501169,CAT 125R,B00,515981,Tosun; Adriana,19,0,20,1
1713340501169,CAT 125R,C00,515987,Hyland; Tina Mae,0,5,20,20
1713340501169,CAT 125R,D00,515988,Bronstein; Phoebe Malan,16,0,20,4
1713340502205,CENG 15,A01,488699,Drews; Aaron,25,0,25,0
1713340503231,CENG 100,A00,505196,Opatkiewicz; Justin Paul,25,0,25,0
1713340504258,CGS 2A,A01,489598,Staff,32,0,35,3
1713340505287,CGS 112,A00,489599,Staff,15,0,15,0
1713340506312,CGS 119,A00,489603,Staff,10,0,10,0
1713340507344,CGS 120,A00,489604,Staff,13,0,15,2
1713340508376,CGS 150,A00,489607,Staff,15,0,15,0
1713340509402,CHEM 6A,A01,488715,Staff,97,0,100,3
1713340510433,CHEM 6B,A01,488719,Piercy; Marc Anthony,99,0,100,1
1713340511466,CHEM 6C,A01,488723,Albizati; Kim F.,93,0,100,7
1713340512559,CHEM 7L,A01,488728,Schurmeier; Kimberly,18,0,24,6
1713340512559,CHEM 7L,A02,488730,Schurmeier; Kimberly,23,0,24,1
1713340512559,CHEM 7L,A03,488734,Schurmeier; Kimberly,20,0,24,4
1713340512559,CHEM 7L,A04,488763,Schurmeier; Kimberly,23,0,24,1
1713340512559,CHEM 7L,B01,488798,Schurmeier; Kimberly,16,0,24,8
1713340512559,CHEM 7L,B02,488801,Schurmeier; Kimberly,22,0,24,2
1713340512559,CHEM 7L,B03,488808,Schurmeier; Kimberly,22,0,24,2
1713340512559,CHEM 7L,B04,488811,Schurmeier; Kimberly,24,0,24,0
1713340513592,CHEM 11,A01,488897,Stallings; Dontarie M,94,0,100,6
1713340514622,CHEM 40A,A01,488913,Albizati; Kim F.,83,0,100,17
1713340515649,CHEM 40B,A01,488920,Weizman; Haim,42,0,50,8
1713340515649,CHEM 40B,A02,488938,Weizman; Haim,43,0,50,7
1713340516678,CHEM 41A,A01,489029,Klosterman; Jeremy K,57,0,60,3
1713340517705,CHEM 41C,A01,500436,Tor; Yitzhak,55,0,60,5
1713340518739,CHEM 43A,A01,500426,Weizman; Haim,0,1,24,24
1713340518739,CHEM 43A,A02,500430,Weizman; Haim,5,0,24,19
1713340518739,CHEM 43A,B01,514041,Klosterman; Jeremy K,15,0,24,9
1713340518739,CHEM 43A,B02,514047,Klosterman; Jeremy K,23,0,24,1
1713340519766,CHEM 108,A01,489140,Jennings; Patricia A.,7,0,24,17
1713340519766,CHEM 108,A02,489142,Jennings; Patricia A.,14,0,24,10
1713340520798,CHEM 114A,A01,489147,Stallings; Dontarie M,65,0,100,35
1713340521826,CHIN 169A,A00,489171,Wang; Xiao,19,0,20,1
1713340523887,COGS 3,A01,518827,Boyle; Mary E. T.,25,0,40,15
1713340524914,COGS 11,A01,489175,Staff,27,0,30,3
1713340525939,COGS 14A,A01,518829,Staff,50,0,60,10
1713340526974,COGS 14B,A01,489177,Hoffman; Drew Ellen,62,0,75,13
1713340528001,COGS 100,A01,489181,Allen; Michael Gordon,62,0,75,13
1713340529029,COGS 101A,A01,489183,Staff,45,0,60,15
1713340530060,COGS 101B,A01,489185,Allen; Michael Gordon,6,0,30,24
1713340531087,COGS 101C,A01,526786,Staff,23,0,30,7
1713340533142,COGS 107A,A01,489189,Boyle; Mary E. T.,16,0,35,19
1713340534172,COGS 107B,A01,627144,Mooshagian; Eric Frederick,60,0,60,0
1713340535208,COGS 118A,A01,489191,Staff,0,46,40,40
1713340537259,COGS 171GS,A01,489194,Pineda; Jaime A,19,0,28,9
1713340538286,COGS 172,A01,489196,Staff,2,0,30,28
1713340539310,COGS 174GS,A01,489264,Pineda; Jaime A,19,0,28,9
1713340540339,COGS 180,A01,627150,Staff,28,0,30,2
1713340541368,COGS 186,A01,489274,Staff,0,2,30,30
1713340542394,COMM 10,A01,489276,Staff,23,0,25,2
1713340542394,COMM 10,A02,489303,Staff,23,0,25,2
1713340543425,COMM 100A,A01,489312,Staff,14,0,25,11
1713340543425,COMM 100A,A02,489313,Staff,24,0,25,1
1713340544452,COMM 106T,A00,512540,Staff,33,0,35,2
1713340545476,COMM 107,A00,489347,Staff,27,0,35,8
1713340546502,COMM 109P,A00,489358,Staff,31,0,35,4
1713340547534,COMM 132,A00,489361,McKenna; Denise,27,0,30,3
1713340548565,COMM 146,A00,489362,Halm; Gavin Patrick,26,0,30,4
1713340549590,COMM 190,A00,489363,Abuelhiga; Soraya Jill,17,0,23,6
1713340550620,CSE 8A,A50,489366,Staff,21,0,25,4
1713340550620,CSE 8A,A51,489367,Staff,24,0,25,1
1713340551650,CSE 11,A01,489398,Cao; Yingjun,72,0,100,28
1713340552678,CSE 12,A01,489487,Staff,43,0,50,7
1713340553706,CSE 20,A01,489497,Staff,47,0,50,3
1713340554733,CSE 21,A01,489517,Braun; Oliver,42,0,50,8
1713340555763,CSE 101,A01,489524,Braun; Oliver,0,33,50,50
1713340556791,CSE 105,A01,512594,Jones; Miles E,72,0,100,28
1713340556791,CSE 105,B01,512598,Jones; Miles E,51,0,100,49
1713340557824,CSE 140,A01,489538,Staff,41,0,50,9
1713340558852,CSE 141,A01,489550,Eldon; John,67,0,100,33
1713340559883,CSE 141L,A01,489571,Eldon; John,65,0,100,35
1713340560910,CSE 151A,A01,489583,Solares; Edwin A,140,0,200,60
1713340561934,CSE 175,A01,510886,Kumar; Rakesh,30,0,30,0
1713340562963,CSE 190,A00,516828,Dubnov; Shlomo,37,0,49,12
1713340563989,DOC 100D,A00,489667,Pass; Natalye Joann,19,0,25,6
1713340565016,DSC 10,A01,624268,Staff,72,0,75,3
1713340566048,DSC 20,A01,624476,Staff,50,0,50,0
1713340567077,DSC 40A,A01,624608,Staff,39,0,40,1
1713340568105,DSGN 1,A01,489179,Rill; Bryan,32,0,50,18
1713340569138,ECE 17,A01,490489,Sahay; Rajeev,18,0,30,12
1713340570170,ECE 65,A50,490492,Staff,11,0,20,9
1713340570170,ECE 65,A51,490493,Staff,18,0,20,2
1713340571199,ECON 1,A01,489715,Famulari; Melissa,67,0,70,3
1713340572227,ECON 2,A01,489717,Levkoff; Steven B.,67,0,70,3
1713340573261,ECON 3,A01,489948,Staff,70,0,70,0
1713340575320,ECON 5,A01,490103,Staff,27,0,30,3
1713340575320,ECON 5,B01,626281,Dai; Yinlin,45,0,45,0
1713340576347,ECON 100A,A01,490127,Famulari; Melissa,62,0,70,8
1713340577372,ECON 100B,A01,490129,Staff,64,0,70,6
1713340578403,ECON 109,A01,490187,Shishkin; Denis,27,0,35,8
1713340579434,ECON 110A,A01,490190,Levkoff; Steven B.,59,0,70,11
1713340580465,ECON 120A,A01,490245,Dai; Yinlin,59,0,70,11
1713340581494,ECON 120B,A01,490247,Nieto-Barthaburu; Augusto,40,0,70,30
1713340582521,ECON 120C,A01,490253,Sun; Yixiao,30,0,35,5
1713340582521,ECON 120C,B01,490255,Sun; Yixiao,34,0,35,1
1713340583547,ECON 129,A00,490256,Eckert; Fabian Paul,22,0,35,13
1713340584573,ECON 131,A00,490257,Nieto-Barthaburu; Augusto,0,6,35,35
1713340585599,ECON 138,A00,490258,Bharadwaj; Prashant,13,0,35,22
1713340585599,ECON 138,B00,490259,Bharadwaj; Prashant,15,0,35,20
1713340586631,ECON 159,A00,490260,Hendrickson; Gerald M.,0,9,0,0
1713340587659,ECON 178,A01,553995,Zhu; Ying,24,0,35,11
1713340588686,EDS 40,A01,512576,Black; Alison Michelle,20,0,20,0
1713340589711,EDS 107,A01,515848,Staff,30,0,30,0
1713340590738,EDS 110R,A01,490262,Staff,26,0,30,4
1713340591767,EDS 112,A01,490264,Chapman; Thandeka K,40,0,50,10
1713340592796,EDS 113,A00,490266,Staff,25,0,30,5
1713340593822,EDS 118,A00,490267,Warstadt; Melissa Fawn,18,0,30,12
1713340594846,EDS 124BR,A00,490268,Eguchi; Emi,4,0,25,21
1713340594846,EDS 124BR,B00,490269,Eguchi; Emi,23,0,25,2
1713340595872,EDS 126,A01,490271,Jones; Makeba,43,0,50,7
1713340596900,EDS 135,A01,490316,Staff,19,0,20,1
1713340597926,ENVR 142GS,A00,519514,Chang; Edmond Yi-Teh,26,0,28,2
1713340598957,ETHN 103,A00,490504,Staff,25,0,36,11
1713340599982,ETHN 103A,A00,490505,Man; Simeon S,3,0,9,6
1713340601011,ETHN 109,A00,490506,Staff,28,0,30,2
1713340602039,ETHN 118,A00,490507,Staff,35,0,36,1
1713340603063,ETHN 119,A00,490508,Staff,32,0,36,4
1713340604090,ETHN 121R,A00,490518,Choi; Esther Min,21,0,36,15
1713340605120,ETHN 127,A00,490528,Staff,14,0,15,1
1713340606146,ETHN 139,A00,490573,Staff,10,0,10,0
1713340607175,ETHN 150,A00,490575,Staff,15,0,15,0
1713340608205,GLBH 20,A00,491705,Elwardani; Nile Regina,38,0,40,2
1713340609234,GLBH 101,A00,491706,Staff,20,0,20,0
1713340610263,GLBH 111,A01,491708,Burgos; Jose L.,15,0,15,0
1713340611291,GLBH 146,A00,491709,Staff,8,0,20,12
1713340612318,GLBH 148,A00,491710,Olivas Hernandez; Olga Lid,10,0,20,10
1713340613344,GLBH 150,A00,491711,Sloane; Julia Kathryn,19,0,20,1
1713340614370,HIEA 131,A00,491760,Staff,28,0,32,4
1713340615395,HIEA 153,A00,491762,Staff,28,0,30,2
1713340616475,HIEU 124,A00,491811,Staff,26,0,32,6
1713340617500,HIEU 124GS,A00,491812,Markman; Kristina,27,0,28,1
1713340618526,HIEU 147,A00,491813,Staff,30,0,32,2
1713340619553,HIEU 149GS,A00,491816,Caldwell; Michael Alan,28,0,28,0
1713340620578,HILD 2C,A01,491713,Hendrickson; Gerald M.,26,0,30,4
1713340621607,HILD 7B,A01,491715,Kwak; Nancy,0,2,30,30
1713340622637,HILD 10,A01,491717,Staff,9,0,20,11
1713340623662,HILD 30GS,A00,491719,Edington; Claire Ellen,23,0,28,5
1713340624688,HINE 109,A00,491818,Shafir; Nir,27,0,32,5
1713340625722,HINE 128,A00,491821,Shafir; Nir,30,0,32,2
1713340626747,HISC 117,A00,491830,Staff,27,0,32,5
1713340627773,HIUS 103,A00,491834,Man; Simeon S,14,0,23,9
1713340628800,HIUS 108B,A00,491835,Staff,27,0,30,3
1713340629827,HIUS 141,A00,491836,Hendrickson; Gerald M.,28,0,32,4
1713340630853,HIUS 149,A00,491839,Staff,24,0,32,8
1713340631881,HUM 3,A01,512617,Crum; Matthew Stephen,42,0,50,8
1713340631881,HUM 3,A02,512618,Crum; Matthew Stephen,48,0,50,2
1713340632912,HUM 3GS,A00,512663,Markman; Kristina,0,0,0,1
1713340632912,HUM 3GS,B00,512664,Staff,0,0,0,0
1713340633943,HUM 4,A01,512620,West; Geoffrey Scott,24,0,50,26
1713340634969,HUM 4GS,A00,512666,Lyon; Antony J.,0,0,0,5
1713340635994,HUM 4R,A01,512625,Watkins; Eric,49,0,50,1
1713340637026,HUM 5,A01,512649,Zavodny; Tatiana Sophia,20,0,50,30
1713340637026,HUM 5,B01,512661,Zroka; Ryan Edward,48,0,50,2
1713340638053,INTL 190,A00,490577,Segui; Alan S,0,0,0,5
1713340639080,JAPN 20AR,A01,491267,Ross; Kayoko F,7,0,20,13
1713340640106,JAPN 180,A00,491285,Berman; Michael David,33,0,40,7
1713340641141,LATI 50,A01,502536,Kokinis; Troy Andreas,16,0,22,6
1713340641141,LATI 50,A02,502551,Kokinis; Troy Andreas,22,0,22,0
1713340641141,LATI 50,A03,502650,Kokinis; Troy Andreas,22,0,22,0
1713340641141,LATI 50,A04,502909,Kokinis; Troy Andreas,21,0,22,1
1713340642166,LATI 160,A01,502920,Kokinis; Troy Andreas,30,0,30,0
1713340643192,LIFR 1A,A00,490494,Van Moer; Vinciane G,17,0,20,3
1713340644221,LIFR 1AX,A00,490495,Van Moer; Vinciane G,17,0,20,3
1713340645245,LIFR 1B,A00,490496,Van Moer; Vinciane G,17,0,20,3
1713340646275,LIFR 1BX,A00,490497,Van Moer; Vinciane G,17,0,20,3
1713340647306,LIGN 8,A00,505198,McIntosh; Justin Daniel,134,0,150,16
1713340648336,LIGN 9GS,A00,491239,Lott; Margaret S.,18,0,20,2
1713340649363,LIGN 101,A01,505200,McIntosh; Justin Daniel,22,0,30,8
1713340650389,LIGN 120,A01,491244,Staff,22,0,30,8
1713340651418,LIGN 149GS,A00,491245,Lott; Margaret S.,18,0,20,2
1713340652450,LIGN 170,A00,491247,Staff,22,0,30,8
1713340653482,LISP 1D,A00,490498,Munoz Sanchez; Alicia,8,0,14,6
1713340653482,LISP 1D,B00,490499,Munoz Sanchez; Alicia,4,0,14,10
1713340653482,LISP 1D,C00,490500,Munoz Sanchez; Alicia,7,0,14,7
1713340653482,LISP 1D,D00,490501,Munoz Sanchez; Alicia,10,0,14,4
1713340654508,LISP 1DX,A00,490502,Munoz Sanchez; Alicia,11,0,28,17
1713340654508,LISP 1DX,B00,490503,Munoz Sanchez; Alicia,16,0,28,12
1713340656569,LTAM 110,A00,491847,Staff,22,0,25,3
1713340657597,LTCS 119,A00,491848,Staff,11,0,15,4
1713340658628,LTCS 130,A00,491849,Staff,24,0,25,1
1713340660679,LTEA 120C,A00,491852,Staff,32,0,40,8
1713340661710,LTEN 130GS,A00,491853,Lyon; Antony J.,23,0,28,5
1713340662742,LTEN 148,A00,491855,Staff,23,0,25,2
1713340663772,LTEN 159,A00,491856,Staff,20,0,25,5
1713340664798,LTEN 180,A00,491857,Staff,8,0,15,7
1713340666851,LTSP 123GS,A00,505928,Bessett; Ryan Matthew,24,0,28,4
1713340667878,LTSP 174GS,A00,506037,Bessett; Ryan Matthew,24,0,28,4
1713340669932,LTWR 102,A00,491861,Staff,9,0,15,6
1713340670958,LTWR 106,A00,491862,Staff,8,0,15,7
1713340671987,MAE 11,A00,490930,Bahadori; Mohammad Yousef,94,0,100,6
1713340673013,MAE 30A,A00,490931,Qi; Huihui,37,0,40,3
1713340674039,MAE 101A,A00,491036,Sadeghizadeh; Zahra,91,0,100,9
1713340675066,MAE 101C,A00,491037,Seshadri; Kalyanasundaram,63,0,100,37
1713340676097,MAE 113,A00,491040,Seshadri; Kalyanasundaram,64,0,80,16
1713340677122,MAE 131A,A00,491041,Ghazinejad; Maziar,37,0,40,3
1713340678148,MAE 142,A00,491053,Staff,39,0,40,1
1713340679175,MAE 143A,A00,491054,Staff,29,0,50,21
1713340680201,MAE 150,A00,491092,Truong; Phuong Thi Ngoc,23,0,35,12
1713340681231,MATH 3C,A01,494031,Pardo Guerra; Sebastian,30,0,30,0
1713340681231,MATH 3C,A02,494032,Pardo Guerra; Sebastian,29,0,30,1
1713340682262,MATH 10A,A01,494034,Staff,27,0,30,3
1713340682262,MATH 10A,A02,494035,Staff,28,0,30,2
1713340682262,MATH 10A,B01,494037,Staff,27,0,30,3
1713340682262,MATH 10A,B02,494038,Staff,29,0,30,1
1713340683294,MATH 10B,A01,494040,Habib; Yousaf,22,0,30,8
1713340683294,MATH 10B,A02,494041,Habib; Yousaf,28,0,30,2
1713340683294,MATH 10B,A03,494042,Habib; Yousaf,29,0,30,1
1713340683294,MATH 10B,A04,494043,Habib; Yousaf,30,0,30,0
1713340683294,MATH 10B,B01,494045,Habib; Yousaf,25,0,30,5
1713340683294,MATH 10B,B02,494046,Habib; Yousaf,30,0,30,0
1713340683294,MATH 10B,B03,494047,Habib; Yousaf,30,0,30,0
1713340683294,MATH 10B,B04,494048,Habib; Yousaf,30,0,30,0
1713340684322,MATH 18,A01,494050,Kemp; Todd Aahron,25,0,30,5
1713340684322,MATH 18,A02,494051,Kemp; Todd Aahron,29,0,30,1
1713340684322,MATH 18,B01,494054,Kemp; Todd Aahron,25,0,30,5
1713340684322,MATH 18,B02,494055,Kemp; Todd Aahron,29,0,30,1
1713340685350,MATH 20A,A01,494059,Suk; Andrew Hoon,30,0,30,0
1713340686384,MATH 20B,A01,494061,Briones; Jor-el Thomas Caparas,33,0,35,2
1713340686384,MATH 20B,B01,494063,Bach; Quang Tran,34,0,35,1
1713340687414,MATH 20C,A01,494065,Staff,28,0,30,2
1713340687414,MATH 20C,A02,494066,Staff,30,0,30,0
1713340687414,MATH 20C,A03,494067,Staff,30,0,30,0
1713340687414,MATH 20C,A04,494068,Staff,30,0,30,0
1713340687414,MATH 20C,B01,494070,Zhang; Ming,24,0,30,6
1713340687414,MATH 20C,B02,494071,Zhang; Ming,27,0,30,3
1713340687414,MATH 20C,B03,494072,Zhang; Ming,29,0,30,1
1713340687414,MATH 20C,B04,494073,Zhang; Ming,29,0,30,1
1713340688440,MATH 20D,A01,494075,Staff,22,0,30,8
1713340688440,MATH 20D,A02,494076,Staff,29,0,30,1
1713340689472,MATH 20E,A01,494079,Staff,24,0,30,6
1713340689472,MATH 20E,A02,494080,Staff,26,0,30,4
1713340689472,MATH 20E,B01,494082,Staff,25,0,30,5
1713340689472,MATH 20E,B02,494083,Staff,25,0,30,5
1713340690498,MATH 103A,A01,494085,Aliabadi Sr.; Mohsen,12,0,30,18
1713340690498,MATH 103A,A02,494086,Aliabadi Sr.; Mohsen,28,0,30,2
1713340690498,MATH 103A,B01,494088,Aliabadi Sr.; Mohsen,20,0,30,10
1713340690498,MATH 103A,B02,494089,Aliabadi Sr.; Mohsen,27,0,30,3
1713340691526,MATH 109,A01,494091,Staff,30,0,30,0
1713340691526,MATH 109,A02,494092,Staff,29,0,30,1
1713340691526,MATH 109,B01,494094,Staff,27,0,30,3
1713340691526,MATH 109,B02,494095,Staff,29,0,30,1
1713340692554,MATH 142A,A01,494097,Chow; Bennett,13,0,30,17
1713340692554,MATH 142A,A02,494098,Chow; Bennett,23,0,30,7
1713340692554,MATH 142A,B01,494100,Chow; Bennett,19,0,30,11
1713340692554,MATH 142A,B02,494101,Chow; Bennett,29,0,30,1
1713340694607,MATH 168A,A01,516677,Dumitriu; Ioana,16,0,35,19
1713340695639,MATH 170A,A01,516679,Dumitriu; Ioana,18,0,30,12
1713340695639,MATH 170A,A02,516680,Dumitriu; Ioana,28,0,30,2
1713340696670,MATH 193A,A01,494107,Staff,12,0,30,18
1713340696670,MATH 193A,A02,494108,Staff,18,0,30,12
1713340696670,MATH 193A,A03,494109,Staff,29,0,30,1
1713340696670,MATH 193A,A04,494110,Staff,22,0,30,8
1713340699748,MGT 16,A00,491930,McKay; Michael J,92,0,98,6
1713340700783,MGT 18,A00,491992,McKay; Michael J,96,0,98,2
1713340701808,MGT 71,A00,492003,Staff,63,0,98,35
1713340702846,MGT 103,A00,505209,Eberhard; Craig A,80,0,98,18
1713340703872,MGT 131A,A00,505210,Anderson; John Charles,89,0,98,9
1713340705928,MGT 153,A00,492077,Perols; Johan Lars,16,0,90,74
1713340709014,MGT 164,A00,492222,McKay; Mary A,91,0,98,7
1713340710043,MGT 172,A00,492245,Staff,59,0,60,1
1713340710043,MGT 172,B00,505526,Hedges; Kathleen,65,0,98,33
1713340711070,MGT 181,A00,505669,Dunn; Louis Jean,78,0,98,20
1713340712097,MMW 14,A01,494399,Staff,15,0,28,13
1713340712097,MMW 14,A02,494400,Staff,25,0,28,3
1713340712097,MMW 14,A03,494401,Staff,28,0,28,0
1713340712097,MMW 14,A04,494402,Staff,28,0,28,0
1713340712097,MMW 14,B01,494404,Carreras; Maria Victoria,8,0,28,20
1713340712097,MMW 14,B02,494405,Carreras; Maria Victoria,25,0,28,3
1713340712097,MMW 14,B03,494406,Carreras; Maria Victoria,27,0,28,1
1713340712097,MMW 14,B04,494407,Carreras; Maria Victoria,28,0,28,0
1713340713126,MMW 14GS,A00,506250,Chang; Edmond Yi-Teh,0,0,0,0
1713340714156,MMW 121R,A01,494415,Adamiak; Patrick John,10,0,28,18
1713340714156,MMW 121R,A02,494416,Adamiak; Patrick John,24,0,28,4
1713340715182,MUS 1A,A01,494113,Staff,12,0,25,13
1713340715182,MUS 1A,A02,494114,Staff,24,0,25,1
1713340716212,MUS 4,A01,494116,Staff,23,0,25,2
1713340716212,MUS 4,A02,494117,Staff,22,0,25,3
1713340717244,MUS 5R,A01,494236,Dubnov; Shlomo,4,0,25,21
1713340717244,MUS 5R,A02,494237,Dubnov; Shlomo,25,0,25,0
1713340718273,MUS 6,A01,494122,Staff,9,0,25,16
1713340718273,MUS 6,A02,494123,Staff,23,0,25,2
1713340719299,MUS 7,A01,494125,Staff,16,0,25,9
1713340719299,MUS 7,A02,494126,Staff,24,0,25,1
1713340720382,MUS 11,A01,494128,Staff,23,0,25,2
1713340720382,MUS 11,A02,494129,Staff,24,0,25,1
1713340721423,MUS 13,A01,494131,Staff,25,0,25,0
1713340721423,MUS 13,A02,494132,Staff,25,0,25,0
1713340722454,MUS 15,A01,494134,Staff,16,0,25,9
1713340722454,MUS 15,A02,494135,Staff,25,0,25,0
1713340722454,MUS 15,B01,494137,Staff,24,0,25,1
1713340723480,MUS 80,A00,494232,Staff,24,0,25,1
1713340723480,MUS 80,B00,494233,Staff,25,0,25,0
1713340723480,MUS 80,C00,494234,Staff,23,0,25,2
1713340724506,MUS 95C,A00,494141,Staff,69,0,75,6
1713340725535,MUS 114,A00,494142,Staff,39,0,50,11
1713340726568,NANO 15,A01,490636,Drews; Aaron,7,0,7,0
1713340727596,PHIL 1,A00,490578,Grush; Rick Scott,49,0,50,1
1713340728623,PHIL 10,A01,490580,Grush; Rick Scott,33,0,35,2
1713340728623,PHIL 10,A02,490586,Grush; Rick Scott,32,0,35,3
1713340729647,PHIL 27,A01,490591,Staff,22,0,25,3
1713340729647,PHIL 27,A02,490592,Staff,25,0,25,0
1713340729647,PHIL 27,A03,490593,Staff,25,0,25,0
1713340729647,PHIL 27,A04,490598,Staff,25,0,25,0
1713340730673,PHIL 32,A01,490611,Staff,20,0,20,0
1713340730673,PHIL 32,A02,490618,Staff,20,0,20,0
1713340731699,PHIL 90,A00,490624,Staff,40,0,40,0
1713340732726,PHIL 136,A00,490627,Cohen; Jonathan David,37,0,40,3
1713340733755,PHIL 155,A00,490634,Staff,62,0,70,8
1713340734786,PHYS 1A,A00,491610,Staff,245,0,250,5
1713340735812,PHYS 1AL,001,491616,Tsai; Philbert S,27,0,30,3
1713340735812,PHYS 1AL,002,491618,Tsai; Philbert S,30,0,30,0
1713340736838,PHYS 1B,A00,491623,Staff,235,0,250,15
1713340737867,PHYS 1BL,001,491626,Tsai; Philbert S,18,0,30,12
1713340737867,PHYS 1BL,002,491628,Tsai; Philbert S,26,0,30,4
1713340738896,PHYS 1C,A00,491632,Staff,212,0,245,33
1713340739921,PHYS 1CL,001,491635,Tsai; Philbert S,3,0,30,27
1713340739921,PHYS 1CL,002,491643,Tsai; Philbert S,22,0,30,8
1713340740948,PHYS 2AR,A01,491651,Meyertholen; Andrew D.,44,0,50,6
1713340741974,PHYS 2B,A01,491659,Staff,105,0,115,10
1713340743004,PHYS 2BL,A01,491685,Staff,21,0,24,3
1713340743004,PHYS 2BL,A02,491700,Staff,21,0,24,3
1713340744032,PHYS 2C,A01,505161,Staff,101,0,115,14
1713340745059,PHYS 4A,A01,491704,Grinstein; Benjamin,99,0,100,1
1713340746088,POLI 5D,A01,494144,Staff,3,0,5,2
1713340746088,POLI 5D,B01,626283,Dai; Yinlin,5,0,5,0
1713340747122,POLI 12,A00,494145,Staff,43,0,45,2
1713340748154,POLI 13R,A00,494146,Forman; Fonna,45,0,50,5
1713340749180,POLI 27,A01,494148,Staff,54,0,60,6
1713340750210,POLI 30,A00,494149,Staff,49,0,50,1
1713340751236,POLI 100DA,A00,494150,Staff,20,0,25,5
1713340753294,POLI 100I,A00,494152,Staff,27,0,30,3
1713340754321,POLI 104B,A00,494153,Smith; Glenn Chatmas,53,0,55,2
1713340755348,POLI 104F,A00,494154,Staff,28,0,30,2
1713340756378,POLI 104I,A00,494155,Smith; Glenn Chatmas,29,0,30,1
1713340757411,POLI 110C,A00,494156,Ingham; Sean,23,0,25,2
1713340758441,POLI 117R,A00,494157,Forman; Fonna,5,0,20,15
1713340759467,POLI 118,A00,494158,Ingham; Sean,21,0,25,4
1713340760497,POLI 120H,A00,494159,Fisk; David Lee,39,0,45,6
1713340761526,POLI 131CR,A00,494160,Hoston; Germaine,35,0,45,10
1713340762552,POLI 133J,A00,494161,Staff,31,0,35,4
1713340763585,POLI 135,A00,494162,Fisk; David Lee,33,0,35,2
1713340764614,POLI 140A,A00,494164,Staff,18,0,30,12
1713340765641,POLI 142I,A00,494165,Staff,30,0,30,0
1713340766666,POLI 144D,A00,494166,Staff,22,0,25,3
1713340767695,POLI 151,A00,494167,Staff,30,0,30,0
1713340768721,POLI 153,A00,494168,Staff,33,0,35,2
1713340769747,POLI 160AA,A00,494169,Staff,33,0,40,7
1713340770773,POLI 162,A00,494170,Mignozzetti; Umberto,18,0,25,7
1713340771799,POLI 171,A00,494171,Mignozzetti; Umberto,18,0,25,7
1713340772848,PSYC 1,A00,494172,Staff,95,0,100,5
1713340773874,PSYC 2,A00,494173,Moranton; Nirelia Melbina-,34,0,50,16
1713340774899,PSYC 3,A00,494174,Staff,29,0,30,1
1713340775929,PSYC 6,A00,494175,Staff,17,0,20,3
1713340776954,PSYC 60,A01,494177,Staff,37,0,45,8
1713340777987,PSYC 70,A01,505724,Geller; Emma Harlan,42,0,45,3
1713340779015,PSYC 101,A00,494180,Heyman; Gail D.,84,0,100,16
1713340780044,PSYC 105,A00,494181,Geller; Emma Harlan,51,0,90,39
1713340781071,PSYC 106,A00,494182,Dobkins; Karen R.,26,0,45,19
1713340782104,PSYC 108,A00,494183,Adrian; Julia Anna,89,0,100,11
1713340783135,PSYC 114,A01,494185,Winkielman; Piotr,0,4,30,30
1713340784162,PSYC 122,A00,494186,Moranton; Nirelia Melbina-,27,0,50,23
1713340785193,PSYC 124,A00,494187,Chapman; Eddie Nathaniel,69,0,80,11
1713340786222,PSYC 131,A00,494188,Anagnostaras; Stephan,40,0,80,40
1713340787252,PSYC 144,A00,494189,Staff,0,1,50,50
1713340788280,PSYC 154,A00,494190,Lacefield; Katharine I,105,0,180,75
1713340789306,PSYC 162,A00,494191,Wixted; John T,70,0,100,30
1713340790331,PSYC 172,A00,494192,Gorman; Michael R.,36,0,45,9
1713340791360,PSYC 178,A00,494193,Glaser; Dale,34,0,45,11
1713340792394,PSYC 193,A00,505725,Chapman; Eddie Nathaniel,20,0,20,0
1713340793420,RELI 145GS,A00,519817,Rahimi; Babak,17,0,20,3
1713340794447,SE 101A,A01,490862,Chadha; Mayank,23,0,25,2
1713340795478,SE 101C,A01,490924,Krysl; Petr,15,0,20,5
1713340796504,SE 110A,A01,490928,Staff,19,0,20,1
1713340797537,SE 130A,A00,490929,Morrison; Machel Leigh,54,0,70,16
1713340798570,SIO 1,A01,519325,Staff,39,0,40,1
1713340799594,SIO 30,A01,519327,Staff,38,0,40,2
1713340800620,SIO 40,A00,519328,Staff,39,0,40,1
1713340801645,SIO 46GS,A00,519819,Cook; Geoffrey W,15,0,25,10
1713340802671,SIO 109R,A00,494197,Forman; Fonna,0,3,20,20
1713340803697,SIO 121GS,A00,519827,Cook; Geoffrey W,15,0,25,10
1713340804723,SIO 132,A01,519330,Staff,38,0,40,2
1713340805747,SIO 133,A01,519397,Staff,37,0,40,3
1713340806774,SIO 139,A00,519396,Kacev; David,29,0,40,11
1713340807806,SOCI 1,A01,494199,Thorpe; Charles Robert,21,0,30,9
1713340807806,SOCI 1,A02,494200,Thorpe; Charles Robert,30,0,30,0
1713340807806,SOCI 1,A03,494201,Thorpe; Charles Robert,29,0,30,1
1713340807806,SOCI 1,A04,494202,Thorpe; Charles Robert,29,0,30,1
1713340807806,SOCI 1,A05,494203,Thorpe; Charles Robert,29,0,30,1
1713340807806,SOCI 1,A06,494204,Thorpe; Charles Robert,30,0,30,0
1713340807806,SOCI 1,A07,494205,Thorpe; Charles Robert,28,0,30,2
1713340808837,SOCI 60,A01,494207,Staff,33,0,40,7
1713340808837,SOCI 60,A02,494208,Staff,39,0,40,1
1713340810130,SOCI 100,A01,494210,Payne; Christine Anna,25,0,30,5
1713340810130,SOCI 100,A02,494211,Payne; Christine Anna,26,0,30,4
1713340811162,SOCI 109M,A00,494212,Staff,20,0,20,0
1713340812187,SOCI 110,A00,494213,Staff,34,0,40,6
1713340814257,SOCI 118E,A00,494215,Ng; Kwai,37,0,40,3
1713340815289,SOCI 125,A00,494216,Calderon-Zaks; Michael Aar,39,0,45,6
1713340816316,SOCI 126,A01,494218,Jones; Makeba,3,0,5,2
1713340817347,SOCI 131,A00,494219,Thorpe; Charles Robert,26,0,30,4
1713340819399,SOCI 135,A00,494221,Payne; Christine Anna,28,0,50,22
1713340820426,SOCI 136E,A00,626690,Ruiz; Jonathan Joseph,24,0,25,1
1713340821452,SOCI 138GS,A00,494222,Navon; Daniel,23,0,28,5
1713340823505,SOCI 145,A00,494224,Staff,40,0,45,5
1713340824609,SOCI 153,A00,494225,Staff,28,0,30,2
1713340825635,SOCI 160E,A00,494226,Ng; Kwai,27,0,40,13
1713340826660,SOCI 180,A00,494227,Staff,29,0,30,1
1713340827686,SOCI 189GS,A00,494228,Ribas Norris; Janet Vanesa,11,0,11,0
1713340828715,SOCI 190GS,A00,553232,Ribas Norris; Janet Vanesa,11,0,11,0
1713340829747,SOMI 220,A00,627178,Schneid; Stephen David,30,0,30,0
1713340830778,SYN 2,001,490768,Staff,13,0,15,2
1713340830778,SYN 2,002,490769,Staff,14,0,15,1
1713340830778,SYN 2,004,490775,Staff,0,0,0,0
1713340830778,SYN 2,003,490774,Staff,0,0,0,0
1713340830778,SYN 2,005,490776,Staff,0,0,0,0
1713340831803,SYN 2R,001,490779,Staff,11,0,15,4
1713340831803,SYN 2R,002,514635,Staff,14,0,15,1
1713340832839,SYN 100,A01,490783,Staff,8,0,20,12
1713340832839,SYN 100,B01,490787,Staff,10,0,20,10
1713340832839,SYN 100,C01,490789,Staff,10,0,20,10
1713340833870,SYN 150,A00,490817,Staff,14,0,15,1
1713340833870,SYN 150,B00,514610,Staff,15,0,15,0
1713340834907,TDAC 1,A00,492753,Walsh; Kim C.,19,0,20,1
1713340834907,TDAC 1,B00,492754,Harting; Carla Kelso,18,0,20,2
1713340834907,TDAC 1,C00,513995,Salovey; Todd,15,0,20,5
1713340835933,TDAC 101,A00,492766,Harting; Carla Kelso,17,0,20,3
1713340836957,TDAC 102,A00,492768,Basso; Beatrice,19,0,20,1
1713340837986,TDDE 111,A00,492769,Staff,25,0,25,0
1713340839017,TDDE 131,A00,492770,Staff,15,0,15,0
1713340839017,TDDE 131,B00,492771,Staff,15,0,15,0
1713340840047,TDDE 131GS,A00,523716,Guirguis; Mark C,23,0,28,5
1713340841074,TDGE 1,A01,492756,Salovey; Todd,56,0,60,4
1713340842106,TDGE 5,A01,492758,Staff,23,0,25,2
1713340843135,TDGE 10,A00,492759,Fulton; Julia,203,0,220,17
1713340844165,TDGE 11,A00,492760,Castro; Robert Jess,198,0,200,2
1713340846218,TDGE 124,A00,492772,Fulton; Julia,181,0,220,39
1713340847246,TDGE 125,A00,492773,Meyer; Ursula,38,0,50,12
1713340847246,TDGE 125,B00,492774,Staff,49,0,50,1
1713340847246,TDGE 125,C00,523565,Staff,48,0,50,2
1713340848274,TDGE 125GS,A00,523580,Guirguis; Mark C,23,0,28,5
1713340849305,TDGE 127,A00,492775,Havis; Allan,32,0,50,18
1713340850332,TDHT 101,A00,492776,Staff,34,0,35,1
1713340851361,TDMV 1,A00,492762,Caligagan; Maria T.,29,0,30,1
1713340851361,TDMV 1,B00,492763,Arcidiacono; Kristin,26,0,30,4
1713340852388,TDMV 2,A00,492764,Weinberg; Sadie,27,0,30,3
1713340853412,TDMV 3,A00,492765,Mack; Kara Shanai',37,0,40,3
1713340854441,TDMV 138,A00,492777,Mack; Kara Shanai',32,0,40,8
1713340855468,TDMV 140,A00,492778,Lima; Paulo Henrique,40,0,40,0
1713340856497,TDMV 142,A00,492779,Caligagan; Maria T.,33,0,40,7
1713340856497,TDMV 142,B00,492780,Caligagan; Tony,37,0,40,3
1713340857524,TDMV 143,A00,492781,Fyall; Daunte Edward,39,0,40,1
1713340858554,USP 1,A01,492401,Kwak; Nancy,27,0,35,8
1713340859580,USP 2,A01,492453,Hinds; Juli Beth,35,0,35,0
1713340860605,USP 3,A01,492516,Staff,28,0,35,7
1713340861631,USP 4,A00,492522,McTague; Sarah,16,0,25,9
1713340862661,USP 100,A00,492523,Staff,32,0,35,3
1713340863690,USP 101,A00,492524,Staff,13,0,15,2
1713340864715,USP 105,A00,492525,Staff,21,0,25,4
1713340865745,USP 151,A00,492526,Shenkman; Michael Thomas,32,0,35,3
1713340866818,USP 170,A00,492545,Hinds; Juli Beth,33,0,35,2
1713340867845,USP 171GS,A00,492608,Bussell; Mirle Rabinowitz,24,0,28,4
1713340868872,USP 183GS,A00,492613,Peerson; Susan,24,0,28,4
1713340869903,VIS 30,A01,490693,Yoldas; Pinar,19,0,22,3
1713340869903,VIS 30,A02,490694,Yoldas; Pinar,18,0,22,4
1713340870929,VIS 83,A00,490695,Kester; Grant,63,0,75,12
1713340871956,VIS 105D,A00,490696,Staff,22,0,25,3
1713340872988,VIS 124CN,A00,490699,Rose; Jordan M,64,0,75,11
1713340874016,VIS 125GS,A00,511221,Williams; Alena J,21,0,22,1
1713340875057,VIS 128D,A00,490700,Staff,73,0,75,2
1713340876082,VIS 151,A01,490717,Staff,33,0,34,1
1713340876082,VIS 151,A02,490766,Staff,33,0,34,1
1713340877109,VIS 154GS,A00,511972,Williams; Alena J,21,0,22,1
1713340878140,VIS 160A,A00,490767,Stone; Patricia,7,0,10,3
1713340879178,WCWP 10A,A00,490638,Staff,14,0,15,1
1713340879178,WCWP 10A,B00,490640,Staff,15,0,15,0
1713340880206,WCWP 10B,A00,490641,Staff,0,0,0,0
1713340880206,WCWP 10B,B00,490642,Staff,14,0,15,1
1713340880206,WCWP 10B,C00,490644,Staff,13,0,15,2
1713340880206,WCWP 10B,D00,490647,Staff,0,0,0,0
1713340881232,WCWP 100,A00,490655,Staff,0,0,0,0
1713340881232,WCWP 100,B00,490687,Staff,10,0,15,5
1713340883399,ANAR 153,A00,487222,Braswell; Geoffrey E.,53,0,60,7
1713340884428,ANBI 134,A00,487223,Staff,5,0,20,15
1713340885458,ANBI 143GS,A00,487224,Noel; Geoffroy Pierre Jean,18,0,24,6
1713340886482,ANBI 144GS,A00,519548,Noel; Geoffroy Pierre Jean,18,0,24,6
1713340887506,ANSC 101,A00,487225,Staff,17,0,20,3
1713340888533,ANSC 125,A00,487227,Brenner; Suzanne A,38,0,40,2
1713340890587,ANSC 146,A00,487229,Staff,35,0,40,5
1713340891613,ANSC 148,A00,487230,Olivas Hernandez; Olga Lid,39,0,40,1
1713340892640,ANSC 150,A00,504165,Sloane; Julia Kathryn,18,0,20,2
1713340893666,ANSC 180,A00,487232,Staff,14,0,15,1
1713340894692,ANSC 188,A00,627155,Staff,37,0,40,3
1713340895717,ANTH 5,A00,519529,Semendeferi; Ekaterini,15,0,15,0
1713340896745,ANTH 10,A00,487219,Staff,58,0,60,2
1713340897772,ANTH 23,A01,487221,Staff,17,0,20,3
1713340898798,ANTH 102,A00,487233,Wilder; Linnea Lorene,50,0,60,10
1713340899827,ANTH 103,A00,487234,Varma; Saiba,54,0,60,6
1713340900856,ANTH 105,A00,487235,Stewart; Alexander B,54,0,60,6
1713340901883,BENG 100,A01,516685,Taylor Amos; Alyssa C,25,0,30,5
1713340902919,BIBC 102,A01,491316,Flagg; Matthew Paul,5,0,88,83
1713340902919,BIBC 102,A02,491366,Flagg; Matthew Paul,78,0,88,10
1713340903946,BIBC 103,A01,491486,Boumechache; Miyyada,16,0,24,8
1713340903946,BIBC 103,A02,491487,Boumechache; Miyyada,24,0,24,0
1713340904977,BICD 100,A01,516882,Staff,73,0,75,2
1713340904977,BICD 100,A02,516890,Staff,69,0,75,6
1713340906003,BICD 102GS,A00,491488,Lo; Stanley M.,26,0,28,2
1713340907028,BIEB 136GS,A00,516940,Holway; David A. & Shurin; Jonathan,18,0,24,6
1713340908055,BIEB 137GS,A01,517034,Holway; David A. & Shurin; Jonathan,18,0,24,6
1713340909085,BIEB 138GS,A01,491492,Pirino; Giorgia,21,0,28,7
1713340910117,BILD 1,A01,491296,Staff,60,0,63,3
1713340910117,BILD 1,A02,491297,Staff,63,0,63,0
1713340911149,BILD 4,A01,517099,Gonzalez Gamboa; Ivonne,22,0,24,2
1713340911149,BILD 4,A02,517100,Gonzalez Gamboa; Ivonne,24,0,24,0
1713340912175,BILD 60GS,A00,491309,Lo; Stanley M.,26,0,28,2
1713340913211,BIMM 100,A01,517136,Staff,82,0,100,18
1713340914245,BIMM 110,A01,517182,Staff,53,0,100,47
1713340915275,BIMM 120,A01,517228,Pickett; Brooke Elizabeth,28,0,63,35
1713340915275,BIMM 120,A02,517240,Pickett; Brooke Elizabeth,44,0,63,19
1713340916303,BIMM 132GS,A01,491498,Pirino; Giorgia,21,0,28,7
1713340917330,BIMM 143,A01,491589,Bozinovic; Goran,12,0,40,28
1713340918359,BIPN 100,A01,491594,Armour; Jon Christopher,83,0,100,17
1713340919388,BIPN 140,A01,491602,Marino; Marc J,23,0,50,27
1713340921446,CAT 125,A00,515973,Staff,18,0,20,2
1713340922472,CAT 125GS,A00,515974,Rahimi; Babak,16,0,20,4
1713340923498,CAT 125R,A00,515980,Staff,12,0,20,8
1713340923498,CAT 125R,B00,515981,Tosun; Adriana,19,0,20,1
1713340923498,CAT 125R,C00,515987,Hyland; Tina Mae,0,5,20,20
1713340923498,CAT 125R,D00,515988,Bronstein; Phoebe Malan,16,0,20,4
1713340924545,CENG 15,A01,488699,Drews; Aaron,25,0,25,0
1713340925578,CENG 100,A00,505196,Opatkiewicz; Justin Paul,25,0,25,0
1713340926605,CGS 2A,A01,489598,Staff,32,0,35,3
1713340927635,CGS 112,A00,489599,Staff,15,0,15,0
1713340928717,CGS 119,A00,489603,Staff,10,0,10,0
1713340929743,CGS 120,A00,489604,Staff,13,0,15,2
1713340930770,CGS 150,A00,489607,Staff,15,0,15,0
1713340931796,CHEM 6A,A01,488715,Staff,97,0,100,3
1713340932827,CHEM 6B,A01,488719,Piercy; Marc Anthony,99,0,100,1
1713340933861,CHEM 6C,A01,488723,Albizati; Kim F.,93,0,100,7
1713340934900,CHEM 7L,A01,488728,Schurmeier; Kimberly,18,0,24,6
1713340934900,CHEM 7L,A02,488730,Schurmeier; Kimberly,23,0,24,1
1713340934900,CHEM 7L,A03,488734,Schurmeier; Kimberly,20,0,24,4
1713340934900,CHEM 7L,A04,488763,Schurmeier; Kimberly,23,0,24,1
1713340934900,CHEM 7L,B01,488798,Schurmeier; Kimberly,16,0,24,8
1713340934900,CHEM 7L,B02,488801,Schurmeier; Kimberly,22,0,24,2
1713340934900,CHEM 7L,B03,488808,Schurmeier; Kimberly,22,0,24,2
1713340934900,CHEM 7L,B04,488811,Schurmeier; Kimberly,24,0,24,0
1713340935927,CHEM 11,A01,488897,Stallings; Dontarie M,94,0,100,6
1713340936954,CHEM 40A,A01,488913,Albizati; Kim F.,83,0,100,17
1713340937985,CHEM 40B,A01,488920,Weizman; Haim,42,0,50,8
1713340937985,CHEM 40B,A02,488938,Weizman; Haim,43,0,50,7
1713340939013,CHEM 41A,A01,489029,Klosterman; Jeremy K,57,0,60,3
1713340940039,CHEM 41C,A01,500436,Tor; Yitzhak,54,0,60,6
1713340941066,CHEM 43A,A01,500426,Weizman; Haim,0,1,24,24
1713340941066,CHEM 43A,A02,500430,Weizman; Haim,6,0,24,18
1713340941066,CHEM 43A,B01,514041,Klosterman; Jeremy K,14,0,24,10
1713340941066,CHEM 43A,B02,514047,Klosterman; Jeremy K,23,0,24,1
1713340942093,CHEM 108,A01,489140,Jennings; Patricia A.,7,0,24,17
1713340942093,CHEM 108,A02,489142,Jennings; Patricia A.,14,0,24,10
1713340943118,CHEM 114A,A01,489147,Stallings; Dontarie M,65,0,100,35
1713340944155,CHIN 169A,A00,489171,Wang; Xiao,19,0,20,1
1713340946211,COGS 3,A01,518827,Boyle; Mary E. T.,25,0,40,15
1713340947235,COGS 11,A01,489175,Staff,27,0,30,3
1713340948261,COGS 14A,A01,518829,Staff,50,0,60,10
1713340949294,COGS 14B,A01,489177,Hoffman; Drew Ellen,62,0,75,13
1713340950323,COGS 100,A01,489181,Allen; Michael Gordon,62,0,75,13
1713340951349,COGS 101A,A01,489183,Staff,45,0,60,15
1713340952378,COGS 101B,A01,489185,Allen; Michael Gordon,6,0,30,24
1713340953408,COGS 101C,A01,526786,Staff,23,0,30,7
1713340955462,COGS 107A,A01,489189,Boyle; Mary E. T.,16,0,35,19
1713340956492,COGS 107B,A01,627144,Mooshagian; Eric Frederick,59,0,60,1
1713340957518,COGS 118A,A01,489191,Staff,0,46,40,40
1713340959573,COGS 171GS,A01,489194,Pineda; Jaime A,19,0,28,9
1713340960599,COGS 172,A01,489196,Staff,2,0,30,28
1713340961629,COGS 174GS,A01,489264,Pineda; Jaime A,19,0,28,9
1713340962659,COGS 180,A01,627150,Staff,28,0,30,2
1713340963685,COGS 186,A01,489274,Staff,0,2,30,30
1713340964711,COMM 10,A01,489276,Staff,23,0,25,2
1713340964711,COMM 10,A02,489303,Staff,23,0,25,2
1713340965740,COMM 100A,A01,489312,Staff,14,0,25,11
1713340965740,COMM 100A,A02,489313,Staff,24,0,25,1
1713340966766,COMM 106T,A00,512540,Staff,33,0,35,2
1713340967795,COMM 107,A00,489347,Staff,27,0,35,8
1713340968825,COMM 109P,A00,489358,Staff,31,0,35,4
1713340969858,COMM 132,A00,489361,McKenna; Denise,27,0,30,3
1713340970883,COMM 146,A00,489362,Halm; Gavin Patrick,26,0,30,4
1713340971913,COMM 190,A00,489363,Abuelhiga; Soraya Jill,17,0,23,6
1713340972950,CSE 8A,A50,489366,Staff,21,0,25,4
1713340972950,CSE 8A,A51,489367,Staff,24,0,25,1
1713340973978,CSE 11,A01,489398,Cao; Yingjun,72,0,100,28
1713340975018,CSE 12,A01,489487,Staff,43,0,50,7
1713340976047,CSE 20,A01,489497,Staff,47,0,50,3
1713340977073,CSE 21,A01,489517,Braun; Oliver,42,0,50,8
1713340978099,CSE 101,A01,489524,Braun; Oliver,0,33,50,50
1713340979136,CSE 105,A01,512594,Jones; Miles E,72,0,100,28
1713340979136,CSE 105,B01,512598,Jones; Miles E,51,0,100,49
1713340980162,CSE 140,A01,489538,Staff,41,0,50,9
1713340981193,CSE 141,A01,489550,Eldon; John,67,0,100,33
1713340982220,CSE 141L,A01,489571,Eldon; John,65,0,100,35
1713340983247,CSE 151A,A01,489583,Solares; Edwin A,140,0,200,60
1713340984278,CSE 175,A01,510886,Kumar; Rakesh,30,0,30,0
1713340985305,CSE 190,A00,516828,Dubnov; Shlomo,37,0,49,12
1713340986330,DOC 100D,A00,489667,Pass; Natalye Joann,19,0,25,6
1713340987358,DSC 10,A01,624268,Staff,72,0,75,3
1713340988387,DSC 20,A01,624476,Staff,50,0,50,0
1713340989412,DSC 40A,A01,624608,Staff,39,0,40,1
1713340990438,DSGN 1,A01,489179,Rill; Bryan,32,0,50,18
1713340991464,ECE 17,A01,490489,Sahay; Rajeev,18,0,30,12
1713340992501,ECE 65,A50,490492,Staff,11,0,20,9
1713340992501,ECE 65,A51,490493,Staff,18,0,20,2
1713340993527,ECON 1,A01,489715,Famulari; Melissa,67,0,70,3
1713340994556,ECON 2,A01,489717,Levkoff; Steven B.,67,0,70,3
1713340995583,ECON 3,A01,489948,Staff,70,0,70,0
1713340997652,ECON 5,A01,490103,Staff,27,0,30,3
1713340997652,ECON 5,B01,626281,Dai; Yinlin,45,0,45,0
1713340998679,ECON 100A,A01,490127,Famulari; Melissa,62,0,70,8
1713340999704,ECON 100B,A01,490129,Staff,64,0,70,6
1713341000734,ECON 109,A01,490187,Shishkin; Denis,27,0,35,8
1713341001761,ECON 110A,A01,490190,Levkoff; Steven B.,59,0,70,11
1713341002791,ECON 120A,A01,490245,Dai; Yinlin,59,0,70,11
1713341003818,ECON 120B,A01,490247,Nieto-Barthaburu; Augusto,40,0,70,30
1713341004844,ECON 120C,A01,490253,Sun; Yixiao,30,0,35,5
1713341004844,ECON 120C,B01,490255,Sun; Yixiao,34,0,35,1
1713341005876,ECON 129,A00,490256,Eckert; Fabian Paul,22,0,35,13
1713341006905,ECON 131,A00,490257,Nieto-Barthaburu; Augusto,0,6,35,35
1713341007934,ECON 138,A00,490258,Bharadwaj; Prashant,13,0,35,22
1713341007934,ECON 138,B00,490259,Bharadwaj; Prashant,15,0,35,20
1713341008960,ECON 159,A00,490260,Hendrickson; Gerald M.,0,9,0,0
1713341009996,ECON 178,A01,553995,Zhu; Ying,24,0,35,11
1713341011023,EDS 40,A01,512576,Black; Alison Michelle,20,0,20,0
1713341012053,EDS 107,A01,515848,Staff,30,0,30,0
1713341013077,EDS 110R,A01,490262,Staff,26,0,30,4
1713341014102,EDS 112,A01,490264,Chapman; Thandeka K,40,0,50,10
1713341015127,EDS 113,A00,490266,Staff,25,0,30,5
1713341016156,EDS 118,A00,490267,Warstadt; Melissa Fawn,18,0,30,12
1713341017182,EDS 124BR,A00,490268,Eguchi; Emi,4,0,25,21
1713341017182,EDS 124BR,B00,490269,Eguchi; Emi,23,0,25,2
1713341018212,EDS 126,A01,490271,Jones; Makeba,43,0,50,7
1713341019240,EDS 135,A01,490316,Staff,19,0,20,1
1713341020265,ENVR 142GS,A00,519514,Chang; Edmond Yi-Teh,26,0,28,2
1713341021297,ETHN 103,A00,490504,Staff,25,0,36,11
1713341022328,ETHN 103A,A00,490505,Man; Simeon S,3,0,9,6
1713341023358,ETHN 109,A00,490506,Staff,28,0,30,2
1713341024384,ETHN 118,A00,490507,Staff,35,0,36,1
1713341025409,ETHN 119,A00,490508,Staff,32,0,36,4
1713341026434,ETHN 121R,A00,490518,Choi; Esther Min,21,0,36,15
1713341027484,ETHN 127,A00,490528,Staff,14,0,15,1
1713341028514,ETHN 139,A00,490573,Staff,10,0,10,0
1713341029541,ETHN 150,A00,490575,Staff,15,0,15,0
1713341030570,GLBH 20,A00,491705,Elwardani; Nile Regina,38,0,40,2
1713341031596,GLBH 101,A00,491706,Staff,20,0,20,0
1713341032679,GLBH 111,A01,491708,Burgos; Jose L.,15,0,15,0
1713341033707,GLBH 146,A00,491709,Staff,8,0,20,12
1713341034734,GLBH 148,A00,491710,Olivas Hernandez; Olga Lid,10,0,20,10
1713341035763,GLBH 150,A00,491711,Sloane; Julia Kathryn,19,0,20,1
1713341036796,HIEA 131,A00,491760,Staff,28,0,32,4
1713341037827,HIEA 153,A00,491762,Staff,28,0,30,2
1713341038851,HIEU 124,A00,491811,Staff,26,0,32,6
1713341039883,HIEU 124GS,A00,491812,Markman; Kristina,27,0,28,1
1713341040911,HIEU 147,A00,491813,Staff,30,0,32,2
1713341041938,HIEU 149GS,A00,491816,Caldwell; Michael Alan,28,0,28,0
1713341042964,HILD 2C,A01,491713,Hendrickson; Gerald M.,26,0,30,4
1713341043991,HILD 7B,A01,491715,Kwak; Nancy,0,2,30,30
1713341045013,HILD 10,A01,491717,Staff,9,0,20,11
1713341046039,HILD 30GS,A00,491719,Edington; Claire Ellen,23,0,28,5
1713341047069,HINE 109,A00,491818,Shafir; Nir,26,0,32,6
1713341048103,HINE 128,A00,491821,Shafir; Nir,30,0,32,2
1713341049130,HISC 117,A00,491830,Staff,27,0,32,5
1713341050160,HIUS 103,A00,491834,Man; Simeon S,14,0,23,9
1713341051185,HIUS 108B,A00,491835,Staff,27,0,30,3
1713341052211,HIUS 141,A00,491836,Hendrickson; Gerald M.,28,0,32,4
1713341053244,HIUS 149,A00,491839,Staff,24,0,32,8
1713341054278,HUM 3,A01,512617,Crum; Matthew Stephen,42,0,50,8
1713341054278,HUM 3,A02,512618,Crum; Matthew Stephen,48,0,50,2
1713341055306,HUM 3GS,A00,512663,Markman; Kristina,0,0,0,1
1713341055306,HUM 3GS,B00,512664,Staff,0,0,0,0
1713341056332,HUM 4,A01,512620,West; Geoffrey Scott,24,0,50,26
1713341057359,HUM 4GS,A00,512666,Lyon; Antony J.,0,0,0,5
1713341058390,HUM 4R,A01,512625,Watkins; Eric,49,0,50,1
1713341059419,HUM 5,A01,512649,Zavodny; Tatiana Sophia,20,0,50,30
1713341059419,HUM 5,B01,512661,Zroka; Ryan Edward,48,0,50,2
1713341060446,INTL 190,A00,490577,Segui; Alan S,0,0,0,5
1713341061477,JAPN 20AR,A01,491267,Ross; Kayoko F,7,0,20,13
1713341062511,JAPN 180,A00,491285,Berman; Michael David,33,0,40,7
1713341063545,LATI 50,A01,502536,Kokinis; Troy Andreas,16,0,22,6
1713341063545,LATI 50,A02,502551,Kokinis; Troy Andreas,22,0,22,0
1713341063545,LATI 50,A03,502650,Kokinis; Troy Andreas,22,0,22,0
1713341063545,LATI 50,A04,502909,Kokinis; Troy Andreas,21,0,22,1
1713341064571,LATI 160,A01,502920,Kokinis; Troy Andreas,30,0,30,0
1713341065597,LIFR 1A,A00,490494,Van Moer; Vinciane G,17,0,20,3
1713341066622,LIFR 1AX,A00,490495,Van Moer; Vinciane G,17,0,20,3
1713341067648,LIFR 1B,A00,490496,Van Moer; Vinciane G,17,0,20,3
1713341068677,LIFR 1BX,A00,490497,Van Moer; Vinciane G,17,0,20,3
1713341069706,LIGN 8,A00,505198,McIntosh; Justin Daniel,134,0,150,16
1713341070736,LIGN 9GS,A00,491239,Lott; Margaret S.,18,0,20,2
1713341071763,LIGN 101,A01,505200,McIntosh; Justin Daniel,22,0,30,8
1713341072788,LIGN 120,A01,491244,Staff,22,0,30,8
1713341073816,LIGN 149GS,A00,491245,Lott; Margaret S.,18,0,20,2
1713341074846,LIGN 170,A00,491247,Staff,22,0,30,8
1713341075873,LISP 1D,A00,490498,Munoz Sanchez; Alicia,8,0,14,6
1713341075873,LISP 1D,B00,490499,Munoz Sanchez; Alicia,4,0,14,10
1713341075873,LISP 1D,C00,490500,Munoz Sanchez; Alicia,7,0,14,7
1713341075873,LISP 1D,D00,490501,Munoz Sanchez; Alicia,10,0,14,4
1713341076903,LISP 1DX,A00,490502,Munoz Sanchez; Alicia,11,0,28,17
1713341076903,LISP 1DX,B00,490503,Munoz Sanchez; Alicia,16,0,28,12
1713341078963,LTAM 110,A00,491847,Staff,22,0,25,3
1713341079994,LTCS 119,A00,491848,Staff,11,0,15,4
1713341081023,LTCS 130,A00,491849,Staff,24,0,25,1
1713341083089,LTEA 120C,A00,491852,Staff,32,0,40,8
1713341084169,LTEN 130GS,A00,491853,Lyon; Antony J.,23,0,28,5
1713341085199,LTEN 148,A00,491855,Staff,23,0,25,2
1713341086225,LTEN 159,A00,491856,Staff,20,0,25,5
1713341087251,LTEN 180,A00,491857,Staff,8,0,15,7
1713341089312,LTSP 123GS,A00,505928,Bessett; Ryan Matthew,24,0,28,4
1713341090338,LTSP 174GS,A00,506037,Bessett; Ryan Matthew,24,0,28,4
1713341092393,LTWR 102,A00,491861,Staff,9,0,15,6
1713341093419,LTWR 106,A00,491862,Staff,8,0,15,7
1713341094451,MAE 11,A00,490930,Bahadori; Mohammad Yousef,94,0,100,6
1713341095481,MAE 30A,A00,490931,Qi; Huihui,37,0,40,3
1713341096512,MAE 101A,A00,491036,Sadeghizadeh; Zahra,91,0,100,9
1713341097539,MAE 101C,A00,491037,Seshadri; Kalyanasundaram,63,0,100,37
1713341098565,MAE 113,A00,491040,Seshadri; Kalyanasundaram,64,0,80,16
1713341099589,MAE 131A,A00,491041,Ghazinejad; Maziar,37,0,40,3
1713341100613,MAE 142,A00,491053,Staff,39,0,40,1
1713341101639,MAE 143A,A00,491054,Staff,29,0,50,21
1713341102665,MAE 150,A00,491092,Truong; Phuong Thi Ngoc,23,0,35,12
1713341103695,MATH 3C,A01,494031,Pardo Guerra; Sebastian,30,0,30,0
1713341103695,MATH 3C,A02,494032,Pardo Guerra; Sebastian,29,0,30,1
1713341104720,MATH 10A,A01,494034,Staff,27,0,30,3
1713341104720,MATH 10A,A02,494035,Staff,28,0,30,2
1713341104720,MATH 10A,B01,494037,Staff,27,0,30,3
1713341104720,MATH 10A,B02,494038,Staff,29,0,30,1
1713341105754,MATH 10B,A01,494040,Habib; Yousaf,22,0,30,8
1713341105754,MATH 10B,A02,494041,Habib; Yousaf,28,0,30,2
1713341105754,MATH 10B,A03,494042,Habib; Yousaf,29,0,30,1
1713341105754,MATH 10B,A04,494043,Habib; Yousaf,30,0,30,0
1713341105754,MATH 10B,B01,494045,Habib; Yousaf,25,0,30,5
1713341105754,MATH 10B,B02,494046,Habib; Yousaf,30,0,30,0
1713341105754,MATH 10B,B03,494047,Habib; Yousaf,30,0,30,0
1713341105754,MATH 10B,B04,494048,Habib; Yousaf,30,0,30,0
1713341106779,MATH 18,A01,494050,Kemp; Todd Aahron,25,0,30,5
1713341106779,MATH 18,A02,494051,Kemp; Todd Aahron,29,0,30,1
1713341106779,MATH 18,B01,494054,Kemp; Todd Aahron,25,0,30,5
1713341106779,MATH 18,B02,494055,Kemp; Todd Aahron,29,0,30,1
1713341107811,MATH 20A,A01,494059,Suk; Andrew Hoon,30,0,30,0
1713341108837,MATH 20B,A01,494061,Briones; Jor-el Thomas Caparas,33,0,35,2
1713341108837,MATH 20B,B01,494063,Bach; Quang Tran,34,0,35,1
1713341109868,MATH 20C,A01,494065,Staff,28,0,30,2
1713341109868,MATH 20C,A02,494066,Staff,30,0,30,0
1713341109868,MATH 20C,A03,494067,Staff,30,0,30,0
1713341109868,MATH 20C,A04,494068,Staff,30,0,30,0
1713341109868,MATH 20C,B01,494070,Zhang; Ming,24,0,30,6
1713341109868,MATH 20C,B02,494071,Zhang; Ming,27,0,30,3
1713341109868,MATH 20C,B03,494072,Zhang; Ming,29,0,30,1
1713341109868,MATH 20C,B04,494073,Zhang; Ming,29,0,30,1
1713341110897,MATH 20D,A01,494075,Staff,22,0,30,8
1713341110897,MATH 20D,A02,494076,Staff,29,0,30,1
1713341111933,MATH 20E,A01,494079,Staff,24,0,30,6
1713341111933,MATH 20E,A02,494080,Staff,26,0,30,4
1713341111933,MATH 20E,B01,494082,Staff,25,0,30,5
1713341111933,MATH 20E,B02,494083,Staff,25,0,30,5
1713341112964,MATH 103A,A01,494085,Aliabadi Sr.; Mohsen,12,0,30,18
1713341112964,MATH 103A,A02,494086,Aliabadi Sr.; Mohsen,28,0,30,2
1713341112964,MATH 103A,B01,494088,Aliabadi Sr.; Mohsen,20,0,30,10
1713341112964,MATH 103A,B02,494089,Aliabadi Sr.; Mohsen,27,0,30,3
1713341114003,MATH 109,A01,494091,Staff,30,0,30,0
1713341114003,MATH 109,A02,494092,Staff,29,0,30,1
1713341114003,MATH 109,B01,494094,Staff,27,0,30,3
1713341114003,MATH 109,B02,494095,Staff,29,0,30,1
1713341115040,MATH 142A,A01,494097,Chow; Bennett,13,0,30,17
1713341115040,MATH 142A,A02,494098,Chow; Bennett,23,0,30,7
1713341115040,MATH 142A,B01,494100,Chow; Bennett,19,0,30,11
1713341115040,MATH 142A,B02,494101,Chow; Bennett,29,0,30,1
1713341117096,MATH 168A,A01,516677,Dumitriu; Ioana,16,0,35,19
1713341118126,MATH 170A,A01,516679,Dumitriu; Ioana,18,0,30,12
1713341118126,MATH 170A,A02,516680,Dumitriu; Ioana,28,0,30,2
1713341119173,MATH 193A,A01,494107,Staff,12,0,30,18
1713341119173,MATH 193A,A02,494108,Staff,18,0,30,12
1713341119173,MATH 193A,A03,494109,Staff,29,0,30,1
1713341119173,MATH 193A,A04,494110,Staff,22,0,30,8
1713341122259,MGT 16,A00,491930,McKay; Michael J,92,0,98,6
1713341123286,MGT 18,A00,491992,McKay; Michael J,96,0,98,2
1713341124311,MGT 71,A00,492003,Staff,63,0,98,35
1713341125339,MGT 103,A00,505209,Eberhard; Craig A,80,0,98,18
1713341126370,MGT 131A,A00,505210,Anderson; John Charles,89,0,98,9
1713341128426,MGT 153,A00,492077,Perols; Johan Lars,16,0,90,74
1713341131533,MGT 164,A00,492222,McKay; Mary A,91,0,98,7
1713341132565,MGT 172,A00,492245,Staff,59,0,60,1
1713341132565,MGT 172,B00,505526,Hedges; Kathleen,65,0,98,33
1713341133596,MGT 181,A00,505669,Dunn; Louis Jean,78,0,98,20
1713341134629,MMW 14,A01,494399,Staff,15,0,28,13
1713341134629,MMW 14,A02,494400,Staff,25,0,28,3
1713341134629,MMW 14,A03,494401,Staff,28,0,28,0
1713341134629,MMW 14,A04,494402,Staff,28,0,28,0
1713341134629,MMW 14,B01,494404,Carreras; Maria Victoria,8,0,28,20
1713341134629,MMW 14,B02,494405,Carreras; Maria Victoria,25,0,28,3
1713341134629,MMW 14,B03,494406,Carreras; Maria Victoria,27,0,28,1
1713341134629,MMW 14,B04,494407,Carreras; Maria Victoria,28,0,28,0
1713341135661,MMW 14GS,A00,506250,Chang; Edmond Yi-Teh,0,0,0,0
1713341136740,MMW 121R,A01,494415,Adamiak; Patrick John,10,0,28,18
1713341136740,MMW 121R,A02,494416,Adamiak; Patrick John,24,0,28,4
1713341137764,MUS 1A,A01,494113,Staff,12,0,25,13
1713341137764,MUS 1A,A02,494114,Staff,24,0,25,1
1713341138789,MUS 4,A01,494116,Staff,23,0,25,2
1713341138789,MUS 4,A02,494117,Staff,22,0,25,3
1713341139825,MUS 5R,A01,494236,Dubnov; Shlomo,4,0,25,21
1713341139825,MUS 5R,A02,494237,Dubnov; Shlomo,25,0,25,0
1713341140854,MUS 6,A01,494122,Staff,9,0,25,16
1713341140854,MUS 6,A02,494123,Staff,23,0,25,2
1713341141882,MUS 7,A01,494125,Staff,16,0,25,9
1713341141882,MUS 7,A02,494126,Staff,24,0,25,1
1713341142912,MUS 11,A01,494128,Staff,23,0,25,2
1713341142912,MUS 11,A02,494129,Staff,24,0,25,1
1713341143948,MUS 13,A01,494131,Staff,25,0,25,0
1713341143948,MUS 13,A02,494132,Staff,25,0,25,0
1713341144975,MUS 15,A01,494134,Staff,16,0,25,9
1713341144975,MUS 15,A02,494135,Staff,25,0,25,0
1713341144975,MUS 15,B01,494137,Staff,24,0,25,1
1713341146007,MUS 80,A00,494232,Staff,24,0,25,1
1713341146007,MUS 80,B00,494233,Staff,25,0,25,0
1713341146007,MUS 80,C00,494234,Staff,23,0,25,2
1713341147036,MUS 95C,A00,494141,Staff,69,0,75,6
1713341148062,MUS 114,A00,494142,Staff,39,0,50,11
1713341149087,NANO 15,A01,490636,Drews; Aaron,7,0,7,0
1713341150119,PHIL 1,A00,490578,Grush; Rick Scott,49,0,50,1
1713341151162,PHIL 10,A01,490580,Grush; Rick Scott,33,0,35,2
1713341151162,PHIL 10,A02,490586,Grush; Rick Scott,32,0,35,3
1713341152189,PHIL 27,A01,490591,Staff,22,0,25,3
1713341152189,PHIL 27,A02,490592,Staff,25,0,25,0
1713341152189,PHIL 27,A03,490593,Staff,25,0,25,0
1713341152189,PHIL 27,A04,490598,Staff,25,0,25,0
1713341153214,PHIL 32,A01,490611,Staff,20,0,20,0
1713341153214,PHIL 32,A02,490618,Staff,20,0,20,0
1713341154239,PHIL 90,A00,490624,Staff,40,0,40,0
1713341155270,PHIL 136,A00,490627,Cohen; Jonathan David,37,0,40,3
1713341156296,PHIL 155,A00,490634,Staff,62,0,70,8
1713341157323,PHYS 1A,A00,491610,Staff,245,0,250,5
1713341158349,PHYS 1AL,001,491616,Tsai; Philbert S,27,0,30,3
1713341158349,PHYS 1AL,002,491618,Tsai; Philbert S,30,0,30,0
1713341159376,PHYS 1B,A00,491623,Staff,235,0,250,15
1713341160401,PHYS 1BL,001,491626,Tsai; Philbert S,18,0,30,12
1713341160401,PHYS 1BL,002,491628,Tsai; Philbert S,26,0,30,4
1713341161430,PHYS 1C,A00,491632,Staff,212,0,245,33
1713341162455,PHYS 1CL,001,491635,Tsai; Philbert S,3,0,30,27
1713341162455,PHYS 1CL,002,491643,Tsai; Philbert S,22,0,30,8
1713341163485,PHYS 2AR,A01,491651,Meyertholen; Andrew D.,44,0,50,6
1713341164511,PHYS 2B,A01,491659,Staff,105,0,115,10
1713341165541,PHYS 2BL,A01,491685,Staff,21,0,24,3
1713341165541,PHYS 2BL,A02,491700,Staff,21,0,24,3
1713341166567,PHYS 2C,A01,505161,Staff,101,0,115,14
1713341167593,PHYS 4A,A01,491704,Grinstein; Benjamin,99,0,100,1
1713341168629,POLI 5D,A01,494144,Staff,3,0,5,2
1713341168629,POLI 5D,B01,626283,Dai; Yinlin,5,0,5,0
1713341169655,POLI 12,A00,494145,Staff,43,0,45,2
1713341170682,POLI 13R,A00,494146,Forman; Fonna,45,0,50,5
1713341171707,POLI 27,A01,494148,Staff,54,0,60,6
1713341172736,POLI 30,A00,494149,Staff,49,0,50,1
1713341173762,POLI 100DA,A00,494150,Staff,20,0,25,5
1713341175820,POLI 100I,A00,494152,Staff,27,0,30,3
1713341176855,POLI 104B,A00,494153,Smith; Glenn Chatmas,53,0,55,2
1713341177882,POLI 104F,A00,494154,Staff,28,0,30,2
1713341178909,POLI 104I,A00,494155,Smith; Glenn Chatmas,29,0,30,1
1713341179938,POLI 110C,A00,494156,Ingham; Sean,23,0,25,2
1713341180965,POLI 117R,A00,494157,Forman; Fonna,5,0,20,15
1713341181991,POLI 118,A00,494158,Ingham; Sean,21,0,25,4
1713341183021,POLI 120H,A00,494159,Fisk; David Lee,39,0,45,6
1713341184049,POLI 131CR,A00,494160,Hoston; Germaine,35,0,45,10
1713341185075,POLI 133J,A00,494161,Staff,31,0,35,4
1713341186105,POLI 135,A00,494162,Fisk; David Lee,33,0,35,2
1713341187134,POLI 140A,A00,494164,Staff,18,0,30,12
1713341188160,POLI 142I,A00,494165,Staff,30,0,30,0
1713341189185,POLI 144D,A00,494166,Staff,22,0,25,3
1713341190212,POLI 151,A00,494167,Staff,30,0,30,0
1713341191237,POLI 153,A00,494168,Staff,33,0,35,2
1713341192262,POLI 160AA,A00,494169,Staff,33,0,40,7
1713341193287,POLI 162,A00,494170,Mignozzetti; Umberto,18,0,25,7
1713341194312,POLI 171,A00,494171,Mignozzetti; Umberto,18,0,25,7
1713341195338,PSYC 1,A00,494172,Staff,95,0,100,5
1713341196363,PSYC 2,A00,494173,Moranton; Nirelia Melbina-,34,0,50,16
1713341197389,PSYC 3,A00,494174,Staff,29,0,30,1
1713341198413,PSYC 6,A00,494175,Staff,17,0,20,3
1713341199442,PSYC 60,A01,494177,Staff,37,0,45,8
1713341200474,PSYC 70,A01,505724,Geller; Emma Harlan,42,0,45,3
1713341201502,PSYC 101,A00,494180,Heyman; Gail D.,84,0,100,16
1713341202532,PSYC 105,A00,494181,Geller; Emma Harlan,51,0,90,39
1713341203566,PSYC 106,A00,494182,Dobkins; Karen R.,26,0,45,19
1713341204594,PSYC 108,A00,494183,Adrian; Julia Anna,89,0,100,11
1713341205624,PSYC 114,A01,494185,Winkielman; Piotr,0,4,30,30
1713341206654,PSYC 122,A00,494186,Moranton; Nirelia Melbina-,27,0,50,23
1713341207684,PSYC 124,A00,494187,Chapman; Eddie Nathaniel,69,0,80,11
1713341208714,PSYC 131,A00,494188,Anagnostaras; Stephan,40,0,80,40
1713341209740,PSYC 144,A00,494189,Staff,0,1,50,50
1713341210772,PSYC 154,A00,494190,Lacefield; Katharine I,105,0,180,75
1713341211798,PSYC 162,A00,494191,Wixted; John T,70,0,100,30
1713341212824,PSYC 172,A00,494192,Gorman; Michael R.,36,0,45,9
1713341213861,PSYC 178,A00,494193,Glaser; Dale,34,0,45,11
1713341214886,PSYC 193,A00,505725,Chapman; Eddie Nathaniel,20,0,20,0
1713341215928,RELI 145GS,A00,519817,Rahimi; Babak,17,0,20,3
1713341216957,SE 101A,A01,490862,Chadha; Mayank,23,0,25,2
1713341217987,SE 101C,A01,490924,Krysl; Petr,15,0,20,5
1713341219013,SE 110A,A01,490928,Staff,19,0,20,1
1713341220040,SE 130A,A00,490929,Morrison; Machel Leigh,54,0,70,16
1713341221071,SIO 1,A01,519325,Staff,39,0,40,1
1713341222109,SIO 30,A01,519327,Staff,38,0,40,2
1713341223135,SIO 40,A00,519328,Staff,39,0,40,1
1713341224160,SIO 46GS,A00,519819,Cook; Geoffrey W,15,0,25,10
1713341225191,SIO 109R,A00,494197,Forman; Fonna,0,3,20,20
1713341226226,SIO 121GS,A00,519827,Cook; Geoffrey W,15,0,25,10
1713341227255,SIO 132,A01,519330,Staff,38,0,40,2
1713341228284,SIO 133,A01,519397,Staff,37,0,40,3
1713341229308,SIO 139,A00,519396,Kacev; David,29,0,40,11
1713341230334,SOCI 1,A01,494199,Thorpe; Charles Robert,21,0,30,9
1713341230334,SOCI 1,A02,494200,Thorpe; Charles Robert,30,0,30,0
1713341230334,SOCI 1,A03,494201,Thorpe; Charles Robert,29,0,30,1
1713341230334,SOCI 1,A04,494202,Thorpe; Charles Robert,29,0,30,1
1713341230334,SOCI 1,A05,494203,Thorpe; Charles Robert,29,0,30,1
1713341230334,SOCI 1,A06,494204,Thorpe; Charles Robert,30,0,30,0
1713341230334,SOCI 1,A07,494205,Thorpe; Charles Robert,28,0,30,2
1713341231360,SOCI 60,A01,494207,Staff,33,0,40,7
1713341231360,SOCI 60,A02,494208,Staff,39,0,40,1
1713341232388,SOCI 100,A01,494210,Payne; Christine Anna,25,0,30,5
1713341232388,SOCI 100,A02,494211,Payne; Christine Anna,26,0,30,4
1713341233417,SOCI 109M,A00,494212,Staff,20,0,20,0
1713341234444,SOCI 110,A00,494213,Staff,34,0,40,6
1713341236498,SOCI 118E,A00,494215,Ng; Kwai,37,0,40,3
1713341237528,SOCI 125,A00,494216,Calderon-Zaks; Michael Aar,39,0,45,6
1713341238554,SOCI 126,A01,494218,Jones; Makeba,3,0,5,2
1713341239582,SOCI 131,A00,494219,Thorpe; Charles Robert,26,0,30,4
1713341241696,SOCI 135,A00,494221,Payne; Christine Anna,28,0,50,22
1713341242723,SOCI 136E,A00,626690,Ruiz; Jonathan Joseph,24,0,25,1
1713341243749,SOCI 138GS,A00,494222,Navon; Daniel,23,0,28,5
1713341245806,SOCI 145,A00,494224,Staff,40,0,45,5
1713341246834,SOCI 153,A00,494225,Staff,28,0,30,2
1713341247859,SOCI 160E,A00,494226,Ng; Kwai,27,0,40,13
1713341248886,SOCI 180,A00,494227,Staff,29,0,30,1
1713341249914,SOCI 189GS,A00,494228,Ribas Norris; Janet Vanesa,11,0,11,0
1713341250941,SOCI 190GS,A00,553232,Ribas Norris; Janet Vanesa,11,0,11,0
1713341251972,SOMI 220,A00,627178,Schneid; Stephen David,30,0,30,0
1713341253002,SYN 2,001,490768,Staff,13,0,15,2
1713341253002,SYN 2,002,490769,Staff,14,0,15,1
1713341253002,SYN 2,004,490775,Staff,0,0,0,0
1713341253002,SYN 2,003,490774,Staff,0,0,0,0
1713341253002,SYN 2,005,490776,Staff,0,0,0,0
1713341254032,SYN 2R,001,490779,Staff,11,0,15,4
1713341254032,SYN 2R,002,514635,Staff,14,0,15,1
1713341255063,SYN 100,A01,490783,Staff,8,0,20,12
1713341255063,SYN 100,B01,490787,Staff,10,0,20,10
1713341255063,SYN 100,C01,490789,Staff,10,0,20,10
1713341256089,SYN 150,A00,490817,Staff,14,0,15,1
1713341256089,SYN 150,B00,514610,Staff,15,0,15,0
1713341257122,TDAC 1,A00,492753,Walsh; Kim C.,19,0,20,1
1713341257122,TDAC 1,B00,492754,Harting; Carla Kelso,18,0,20,2
1713341257122,TDAC 1,C00,513995,Salovey; Todd,15,0,20,5
1713341258157,TDAC 101,A00,492766,Harting; Carla Kelso,17,0,20,3
1713341259183,TDAC 102,A00,492768,Basso; Beatrice,19,0,20,1
1713341260215,TDDE 111,A00,492769,Staff,25,0,25,0
1713341261244,TDDE 131,A00,492770,Staff,15,0,15,0
1713341261244,TDDE 131,B00,492771,Staff,15,0,15,0
1713341262268,TDDE 131GS,A00,523716,Guirguis; Mark C,23,0,28,5
1713341263295,TDGE 1,A01,492756,Salovey; Todd,56,0,60,4
1713341264323,TDGE 5,A01,492758,Staff,23,0,25,2
1713341265351,TDGE 10,A00,492759,Fulton; Julia,203,0,220,17
1713341266380,TDGE 11,A00,492760,Castro; Robert Jess,198,0,200,2
1713341268440,TDGE 124,A00,492772,Fulton; Julia,181,0,220,39
1713341269467,TDGE 125,A00,492773,Meyer; Ursula,38,0,50,12
1713341269467,TDGE 125,B00,492774,Staff,49,0,50,1
1713341269467,TDGE 125,C00,523565,Staff,48,0,50,2
1713341270496,TDGE 125GS,A00,523580,Guirguis; Mark C,23,0,28,5
1713341271525,TDGE 127,A00,492775,Havis; Allan,32,0,50,18
1713341272550,TDHT 101,A00,492776,Staff,34,0,35,1
1713341273576,TDMV 1,A00,492762,Caligagan; Maria T.,29,0,30,1
1713341273576,TDMV 1,B00,492763,Arcidiacono; Kristin,26,0,30,4
1713341274607,TDMV 2,A00,492764,Weinberg; Sadie,27,0,30,3
1713341275638,TDMV 3,A00,492765,Mack; Kara Shanai',37,0,40,3
1713341276668,TDMV 138,A00,492777,Mack; Kara Shanai',32,0,40,8
1713341277699,TDMV 140,A00,492778,Lima; Paulo Henrique,40,0,40,0
1713341278736,TDMV 142,A00,492779,Caligagan; Maria T.,33,0,40,7
1713341278736,TDMV 142,B00,492780,Caligagan; Tony,37,0,40,3
1713341279762,TDMV 143,A00,492781,Fyall; Daunte Edward,39,0,40,1
1713341280791,USP 1,A01,492401,Kwak; Nancy,27,0,35,8
1713341281822,USP 2,A01,492453,Hinds; Juli Beth,35,0,35,0
1713341282849,USP 3,A01,492516,Staff,28,0,35,7
1713341283894,USP 4,A00,492522,McTague; Sarah,16,0,25,9
1713341284921,USP 100,A00,492523,Staff,32,0,35,3
1713341285944,USP 101,A00,492524,Staff,13,0,15,2
1713341286971,USP 105,A00,492525,Staff,21,0,25,4
1713341287998,USP 151,A00,492526,Shenkman; Michael Thomas,32,0,35,3
1713341289029,USP 170,A00,492545,Hinds; Juli Beth,33,0,35,2
1713341290056,USP 171GS,A00,492608,Bussell; Mirle Rabinowitz,24,0,28,4
1713341291081,USP 183GS,A00,492613,Peerson; Susan,24,0,28,4
1713341292108,VIS 30,A01,490693,Yoldas; Pinar,19,0,22,3
1713341292108,VIS 30,A02,490694,Yoldas; Pinar,18,0,22,4
1713341293141,VIS 83,A00,490695,Kester; Grant,63,0,75,12
1713341294167,VIS 105D,A00,490696,Staff,22,0,25,3
1713341295193,VIS 124CN,A00,490699,Rose; Jordan M,64,0,75,11
1713341296223,VIS 125GS,A00,511221,Williams; Alena J,21,0,22,1
1713341297250,VIS 128D,A00,490700,Staff,73,0,75,2
1713341298277,VIS 151,A01,490717,Staff,33,0,34,1
1713341298277,VIS 151,A02,490766,Staff,33,0,34,1
1713341299303,VIS 154GS,A00,511972,Williams; Alena J,21,0,22,1
1713341300329,VIS 160A,A00,490767,Stone; Patricia,7,0,10,3
1713341301362,WCWP 10A,A00,490638,Staff,14,0,15,1
1713341301362,WCWP 10A,B00,490640,Staff,15,0,15,0
1713341302391,WCWP 10B,A00,490641,Staff,0,0,0,0
1713341302391,WCWP 10B,B00,490642,Staff,14,0,15,1
1713341302391,WCWP 10B,C00,490644,Staff,13,0,15,2
1713341302391,WCWP 10B,D00,490647,Staff,0,0,0,0
1713341303420,WCWP 100,A00,490655,Staff,0,0,0,0
1713341303420,WCWP 100,B00,490687,Staff,10,0,15,5
1713341305540,ANAR 153,A00,487222,Braswell; Geoffrey E.,53,0,60,7
1713341306568,ANBI 134,A00,487223,Staff,5,0,20,15
1713341307595,ANBI 143GS,A00,487224,Noel; Geoffroy Pierre Jean,18,0,24,6
1713341308620,ANBI 144GS,A00,519548,Noel; Geoffroy Pierre Jean,18,0,24,6
1713341309650,ANSC 101,A00,487225,Staff,17,0,20,3
1713341310676,ANSC 125,A00,487227,Brenner; Suzanne A,38,0,40,2
1713341312728,ANSC 146,A00,487229,Staff,35,0,40,5
1713341313754,ANSC 148,A00,487230,Olivas Hernandez; Olga Lid,39,0,40,1
1713341314787,ANSC 150,A00,504165,Sloane; Julia Kathryn,18,0,20,2
1713341315813,ANSC 180,A00,487232,Staff,14,0,15,1
1713341316854,ANSC 188,A00,627155,Staff,37,0,40,3
1713341317879,ANTH 5,A00,519529,Semendeferi; Ekaterini,15,0,15,0
1713341318907,ANTH 10,A00,487219,Staff,58,0,60,2
1713341319937,ANTH 23,A01,487221,Staff,17,0,20,3
1713341320961,ANTH 102,A00,487233,Wilder; Linnea Lorene,50,0,60,10
1713341321986,ANTH 103,A00,487234,Varma; Saiba,54,0,60,6
1713341323012,ANTH 105,A00,487235,Stewart; Alexander B,54,0,60,6
1713341324042,BENG 100,A01,516685,Taylor Amos; Alyssa C,25,0,30,5
1713341325080,BIBC 102,A01,491316,Flagg; Matthew Paul,5,0,88,83
1713341325080,BIBC 102,A02,491366,Flagg; Matthew Paul,78,0,88,10
1713341326111,BIBC 103,A01,491486,Boumechache; Miyyada,16,0,24,8
1713341326111,BIBC 103,A02,491487,Boumechache; Miyyada,24,0,24,0
1713341327142,BICD 100,A01,516882,Staff,73,0,75,2
1713341327142,BICD 100,A02,516890,Staff,69,0,75,6
1713341328167,BICD 102GS,A00,491488,Lo; Stanley M.,26,0,28,2
1713341329193,BIEB 136GS,A00,516940,Holway; David A. & Shurin; Jonathan,18,0,24,6
1713341330221,BIEB 137GS,A01,517034,Holway; David A. & Shurin; Jonathan,18,0,24,6
1713341331245,BIEB 138GS,A01,491492,Pirino; Giorgia,21,0,28,7
1713341332277,BILD 1,A01,491296,Staff,60,0,63,3
1713341332277,BILD 1,A02,491297,Staff,63,0,63,0
1713341333308,BILD 4,A01,517099,Gonzalez Gamboa; Ivonne,22,0,24,2
1713341333308,BILD 4,A02,517100,Gonzalez Gamboa; Ivonne,24,0,24,0
1713341334335,BILD 60GS,A00,491309,Lo; Stanley M.,26,0,28,2
1713341335362,BIMM 100,A01,517136,Staff,82,0,100,18
1713341336387,BIMM 110,A01,517182,Staff,53,0,100,47
1713341337413,BIMM 120,A01,517228,Pickett; Brooke Elizabeth,28,0,63,35
1713341337413,BIMM 120,A02,517240,Pickett; Brooke Elizabeth,44,0,63,19
1713341338441,BIMM 132GS,A01,491498,Pirino; Giorgia,21,0,28,7
1713341339471,BIMM 143,A01,491589,Bozinovic; Goran,12,0,40,28
1713341340502,BIPN 100,A01,491594,Armour; Jon Christopher,83,0,100,17
1713341341530,BIPN 140,A01,491602,Marino; Marc J,23,0,50,27
1713341343592,CAT 125,A00,515973,Staff,18,0,20,2
1713341344689,CAT 125GS,A00,515974,Rahimi; Babak,16,0,20,4
1713341345719,CAT 125R,A00,515980,Staff,12,0,20,8
1713341345719,CAT 125R,B00,515981,Tosun; Adriana,19,0,20,1
1713341345719,CAT 125R,C00,515987,Hyland; Tina Mae,0,5,20,20
1713341345719,CAT 125R,D00,515988,Bronstein; Phoebe Malan,16,0,20,4
1713341346753,CENG 15,A01,488699,Drews; Aaron,25,0,25,0
1713341347781,CENG 100,A00,505196,Opatkiewicz; Justin Paul,25,0,25,0
1713341348807,CGS 2A,A01,489598,Staff,32,0,35,3
1713341349832,CGS 112,A00,489599,Staff,15,0,15,0
1713341350856,CGS 119,A00,489603,Staff,10,0,10,0
1713341351885,CGS 120,A00,489604,Staff,13,0,15,2
1713341352912,CGS 150,A00,489607,Staff,15,0,15,0
1713341353938,CHEM 6A,A01,488715,Staff,97,0,100,3
1713341354967,CHEM 6B,A01,488719,Piercy; Marc Anthony,99,0,100,1
1713341355998,CHEM 6C,A01,488723,Albizati; Kim F.,93,0,100,7
1713341357028,CHEM 7L,A01,488728,Schurmeier; Kimberly,18,0,24,6
1713341357028,CHEM 7L,A02,488730,Schurmeier; Kimberly,23,0,24,1
1713341357028,CHEM 7L,A03,488734,Schurmeier; Kimberly,20,0,24,4
1713341357028,CHEM 7L,A04,488763,Schurmeier; Kimberly,23,0,24,1
1713341357028,CHEM 7L,B01,488798,Schurmeier; Kimberly,16,0,24,8
1713341357028,CHEM 7L,B02,488801,Schurmeier; Kimberly,22,0,24,2
1713341357028,CHEM 7L,B03,488808,Schurmeier; Kimberly,22,0,24,2
1713341357028,CHEM 7L,B04,488811,Schurmeier; Kimberly,24,0,24,0
1713341358068,CHEM 11,A01,488897,Stallings; Dontarie M,94,0,100,6
1713341359101,CHEM 40A,A01,488913,Albizati; Kim F.,83,0,100,17
1713341360132,CHEM 40B,A01,488920,Weizman; Haim,42,0,50,8
1713341360132,CHEM 40B,A02,488938,Weizman; Haim,43,0,50,7
1713341361163,CHEM 41A,A01,489029,Klosterman; Jeremy K,57,0,60,3
1713341362192,CHEM 41C,A01,500436,Tor; Yitzhak,54,0,60,6
1713341363229,CHEM 43A,A01,500426,Weizman; Haim,0,1,24,24
1713341363229,CHEM 43A,A02,500430,Weizman; Haim,6,0,24,18
1713341363229,CHEM 43A,B01,514041,Klosterman; Jeremy K,14,0,24,10
1713341363229,CHEM 43A,B02,514047,Klosterman; Jeremy K,23,0,24,1
1713341364260,CHEM 108,A01,489140,Jennings; Patricia A.,7,0,24,17
1713341364260,CHEM 108,A02,489142,Jennings; Patricia A.,14,0,24,10
1713341365287,CHEM 114A,A01,489147,Stallings; Dontarie M,65,0,100,35
1713341366313,CHIN 169A,A00,489171,Wang; Xiao,19,0,20,1
1713341368369,COGS 3,A01,518827,Boyle; Mary E. T.,25,0,40,15
1713341369399,COGS 11,A01,489175,Staff,27,0,30,3
1713341370424,COGS 14A,A01,518829,Staff,50,0,60,10
1713341371451,COGS 14B,A01,489177,Hoffman; Drew Ellen,62,0,75,13
1713341372477,COGS 100,A01,489181,Allen; Michael Gordon,62,0,75,13
1713341373558,COGS 101A,A01,489183,Staff,45,0,60,15
1713341374585,COGS 101B,A01,489185,Allen; Michael Gordon,6,0,30,24
1713341375611,COGS 101C,A01,526786,Staff,23,0,30,7
1713341377663,COGS 107A,A01,489189,Boyle; Mary E. T.,16,0,35,19
1713341378695,COGS 107B,A01,627144,Mooshagian; Eric Frederick,59,0,60,1
1713341379731,COGS 118A,A01,489191,Staff,0,46,40,40
1713341381784,COGS 171GS,A01,489194,Pineda; Jaime A,19,0,28,9
1713341382811,COGS 172,A01,489196,Staff,1,0,30,29
1713341383835,COGS 174GS,A01,489264,Pineda; Jaime A,19,0,28,9
1713341384867,COGS 180,A01,627150,Staff,28,0,30,2
1713341385892,COGS 186,A01,489274,Staff,0,2,30,30
1713341386917,COMM 10,A01,489276,Staff,23,0,25,2
1713341386917,COMM 10,A02,489303,Staff,23,0,25,2
1713341387942,COMM 100A,A01,489312,Staff,14,0,25,11
1713341387942,COMM 100A,A02,489313,Staff,24,0,25,1
1713341388973,COMM 106T,A00,512540,Staff,33,0,35,2
1713341389999,COMM 107,A00,489347,Staff,27,0,35,8
1713341391027,COMM 109P,A00,489358,Staff,31,0,35,4
1713341392052,COMM 132,A00,489361,McKenna; Denise,27,0,30,3
1713341393082,COMM 146,A00,489362,Halm; Gavin Patrick,26,0,30,4
1713341394108,COMM 190,A00,489363,Abuelhiga; Soraya Jill,17,0,23,6
1713341395149,CSE 8A,A50,489366,Staff,21,0,25,4
1713341395149,CSE 8A,A51,489367,Staff,24,0,25,1
1713341396175,CSE 11,A01,489398,Cao; Yingjun,72,0,100,28
1713341397211,CSE 12,A01,489487,Staff,43,0,50,7
1713341398237,CSE 20,A01,489497,Staff,47,0,50,3
1713341399269,CSE 21,A01,489517,Braun; Oliver,42,0,50,8
1713341400294,CSE 101,A01,489524,Braun; Oliver,0,33,50,50
1713341401322,CSE 105,A01,512594,Jones; Miles E,72,0,100,28
1713341401322,CSE 105,B01,512598,Jones; Miles E,51,0,100,49
1713341402355,CSE 140,A01,489538,Staff,41,0,50,9
1713341403385,CSE 141,A01,489550,Eldon; John,67,0,100,33
1713341404412,CSE 141L,A01,489571,Eldon; John,65,0,100,35
1713341405439,CSE 151A,A01,489583,Solares; Edwin A,140,0,200,60
1713341406465,CSE 175,A01,510886,Kumar; Rakesh,30,0,30,0
1713341407491,CSE 190,A00,516828,Dubnov; Shlomo,37,0,49,12
1713341408517,DOC 100D,A00,489667,Pass; Natalye Joann,19,0,25,6
1713341409543,DSC 10,A01,624268,Staff,72,0,75,3
1713341410571,DSC 20,A01,624476,Staff,50,0,50,0
1713341411601,DSC 40A,A01,624608,Staff,39,0,40,1
1713341412628,DSGN 1,A01,489179,Rill; Bryan,32,0,50,18
1713341413661,ECE 17,A01,490489,Sahay; Rajeev,18,0,30,12
1713341414691,ECE 65,A50,490492,Staff,11,0,20,9
1713341414691,ECE 65,A51,490493,Staff,18,0,20,2
1713341415718,ECON 1,A01,489715,Famulari; Melissa,67,0,70,3
1713341416744,ECON 2,A01,489717,Levkoff; Steven B.,67,0,70,3
1713341417773,ECON 3,A01,489948,Staff,70,0,70,0
1713341419826,ECON 5,A01,490103,Staff,27,0,30,3
1713341419826,ECON 5,B01,626281,Dai; Yinlin,45,0,45,0
1713341420850,ECON 100A,A01,490127,Famulari; Melissa,62,0,70,8
1713341421874,ECON 100B,A01,490129,Staff,64,0,70,6
1713341422900,ECON 109,A01,490187,Shishkin; Denis,27,0,35,8
1713341423927,ECON 110A,A01,490190,Levkoff; Steven B.,59,0,70,11
1713341424953,ECON 120A,A01,490245,Dai; Yinlin,59,0,70,11
1713341425983,ECON 120B,A01,490247,Nieto-Barthaburu; Augusto,40,0,70,30
1713341427011,ECON 120C,A01,490253,Sun; Yixiao,30,0,35,5
1713341427011,ECON 120C,B01,490255,Sun; Yixiao,34,0,35,1
1713341428052,ECON 129,A00,490256,Eckert; Fabian Paul,22,0,35,13
1713341429080,ECON 131,A00,490257,Nieto-Barthaburu; Augusto,0,6,35,35
1713341430115,ECON 138,A00,490258,Bharadwaj; Prashant,13,0,35,22
1713341430115,ECON 138,B00,490259,Bharadwaj; Prashant,15,0,35,20
1713341431143,ECON 159,A00,490260,Hendrickson; Gerald M.,0,9,0,0
1713341432169,ECON 178,A01,553995,Zhu; Ying,24,0,35,11
1713341433200,EDS 40,A01,512576,Black; Alison Michelle,20,0,20,0
1713341434231,EDS 107,A01,515848,Staff,30,0,30,0
1713341435261,EDS 110R,A01,490262,Staff,26,0,30,4
1713341436293,EDS 112,A01,490264,Chapman; Thandeka K,40,0,50,10
1713341437321,EDS 113,A00,490266,Staff,25,0,30,5
1713341438345,EDS 118,A00,490267,Warstadt; Melissa Fawn,18,0,30,12
1713341439373,EDS 124BR,A00,490268,Eguchi; Emi,4,0,25,21
1713341439373,EDS 124BR,B00,490269,Eguchi; Emi,23,0,25,2
1713341440397,EDS 126,A01,490271,Jones; Makeba,43,0,50,7
1713341441427,EDS 135,A01,490316,Staff,19,0,20,1
1713341442468,ENVR 142GS,A00,519514,Chang; Edmond Yi-Teh,26,0,28,2
1713341443500,ETHN 103,A00,490504,Staff,25,0,36,11
1713341444528,ETHN 103A,A00,490505,Man; Simeon S,3,0,9,6
1713341445553,ETHN 109,A00,490506,Staff,28,0,30,2
1713341446581,ETHN 118,A00,490507,Staff,35,0,36,1
1713341447610,ETHN 119,A00,490508,Staff,32,0,36,4
1713341448698,ETHN 121R,A00,490518,Choi; Esther Min,21,0,36,15
1713341449726,ETHN 127,A00,490528,Staff,14,0,15,1
1713341450751,ETHN 139,A00,490573,Staff,10,0,10,0
1713341451777,ETHN 150,A00,490575,Staff,15,0,15,0
1713341452804,GLBH 20,A00,491705,Elwardani; Nile Regina,38,0,40,2
1713341453829,GLBH 101,A00,491706,Staff,20,0,20,0
1713341454855,GLBH 111,A01,491708,Burgos; Jose L.,15,0,15,0
1713341455884,GLBH 146,A00,491709,Staff,8,0,20,12
1713341456910,GLBH 148,A00,491710,Olivas Hernandez; Olga Lid,10,0,20,10
1713341457938,GLBH 150,A00,491711,Sloane; Julia Kathryn,19,0,20,1
1713341458965,HIEA 131,A00,491760,Staff,28,0,32,4
1713341459990,HIEA 153,A00,491762,Staff,28,0,30,2
1713341461021,HIEU 124,A00,491811,Staff,26,0,32,6
1713341462047,HIEU 124GS,A00,491812,Markman; Kristina,27,0,28,1
1713341463075,HIEU 147,A00,491813,Staff,30,0,32,2
1713341464100,HIEU 149GS,A00,491816,Caldwell; Michael Alan,28,0,28,0
1713341465127,HILD 2C,A01,491713,Hendrickson; Gerald M.,26,0,30,4
1713341466153,HILD 7B,A01,491715,Kwak; Nancy,0,2,30,30
1713341467181,HILD 10,A01,491717,Staff,9,0,20,11
1713341468210,HILD 30GS,A00,491719,Edington; Claire Ellen,23,0,28,5
1713341469234,HINE 109,A00,491818,Shafir; Nir,26,0,32,6
1713341470261,HINE 128,A00,491821,Shafir; Nir,30,0,32,2
1713341471288,HISC 117,A00,491830,Staff,27,0,32,5
1713341472319,HIUS 103,A00,491834,Man; Simeon S,14,0,23,9
1713341473349,HIUS 108B,A00,491835,Staff,27,0,30,3
1713341474387,HIUS 141,A00,491836,Hendrickson; Gerald M.,28,0,32,4
1713341475412,HIUS 149,A00,491839,Staff,24,0,32,8
1713341476442,HUM 3,A01,512617,Crum; Matthew Stephen,42,0,50,8
1713341476442,HUM 3,A02,512618,Crum; Matthew Stephen,48,0,50,2
1713341477468,HUM 3GS,A00,512663,Markman; Kristina,0,0,0,1
1713341477468,HUM 3GS,B00,512664,Staff,0,0,0,0
1713341478500,HUM 4,A01,512620,West; Geoffrey Scott,24,0,50,26
1713341479531,HUM 4GS,A00,512666,Lyon; Antony J.,0,0,0,5
1713341480558,HUM 4R,A01,512625,Watkins; Eric,49,0,50,1
1713341481585,HUM 5,A01,512649,Zavodny; Tatiana Sophia,20,0,50,30
1713341481585,HUM 5,B01,512661,Zroka; Ryan Edward,48,0,50,2
1713341482639,INTL 190,A00,490577,Segui; Alan S,0,0,0,5
1713341483676,JAPN 20AR,A01,491267,Ross; Kayoko F,7,0,20,13
1713341484707,JAPN 180,A00,491285,Berman; Michael David,33,0,40,7
1713341485739,LATI 50,A01,502536,Kokinis; Troy Andreas,16,0,22,6
1713341485739,LATI 50,A02,502551,Kokinis; Troy Andreas,22,0,22,0
1713341485739,LATI 50,A03,502650,Kokinis; Troy Andreas,22,0,22,0
1713341485739,LATI 50,A04,502909,Kokinis; Troy Andreas,21,0,22,1
1713341486765,LATI 160,A01,502920,Kokinis; Troy Andreas,30,0,30,0
1713341487795,LIFR 1A,A00,490494,Van Moer; Vinciane G,17,0,20,3
1713341488827,LIFR 1AX,A00,490495,Van Moer; Vinciane G,17,0,20,3
1713341489853,LIFR 1B,A00,490496,Van Moer; Vinciane G,17,0,20,3
1713341490883,LIFR 1BX,A00,490497,Van Moer; Vinciane G,17,0,20,3
1713341491910,LIGN 8,A00,505198,McIntosh; Justin Daniel,134,0,150,16
1713341492936,LIGN 9GS,A00,491239,Lott; Margaret S.,18,0,20,2
1713341493964,LIGN 101,A01,505200,McIntosh; Justin Daniel,22,0,30,8
1713341494990,LIGN 120,A01,491244,Staff,22,0,30,8
1713341496016,LIGN 149GS,A00,491245,Lott; Margaret S.,18,0,20,2
1713341497041,LIGN 170,A00,491247,Staff,22,0,30,8
1713341498073,LISP 1D,A00,490498,Munoz Sanchez; Alicia,8,0,14,6
1713341498073,LISP 1D,B00,490499,Munoz Sanchez; Alicia,4,0,14,10
1713341498073,LISP 1D,C00,490500,Munoz Sanchez; Alicia,7,0,14,7
1713341498073,LISP 1D,D00,490501,Munoz Sanchez; Alicia,10,0,14,4
1713341499100,LISP 1DX,A00,490502,Munoz Sanchez; Alicia,11,0,28,17
1713341499100,LISP 1DX,B00,490503,Munoz Sanchez; Alicia,16,0,28,12
1713341501154,LTAM 110,A00,491847,Staff,22,0,25,3
1713341502180,LTCS 119,A00,491848,Staff,11,0,15,4
1713341503212,LTCS 130,A00,491849,Staff,24,0,25,1
1713341505267,LTEA 120C,A00,491852,Staff,32,0,40,8
1713341506296,LTEN 130GS,A00,491853,Lyon; Antony J.,23,0,28,5
1713341507320,LTEN 148,A00,491855,Staff,23,0,25,2
1713341508349,LTEN 159,A00,491856,Staff,20,0,25,5
1713341509376,LTEN 180,A00,491857,Staff,8,0,15,7
1713341511426,LTSP 123GS,A00,505928,Bessett; Ryan Matthew,24,0,28,4
1713341512453,LTSP 174GS,A00,506037,Bessett; Ryan Matthew,24,0,28,4
1713341514508,LTWR 102,A00,491861,Staff,9,0,15,6
1713341515531,LTWR 106,A00,491862,Staff,8,0,15,7
1713341516565,MAE 11,A00,490930,Bahadori; Mohammad Yousef,94,0,100,6
1713341517597,MAE 30A,A00,490931,Qi; Huihui,37,0,40,3
1713341518630,MAE 101A,A00,491036,Sadeghizadeh; Zahra,91,0,100,9
1713341519663,MAE 101C,A00,491037,Seshadri; Kalyanasundaram,63,0,100,37
1713341520694,MAE 113,A00,491040,Seshadri; Kalyanasundaram,64,0,80,16
1713341521720,MAE 131A,A00,491041,Ghazinejad; Maziar,37,0,40,3
1713341522747,MAE 142,A00,491053,Staff,39,0,40,1
1713341523773,MAE 143A,A00,491054,Staff,29,0,50,21
1713341524800,MAE 150,A00,491092,Truong; Phuong Thi Ngoc,23,0,35,12
1713341525832,MATH 3C,A01,494031,Pardo Guerra; Sebastian,30,0,30,0
1713341525832,MATH 3C,A02,494032,Pardo Guerra; Sebastian,29,0,30,1
1713341526863,MATH 10A,A01,494034,Staff,27,0,30,3
1713341526863,MATH 10A,A02,494035,Staff,28,0,30,2
1713341526863,MATH 10A,B01,494037,Staff,27,0,30,3
1713341526863,MATH 10A,B02,494038,Staff,29,0,30,1
1713341527909,MATH 10B,A01,494040,Habib; Yousaf,22,0,30,8
1713341527909,MATH 10B,A02,494041,Habib; Yousaf,28,0,30,2
1713341527909,MATH 10B,A03,494042,Habib; Yousaf,29,0,30,1
1713341527909,MATH 10B,A04,494043,Habib; Yousaf,30,0,30,0
1713341527909,MATH 10B,B01,494045,Habib; Yousaf,25,0,30,5
1713341527909,MATH 10B,B02,494046,Habib; Yousaf,30,0,30,0
1713341527909,MATH 10B,B03,494047,Habib; Yousaf,30,0,30,0
1713341527909,MATH 10B,B04,494048,Habib; Yousaf,30,0,30,0
1713341528945,MATH 18,A01,494050,Kemp; Todd Aahron,25,0,30,5
1713341528945,MATH 18,A02,494051,Kemp; Todd Aahron,29,0,30,1
1713341528945,MATH 18,B01,494054,Kemp; Todd Aahron,25,0,30,5
1713341528945,MATH 18,B02,494055,Kemp; Todd Aahron,29,0,30,1
1713341529975,MATH 20A,A01,494059,Suk; Andrew Hoon,30,0,30,0
1713341531008,MATH 20B,A01,494061,Briones; Jor-el Thomas Caparas,33,0,35,2
1713341531008,MATH 20B,B01,494063,Bach; Quang Tran,34,0,35,1
1713341532035,MATH 20C,A01,494065,Staff,28,0,30,2
1713341532035,MATH 20C,A02,494066,Staff,30,0,30,0
1713341532035,MATH 20C,A03,494067,Staff,30,0,30,0
1713341532035,MATH 20C,A04,494068,Staff,30,0,30,0
1713341532035,MATH 20C,B01,494070,Zhang; Ming,24,0,30,6
1713341532035,MATH 20C,B02,494071,Zhang; Ming,27,0,30,3
1713341532035,MATH 20C,B03,494072,Zhang; Ming,29,0,30,1
1713341532035,MATH 20C,B04,494073,Zhang; Ming,29,0,30,1
1713341533061,MATH 20D,A01,494075,Staff,22,0,30,8
1713341533061,MATH 20D,A02,494076,Staff,29,0,30,1
1713341534086,MATH 20E,A01,494079,Staff,24,0,30,6
1713341534086,MATH 20E,A02,494080,Staff,26,0,30,4
1713341534086,MATH 20E,B01,494082,Staff,25,0,30,5
1713341534086,MATH 20E,B02,494083,Staff,25,0,30,5
1713341535114,MATH 103A,A01,494085,Aliabadi Sr.; Mohsen,12,0,30,18
1713341535114,MATH 103A,A02,494086,Aliabadi Sr.; Mohsen,28,0,30,2
1713341535114,MATH 103A,B01,494088,Aliabadi Sr.; Mohsen,20,0,30,10
1713341535114,MATH 103A,B02,494089,Aliabadi Sr.; Mohsen,27,0,30,3
1713341536140,MATH 109,A01,494091,Staff,30,0,30,0
1713341536140,MATH 109,A02,494092,Staff,29,0,30,1
1713341536140,MATH 109,B01,494094,Staff,27,0,30,3
1713341536140,MATH 109,B02,494095,Staff,29,0,30,1
1713341537174,MATH 142A,A01,494097,Chow; Bennett,13,0,30,17
1713341537174,MATH 142A,A02,494098,Chow; Bennett,23,0,30,7
1713341537174,MATH 142A,B01,494100,Chow; Bennett,19,0,30,11
1713341537174,MATH 142A,B02,494101,Chow; Bennett,29,0,30,1
1713341539226,MATH 168A,A01,516677,Dumitriu; Ioana,16,0,35,19
1713341540258,MATH 170A,A01,516679,Dumitriu; Ioana,18,0,30,12
1713341540258,MATH 170A,A02,516680,Dumitriu; Ioana,28,0,30,2
1713341541288,MATH 193A,A01,494107,Staff,12,0,30,18
1713341541288,MATH 193A,A02,494108,Staff,18,0,30,12
1713341541288,MATH 193A,A03,494109,Staff,29,0,30,1
1713341541288,MATH 193A,A04,494110,Staff,22,0,30,8
1713341544371,MGT 16,A00,491930,McKay; Michael J,92,0,98,6
1713341545400,MGT 18,A00,491992,McKay; Michael J,96,0,98,2
1713341546428,MGT 71,A00,492003,Staff,63,0,98,35
1713341547464,MGT 103,A00,505209,Eberhard; Craig A,80,0,98,18
1713341548490,MGT 131A,A00,505210,Anderson; John Charles,89,0,98,9
1713341550549,MGT 153,A00,492077,Perols; Johan Lars,16,0,90,74
1713341553680,MGT 164,A00,492222,McKay; Mary A,91,0,98,7
1713341554712,MGT 172,A00,492245,Staff,59,0,60,1
1713341554712,MGT 172,B00,505526,Hedges; Kathleen,65,0,98,33
1713341555739,MGT 181,A00,505669,Dunn; Louis Jean,78,0,98,20
1713341556767,MMW 14,A01,494399,Staff,15,0,28,13
1713341556767,MMW 14,A02,494400,Staff,25,0,28,3
1713341556767,MMW 14,A03,494401,Staff,28,0,28,0
1713341556767,MMW 14,A04,494402,Staff,28,0,28,0
1713341556767,MMW 14,B01,494404,Carreras; Maria Victoria,8,0,28,20
1713341556767,MMW 14,B02,494405,Carreras; Maria Victoria,25,0,28,3
1713341556767,MMW 14,B03,494406,Carreras; Maria Victoria,27,0,28,1
1713341556767,MMW 14,B04,494407,Carreras; Maria Victoria,28,0,28,0
1713341557794,MMW 14GS,A00,506250,Chang; Edmond Yi-Teh,0,0,0,0
1713341558820,MMW 121R,A01,494415,Adamiak; Patrick John,10,0,28,18
1713341558820,MMW 121R,A02,494416,Adamiak; Patrick John,24,0,28,4
1713341559844,MUS 1A,A01,494113,Staff,12,0,25,13
1713341559844,MUS 1A,A02,494114,Staff,24,0,25,1
1713341560875,MUS 4,A01,494116,Staff,23,0,25,2
1713341560875,MUS 4,A02,494117,Staff,22,0,25,3
1713341561907,MUS 5R,A01,494236,Dubnov; Shlomo,4,0,25,21
1713341561907,MUS 5R,A02,494237,Dubnov; Shlomo,25,0,25,0
1713341562938,MUS 6,A01,494122,Staff,9,0,25,16
1713341562938,MUS 6,A02,494123,Staff,23,0,25,2
1713341563963,MUS 7,A01,494125,Staff,16,0,25,9
1713341563963,MUS 7,A02,494126,Staff,24,0,25,1
1713341564987,MUS 11,A01,494128,Staff,23,0,25,2
1713341564987,MUS 11,A02,494129,Staff,24,0,25,1
1713341566016,MUS 13,A01,494131,Staff,25,0,25,0
1713341566016,MUS 13,A02,494132,Staff,25,0,25,0
1713341567042,MUS 15,A01,494134,Staff,16,0,25,9
1713341567042,MUS 15,A02,494135,Staff,25,0,25,0
1713341567042,MUS 15,B01,494137,Staff,24,0,25,1
1713341568068,MUS 80,A00,494232,Staff,24,0,25,1
1713341568068,MUS 80,B00,494233,Staff,25,0,25,0
1713341568068,MUS 80,C00,494234,Staff,23,0,25,2
1713341569094,MUS 95C,A00,494141,Staff,69,0,75,6
1713341570128,MUS 114,A00,494142,Staff,39,0,50,11
1713341571157,NANO 15,A01,490636,Drews; Aaron,7,0,7,0
1713341572187,PHIL 1,A00,490578,Grush; Rick Scott,49,0,50,1
1713341573214,PHIL 10,A01,490580,Grush; Rick Scott,33,0,35,2
1713341573214,PHIL 10,A02,490586,Grush; Rick Scott,32,0,35,3
1713341574240,PHIL 27,A01,490591,Staff,22,0,25,3
1713341574240,PHIL 27,A02,490592,Staff,25,0,25,0
1713341574240,PHIL 27,A03,490593,Staff,25,0,25,0
1713341574240,PHIL 27,A04,490598,Staff,25,0,25,0
1713341575274,PHIL 32,A01,490611,Staff,20,0,20,0
1713341575274,PHIL 32,A02,490618,Staff,20,0,20,0
1713341576299,PHIL 90,A00,490624,Staff,40,0,40,0
1713341577325,PHIL 136,A00,490627,Cohen; Jonathan David,37,0,40,3
1713341578352,PHIL 155,A00,490634,Staff,62,0,70,8
1713341579383,PHYS 1A,A00,491610,Staff,245,0,250,5
1713341580410,PHYS 1AL,001,491616,Tsai; Philbert S,27,0,30,3
1713341580410,PHYS 1AL,002,491618,Tsai; Philbert S,30,0,30,0
1713341581440,PHYS 1B,A00,491623,Staff,235,0,250,15
1713341582466,PHYS 1BL,001,491626,Tsai; Philbert S,18,0,30,12
1713341582466,PHYS 1BL,002,491628,Tsai; Philbert S,26,0,30,4
1713341583494,PHYS 1C,A00,491632,Staff,212,0,245,33
1713341584517,PHYS 1CL,001,491635,Tsai; Philbert S,3,0,30,27
1713341584517,PHYS 1CL,002,491643,Tsai; Philbert S,22,0,30,8
1713341585552,PHYS 2AR,A01,491651,Meyertholen; Andrew D.,44,0,50,6
1713341586578,PHYS 2B,A01,491659,Staff,105,0,115,10
1713341587605,PHYS 2BL,A01,491685,Staff,21,0,24,3
1713341587605,PHYS 2BL,A02,491700,Staff,21,0,24,3
1713341588631,PHYS 2C,A01,505161,Staff,101,0,115,14
1713341589657,PHYS 4A,A01,491704,Grinstein; Benjamin,99,0,100,1
1713341590686,POLI 5D,A01,494144,Staff,3,0,5,2
1713341590686,POLI 5D,B01,626283,Dai; Yinlin,5,0,5,0
1713341591715,POLI 12,A00,494145,Staff,43,0,45,2
1713341592747,POLI 13R,A00,494146,Forman; Fonna,45,0,50,5
1713341593775,POLI 27,A01,494148,Staff,54,0,60,6
1713341594802,POLI 30,A00,494149,Staff,49,0,50,1
1713341595828,POLI 100DA,A00,494150,Staff,20,0,25,5
1713341597879,POLI 100I,A00,494152,Staff,27,0,30,3
1713341598910,POLI 104B,A00,494153,Smith; Glenn Chatmas,53,0,55,2
1713341599935,POLI 104F,A00,494154,Staff,28,0,30,2
1713341600964,POLI 104I,A00,494155,Smith; Glenn Chatmas,29,0,30,1
1713341601997,POLI 110C,A00,494156,Ingham; Sean,23,0,25,2
1713341603023,POLI 117R,A00,494157,Forman; Fonna,5,0,20,15
1713341604052,POLI 118,A00,494158,Ingham; Sean,21,0,25,4
1713341605080,POLI 120H,A00,494159,Fisk; David Lee,39,0,45,6
1713341606107,POLI 131CR,A00,494160,Hoston; Germaine,35,0,45,10
1713341607135,POLI 133J,A00,494161,Staff,31,0,35,4
1713341608166,POLI 135,A00,494162,Fisk; David Lee,33,0,35,2
1713341609192,POLI 140A,A00,494164,Staff,18,0,30,12
1713341610218,POLI 142I,A00,494165,Staff,30,0,30,0
1713341611248,POLI 144D,A00,494166,Staff,22,0,25,3
1713341612278,POLI 151,A00,494167,Staff,30,0,30,0
1713341613303,POLI 153,A00,494168,Staff,33,0,35,2
1713341614328,POLI 160AA,A00,494169,Staff,33,0,40,7
1713341615356,POLI 162,A00,494170,Mignozzetti; Umberto,18,0,25,7
1713341616382,POLI 171,A00,494171,Mignozzetti; Umberto,18,0,25,7
1713341617410,PSYC 1,A00,494172,Staff,95,0,100,5
1713341618444,PSYC 2,A00,494173,Moranton; Nirelia Melbina-,34,0,50,16
1713341619474,PSYC 3,A00,494174,Staff,29,0,30,1
1713341620499,PSYC 6,A00,494175,Staff,17,0,20,3
1713341621524,PSYC 60,A01,494177,Staff,37,0,45,8
1713341622551,PSYC 70,A01,505724,Geller; Emma Harlan,42,0,45,3
1713341623581,PSYC 101,A00,494180,Heyman; Gail D.,84,0,100,16
1713341624607,PSYC 105,A00,494181,Geller; Emma Harlan,51,0,90,39
1713341625634,PSYC 106,A00,494182,Dobkins; Karen R.,26,0,45,19
1713341626662,PSYC 108,A00,494183,Adrian; Julia Anna,89,0,100,11
1713341627696,PSYC 114,A01,494185,Winkielman; Piotr,0,4,30,30
1713341628722,PSYC 122,A00,494186,Moranton; Nirelia Melbina-,27,0,50,23
1713341629747,PSYC 124,A00,494187,Chapman; Eddie Nathaniel,69,0,80,11
1713341630781,PSYC 131,A00,494188,Anagnostaras; Stephan,40,0,80,40
1713341631806,PSYC 144,A00,494189,Staff,0,2,50,50
1713341632832,PSYC 154,A00,494190,Lacefield; Katharine I,105,0,180,75
1713341633888,PSYC 162,A00,494191,Wixted; John T,70,0,100,30
1713341634913,PSYC 172,A00,494192,Gorman; Michael R.,36,0,45,9
1713341635939,PSYC 178,A00,494193,Glaser; Dale,33,0,45,12
1713341636967,PSYC 193,A00,505725,Chapman; Eddie Nathaniel,20,0,20,0
1713341637993,RELI 145GS,A00,519817,Rahimi; Babak,17,0,20,3
1713341639023,SE 101A,A01,490862,Chadha; Mayank,23,0,25,2
1713341640072,SE 101C,A01,490924,Krysl; Petr,15,0,20,5
1713341641098,SE 110A,A01,490928,Staff,19,0,20,1
1713341642125,SE 130A,A00,490929,Morrison; Machel Leigh,54,0,70,16
1713341643152,SIO 1,A01,519325,Staff,39,0,40,1
1713341644179,SIO 30,A01,519327,Staff,38,0,40,2
1713341645205,SIO 40,A00,519328,Staff,39,0,40,1
1713341646231,SIO 46GS,A00,519819,Cook; Geoffrey W,15,0,25,10
1713341647256,SIO 109R,A00,494197,Forman; Fonna,0,3,20,20
1713341648286,SIO 121GS,A00,519827,Cook; Geoffrey W,15,0,25,10
1713341649313,SIO 132,A01,519330,Staff,38,0,40,2
1713341650340,SIO 133,A01,519397,Staff,37,0,40,3
1713341651365,SIO 139,A00,519396,Kacev; David,29,0,40,11
1713341652392,SOCI 1,A01,494199,Thorpe; Charles Robert,21,0,30,9
1713341652392,SOCI 1,A02,494200,Thorpe; Charles Robert,30,0,30,0
1713341652392,SOCI 1,A03,494201,Thorpe; Charles Robert,29,0,30,1
1713341652392,SOCI 1,A04,494202,Thorpe; Charles Robert,29,0,30,1
1713341652392,SOCI 1,A05,494203,Thorpe; Charles Robert,29,0,30,1
1713341652392,SOCI 1,A06,494204,Thorpe; Charles Robert,30,0,30,0
1713341652392,SOCI 1,A07,494205,Thorpe; Charles Robert,28,0,30,2
1713341653420,SOCI 60,A01,494207,Staff,33,0,40,7
1713341653420,SOCI 60,A02,494208,Staff,39,0,40,1
1713341654447,SOCI 100,A01,494210,Payne; Christine Anna,25,0,30,5
1713341654447,SOCI 100,A02,494211,Payne; Christine Anna,26,0,30,4
1713341655477,SOCI 109M,A00,494212,Staff,20,0,20,0
1713341656556,SOCI 110,A00,494213,Staff,34,0,40,6
1713341658607,SOCI 118E,A00,494215,Ng; Kwai,37,0,40,3
1713341659633,SOCI 125,A00,494216,Calderon-Zaks; Michael Aar,39,0,45,6
1713341660660,SOCI 126,A01,494218,Jones; Makeba,3,0,5,2
1713341661686,SOCI 131,A00,494219,Thorpe; Charles Robert,26,0,30,4
1713341663737,SOCI 135,A00,494221,Payne; Christine Anna,28,0,50,22
1713341664762,SOCI 136E,A00,626690,Ruiz; Jonathan Joseph,24,0,25,1
1713341665788,SOCI 138GS,A00,494222,Navon; Daniel,23,0,28,5
1713341667847,SOCI 145,A00,494224,Staff,40,0,45,5
1713341668873,SOCI 153,A00,494225,Staff,28,0,30,2
1713341669904,SOCI 160E,A00,494226,Ng; Kwai,27,0,40,13
1713341670929,SOCI 180,A00,494227,Staff,29,0,30,1
1713341671955,SOCI 189GS,A00,494228,Ribas Norris; Janet Vanesa,11,0,11,0
1713341672992,SOCI 190GS,A00,553232,Ribas Norris; Janet Vanesa,11,0,11,0
1713341674023,SOMI 220,A00,627178,Schneid; Stephen David,30,0,30,0
1713341675049,SYN 2,001,490768,Staff,13,0,15,2
1713341675049,SYN 2,002,490769,Staff,14,0,15,1
1713341675049,SYN 2,004,490775,Staff,0,0,0,0
1713341675049,SYN 2,003,490774,Staff,0,0,0,0
1713341675049,SYN 2,005,490776,Staff,0,0,0,0
1713341676076,SYN 2R,001,490779,Staff,11,0,15,4
1713341676076,SYN 2R,002,514635,Staff,14,0,15,1
1713341677110,SYN 100,A01,490783,Staff,8,0,20,12
1713341677110,SYN 100,B01,490787,Staff,10,0,20,10
1713341677110,SYN 100,C01,490789,Staff,10,0,20,10
1713341678139,SYN 150,A00,490817,Staff,14,0,15,1
1713341678139,SYN 150,B00,514610,Staff,15,0,15,0
1713341679168,TDAC 1,A00,492753,Walsh; Kim C.,19,0,20,1
1713341679168,TDAC 1,B00,492754,Harting; Carla Kelso,18,0,20,2
1713341679168,TDAC 1,C00,513995,Salovey; Todd,15,0,20,5
1713341680194,TDAC 101,A00,492766,Harting; Carla Kelso,17,0,20,3
1713341681225,TDAC 102,A00,492768,Basso; Beatrice,19,0,20,1
1713341682253,TDDE 111,A00,492769,Staff,25,0,25,0
1713341683278,TDDE 131,A00,492770,Staff,15,0,15,0
1713341683278,TDDE 131,B00,492771,Staff,15,0,15,0
1713341684304,TDDE 131GS,A00,523716,Guirguis; Mark C,23,0,28,5
1713341685335,TDGE 1,A01,492756,Salovey; Todd,56,0,60,4
1713341686361,TDGE 5,A01,492758,Staff,23,0,25,2
1713341687387,TDGE 10,A00,492759,Fulton; Julia,203,0,220,17
1713341688414,TDGE 11,A00,492760,Castro; Robert Jess,198,0,200,2
1713341690471,TDGE 124,A00,492772,Fulton; Julia,180,0,220,40
1713341691499,TDGE 125,A00,492773,Meyer; Ursula,38,0,50,12
1713341691499,TDGE 125,B00,492774,Staff,49,0,50,1
1713341691499,TDGE 125,C00,523565,Staff,48,0,50,2
1713341692524,TDGE 125GS,A00,523580,Guirguis; Mark C,23,0,28,5
1713341693553,TDGE 127,A00,492775,Havis; Allan,32,0,50,18
1713341694581,TDHT 101,A00,492776,Staff,34,0,35,1
1713341695615,TDMV 1,A00,492762,Caligagan; Maria T.,29,0,30,1
1713341695615,TDMV 1,B00,492763,Arcidiacono; Kristin,26,0,30,4
1713341696644,TDMV 2,A00,492764,Weinberg; Sadie,27,0,30,3
1713341697670,TDMV 3,A00,492765,Mack; Kara Shanai',37,0,40,3
1713341698697,TDMV 138,A00,492777,Mack; Kara Shanai',32,0,40,8
1713341699727,TDMV 140,A00,492778,Lima; Paulo Henrique,40,0,40,0
1713341700753,TDMV 142,A00,492779,Caligagan; Maria T.,33,0,40,7
1713341700753,TDMV 142,B00,492780,Caligagan; Tony,37,0,40,3
1713341701786,TDMV 143,A00,492781,Fyall; Daunte Edward,39,0,40,1
1713341702817,USP 1,A01,492401,Kwak; Nancy,27,0,35,8
1713341703842,USP 2,A01,492453,Hinds; Juli Beth,35,0,35,0
1713341704872,USP 3,A01,492516,Staff,28,0,35,7
1713341705897,USP 4,A00,492522,McTague; Sarah,16,0,25,9
1713341706925,USP 100,A00,492523,Staff,32,0,35,3
1713341707954,USP 101,A00,492524,Staff,13,0,15,2
1713341708979,USP 105,A00,492525,Staff,21,0,25,4
1713341710010,USP 151,A00,492526,Shenkman; Michael Thomas,32,0,35,3
1713341711035,USP 170,A00,492545,Hinds; Juli Beth,33,0,35,2
1713341712063,USP 171GS,A00,492608,Bussell; Mirle Rabinowitz,24,0,28,4
1713341713089,USP 183GS,A00,492613,Peerson; Susan,24,0,28,4
1713341714117,VIS 30,A01,490693,Yoldas; Pinar,19,0,22,3
1713341714117,VIS 30,A02,490694,Yoldas; Pinar,18,0,22,4
1713341715143,VIS 83,A00,490695,Kester; Grant,63,0,75,12
1713341716168,VIS 105D,A00,490696,Staff,22,0,25,3
1713341717194,VIS 124CN,A00,490699,Rose; Jordan M,64,0,75,11
1713341718219,VIS 125GS,A00,511221,Williams; Alena J,21,0,22,1
1713341719245,VIS 128D,A00,490700,Staff,73,0,75,2
1713341720269,VIS 151,A01,490717,Staff,33,0,34,1
1713341720269,VIS 151,A02,490766,Staff,33,0,34,1
1713341721299,VIS 154GS,A00,511972,Williams; Alena J,21,0,22,1
1713341722332,VIS 160A,A00,490767,Stone; Patricia,7,0,10,3
1713341723359,WCWP 10A,A00,490638,Staff,14,0,15,1
1713341723359,WCWP 10A,B00,490640,Staff,15,0,15,0
1713341724385,WCWP 10B,A00,490641,Staff,0,0,0,0
1713341724385,WCWP 10B,B00,490642,Staff,14,0,15,1
1713341724385,WCWP 10B,C00,490644,Staff,13,0,15,2
1713341724385,WCWP 10B,D00,490647,Staff,0,0,0,0
1713341725414,WCWP 100,A00,490655,Staff,0,0,0,0
1713341725414,WCWP 100,B00,490687,Staff,10,0,15,5
1713341727563,ANAR 153,A00,487222,Braswell; Geoffrey E.,53,0,60,7
1713341728589,ANBI 134,A00,487223,Staff,5,0,20,15
1713341729620,ANBI 143GS,A00,487224,Noel; Geoffroy Pierre Jean,18,0,24,6
1713341730650,ANBI 144GS,A00,519548,Noel; Geoffroy Pierre Jean,18,0,24,6
1713341731680,ANSC 101,A00,487225,Staff,17,0,20,3
1713341732712,ANSC 125,A00,487227,Brenner; Suzanne A,38,0,40,2
1713341734776,ANSC 146,A00,487229,Staff,35,0,40,5
1713341735803,ANSC 148,A00,487230,Olivas Hernandez; Olga Lid,39,0,40,1
1713341736833,ANSC 150,A00,504165,Sloane; Julia Kathryn,18,0,20,2
1713341737863,ANSC 180,A00,487232,Staff,14,0,15,1
1713341738894,ANSC 188,A00,627155,Staff,37,0,40,3
1713341739922,ANTH 5,A00,519529,Semendeferi; Ekaterini,15,0,15,0
1713341740948,ANTH 10,A00,487219,Staff,58,0,60,2
1713341741975,ANTH 23,A01,487221,Staff,17,0,20,3
1713341743001,ANTH 102,A00,487233,Wilder; Linnea Lorene,50,0,60,10
1713341744031,ANTH 103,A00,487234,Varma; Saiba,54,0,60,6
1713341745062,ANTH 105,A00,487235,Stewart; Alexander B,54,0,60,6
1713341746094,BENG 100,A01,516685,Taylor Amos; Alyssa C,25,0,30,5
1713341747121,BIBC 102,A01,491316,Flagg; Matthew Paul,5,0,88,83
1713341747121,BIBC 102,A02,491366,Flagg; Matthew Paul,78,0,88,10
1713341748147,BIBC 103,A01,491486,Boumechache; Miyyada,16,0,24,8
1713341748147,BIBC 103,A02,491487,Boumechache; Miyyada,24,0,24,0
1713341749180,BICD 100,A01,516882,Staff,73,0,75,2
1713341749180,BICD 100,A02,516890,Staff,69,0,75,6
1713341750209,BICD 102GS,A00,491488,Lo; Stanley M.,26,0,28,2
1713341751234,BIEB 136GS,A00,516940,Holway; David A. & Shurin; Jonathan,18,0,24,6
1713341752260,BIEB 137GS,A01,517034,Holway; David A. & Shurin; Jonathan,18,0,24,6
1713341753286,BIEB 138GS,A01,491492,Pirino; Giorgia,21,0,28,7
1713341754320,BILD 1,A01,491296,Staff,60,0,63,3
1713341754320,BILD 1,A02,491297,Staff,63,0,63,0
1713341755347,BILD 4,A01,517099,Gonzalez Gamboa; Ivonne,22,0,24,2
1713341755347,BILD 4,A02,517100,Gonzalez Gamboa; Ivonne,24,0,24,0
1713341756376,BILD 60GS,A00,491309,Lo; Stanley M.,26,0,28,2
1713341757408,BIMM 100,A01,517136,Staff,82,0,100,18
1713341758436,BIMM 110,A01,517182,Staff,53,0,100,47
1713341759462,BIMM 120,A01,517228,Pickett; Brooke Elizabeth,28,0,63,35
1713341759462,BIMM 120,A02,517240,Pickett; Brooke Elizabeth,44,0,63,19
1713341760547,BIMM 132GS,A01,491498,Pirino; Giorgia,21,0,28,7
1713341761575,BIMM 143,A01,491589,Bozinovic; Goran,12,0,40,28
1713341762606,BIPN 100,A01,491594,Armour; Jon Christopher,83,0,100,17
1713341763632,BIPN 140,A01,491602,Marino; Marc J,23,0,50,27
1713341765688,CAT 125,A00,515973,Staff,18,0,20,2
1713341766713,CAT 125GS,A00,515974,Rahimi; Babak,16,0,20,4
1713341767745,CAT 125R,A00,515980,Staff,12,0,20,8
1713341767745,CAT 125R,B00,515981,Tosun; Adriana,19,0,20,1
1713341767745,CAT 125R,C00,515987,Hyland; Tina Mae,0,5,20,20
1713341767745,CAT 125R,D00,515988,Bronstein; Phoebe Malan,16,0,20,4
1713341768775,CENG 15,A01,488699,Drews; Aaron,25,0,25,0
1713341769800,CENG 100,A00,505196,Opatkiewicz; Justin Paul,25,0,25,0
1713341770831,CGS 2A,A01,489598,Staff,32,0,35,3
1713341771858,CGS 112,A00,489599,Staff,15,0,15,0
1713341772884,CGS 119,A00,489603,Staff,10,0,10,0
1713341773911,CGS 120,A00,489604,Staff,13,0,15,2
1713341774942,CGS 150,A00,489607,Staff,15,0,15,0
1713341775968,CHEM 6A,A01,488715,Staff,97,0,100,3
1713341776999,CHEM 6B,A01,488719,Piercy; Marc Anthony,99,0,100,1
1713341778025,CHEM 6C,A01,488723,Albizati; Kim F.,93,0,100,7
1713341779051,CHEM 7L,A01,488728,Schurmeier; Kimberly,18,0,24,6
1713341779051,CHEM 7L,A02,488730,Schurmeier; Kimberly,23,0,24,1
1713341779051,CHEM 7L,A03,488734,Schurmeier; Kimberly,20,0,24,4
1713341779051,CHEM 7L,A04,488763,Schurmeier; Kimberly,23,0,24,1
1713341779051,CHEM 7L,B01,488798,Schurmeier; Kimberly,16,0,24,8
1713341779051,CHEM 7L,B02,488801,Schurmeier; Kimberly,22,0,24,2
1713341779051,CHEM 7L,B03,488808,Schurmeier; Kimberly,22,0,24,2
1713341779051,CHEM 7L,B04,488811,Schurmeier; Kimberly,24,0,24,0
1713341780081,CHEM 11,A01,488897,Stallings; Dontarie M,94,0,100,6
1713341781110,CHEM 40A,A01,488913,Albizati; Kim F.,83,0,100,17
1713341782145,CHEM 40B,A01,488920,Weizman; Haim,42,0,50,8
1713341782145,CHEM 40B,A02,488938,Weizman; Haim,43,0,50,7
1713341783171,CHEM 41A,A01,489029,Klosterman; Jeremy K,57,0,60,3
1713341784198,CHEM 41C,A01,500436,Tor; Yitzhak,54,0,60,6
1713341785235,CHEM 43A,A01,500426,Weizman; Haim,0,1,24,24
1713341785235,CHEM 43A,A02,500430,Weizman; Haim,6,0,24,18
1713341785235,CHEM 43A,B01,514041,Klosterman; Jeremy K,14,0,24,10
1713341785235,CHEM 43A,B02,514047,Klosterman; Jeremy K,23,0,24,1
1713341786261,CHEM 108,A01,489140,Jennings; Patricia A.,7,0,24,17
1713341786261,CHEM 108,A02,489142,Jennings; Patricia A.,14,0,24,10
1713341787286,CHEM 114A,A01,489147,Stallings; Dontarie M,65,0,100,35
1713341788311,CHIN 169A,A00,489171,Wang; Xiao,19,0,20,1
1713341790363,COGS 3,A01,518827,Boyle; Mary E. T.,25,0,40,15
1713341791389,COGS 11,A01,489175,Staff,27,0,30,3
1713341792417,COGS 14A,A01,518829,Staff,50,0,60,10
1713341793447,COGS 14B,A01,489177,Hoffman; Drew Ellen,62,0,75,13
1713341794473,COGS 100,A01,489181,Allen; Michael Gordon,62,0,75,13
1713341795499,COGS 101A,A01,489183,Staff,45,0,60,15
1713341796531,COGS 101B,A01,489185,Allen; Michael Gordon,6,0,30,24
1713341797562,COGS 101C,A01,526786,Staff,23,0,30,7
1713341799615,COGS 107A,A01,489189,Boyle; Mary E. T.,16,0,35,19
1713341800649,COGS 107B,A01,627144,Mooshagian; Eric Frederick,59,0,60,1
1713341801675,COGS 118A,A01,489191,Staff,0,46,40,40
1713341803736,COGS 171GS,A01,489194,Pineda; Jaime A,19,0,28,9
1713341804764,COGS 172,A01,489196,Staff,1,0,30,29
1713341805790,COGS 174GS,A01,489264,Pineda; Jaime A,19,0,28,9
1713341806820,COGS 180,A01,627150,Staff,28,0,30,2
1713341807850,COGS 186,A01,489274,Staff,0,2,30,30
1713341808879,COMM 10,A01,489276,Staff,23,0,25,2
1713341808879,COMM 10,A02,489303,Staff,23,0,25,2
1713341809903,COMM 100A,A01,489312,Staff,14,0,25,11
1713341809903,COMM 100A,A02,489313,Staff,24,0,25,1
1713341810935,COMM 106T,A00,512540,Staff,33,0,35,2
1713341811961,COMM 107,A00,489347,Staff,27,0,35,8
1713341812985,COMM 109P,A00,489358,Staff,31,0,35,4
1713341814016,COMM 132,A00,489361,McKenna; Denise,27,0,30,3
1713341815042,COMM 146,A00,489362,Halm; Gavin Patrick,26,0,30,4
1713341816075,COMM 190,A00,489363,Abuelhiga; Soraya Jill,17,0,23,6
1713341817103,CSE 8A,A50,489366,Staff,21,0,25,4
1713341817103,CSE 8A,A51,489367,Staff,24,0,25,1
1713341818128,CSE 11,A01,489398,Cao; Yingjun,72,0,100,28
1713341819155,CSE 12,A01,489487,Staff,43,0,50,7
1713341820182,CSE 20,A01,489497,Staff,47,0,50,3
1713341821207,CSE 21,A01,489517,Braun; Oliver,42,0,50,8
1713341822232,CSE 101,A01,489524,Braun; Oliver,0,33,50,50
1713341823259,CSE 105,A01,512594,Jones; Miles E,72,0,100,28
1713341823259,CSE 105,B01,512598,Jones; Miles E,51,0,100,49
1713341824285,CSE 140,A01,489538,Staff,41,0,50,9
1713341825311,CSE 141,A01,489550,Eldon; John,67,0,100,33
1713341826337,CSE 141L,A01,489571,Eldon; John,65,0,100,35
1713341827362,CSE 151A,A01,489583,Solares; Edwin A,140,0,200,60
1713341828389,CSE 175,A01,510886,Kumar; Rakesh,30,0,30,0
1713341829415,CSE 190,A00,516828,Dubnov; Shlomo,37,0,49,12
1713341830441,DOC 100D,A00,489667,Pass; Natalye Joann,19,0,25,6
1713341831471,DSC 10,A01,624268,Staff,72,0,75,3
1713341832497,DSC 20,A01,624476,Staff,50,0,50,0
1713341833521,DSC 40A,A01,624608,Staff,39,0,40,1
1713341834547,DSGN 1,A01,489179,Rill; Bryan,32,0,50,18
1713341835573,ECE 17,A01,490489,Sahay; Rajeev,18,0,30,12
1713341836600,ECE 65,A50,490492,Staff,11,0,20,9
1713341836600,ECE 65,A51,490493,Staff,18,0,20,2
1713341837628,ECON 1,A01,489715,Famulari; Melissa,67,0,70,3
1713341838660,ECON 2,A01,489717,Levkoff; Steven B.,67,0,70,3
1713341839685,ECON 3,A01,489948,Staff,70,0,70,0
1713341841742,ECON 5,A01,490103,Staff,27,0,30,3
1713341841742,ECON 5,B01,626281,Dai; Yinlin,45,0,45,0
1713341842769,ECON 100A,A01,490127,Famulari; Melissa,62,0,70,8
1713341843799,ECON 100B,A01,490129,Staff,64,0,70,6
1713341844825,ECON 109,A01,490187,Shishkin; Denis,27,0,35,8
1713341845848,ECON 110A,A01,490190,Levkoff; Steven B.,59,0,70,11
1713341846875,ECON 120A,A01,490245,Dai; Yinlin,59,0,70,11
1713341847911,ECON 120B,A01,490247,Nieto-Barthaburu; Augusto,40,0,70,30
1713341848944,ECON 120C,A01,490253,Sun; Yixiao,30,0,35,5
1713341848944,ECON 120C,B01,490255,Sun; Yixiao,34,0,35,1
1713341849971,ECON 129,A00,490256,Eckert; Fabian Paul,22,0,35,13
1713341850998,ECON 131,A00,490257,Nieto-Barthaburu; Augusto,0,6,35,35
1713341852024,ECON 138,A00,490258,Bharadwaj; Prashant,13,0,35,22
1713341852024,ECON 138,B00,490259,Bharadwaj; Prashant,15,0,35,20
1713341853051,ECON 159,A00,490260,Hendrickson; Gerald M.,0,9,0,0
1713341854077,ECON 178,A01,553995,Zhu; Ying,24,0,35,11
1713341855103,EDS 40,A01,512576,Black; Alison Michelle,20,0,20,0
1713341856128,EDS 107,A01,515848,Staff,30,0,30,0
1713341857152,EDS 110R,A01,490262,Staff,26,0,30,4
1713341858182,EDS 112,A01,490264,Chapman; Thandeka K,40,0,50,10
1713341859206,EDS 113,A00,490266,Staff,25,0,30,5
1713341860233,EDS 118,A00,490267,Warstadt; Melissa Fawn,18,0,30,12
1713341861268,EDS 124BR,A00,490268,Eguchi; Emi,4,0,25,21
1713341861268,EDS 124BR,B00,490269,Eguchi; Emi,23,0,25,2
1713341862294,EDS 126,A01,490271,Jones; Makeba,43,0,50,7
1713341863320,EDS 135,A01,490316,Staff,19,0,20,1
1713341864411,ENVR 142GS,A00,519514,Chang; Edmond Yi-Teh,26,0,28,2
1713341865443,ETHN 103,A00,490504,Staff,25,0,36,11
1713341866469,ETHN 103A,A00,490505,Man; Simeon S,3,0,9,6
1713341867500,ETHN 109,A00,490506,Staff,28,0,30,2
1713341868524,ETHN 118,A00,490507,Staff,35,0,36,1
1713341869549,ETHN 119,A00,490508,Staff,32,0,36,4
1713341870581,ETHN 121R,A00,490518,Choi; Esther Min,21,0,36,15
1713341871611,ETHN 127,A00,490528,Staff,14,0,15,1
1713341872636,ETHN 139,A00,490573,Staff,10,0,10,0
1713341873662,ETHN 150,A00,490575,Staff,15,0,15,0
1713341874689,GLBH 20,A00,491705,Elwardani; Nile Regina,38,0,40,2
1713341875718,GLBH 101,A00,491706,Staff,20,0,20,0
1713341876745,GLBH 111,A01,491708,Burgos; Jose L.,15,0,15,0
1713341877770,GLBH 146,A00,491709,Staff,8,0,20,12
1713341878800,GLBH 148,A00,491710,Olivas Hernandez; Olga Lid,10,0,20,10
1713341879831,GLBH 150,A00,491711,Sloane; Julia Kathryn,19,0,20,1
1713341880856,HIEA 131,A00,491760,Staff,28,0,32,4
1713341881881,HIEA 153,A00,491762,Staff,28,0,30,2
1713341882907,HIEU 124,A00,491811,Staff,26,0,32,6
1713341883933,HIEU 124GS,A00,491812,Markman; Kristina,27,0,28,1
1713341884959,HIEU 147,A00,491813,Staff,30,0,32,2
1713341885985,HIEU 149GS,A00,491816,Caldwell; Michael Alan,28,0,28,0
1713341887015,HILD 2C,A01,491713,Hendrickson; Gerald M.,26,0,30,4
1713341888045,HILD 7B,A01,491715,Kwak; Nancy,0,2,30,30
1713341889074,HILD 10,A01,491717,Staff,9,0,20,11
1713341890099,HILD 30GS,A00,491719,Edington; Claire Ellen,23,0,28,5
1713341891125,HINE 109,A00,491818,Shafir; Nir,26,0,32,6
1713341892156,HINE 128,A00,491821,Shafir; Nir,30,0,32,2
1713341893183,HISC 117,A00,491830,Staff,27,0,32,5
1713341894209,HIUS 103,A00,491834,Man; Simeon S,14,0,23,9
1713341895234,HIUS 108B,A00,491835,Staff,27,0,30,3
1713341896265,HIUS 141,A00,491836,Hendrickson; Gerald M.,28,0,32,4
1713341897291,HIUS 149,A00,491839,Staff,24,0,32,8
1713341898319,HUM 3,A01,512617,Crum; Matthew Stephen,42,0,50,8
1713341898319,HUM 3,A02,512618,Crum; Matthew Stephen,48,0,50,2
1713341899344,HUM 3GS,A00,512663,Markman; Kristina,0,0,0,1
1713341899344,HUM 3GS,B00,512664,Staff,0,0,0,0
1713341900371,HUM 4,A01,512620,West; Geoffrey Scott,24,0,50,26
1713341901397,HUM 4GS,A00,512666,Lyon; Antony J.,0,0,0,5
1713341902429,HUM 4R,A01,512625,Watkins; Eric,49,0,50,1
1713341903455,HUM 5,A01,512649,Zavodny; Tatiana Sophia,20,0,50,30
1713341903455,HUM 5,B01,512661,Zroka; Ryan Edward,48,0,50,2
1713341904485,INTL 190,A00,490577,Segui; Alan S,0,0,0,5
1713341905513,JAPN 20AR,A01,491267,Ross; Kayoko F,7,0,20,13
1713341906538,JAPN 180,A00,491285,Berman; Michael David,33,0,40,7
1713341907565,LATI 50,A01,502536,Kokinis; Troy Andreas,16,0,22,6
1713341907565,LATI 50,A02,502551,Kokinis; Troy Andreas,22,0,22,0
1713341907565,LATI 50,A03,502650,Kokinis; Troy Andreas,22,0,22,0
1713341907565,LATI 50,A04,502909,Kokinis; Troy Andreas,21,0,22,1
1713341908591,LATI 160,A01,502920,Kokinis; Troy Andreas,30,0,30,0
1713341909617,LIFR 1A,A00,490494,Van Moer; Vinciane G,17,0,20,3
1713341910643,LIFR 1AX,A00,490495,Van Moer; Vinciane G,17,0,20,3
1713341911672,LIFR 1B,A00,490496,Van Moer; Vinciane G,17,0,20,3
1713341912698,LIFR 1BX,A00,490497,Van Moer; Vinciane G,17,0,20,3
1713341913724,LIGN 8,A00,505198,McIntosh; Justin Daniel,134,0,150,16
1713341914753,LIGN 9GS,A00,491239,Lott; Margaret S.,18,0,20,2
1713341915779,LIGN 101,A01,505200,McIntosh; Justin Daniel,22,0,30,8
1713341916808,LIGN 120,A01,491244,Staff,22,0,30,8
1713341917835,LIGN 149GS,A00,491245,Lott; Margaret S.,18,0,20,2
1713341918860,LIGN 170,A00,491247,Staff,22,0,30,8
1713341919892,LISP 1D,A00,490498,Munoz Sanchez; Alicia,8,0,14,6
1713341919892,LISP 1D,B00,490499,Munoz Sanchez; Alicia,4,0,14,10
1713341919892,LISP 1D,C00,490500,Munoz Sanchez; Alicia,7,0,14,7
1713341919892,LISP 1D,D00,490501,Munoz Sanchez; Alicia,10,0,14,4
1713341920917,LISP 1DX,A00,490502,Munoz Sanchez; Alicia,11,0,28,17
1713341920917,LISP 1DX,B00,490503,Munoz Sanchez; Alicia,16,0,28,12
1713341922967,LTAM 110,A00,491847,Staff,22,0,25,3
1713341923992,LTCS 119,A00,491848,Staff,11,0,15,4
1713341925017,LTCS 130,A00,491849,Staff,24,0,25,1
1713341927072,LTEA 120C,A00,491852,Staff,32,0,40,8
1713341928103,LTEN 130GS,A00,491853,Lyon; Antony J.,23,0,28,5
1713341929129,LTEN 148,A00,491855,Staff,23,0,25,2
1713341930154,LTEN 159,A00,491856,Staff,20,0,25,5
1713341931180,LTEN 180,A00,491857,Staff,8,0,15,7
1713341933239,LTSP 123GS,A00,505928,Bessett; Ryan Matthew,24,0,28,4
1713341934265,LTSP 174GS,A00,506037,Bessett; Ryan Matthew,24,0,28,4
1713341936319,LTWR 102,A00,491861,Staff,9,0,15,6
1713341937344,LTWR 106,A00,491862,Staff,8,0,15,7
1713341938373,MAE 11,A00,490930,Bahadori; Mohammad Yousef,94,0,100,6
1713341939406,MAE 30A,A00,490931,Qi; Huihui,37,0,40,3
1713341940432,MAE 101A,A00,491036,Sadeghizadeh; Zahra,91,0,100,9
1713341941466,MAE 101C,A00,491037,Seshadri; Kalyanasundaram,63,0,100,37
1713341942492,MAE 113,A00,491040,Seshadri; Kalyanasundaram,64,0,80,16
1713341943518,MAE 131A,A00,491041,Ghazinejad; Maziar,37,0,40,3
1713341944542,MAE 142,A00,491053,Staff,39,0,40,1
1713341945572,MAE 143A,A00,491054,Staff,29,0,50,21
1713341946597,MAE 150,A00,491092,Truong; Phuong Thi Ngoc,23,0,35,12
1713341947625,MATH 3C,A01,494031,Pardo Guerra; Sebastian,30,0,30,0
1713341947625,MATH 3C,A02,494032,Pardo Guerra; Sebastian,29,0,30,1
1713341948649,MATH 10A,A01,494034,Staff,27,0,30,3
1713341948649,MATH 10A,A02,494035,Staff,28,0,30,2
1713341948649,MATH 10A,B01,494037,Staff,27,0,30,3
1713341948649,MATH 10A,B02,494038,Staff,29,0,30,1
1713341949679,MATH 10B,A01,494040,Habib; Yousaf,22,0,30,8
1713341949679,MATH 10B,A02,494041,Habib; Yousaf,28,0,30,2
1713341949679,MATH 10B,A03,494042,Habib; Yousaf,29,0,30,1
1713341949679,MATH 10B,A04,494043,Habib; Yousaf,30,0,30,0
1713341949679,MATH 10B,B01,494045,Habib; Yousaf,25,0,30,5
1713341949679,MATH 10B,B02,494046,Habib; Yousaf,30,0,30,0
1713341949679,MATH 10B,B03,494047,Habib; Yousaf,30,0,30,0
1713341949679,MATH 10B,B04,494048,Habib; Yousaf,30,0,30,0
1713341950706,MATH 18,A01,494050,Kemp; Todd Aahron,25,0,30,5
1713341950706,MATH 18,A02,494051,Kemp; Todd Aahron,29,0,30,1
1713341950706,MATH 18,B01,494054,Kemp; Todd Aahron,25,0,30,5
1713341950706,MATH 18,B02,494055,Kemp; Todd Aahron,29,0,30,1
1713341951732,MATH 20A,A01,494059,Suk; Andrew Hoon,30,0,30,0
1713341952758,MATH 20B,A01,494061,Briones; Jor-el Thomas Caparas,33,0,35,2
1713341952758,MATH 20B,B01,494063,Bach; Quang Tran,34,0,35,1
1713341953785,MATH 20C,A01,494065,Staff,28,0,30,2
1713341953785,MATH 20C,A02,494066,Staff,30,0,30,0
1713341953785,MATH 20C,A03,494067,Staff,30,0,30,0
1713341953785,MATH 20C,A04,494068,Staff,30,0,30,0
1713341953785,MATH 20C,B01,494070,Zhang; Ming,24,0,30,6
1713341953785,MATH 20C,B02,494071,Zhang; Ming,27,0,30,3
1713341953785,MATH 20C,B03,494072,Zhang; Ming,29,0,30,1
1713341953785,MATH 20C,B04,494073,Zhang; Ming,29,0,30,1
1713341954811,MATH 20D,A01,494075,Staff,22,0,30,8
1713341954811,MATH 20D,A02,494076,Staff,29,0,30,1
1713341955835,MATH 20E,A01,494079,Staff,24,0,30,6
1713341955835,MATH 20E,A02,494080,Staff,26,0,30,4
1713341955835,MATH 20E,B01,494082,Staff,25,0,30,5
1713341955835,MATH 20E,B02,494083,Staff,25,0,30,5
1713341956861,MATH 103A,A01,494085,Aliabadi Sr.; Mohsen,12,0,30,18
1713341956861,MATH 103A,A02,494086,Aliabadi Sr.; Mohsen,28,0,30,2
1713341956861,MATH 103A,B01,494088,Aliabadi Sr.; Mohsen,20,0,30,10
1713341956861,MATH 103A,B02,494089,Aliabadi Sr.; Mohsen,27,0,30,3
1713341957887,MATH 109,A01,494091,Staff,30,0,30,0
1713341957887,MATH 109,A02,494092,Staff,29,0,30,1
1713341957887,MATH 109,B01,494094,Staff,27,0,30,3
1713341957887,MATH 109,B02,494095,Staff,29,0,30,1
1713341958915,MATH 142A,A01,494097,Chow; Bennett,13,0,30,17
1713341958915,MATH 142A,A02,494098,Chow; Bennett,23,0,30,7
1713341958915,MATH 142A,B01,494100,Chow; Bennett,19,0,30,11
1713341958915,MATH 142A,B02,494101,Chow; Bennett,29,0,30,1
1713341960968,MATH 168A,A01,516677,Dumitriu; Ioana,16,0,35,19
1713341961991,MATH 170A,A01,516679,Dumitriu; Ioana,18,0,30,12
1713341961991,MATH 170A,A02,516680,Dumitriu; Ioana,28,0,30,2
1713341963019,MATH 193A,A01,494107,Staff,12,0,30,18
1713341963019,MATH 193A,A02,494108,Staff,18,0,30,12
1713341963019,MATH 193A,A03,494109,Staff,29,0,30,1
1713341963019,MATH 193A,A04,494110,Staff,22,0,30,8
1713341966097,MGT 16,A00,491930,McKay; Michael J,92,0,98,6
1713341967127,MGT 18,A00,491992,McKay; Michael J,96,0,98,2
1713341968211,MGT 71,A00,492003,Staff,63,0,98,35
1713341969236,MGT 103,A00,505209,Eberhard; Craig A,80,0,98,18
1713341970269,MGT 131A,A00,505210,Anderson; John Charles,89,0,98,9
1713341972325,MGT 153,A00,492077,Perols; Johan Lars,16,0,90,74
1713341975402,MGT 164,A00,492222,McKay; Mary A,91,0,98,7
1713341976434,MGT 172,A00,492245,Staff,59,0,60,1
1713341976434,MGT 172,B00,505526,Hedges; Kathleen,65,0,98,33
1713341977459,MGT 181,A00,505669,Dunn; Louis Jean,78,0,98,20
1713341978492,MMW 14,A01,494399,Staff,15,0,28,13
1713341978492,MMW 14,A02,494400,Staff,25,0,28,3
1713341978492,MMW 14,A03,494401,Staff,28,0,28,0
1713341978492,MMW 14,A04,494402,Staff,28,0,28,0
1713341978492,MMW 14,B01,494404,Carreras; Maria Victoria,8,0,28,20
1713341978492,MMW 14,B02,494405,Carreras; Maria Victoria,25,0,28,3
1713341978492,MMW 14,B03,494406,Carreras; Maria Victoria,27,0,28,1
1713341978492,MMW 14,B04,494407,Carreras; Maria Victoria,28,0,28,0
1713341979519,MMW 14GS,A00,506250,Chang; Edmond Yi-Teh,0,0,0,0
1713341980546,MMW 121R,A01,494415,Adamiak; Patrick John,10,0,28,18
1713341980546,MMW 121R,A02,494416,Adamiak; Patrick John,24,0,28,4
1713341981576,MUS 1A,A01,494113,Staff,12,0,25,13
1713341981576,MUS 1A,A02,494114,Staff,24,0,25,1
1713341982607,MUS 4,A01,494116,Staff,23,0,25,2
1713341982607,MUS 4,A02,494117,Staff,22,0,25,3
1713341983642,MUS 5R,A01,494236,Dubnov; Shlomo,4,0,25,21
1713341983642,MUS 5R,A02,494237,Dubnov; Shlomo,25,0,25,0
1713341984673,MUS 6,A01,494122,Staff,9,0,25,16
1713341984673,MUS 6,A02,494123,Staff,23,0,25,2
1713341985699,MUS 7,A01,494125,Staff,16,0,25,9
1713341985699,MUS 7,A02,494126,Staff,24,0,25,1
1713341986730,MUS 11,A01,494128,Staff,23,0,25,2
1713341986730,MUS 11,A02,494129,Staff,24,0,25,1
1713341987756,MUS 13,A01,494131,Staff,25,0,25,0
1713341987756,MUS 13,A02,494132,Staff,25,0,25,0
1713341988784,MUS 15,A01,494134,Staff,16,0,25,9
1713341988784,MUS 15,A02,494135,Staff,25,0,25,0
1713341988784,MUS 15,B01,494137,Staff,24,0,25,1
1713341989809,MUS 80,A00,494232,Staff,24,0,25,1
1713341989809,MUS 80,B00,494233,Staff,25,0,25,0
1713341989809,MUS 80,C00,494234,Staff,23,0,25,2
1713341990834,MUS 95C,A00,494141,Staff,69,0,75,6
1713341991859,MUS 114,A00,494142,Staff,39,0,50,11
1713341992885,NANO 15,A01,490636,Drews; Aaron,7,0,7,0
1713341993917,PHIL 1,A00,490578,Grush; Rick Scott,49,0,50,1
1713341994948,PHIL 10,A01,490580,Grush; Rick Scott,33,0,35,2
1713341994948,PHIL 10,A02,490586,Grush; Rick Scott,32,0,35,3
1713341995978,PHIL 27,A01,490591,Staff,22,0,25,3
1713341995978,PHIL 27,A02,490592,Staff,25,0,25,0
1713341995978,PHIL 27,A03,490593,Staff,25,0,25,0
1713341995978,PHIL 27,A04,490598,Staff,25,0,25,0
1713341997008,PHIL 32,A01,490611,Staff,20,0,20,0
1713341997008,PHIL 32,A02,490618,Staff,20,0,20,0
1713341998033,PHIL 90,A00,490624,Staff,40,0,40,0
1713341999058,PHIL 136,A00,490627,Cohen; Jonathan David,37,0,40,3
1713342000089,PHIL 155,A00,490634,Staff,62,0,70,8
1713342001116,PHYS 1A,A00,491610,Staff,245,0,250,5
1713342002142,PHYS 1AL,001,491616,Tsai; Philbert S,27,0,30,3
1713342002142,PHYS 1AL,002,491618,Tsai; Philbert S,30,0,30,0
1713342003167,PHYS 1B,A00,491623,Staff,235,0,250,15
1713342004191,PHYS 1BL,001,491626,Tsai; Philbert S,18,0,30,12
1713342004191,PHYS 1BL,002,491628,Tsai; Philbert S,26,0,30,4
1713342005221,PHYS 1C,A00,491632,Staff,212,0,245,33
1713342006250,PHYS 1CL,001,491635,Tsai; Philbert S,3,0,30,27
1713342006250,PHYS 1CL,002,491643,Tsai; Philbert S,22,0,30,8
1713342007281,PHYS 2AR,A01,491651,Meyertholen; Andrew D.,44,0,50,6
1713342008311,PHYS 2B,A01,491659,Staff,105,0,115,10
1713342009341,PHYS 2BL,A01,491685,Staff,21,0,24,3
1713342009341,PHYS 2BL,A02,491700,Staff,21,0,24,3
1713342010368,PHYS 2C,A01,505161,Staff,101,0,115,14
1713342011398,PHYS 4A,A01,491704,Grinstein; Benjamin,99,0,100,1
1713342012424,POLI 5D,A01,494144,Staff,3,0,5,2
1713342012424,POLI 5D,B01,626283,Dai; Yinlin,5,0,5,0
1713342013454,POLI 12,A00,494145,Staff,43,0,45,2
1713342014484,POLI 13R,A00,494146,Forman; Fonna,45,0,50,5
1713342015513,POLI 27,A01,494148,Staff,54,0,60,6
1713342016543,POLI 30,A00,494149,Staff,49,0,50,1
1713342017569,POLI 100DA,A00,494150,Staff,20,0,25,5
1713342019625,POLI 100I,A00,494152,Staff,27,0,30,3
1713342020658,POLI 104B,A00,494153,Smith; Glenn Chatmas,53,0,55,2
1713342021686,POLI 104F,A00,494154,Staff,28,0,30,2
1713342022712,POLI 104I,A00,494155,Smith; Glenn Chatmas,29,0,30,1
1713342023745,POLI 110C,A00,494156,Ingham; Sean,23,0,25,2
1713342024774,POLI 117R,A00,494157,Forman; Fonna,5,0,20,15
1713342025810,POLI 118,A00,494158,Ingham; Sean,21,0,25,4
1713342026839,POLI 120H,A00,494159,Fisk; David Lee,39,0,45,6
1713342027865,POLI 131CR,A00,494160,Hoston; Germaine,35,0,45,10
1713342028891,POLI 133J,A00,494161,Staff,31,0,35,4
1713342029917,POLI 135,A00,494162,Fisk; David Lee,33,0,35,2
1713342030943,POLI 140A,A00,494164,Staff,18,0,30,12
1713342031967,POLI 142I,A00,494165,Staff,30,0,30,0
1713342032994,POLI 144D,A00,494166,Staff,22,0,25,3
1713342034019,POLI 151,A00,494167,Staff,30,0,30,0
1713342035047,POLI 153,A00,494168,Staff,33,0,35,2
1713342036073,POLI 160AA,A00,494169,Staff,33,0,40,7
1713342037108,POLI 162,A00,494170,Mignozzetti; Umberto,18,0,25,7
1713342038132,POLI 171,A00,494171,Mignozzetti; Umberto,18,0,25,7
1713342039159,PSYC 1,A00,494172,Staff,95,0,100,5
1713342040188,PSYC 2,A00,494173,Moranton; Nirelia Melbina-,34,0,50,16
1713342041214,PSYC 3,A00,494174,Staff,29,0,30,1
1713342042239,PSYC 6,A00,494175,Staff,17,0,20,3
1713342043270,PSYC 60,A01,494177,Staff,37,0,45,8
1713342044303,PSYC 70,A01,505724,Geller; Emma Harlan,42,0,45,3
1713342045328,PSYC 101,A00,494180,Heyman; Gail D.,84,0,100,16
1713342046356,PSYC 105,A00,494181,Geller; Emma Harlan,51,0,90,39
1713342047383,PSYC 106,A00,494182,Dobkins; Karen R.,26,0,45,19
1713342048414,PSYC 108,A00,494183,Adrian; Julia Anna,89,0,100,11
1713342049441,PSYC 114,A01,494185,Winkielman; Piotr,0,4,30,30
1713342050466,PSYC 122,A00,494186,Moranton; Nirelia Melbina-,27,0,50,23
1713342051496,PSYC 124,A00,494187,Chapman; Eddie Nathaniel,69,0,80,11
1713342052524,PSYC 131,A00,494188,Anagnostaras; Stephan,40,0,80,40
1713342053550,PSYC 144,A00,494189,Staff,0,1,50,50
1713342054584,PSYC 154,A00,494190,Lacefield; Katharine I,105,0,180,75
1713342055609,PSYC 162,A00,494191,Wixted; John T,70,0,100,30
1713342056634,PSYC 172,A00,494192,Gorman; Michael R.,36,0,45,9
1713342057661,PSYC 178,A00,494193,Glaser; Dale,33,0,45,12
1713342058691,PSYC 193,A00,505725,Chapman; Eddie Nathaniel,20,0,20,0
1713342059721,RELI 145GS,A00,519817,Rahimi; Babak,17,0,20,3
1713342060749,SE 101A,A01,490862,Chadha; Mayank,23,0,25,2
1713342061774,SE 101C,A01,490924,Krysl; Petr,15,0,20,5
1713342062803,SE 110A,A01,490928,Staff,19,0,20,1
1713342063829,SE 130A,A00,490929,Morrison; Machel Leigh,54,0,70,16
1713342064856,SIO 1,A01,519325,Staff,39,0,40,1
1713342065879,SIO 30,A01,519327,Staff,38,0,40,2
1713342066905,SIO 40,A00,519328,Staff,39,0,40,1
1713342067934,SIO 46GS,A00,519819,Cook; Geoffrey W,15,0,25,10
1713342068960,SIO 109R,A00,494197,Forman; Fonna,0,3,20,20
1713342069991,SIO 121GS,A00,519827,Cook; Geoffrey W,15,0,25,10
1713342071021,SIO 132,A01,519330,Staff,38,0,40,2
1713342072101,SIO 133,A01,519397,Staff,37,0,40,3
1713342073127,SIO 139,A00,519396,Kacev; David,29,0,40,11
1713342074153,SOCI 1,A01,494199,Thorpe; Charles Robert,21,0,30,9
1713342074153,SOCI 1,A02,494200,Thorpe; Charles Robert,30,0,30,0
1713342074153,SOCI 1,A03,494201,Thorpe; Charles Robert,29,0,30,1
1713342074153,SOCI 1,A04,494202,Thorpe; Charles Robert,29,0,30,1
1713342074153,SOCI 1,A05,494203,Thorpe; Charles Robert,29,0,30,1
1713342074153,SOCI 1,A06,494204,Thorpe; Charles Robert,30,0,30,0
1713342074153,SOCI 1,A07,494205,Thorpe; Charles Robert,28,0,30,2
1713342075184,SOCI 60,A01,494207,Staff,33,0,40,7
1713342075184,SOCI 60,A02,494208,Staff,39,0,40,1
1713342076208,SOCI 100,A01,494210,Payne; Christine Anna,25,0,30,5
1713342076208,SOCI 100,A02,494211,Payne; Christine Anna,26,0,30,4
1713342077235,SOCI 109M,A00,494212,Staff,20,0,20,0
1713342078260,SOCI 110,A00,494213,Staff,34,0,40,6
1713342080317,SOCI 118E,A00,494215,Ng; Kwai,37,0,40,3
1713342081349,SOCI 125,A00,494216,Calderon-Zaks; Michael Aar,39,0,45,6
1713342082375,SOCI 126,A01,494218,Jones; Makeba,3,0,5,2
1713342083401,SOCI 131,A00,494219,Thorpe; Charles Robert,26,0,30,4
1713342085453,SOCI 135,A00,494221,Payne; Christine Anna,28,0,50,22
1713342086485,SOCI 136E,A00,626690,Ruiz; Jonathan Joseph,24,0,25,1
1713342087511,SOCI 138GS,A00,494222,Navon; Daniel,23,0,28,5
1713342089566,SOCI 145,A00,494224,Staff,40,0,45,5
1713342090593,SOCI 153,A00,494225,Staff,28,0,30,2
1713342091622,SOCI 160E,A00,494226,Ng; Kwai,27,0,40,13
1713342092651,SOCI 180,A00,494227,Staff,29,0,30,1
1713342093683,SOCI 189GS,A00,494228,Ribas Norris; Janet Vanesa,11,0,11,0
1713342094710,SOCI 190GS,A00,553232,Ribas Norris; Janet Vanesa,11,0,11,0
1713342095737,SOMI 220,A00,627178,Schneid; Stephen David,30,0,30,0
1713342096769,SYN 2,001,490768,Staff,13,0,15,2
1713342096769,SYN 2,002,490769,Staff,14,0,15,1
1713342096769,SYN 2,004,490775,Staff,0,0,0,0
1713342096769,SYN 2,003,490774,Staff,0,0,0,0
1713342096769,SYN 2,005,490776,Staff,0,0,0,0
1713342097802,SYN 2R,001,490779,Staff,11,0,15,4
1713342097802,SYN 2R,002,514635,Staff,14,0,15,1
1713342098834,SYN 100,A01,490783,Staff,8,0,20,12
1713342098834,SYN 100,B01,490787,Staff,10,0,20,10
1713342098834,SYN 100,C01,490789,Staff,10,0,20,10
1713342099859,SYN 150,A00,490817,Staff,14,0,15,1
1713342099859,SYN 150,B00,514610,Staff,15,0,15,0
1713342100889,TDAC 1,A00,492753,Walsh; Kim C.,19,0,20,1
1713342100889,TDAC 1,B00,492754,Harting; Carla Kelso,18,0,20,2
1713342100889,TDAC 1,C00,513995,Salovey; Todd,15,0,20,5
1713342101918,TDAC 101,A00,492766,Harting; Carla Kelso,17,0,20,3
1713342102950,TDAC 102,A00,492768,Basso; Beatrice,19,0,20,1
1713342103980,TDDE 111,A00,492769,Staff,25,0,25,0
1713342105007,TDDE 131,A00,492770,Staff,15,0,15,0
1713342105007,TDDE 131,B00,492771,Staff,15,0,15,0
1713342106033,TDDE 131GS,A00,523716,Guirguis; Mark C,23,0,28,5
1713342107060,TDGE 1,A01,492756,Salovey; Todd,56,0,60,4
1713342108086,TDGE 5,A01,492758,Staff,23,0,25,2
1713342109113,TDGE 10,A00,492759,Fulton; Julia,203,0,220,17
1713342110142,TDGE 11,A00,492760,Castro; Robert Jess,198,0,200,2
1713342112197,TDGE 124,A00,492772,Fulton; Julia,180,0,220,40
1713342113232,TDGE 125,A00,492773,Meyer; Ursula,38,0,50,12
1713342113232,TDGE 125,B00,492774,Staff,49,0,50,1
1713342113232,TDGE 125,C00,523565,Staff,48,0,50,2
1713342114259,TDGE 125GS,A00,523580,Guirguis; Mark C,23,0,28,5
1713342115286,TDGE 127,A00,492775,Havis; Allan,32,0,50,18
1713342116313,TDHT 101,A00,492776,Staff,34,0,35,1
1713342117350,TDMV 1,A00,492762,Caligagan; Maria T.,29,0,30,1
1713342117350,TDMV 1,B00,492763,Arcidiacono; Kristin,26,0,30,4
1713342118378,TDMV 2,A00,492764,Weinberg; Sadie,27,0,30,3
1713342119410,TDMV 3,A00,492765,Mack; Kara Shanai',37,0,40,3
1713342120436,TDMV 138,A00,492777,Mack; Kara Shanai',32,0,40,8
1713342121468,TDMV 140,A00,492778,Lima; Paulo Henrique,40,0,40,0
1713342122501,TDMV 142,A00,492779,Caligagan; Maria T.,33,0,40,7
1713342122501,TDMV 142,B00,492780,Caligagan; Tony,37,0,40,3
1713342123529,TDMV 143,A00,492781,Fyall; Daunte Edward,39,0,40,1
1713342124555,USP 1,A01,492401,Kwak; Nancy,27,0,35,8
1713342125582,USP 2,A01,492453,Hinds; Juli Beth,35,0,35,0
1713342126612,USP 3,A01,492516,Staff,28,0,35,7
1713342127640,USP 4,A00,492522,McTague; Sarah,16,0,25,9
1713342128665,USP 100,A00,492523,Staff,32,0,35,3
1713342129691,USP 101,A00,492524,Staff,13,0,15,2
1713342130721,USP 105,A00,492525,Staff,21,0,25,4
1713342131752,USP 151,A00,492526,Shenkman; Michael Thomas,32,0,35,3
1713342132778,USP 170,A00,492545,Hinds; Juli Beth,33,0,35,2
1713342133808,USP 171GS,A00,492608,Bussell; Mirle Rabinowitz,24,0,28,4
1713342134833,USP 183GS,A00,492613,Peerson; Susan,24,0,28,4
1713342135859,VIS 30,A01,490693,Yoldas; Pinar,19,0,22,3
1713342135859,VIS 30,A02,490694,Yoldas; Pinar,18,0,22,4
1713342136892,VIS 83,A00,490695,Kester; Grant,63,0,75,12
1713342137921,VIS 105D,A00,490696,Staff,22,0,25,3
1713342138948,VIS 124CN,A00,490699,Rose; Jordan M,64,0,75,11
1713342139973,VIS 125GS,A00,511221,Williams; Alena J,21,0,22,1
1713342141003,VIS 128D,A00,490700,Staff,73,0,75,2
1713342142029,VIS 151,A01,490717,Staff,33,0,34,1
1713342142029,VIS 151,A02,490766,Staff,33,0,34,1
1713342143056,VIS 154GS,A00,511972,Williams; Alena J,21,0,22,1
1713342144087,VIS 160A,A00,490767,Stone; Patricia,7,0,10,3
1713342145113,WCWP 10A,A00,490638,Staff,14,0,15,1
1713342145113,WCWP 10A,B00,490640,Staff,15,0,15,0
1713342146144,WCWP 10B,A00,490641,Staff,0,0,0,0
1713342146144,WCWP 10B,B00,490642,Staff,14,0,15,1
1713342146144,WCWP 10B,C00,490644,Staff,13,0,15,2
1713342146144,WCWP 10B,D00,490647,Staff,0,0,0,0
1713342147172,WCWP 100,A00,490655,Staff,0,0,0,0
1713342147172,WCWP 100,B00,490687,Staff,10,0,15,5
1713342149284,ANAR 153,A00,487222,Braswell; Geoffrey E.,53,0,60,7
1713342150313,ANBI 134,A00,487223,Staff,5,0,20,15
1713342151339,ANBI 143GS,A00,487224,Noel; Geoffroy Pierre Jean,18,0,24,6
1713342152365,ANBI 144GS,A00,519548,Noel; Geoffroy Pierre Jean,18,0,24,6
1713342153396,ANSC 101,A00,487225,Staff,17,0,20,3
1713342154422,ANSC 125,A00,487227,Brenner; Suzanne A,38,0,40,2
1713342156474,ANSC 146,A00,487229,Staff,35,0,40,5
1713342157499,ANSC 148,A00,487230,Olivas Hernandez; Olga Lid,39,0,40,1
1713342158536,ANSC 150,A00,504165,Sloane; Julia Kathryn,18,0,20,2
1713342159560,ANSC 180,A00,487232,Staff,14,0,15,1
1713342160586,ANSC 188,A00,627155,Staff,37,0,40,3
1713342161611,ANTH 5,A00,519529,Semendeferi; Ekaterini,15,0,15,0
1713342162640,ANTH 10,A00,487219,Staff,58,0,60,2
1713342163665,ANTH 23,A01,487221,Staff,17,0,20,3
1713342164697,ANTH 102,A00,487233,Wilder; Linnea Lorene,50,0,60,10
1713342165722,ANTH 103,A00,487234,Varma; Saiba,54,0,60,6
1713342166749,ANTH 105,A00,487235,Stewart; Alexander B,54,0,60,6
1713342167775,BENG 100,A01,516685,Taylor Amos; Alyssa C,25,0,30,5
1713342168807,BIBC 102,A01,491316,Flagg; Matthew Paul,5,0,88,83
1713342168807,BIBC 102,A02,491366,Flagg; Matthew Paul,78,0,88,10
1713342169834,BIBC 103,A01,491486,Boumechache; Miyyada,16,0,24,8
1713342169834,BIBC 103,A02,491487,Boumechache; Miyyada,24,0,24,0
1713342170868,BICD 100,A01,516882,Staff,73,0,75,2
1713342170868,BICD 100,A02,516890,Staff,69,0,75,6
1713342171893,BICD 102GS,A00,491488,Lo; Stanley M.,26,0,28,2
1713342172926,BIEB 136GS,A00,516940,Holway; David A. & Shurin; Jonathan,18,0,24,6
1713342173951,BIEB 137GS,A01,517034,Holway; David A. & Shurin; Jonathan,18,0,24,6
1713342174977,BIEB 138GS,A01,491492,Pirino; Giorgia,21,0,28,7
1713342176060,BILD 1,A01,491296,Staff,60,0,63,3
1713342176060,BILD 1,A02,491297,Staff,63,0,63,0
1713342177087,BILD 4,A01,517099,Gonzalez Gamboa; Ivonne,22,0,24,2
1713342177087,BILD 4,A02,517100,Gonzalez Gamboa; Ivonne,24,0,24,0
1713342178116,BILD 60GS,A00,491309,Lo; Stanley M.,26,0,28,2
1713342179142,BIMM 100,A01,517136,Staff,82,0,100,18
1713342180175,BIMM 110,A01,517182,Staff,52,0,100,48
1713342181203,BIMM 120,A01,517228,Pickett; Brooke Elizabeth,28,0,63,35
1713342181203,BIMM 120,A02,517240,Pickett; Brooke Elizabeth,44,0,63,19
1713342182230,BIMM 132GS,A01,491498,Pirino; Giorgia,21,0,28,7
1713342183256,BIMM 143,A01,491589,Bozinovic; Goran,12,0,40,28
1713342184289,BIPN 100,A01,491594,Armour; Jon Christopher,83,0,100,17
1713342185316,BIPN 140,A01,491602,Marino; Marc J,23,0,50,27
1713342187372,CAT 125,A00,515973,Staff,18,0,20,2
1713342188399,CAT 125GS,A00,515974,Rahimi; Babak,16,0,20,4
1713342189434,CAT 125R,A00,515980,Staff,12,0,20,8
1713342189434,CAT 125R,B00,515981,Tosun; Adriana,19,0,20,1
1713342189434,CAT 125R,C00,515987,Hyland; Tina Mae,0,5,20,20
1713342189434,CAT 125R,D00,515988,Bronstein; Phoebe Malan,16,0,20,4
1713342190461,CENG 15,A01,488699,Drews; Aaron,25,0,25,0
1713342191497,CENG 100,A00,505196,Opatkiewicz; Justin Paul,25,0,25,0
1713342192527,CGS 2A,A01,489598,Staff,32,0,35,3
1713342193556,CGS 112,A00,489599,Staff,15,0,15,0
1713342194584,CGS 119,A00,489603,Staff,10,0,10,0
1713342195609,CGS 120,A00,489604,Staff,13,0,15,2
1713342196634,CGS 150,A00,489607,Staff,15,0,15,0
1713342197665,CHEM 6A,A01,488715,Staff,97,0,100,3
1713342198692,CHEM 6B,A01,488719,Piercy; Marc Anthony,99,0,100,1
1713342199722,CHEM 6C,A01,488723,Albizati; Kim F.,93,0,100,7
1713342200769,CHEM 7L,A01,488728,Schurmeier; Kimberly,18,0,24,6
1713342200769,CHEM 7L,A02,488730,Schurmeier; Kimberly,23,0,24,1
1713342200769,CHEM 7L,A03,488734,Schurmeier; Kimberly,20,0,24,4
1713342200769,CHEM 7L,A04,488763,Schurmeier; Kimberly,23,0,24,1
1713342200769,CHEM 7L,B01,488798,Schurmeier; Kimberly,16,0,24,8
1713342200769,CHEM 7L,B02,488801,Schurmeier; Kimberly,22,0,24,2
1713342200769,CHEM 7L,B03,488808,Schurmeier; Kimberly,22,0,24,2
1713342200769,CHEM 7L,B04,488811,Schurmeier; Kimberly,24,0,24,0
1713342201794,CHEM 11,A01,488897,Stallings; Dontarie M,94,0,100,6
1713342202826,CHEM 40A,A01,488913,Albizati; Kim F.,83,0,100,17
1713342203859,CHEM 40B,A01,488920,Weizman; Haim,42,0,50,8
1713342203859,CHEM 40B,A02,488938,Weizman; Haim,43,0,50,7
1713342204887,CHEM 41A,A01,489029,Klosterman; Jeremy K,57,0,60,3
1713342205914,CHEM 41C,A01,500436,Tor; Yitzhak,54,0,60,6
1713342206951,CHEM 43A,A01,500426,Weizman; Haim,0,1,24,24
1713342206951,CHEM 43A,A02,500430,Weizman; Haim,6,0,24,18
1713342206951,CHEM 43A,B01,514041,Klosterman; Jeremy K,14,0,24,10
1713342206951,CHEM 43A,B02,514047,Klosterman; Jeremy K,23,0,24,1
1713342207983,CHEM 108,A01,489140,Jennings; Patricia A.,6,0,24,18
1713342207983,CHEM 108,A02,489142,Jennings; Patricia A.,14,0,24,10
1713342209010,CHEM 114A,A01,489147,Stallings; Dontarie M,65,0,100,35
1713342210042,CHIN 169A,A00,489171,Wang; Xiao,19,0,20,1
1713342212097,COGS 3,A01,518827,Boyle; Mary E. T.,25,0,40,15
1713342213127,COGS 11,A01,489175,Staff,27,0,30,3
1713342214152,COGS 14A,A01,518829,Staff,50,0,60,10
1713342215185,COGS 14B,A01,489177,Hoffman; Drew Ellen,62,0,75,13
1713342216210,COGS 100,A01,489181,Allen; Michael Gordon,62,0,75,13
1713342217236,COGS 101A,A01,489183,Staff,45,0,60,15
1713342218261,COGS 101B,A01,489185,Allen; Michael Gordon,6,0,30,24
1713342219287,COGS 101C,A01,526786,Staff,23,0,30,7
1713342221342,COGS 107A,A01,489189,Boyle; Mary E. T.,16,0,35,19
1713342222371,COGS 107B,A01,627144,Mooshagian; Eric Frederick,59,0,60,1
1713342223397,COGS 118A,A01,489191,Staff,0,46,40,40
1713342225453,COGS 171GS,A01,489194,Pineda; Jaime A,19,0,28,9
1713342226479,COGS 172,A01,489196,Staff,1,0,30,29
1713342227507,COGS 174GS,A01,489264,Pineda; Jaime A,19,0,28,9
1713342228531,COGS 180,A01,627150,Staff,28,0,30,2
1713342229557,COGS 186,A01,489274,Staff,0,2,30,30
1713342230585,COMM 10,A01,489276,Staff,23,0,25,2
1713342230585,COMM 10,A02,489303,Staff,23,0,25,2
1713342231618,COMM 100A,A01,489312,Staff,14,0,25,11
1713342231618,COMM 100A,A02,489313,Staff,24,0,25,1
1713342232642,COMM 106T,A00,512540,Staff,33,0,35,2
1713342233668,COMM 107,A00,489347,Staff,27,0,35,8
1713342234696,COMM 109P,A00,489358,Staff,31,0,35,4
1713342235727,COMM 132,A00,489361,McKenna; Denise,27,0,30,3
1713342236757,COMM 146,A00,489362,Halm; Gavin Patrick,26,0,30,4
1713342237784,COMM 190,A00,489363,Abuelhiga; Soraya Jill,17,0,23,6
1713342238810,CSE 8A,A50,489366,Staff,21,0,25,4
1713342238810,CSE 8A,A51,489367,Staff,24,0,25,1
1713342239837,CSE 11,A01,489398,Cao; Yingjun,72,0,100,28
1713342240874,CSE 12,A01,489487,Staff,43,0,50,7
1713342241901,CSE 20,A01,489497,Staff,47,0,50,3
1713342242925,CSE 21,A01,489517,Braun; Oliver,42,0,50,8
1713342243951,CSE 101,A01,489524,Braun; Oliver,0,33,50,50
1713342244978,CSE 105,A01,512594,Jones; Miles E,72,0,100,28
1713342244978,CSE 105,B01,512598,Jones; Miles E,51,0,100,49
1713342246009,CSE 140,A01,489538,Staff,40,0,50,10
1713342247038,CSE 141,A01,489550,Eldon; John,67,0,100,33
1713342248067,CSE 141L,A01,489571,Eldon; John,65,0,100,35
1713342249097,CSE 151A,A01,489583,Solares; Edwin A,140,0,200,60
1713342250124,CSE 175,A01,510886,Kumar; Rakesh,30,0,30,0
1713342251151,CSE 190,A00,516828,Dubnov; Shlomo,37,0,49,12
1713342252180,DOC 100D,A00,489667,Pass; Natalye Joann,19,0,25,6
1713342253207,DSC 10,A01,624268,Staff,72,0,75,3
1713342254232,DSC 20,A01,624476,Staff,50,0,50,0
1713342255263,DSC 40A,A01,624608,Staff,39,0,40,1
1713342256290,DSGN 1,A01,489179,Rill; Bryan,32,0,50,18
1713342257315,ECE 17,A01,490489,Sahay; Rajeev,18,0,30,12
1713342258342,ECE 65,A50,490492,Staff,11,0,20,9
1713342258342,ECE 65,A51,490493,Staff,18,0,20,2
1713342259368,ECON 1,A01,489715,Famulari; Melissa,67,0,70,3
1713342260400,ECON 2,A01,489717,Levkoff; Steven B.,67,0,70,3
1713342261426,ECON 3,A01,489948,Staff,70,0,70,0
1713342263493,ECON 5,A01,490103,Staff,27,0,30,3
1713342263493,ECON 5,B01,626281,Dai; Yinlin,45,0,45,0
1713342264519,ECON 100A,A01,490127,Famulari; Melissa,62,0,70,8
1713342265549,ECON 100B,A01,490129,Staff,64,0,70,6
1713342266576,ECON 109,A01,490187,Shishkin; Denis,27,0,35,8
1713342267607,ECON 110A,A01,490190,Levkoff; Steven B.,59,0,70,11
1713342268640,ECON 120A,A01,490245,Dai; Yinlin,59,0,70,11
1713342269667,ECON 120B,A01,490247,Nieto-Barthaburu; Augusto,40,0,70,30
1713342270713,ECON 120C,A01,490253,Sun; Yixiao,30,0,35,5
1713342270713,ECON 120C,B01,490255,Sun; Yixiao,34,0,35,1
1713342271744,ECON 129,A00,490256,Eckert; Fabian Paul,22,0,35,13
1713342272770,ECON 131,A00,490257,Nieto-Barthaburu; Augusto,0,6,35,35
1713342273798,ECON 138,A00,490258,Bharadwaj; Prashant,13,0,35,22
1713342273798,ECON 138,B00,490259,Bharadwaj; Prashant,15,0,35,20
1713342274823,ECON 159,A00,490260,Hendrickson; Gerald M.,0,9,0,0
1713342275871,ECON 178,A01,553995,Zhu; Ying,24,0,35,11
1713342276905,EDS 40,A01,512576,Black; Alison Michelle,20,0,20,0
1713342277936,EDS 107,A01,515848,Staff,30,0,30,0
1713342278966,EDS 110R,A01,490262,Staff,26,0,30,4
1713342280049,EDS 112,A01,490264,Chapman; Thandeka K,40,0,50,10
1713342281080,EDS 113,A00,490266,Staff,25,0,30,5
1713342282105,EDS 118,A00,490267,Warstadt; Melissa Fawn,18,0,30,12
1713342283130,EDS 124BR,A00,490268,Eguchi; Emi,4,0,25,21
1713342283130,EDS 124BR,B00,490269,Eguchi; Emi,23,0,25,2
1713342284157,EDS 126,A01,490271,Jones; Makeba,43,0,50,7
1713342285186,EDS 135,A01,490316,Staff,19,0,20,1
1713342286217,ENVR 142GS,A00,519514,Chang; Edmond Yi-Teh,26,0,28,2
1713342287242,ETHN 103,A00,490504,Staff,25,0,36,11
1713342288275,ETHN 103A,A00,490505,Man; Simeon S,3,0,9,6
1713342289307,ETHN 109,A00,490506,Staff,28,0,30,2
1713342290338,ETHN 118,A00,490507,Staff,35,0,36,1
1713342291364,ETHN 119,A00,490508,Staff,32,0,36,4
1713342292395,ETHN 121R,A00,490518,Choi; Esther Min,21,0,36,15
1713342293424,ETHN 127,A00,490528,Staff,14,0,15,1
1713342294454,ETHN 139,A00,490573,Staff,10,0,10,0
1713342295478,ETHN 150,A00,490575,Staff,15,0,15,0
1713342296510,GLBH 20,A00,491705,Elwardani; Nile Regina,38,0,40,2
1713342297535,GLBH 101,A00,491706,Staff,20,0,20,0
1713342298561,GLBH 111,A01,491708,Burgos; Jose L.,15,0,15,0
1713342299587,GLBH 146,A00,491709,Staff,8,0,20,12
1713342300618,GLBH 148,A00,491710,Olivas Hernandez; Olga Lid,10,0,20,10
1713342301652,GLBH 150,A00,491711,Sloane; Julia Kathryn,19,0,20,1
1713342302680,HIEA 131,A00,491760,Staff,28,0,32,4
1713342303710,HIEA 153,A00,491762,Staff,28,0,30,2
1713342304739,HIEU 124,A00,491811,Staff,26,0,32,6
1713342305764,HIEU 124GS,A00,491812,Markman; Kristina,27,0,28,1
1713342306790,HIEU 147,A00,491813,Staff,30,0,32,2
1713342307816,HIEU 149GS,A00,491816,Caldwell; Michael Alan,28,0,28,0
1713342308841,HILD 2C,A01,491713,Hendrickson; Gerald M.,26,0,30,4
1713342309870,HILD 7B,A01,491715,Kwak; Nancy,0,2,30,30
1713342310894,HILD 10,A01,491717,Staff,9,0,20,11
1713342311919,HILD 30GS,A00,491719,Edington; Claire Ellen,23,0,28,5
1713342312945,HINE 109,A00,491818,Shafir; Nir,26,0,32,6
1713342313971,HINE 128,A00,491821,Shafir; Nir,30,0,32,2
1713342314997,HISC 117,A00,491830,Staff,27,0,32,5
1713342316023,HIUS 103,A00,491834,Man; Simeon S,14,0,23,9
1713342317052,HIUS 108B,A00,491835,Staff,27,0,30,3
1713342318079,HIUS 141,A00,491836,Hendrickson; Gerald M.,28,0,32,4
1713342319110,HIUS 149,A00,491839,Staff,24,0,32,8
1713342320138,HUM 3,A01,512617,Crum; Matthew Stephen,42,0,50,8
1713342320138,HUM 3,A02,512618,Crum; Matthew Stephen,48,0,50,2
1713342321164,HUM 3GS,A00,512663,Markman; Kristina,0,0,0,1
1713342321164,HUM 3GS,B00,512664,Staff,0,0,0,0
1713342322191,HUM 4,A01,512620,West; Geoffrey Scott,24,0,50,26
1713342323226,HUM 4GS,A00,512666,Lyon; Antony J.,0,0,0,5
1713342324254,HUM 4R,A01,512625,Watkins; Eric,49,0,50,1
1713342325922,HUM 5,A01,512649,Zavodny; Tatiana Sophia,20,0,50,30
1713342325922,HUM 5,B01,512661,Zroka; Ryan Edward,48,0,50,2
1713342326954,INTL 190,A00,490577,Segui; Alan S,0,0,0,5
1713342327991,JAPN 20AR,A01,491267,Ross; Kayoko F,7,0,20,13
1713342329020,JAPN 180,A00,491285,Berman; Michael David,33,0,40,7
1713342330051,LATI 50,A01,502536,Kokinis; Troy Andreas,16,0,22,6
1713342330051,LATI 50,A02,502551,Kokinis; Troy Andreas,22,0,22,0
1713342330051,LATI 50,A03,502650,Kokinis; Troy Andreas,22,0,22,0
1713342330051,LATI 50,A04,502909,Kokinis; Troy Andreas,21,0,22,1
1713342331077,LATI 160,A01,502920,Kokinis; Troy Andreas,30,0,30,0
1713342332110,LIFR 1A,A00,490494,Van Moer; Vinciane G,17,0,20,3
1713342333135,LIFR 1AX,A00,490495,Van Moer; Vinciane G,17,0,20,3
1713342334160,LIFR 1B,A00,490496,Van Moer; Vinciane G,17,0,20,3
1713342335186,LIFR 1BX,A00,490497,Van Moer; Vinciane G,17,0,20,3
1713342336218,LIGN 8,A00,505198,McIntosh; Justin Daniel,134,0,150,16
1713342337249,LIGN 9GS,A00,491239,Lott; Margaret S.,18,0,20,2
1713342338275,LIGN 101,A01,505200,McIntosh; Justin Daniel,22,0,30,8
1713342339302,LIGN 120,A01,491244,Staff,22,0,30,8
1713342340333,LIGN 149GS,A00,491245,Lott; Margaret S.,18,0,20,2
1713342341362,LIGN 170,A00,491247,Staff,22,0,30,8
1713342342391,LISP 1D,A00,490498,Munoz Sanchez; Alicia,8,0,14,6
1713342342391,LISP 1D,B00,490499,Munoz Sanchez; Alicia,4,0,14,10
1713342342391,LISP 1D,C00,490500,Munoz Sanchez; Alicia,7,0,14,7
1713342342391,LISP 1D,D00,490501,Munoz Sanchez; Alicia,10,0,14,4
1713342343419,LISP 1DX,A00,490502,Munoz Sanchez; Alicia,11,0,28,17
1713342343419,LISP 1DX,B00,490503,Munoz Sanchez; Alicia,16,0,28,12
1713342345476,LTAM 110,A00,491847,Staff,22,0,25,3
1713342346501,LTCS 119,A00,491848,Staff,11,0,15,4
1713342347526,LTCS 130,A00,491849,Staff,24,0,25,1
1713342350159,LTEA 120C,A00,491852,Staff,32,0,40,8
1713342351188,LTEN 130GS,A00,491853,Lyon; Antony J.,23,0,28,5
1713342352214,LTEN 148,A00,491855,Staff,23,0,25,2
1713342353238,LTEN 159,A00,491856,Staff,20,0,25,5
1713342354263,LTEN 180,A00,491857,Staff,8,0,15,7
1713342356313,LTSP 123GS,A00,505928,Bessett; Ryan Matthew,24,0,28,4
1713342357344,LTSP 174GS,A00,506037,Bessett; Ryan Matthew,24,0,28,4
1713342359399,LTWR 102,A00,491861,Staff,9,0,15,6
1713342360428,LTWR 106,A00,491862,Staff,8,0,15,7
1713342361456,MAE 11,A00,490930,Bahadori; Mohammad Yousef,94,0,100,6
1713342362490,MAE 30A,A00,490931,Qi; Huihui,37,0,40,3
1713342363520,MAE 101A,A00,491036,Sadeghizadeh; Zahra,91,0,100,9
1713342364554,MAE 101C,A00,491037,Seshadri; Kalyanasundaram,63,0,100,37
1713342365579,MAE 113,A00,491040,Seshadri; Kalyanasundaram,64,0,80,16
1713342366610,MAE 131A,A00,491041,Ghazinejad; Maziar,37,0,40,3
1713342367635,MAE 142,A00,491053,Staff,39,0,40,1
1713342368660,MAE 143A,A00,491054,Staff,29,0,50,21
1713342369692,MAE 150,A00,491092,Truong; Phuong Thi Ngoc,23,0,35,12
1713342370726,MATH 3C,A01,494031,Pardo Guerra; Sebastian,30,0,30,0
1713342370726,MATH 3C,A02,494032,Pardo Guerra; Sebastian,29,0,30,1
1713342371752,MATH 10A,A01,494034,Staff,27,0,30,3
1713342371752,MATH 10A,A02,494035,Staff,28,0,30,2
1713342371752,MATH 10A,B01,494037,Staff,27,0,30,3
1713342371752,MATH 10A,B02,494038,Staff,29,0,30,1
1713342372791,MATH 10B,A01,494040,Habib; Yousaf,22,0,30,8
1713342372791,MATH 10B,A02,494041,Habib; Yousaf,28,0,30,2
1713342372791,MATH 10B,A03,494042,Habib; Yousaf,29,0,30,1
1713342372791,MATH 10B,A04,494043,Habib; Yousaf,30,0,30,0
1713342372791,MATH 10B,B01,494045,Habib; Yousaf,25,0,30,5
1713342372791,MATH 10B,B02,494046,Habib; Yousaf,30,0,30,0
1713342372791,MATH 10B,B03,494047,Habib; Yousaf,30,0,30,0
1713342372791,MATH 10B,B04,494048,Habib; Yousaf,30,0,30,0
1713342373819,MATH 18,A01,494050,Kemp; Todd Aahron,25,0,30,5
1713342373819,MATH 18,A02,494051,Kemp; Todd Aahron,29,0,30,1
1713342373819,MATH 18,B01,494054,Kemp; Todd Aahron,25,0,30,5
1713342373819,MATH 18,B02,494055,Kemp; Todd Aahron,29,0,30,1
1713342374847,MATH 20A,A01,494059,Suk; Andrew Hoon,30,0,30,0
1713342375881,MATH 20B,A01,494061,Briones; Jor-el Thomas Caparas,33,0,35,2
1713342375881,MATH 20B,B01,494063,Bach; Quang Tran,34,0,35,1
1713342376915,MATH 20C,A01,494065,Staff,28,0,30,2
1713342376915,MATH 20C,A02,494066,Staff,30,0,30,0
1713342376915,MATH 20C,A03,494067,Staff,30,0,30,0
1713342376915,MATH 20C,A04,494068,Staff,30,0,30,0
1713342376915,MATH 20C,B01,494070,Zhang; Ming,24,0,30,6
1713342376915,MATH 20C,B02,494071,Zhang; Ming,27,0,30,3
1713342376915,MATH 20C,B03,494072,Zhang; Ming,29,0,30,1
1713342376915,MATH 20C,B04,494073,Zhang; Ming,29,0,30,1
1713342377945,MATH 20D,A01,494075,Staff,22,0,30,8
1713342377945,MATH 20D,A02,494076,Staff,29,0,30,1
1713342378973,MATH 20E,A01,494079,Staff,24,0,30,6
1713342378973,MATH 20E,A02,494080,Staff,26,0,30,4
1713342378973,MATH 20E,B01,494082,Staff,25,0,30,5
1713342378973,MATH 20E,B02,494083,Staff,25,0,30,5
1713342380007,MATH 103A,A01,494085,Aliabadi Sr.; Mohsen,12,0,30,18
1713342380007,MATH 103A,A02,494086,Aliabadi Sr.; Mohsen,28,0,30,2
1713342380007,MATH 103A,B01,494088,Aliabadi Sr.; Mohsen,20,0,30,10
1713342380007,MATH 103A,B02,494089,Aliabadi Sr.; Mohsen,27,0,30,3
1713342381034,MATH 109,A01,494091,Staff,30,0,30,0
1713342381034,MATH 109,A02,494092,Staff,29,0,30,1
1713342381034,MATH 109,B01,494094,Staff,27,0,30,3
1713342381034,MATH 109,B02,494095,Staff,29,0,30,1
1713342382065,MATH 142A,A01,494097,Chow; Bennett,13,0,30,17
1713342382065,MATH 142A,A02,494098,Chow; Bennett,23,0,30,7
1713342382065,MATH 142A,B01,494100,Chow; Bennett,19,0,30,11
1713342382065,MATH 142A,B02,494101,Chow; Bennett,29,0,30,1
1713342384120,MATH 168A,A01,516677,Dumitriu; Ioana,16,0,35,19
1713342385210,MATH 170A,A01,516679,Dumitriu; Ioana,18,0,30,12
1713342385210,MATH 170A,A02,516680,Dumitriu; Ioana,28,0,30,2
1713342386236,MATH 193A,A01,494107,Staff,12,0,30,18
1713342386236,MATH 193A,A02,494108,Staff,18,0,30,12
1713342386236,MATH 193A,A03,494109,Staff,29,0,30,1
1713342386236,MATH 193A,A04,494110,Staff,22,0,30,8
1713342389318,MGT 16,A00,491930,McKay; Michael J,92,0,98,6
1713342390344,MGT 18,A00,491992,McKay; Michael J,96,0,98,2
1713342391369,MGT 71,A00,492003,Staff,63,0,98,35
1713342392399,MGT 103,A00,505209,Eberhard; Craig A,80,0,98,18
1713342393426,MGT 131A,A00,505210,Anderson; John Charles,89,0,98,9
1713342395479,MGT 153,A00,492077,Perols; Johan Lars,16,0,90,74
1713342398567,MGT 164,A00,492222,McKay; Mary A,91,0,98,7
1713342399594,MGT 172,A00,492245,Staff,59,0,60,1
1713342399594,MGT 172,B00,505526,Hedges; Kathleen,65,0,98,33
1713342400624,MGT 181,A00,505669,Dunn; Louis Jean,78,0,98,20
1713342401652,MMW 14,A01,494399,Staff,15,0,28,13
1713342401652,MMW 14,A02,494400,Staff,25,0,28,3
1713342401652,MMW 14,A03,494401,Staff,28,0,28,0
1713342401652,MMW 14,A04,494402,Staff,28,0,28,0
1713342401652,MMW 14,B01,494404,Carreras; Maria Victoria,8,0,28,20
1713342401652,MMW 14,B02,494405,Carreras; Maria Victoria,25,0,28,3
1713342401652,MMW 14,B03,494406,Carreras; Maria Victoria,27,0,28,1
1713342401652,MMW 14,B04,494407,Carreras; Maria Victoria,28,0,28,0
1713342402691,MMW 14GS,A00,506250,Chang; Edmond Yi-Teh,0,0,0,0
1713342403722,MMW 121R,A01,494415,Adamiak; Patrick John,10,0,28,18
1713342403722,MMW 121R,A02,494416,Adamiak; Patrick John,24,0,28,4
1713342404748,MUS 1A,A01,494113,Staff,12,0,25,13
1713342404748,MUS 1A,A02,494114,Staff,24,0,25,1
1713342405776,MUS 4,A01,494116,Staff,23,0,25,2
1713342405776,MUS 4,A02,494117,Staff,22,0,25,3
1713342406807,MUS 5R,A01,494236,Dubnov; Shlomo,4,0,25,21
1713342406807,MUS 5R,A02,494237,Dubnov; Shlomo,25,0,25,0
1713342407833,MUS 6,A01,494122,Staff,9,0,25,16
1713342407833,MUS 6,A02,494123,Staff,23,0,25,2
1713342408859,MUS 7,A01,494125,Staff,16,0,25,9
1713342408859,MUS 7,A02,494126,Staff,24,0,25,1
1713342409884,MUS 11,A01,494128,Staff,23,0,25,2
1713342409884,MUS 11,A02,494129,Staff,24,0,25,1
1713342410911,MUS 13,A01,494131,Staff,25,0,25,0
1713342410911,MUS 13,A02,494132,Staff,25,0,25,0
1713342411937,MUS 15,A01,494134,Staff,16,0,25,9
1713342411937,MUS 15,A02,494135,Staff,25,0,25,0
1713342411937,MUS 15,B01,494137,Staff,24,0,25,1
1713342412965,MUS 80,A00,494232,Staff,24,0,25,1
1713342412965,MUS 80,B00,494233,Staff,25,0,25,0
1713342412965,MUS 80,C00,494234,Staff,23,0,25,2
1713342413991,MUS 95C,A00,494141,Staff,69,0,75,6
1713342415016,MUS 114,A00,494142,Staff,39,0,50,11
1713342416042,NANO 15,A01,490636,Drews; Aaron,7,0,7,0
1713342417076,PHIL 1,A00,490578,Grush; Rick Scott,49,0,50,1
1713342418102,PHIL 10,A01,490580,Grush; Rick Scott,33,0,35,2
1713342418102,PHIL 10,A02,490586,Grush; Rick Scott,32,0,35,3
1713342419127,PHIL 27,A01,490591,Staff,22,0,25,3
1713342419127,PHIL 27,A02,490592,Staff,25,0,25,0
1713342419127,PHIL 27,A03,490593,Staff,25,0,25,0
1713342419127,PHIL 27,A04,490598,Staff,25,0,25,0
1713342420154,PHIL 32,A01,490611,Staff,20,0,20,0
1713342420154,PHIL 32,A02,490618,Staff,20,0,20,0
1713342421184,PHIL 90,A00,490624,Staff,40,0,40,0
1713342422210,PHIL 136,A00,490627,Cohen; Jonathan David,37,0,40,3
1713342423240,PHIL 155,A00,490634,Staff,62,0,70,8
1713342424268,PHYS 1A,A00,491610,Staff,245,0,250,5
1713342425316,PHYS 1AL,001,491616,Tsai; Philbert S,27,0,30,3
1713342425316,PHYS 1AL,002,491618,Tsai; Philbert S,30,0,30,0
1713342426344,PHYS 1B,A00,491623,Staff,235,0,250,15
1713342427370,PHYS 1BL,001,491626,Tsai; Philbert S,18,0,30,12
1713342427370,PHYS 1BL,002,491628,Tsai; Philbert S,26,0,30,4
1713342428399,PHYS 1C,A00,491632,Staff,212,0,245,33
1713342429424,PHYS 1CL,001,491635,Tsai; Philbert S,3,0,30,27
1713342429424,PHYS 1CL,002,491643,Tsai; Philbert S,22,0,30,8
1713342430456,PHYS 2AR,A01,491651,Meyertholen; Andrew D.,44,0,50,6
1713342431482,PHYS 2B,A01,491659,Staff,105,0,115,10
1713342432506,PHYS 2BL,A01,491685,Staff,21,0,24,3
1713342432506,PHYS 2BL,A02,491700,Staff,21,0,24,3
1713342433537,PHYS 2C,A01,505161,Staff,101,0,115,14
1713342434563,PHYS 4A,A01,491704,Grinstein; Benjamin,99,0,100,1
1713342435597,POLI 5D,A01,494144,Staff,3,0,5,2
1713342435597,POLI 5D,B01,626283,Dai; Yinlin,5,0,5,0
1713342436629,POLI 12,A00,494145,Staff,43,0,45,2
1713342437656,POLI 13R,A00,494146,Forman; Fonna,45,0,50,5
1713342438683,POLI 27,A01,494148,Staff,54,0,60,6
1713342439708,POLI 30,A00,494149,Staff,49,0,50,1
1713342440734,POLI 100DA,A00,494150,Staff,20,0,25,5
1713342442785,POLI 100I,A00,494152,Staff,27,0,30,3
1713342443819,POLI 104B,A00,494153,Smith; Glenn Chatmas,53,0,55,2
1713342444844,POLI 104F,A00,494154,Staff,28,0,30,2
1713342445874,POLI 104I,A00,494155,Smith; Glenn Chatmas,29,0,30,1
1713342446905,POLI 110C,A00,494156,Ingham; Sean,23,0,25,2
1713342447935,POLI 117R,A00,494157,Forman; Fonna,5,0,20,15
1713342448961,POLI 118,A00,494158,Ingham; Sean,21,0,25,4
1713342449989,POLI 120H,A00,494159,Fisk; David Lee,39,0,45,6
1713342451015,POLI 131CR,A00,494160,Hoston; Germaine,35,0,45,10
1713342452045,POLI 133J,A00,494161,Staff,31,0,35,4
1713342453071,POLI 135,A00,494162,Fisk; David Lee,33,0,35,2
1713342454097,POLI 140A,A00,494164,Staff,18,0,30,12
1713342455124,POLI 142I,A00,494165,Staff,30,0,30,0
1713342456148,POLI 144D,A00,494166,Staff,22,0,25,3
1713342457174,POLI 151,A00,494167,Staff,30,0,30,0
1713342458201,POLI 153,A00,494168,Staff,33,0,35,2
1713342459225,POLI 160AA,A00,494169,Staff,33,0,40,7
1713342460252,POLI 162,A00,494170,Mignozzetti; Umberto,18,0,25,7
1713342461278,POLI 171,A00,494171,Mignozzetti; Umberto,18,0,25,7
1713342462303,PSYC 1,A00,494172,Staff,95,0,100,5
1713342463330,PSYC 2,A00,494173,Moranton; Nirelia Melbina-,34,0,50,16
1713342464362,PSYC 3,A00,494174,Staff,29,0,30,1
1713342465387,PSYC 6,A00,494175,Staff,17,0,20,3
1713342466413,PSYC 60,A01,494177,Staff,37,0,45,8
1713342467441,PSYC 70,A01,505724,Geller; Emma Harlan,42,0,45,3
1713342468467,PSYC 101,A00,494180,Heyman; Gail D.,84,0,100,16
1713342469497,PSYC 105,A00,494181,Geller; Emma Harlan,51,0,90,39
1713342470526,PSYC 106,A00,494182,Dobkins; Karen R.,26,0,45,19
1713342471557,PSYC 108,A00,494183,Adrian; Julia Anna,89,0,100,11
1713342472584,PSYC 114,A01,494185,Winkielman; Piotr,0,4,30,30
1713342473610,PSYC 122,A00,494186,Moranton; Nirelia Melbina-,27,0,50,23
1713342474637,PSYC 124,A00,494187,Chapman; Eddie Nathaniel,69,0,80,11
1713342475668,PSYC 131,A00,494188,Anagnostaras; Stephan,40,0,80,40
1713342476697,PSYC 144,A00,494189,Staff,1,1,50,49
1713342477724,PSYC 154,A00,494190,Lacefield; Katharine I,105,0,180,75
1713342478751,PSYC 162,A00,494191,Wixted; John T,70,0,100,30
1713342479778,PSYC 172,A00,494192,Gorman; Michael R.,36,0,45,9
1713342480803,PSYC 178,A00,494193,Glaser; Dale,33,0,45,12
1713342481836,PSYC 193,A00,505725,Chapman; Eddie Nathaniel,20,0,20,0
1713342482862,RELI 145GS,A00,519817,Rahimi; Babak,17,0,20,3
1713342483909,SE 101A,A01,490862,Chadha; Mayank,23,0,25,2
1713342484941,SE 101C,A01,490924,Krysl; Petr,15,0,20,5
1713342485967,SE 110A,A01,490928,Staff,19,0,20,1
1713342486994,SE 130A,A00,490929,Morrison; Machel Leigh,54,0,70,16
1713342488024,SIO 1,A01,519325,Staff,39,0,40,1
1713342489103,SIO 30,A01,519327,Staff,38,0,40,2
1713342490132,SIO 40,A00,519328,Staff,39,0,40,1
1713342491164,SIO 46GS,A00,519819,Cook; Geoffrey W,15,0,25,10
1713342492194,SIO 109R,A00,494197,Forman; Fonna,0,3,20,20
1713342493220,SIO 121GS,A00,519827,Cook; Geoffrey W,15,0,25,10
1713342494245,SIO 132,A01,519330,Staff,38,0,40,2
1713342495270,SIO 133,A01,519397,Staff,37,0,40,3
1713342496297,SIO 139,A00,519396,Kacev; David,29,0,40,11
1713342497323,SOCI 1,A01,494199,Thorpe; Charles Robert,21,0,30,9
1713342497323,SOCI 1,A02,494200,Thorpe; Charles Robert,30,0,30,0
1713342497323,SOCI 1,A03,494201,Thorpe; Charles Robert,29,0,30,1
1713342497323,SOCI 1,A04,494202,Thorpe; Charles Robert,29,0,30,1
1713342497323,SOCI 1,A05,494203,Thorpe; Charles Robert,29,0,30,1
1713342497323,SOCI 1,A06,494204,Thorpe; Charles Robert,30,0,30,0
1713342497323,SOCI 1,A07,494205,Thorpe; Charles Robert,28,0,30,2
1713342498349,SOCI 60,A01,494207,Staff,33,0,40,7
1713342498349,SOCI 60,A02,494208,Staff,39,0,40,1
1713342499375,SOCI 100,A01,494210,Payne; Christine Anna,25,0,30,5
1713342499375,SOCI 100,A02,494211,Payne; Christine Anna,26,0,30,4
1713342500406,SOCI 109M,A00,494212,Staff,20,0,20,0
1713342501432,SOCI 110,A00,494213,Staff,34,0,40,6
1713342503486,SOCI 118E,A00,494215,Ng; Kwai,37,0,40,3
1713342504516,SOCI 125,A00,494216,Calderon-Zaks; Michael Aar,39,0,45,6
1713342505547,SOCI 126,A01,494218,Jones; Makeba,3,0,5,2
1713342506575,SOCI 131,A00,494219,Thorpe; Charles Robert,26,0,30,4
1713342508626,SOCI 135,A00,494221,Payne; Christine Anna,28,0,50,22
1713342509653,SOCI 136E,A00,626690,Ruiz; Jonathan Joseph,24,0,25,1
1713342510682,SOCI 138GS,A00,494222,Navon; Daniel,23,0,28,5
1713342512734,SOCI 145,A00,494224,Staff,40,0,45,5
1713342513763,SOCI 153,A00,494225,Staff,28,0,30,2
1713342514789,SOCI 160E,A00,494226,Ng; Kwai,27,0,40,13
1713342515826,SOCI 180,A00,494227,Staff,29,0,30,1
1713342516851,SOCI 189GS,A00,494228,Ribas Norris; Janet Vanesa,11,0,11,0
1713342517883,SOCI 190GS,A00,553232,Ribas Norris; Janet Vanesa,11,0,11,0
1713342518910,SOMI 220,A00,627178,Schneid; Stephen David,30,0,30,0
1713342519936,SYN 2,001,490768,Staff,13,0,15,2
1713342519936,SYN 2,002,490769,Staff,14,0,15,1
1713342519936,SYN 2,004,490775,Staff,0,0,0,0
1713342519936,SYN 2,003,490774,Staff,0,0,0,0
1713342519936,SYN 2,005,490776,Staff,0,0,0,0
1713342520961,SYN 2R,001,490779,Staff,11,0,15,4
1713342520961,SYN 2R,002,514635,Staff,14,0,15,1
1713342521988,SYN 100,A01,490783,Staff,8,0,20,12
1713342521988,SYN 100,B01,490787,Staff,10,0,20,10
1713342521988,SYN 100,C01,490789,Staff,10,0,20,10
1713342523017,SYN 150,A00,490817,Staff,14,0,15,1
1713342523017,SYN 150,B00,514610,Staff,15,0,15,0
1713342524047,TDAC 1,A00,492753,Walsh; Kim C.,19,0,20,1
1713342524047,TDAC 1,B00,492754,Harting; Carla Kelso,18,0,20,2
1713342524047,TDAC 1,C00,513995,Salovey; Todd,15,0,20,5
1713342525073,TDAC 101,A00,492766,Harting; Carla Kelso,17,0,20,3
1713342526100,TDAC 102,A00,492768,Basso; Beatrice,19,0,20,1
1713342527130,TDDE 111,A00,492769,Staff,25,0,25,0
1713342528155,TDDE 131,A00,492770,Staff,15,0,15,0
1713342528155,TDDE 131,B00,492771,Staff,15,0,15,0
1713342529182,TDDE 131GS,A00,523716,Guirguis; Mark C,23,0,28,5
1713342530214,TDGE 1,A01,492756,Salovey; Todd,56,0,60,4
1713342531242,TDGE 5,A01,492758,Staff,23,0,25,2
1713342532273,TDGE 10,A00,492759,Fulton; Julia,203,0,220,17
1713342533298,TDGE 11,A00,492760,Castro; Robert Jess,198,0,200,2
1713342535362,TDGE 124,A00,492772,Fulton; Julia,180,0,220,40
1713342536392,TDGE 125,A00,492773,Meyer; Ursula,38,0,50,12
1713342536392,TDGE 125,B00,492774,Staff,49,0,50,1
1713342536392,TDGE 125,C00,523565,Staff,48,0,50,2
1713342537415,TDGE 125GS,A00,523580,Guirguis; Mark C,23,0,28,5
1713342538448,TDGE 127,A00,492775,Havis; Allan,32,0,50,18
1713342539474,TDHT 101,A00,492776,Staff,34,0,35,1
1713342540500,TDMV 1,A00,492762,Caligagan; Maria T.,29,0,30,1
1713342540500,TDMV 1,B00,492763,Arcidiacono; Kristin,26,0,30,4
1713342541526,TDMV 2,A00,492764,Weinberg; Sadie,27,0,30,3
1713342542553,TDMV 3,A00,492765,Mack; Kara Shanai',37,0,40,3
1713342543582,TDMV 138,A00,492777,Mack; Kara Shanai',32,0,40,8
1713342544607,TDMV 140,A00,492778,Lima; Paulo Henrique,40,0,40,0
1713342545634,TDMV 142,A00,492779,Caligagan; Maria T.,33,0,40,7
1713342545634,TDMV 142,B00,492780,Caligagan; Tony,37,0,40,3
1713342546660,TDMV 143,A00,492781,Fyall; Daunte Edward,39,0,40,1
1713342547687,USP 1,A01,492401,Kwak; Nancy,27,0,35,8
1713342548715,USP 2,A01,492453,Hinds; Juli Beth,35,0,35,0
1713342549745,USP 3,A01,492516,Staff,28,0,35,7
1713342550772,USP 4,A00,492522,McTague; Sarah,16,0,25,9
1713342551798,USP 100,A00,492523,Staff,32,0,35,3
1713342552827,USP 101,A00,492524,Staff,13,0,15,2
1713342553853,USP 105,A00,492525,Staff,21,0,25,4
1713342554884,USP 151,A00,492526,Shenkman; Michael Thomas,32,0,35,3
1713342555913,USP 170,A00,492545,Hinds; Juli Beth,33,0,35,2
1713342556939,USP 171GS,A00,492608,Bussell; Mirle Rabinowitz,24,0,28,4
1713342557966,USP 183GS,A00,492613,Peerson; Susan,24,0,28,4
1713342558994,VIS 30,A01,490693,Yoldas; Pinar,19,0,22,3
1713342558994,VIS 30,A02,490694,Yoldas; Pinar,18,0,22,4
1713342560033,VIS 83,A00,490695,Kester; Grant,63,0,75,12
1713342561060,VIS 105D,A00,490696,Staff,22,0,25,3
1713342562094,VIS 124CN,A00,490699,Rose; Jordan M,64,0,75,11
1713342563121,VIS 125GS,A00,511221,Williams; Alena J,21,0,22,1
1713342564147,VIS 128D,A00,490700,Staff,73,0,75,2
1713342565178,VIS 151,A01,490717,Staff,33,0,34,1
1713342565178,VIS 151,A02,490766,Staff,33,0,34,1
1713342566204,VIS 154GS,A00,511972,Williams; Alena J,21,0,22,1
1713342567235,VIS 160A,A00,490767,Stone; Patricia,7,0,10,3
1713342568263,WCWP 10A,A00,490638,Staff,14,0,15,1
1713342568263,WCWP 10A,B00,490640,Staff,15,0,15,0
1713342569294,WCWP 10B,A00,490641,Staff,0,0,0,0
1713342569294,WCWP 10B,B00,490642,Staff,14,0,15,1
1713342569294,WCWP 10B,C00,490644,Staff,13,0,15,2
1713342569294,WCWP 10B,D00,490647,Staff,0,0,0,0
1713342570320,WCWP 100,A00,490655,Staff,0,0,0,0
1713342570320,WCWP 100,B00,490687,Staff,10,0,15,5
1713342572490,ANAR 153,A00,487222,Braswell; Geoffrey E.,53,0,60,7
1713342573517,ANBI 134,A00,487223,Staff,5,0,20,15
1713342574543,ANBI 143GS,A00,487224,Noel; Geoffroy Pierre Jean,18,0,24,6
1713342575569,ANBI 144GS,A00,519548,Noel; Geoffroy Pierre Jean,18,0,24,6
1713342576600,ANSC 101,A00,487225,Staff,17,0,20,3
1713342577631,ANSC 125,A00,487227,Brenner; Suzanne A,38,0,40,2
1713342579691,ANSC 146,A00,487229,Staff,35,0,40,5
1713342580720,ANSC 148,A00,487230,Olivas Hernandez; Olga Lid,39,0,40,1
1713342581748,ANSC 150,A00,504165,Sloane; Julia Kathryn,18,0,20,2
1713342582778,ANSC 180,A00,487232,Staff,14,0,15,1
1713342583808,ANSC 188,A00,627155,Staff,37,0,40,3
1713342584834,ANTH 5,A00,519529,Semendeferi; Ekaterini,15,0,15,0
1713342585864,ANTH 10,A00,487219,Staff,58,0,60,2
1713342586890,ANTH 23,A01,487221,Staff,17,0,20,3
1713342587915,ANTH 102,A00,487233,Wilder; Linnea Lorene,50,0,60,10
1713342588946,ANTH 103,A00,487234,Varma; Saiba,54,0,60,6
1713342589972,ANTH 105,A00,487235,Stewart; Alexander B,54,0,60,6
1713342590998,BENG 100,A01,516685,Taylor Amos; Alyssa C,25,0,30,5
1713342592032,BIBC 102,A01,491316,Flagg; Matthew Paul,5,0,88,83
1713342592032,BIBC 102,A02,491366,Flagg; Matthew Paul,78,0,88,10
1713342593130,BIBC 103,A01,491486,Boumechache; Miyyada,16,0,24,8
1713342593130,BIBC 103,A02,491487,Boumechache; Miyyada,24,0,24,0
1713342594161,BICD 100,A01,516882,Staff,73,0,75,2
1713342594161,BICD 100,A02,516890,Staff,69,0,75,6
1713342595192,BICD 102GS,A00,491488,Lo; Stanley M.,26,0,28,2
1713342596224,BIEB 136GS,A00,516940,Holway; David A. & Shurin; Jonathan,18,0,24,6
1713342597250,BIEB 137GS,A01,517034,Holway; David A. & Shurin; Jonathan,18,0,24,6
1713342598276,BIEB 138GS,A01,491492,Pirino; Giorgia,21,0,28,7
1713342599306,BILD 1,A01,491296,Staff,60,0,63,3
1713342599306,BILD 1,A02,491297,Staff,63,0,63,0
1713342600332,BILD 4,A01,517099,Gonzalez Gamboa; Ivonne,22,0,24,2
1713342600332,BILD 4,A02,517100,Gonzalez Gamboa; Ivonne,24,0,24,0
1713342601364,BILD 60GS,A00,491309,Lo; Stanley M.,26,0,28,2
1713342602397,BIMM 100,A01,517136,Staff,82,0,100,18
1713342603427,BIMM 110,A01,517182,Staff,52,0,100,48
1713342604457,BIMM 120,A01,517228,Pickett; Brooke Elizabeth,28,0,63,35
1713342604457,BIMM 120,A02,517240,Pickett; Brooke Elizabeth,44,0,63,19
1713342605483,BIMM 132GS,A01,491498,Pirino; Giorgia,21,0,28,7
1713342606510,BIMM 143,A01,491589,Bozinovic; Goran,12,0,40,28
1713342607538,BIPN 100,A01,491594,Armour; Jon Christopher,83,0,100,17
1713342608565,BIPN 140,A01,491602,Marino; Marc J,23,0,50,27
1713342610619,CAT 125,A00,515973,Staff,18,0,20,2
1713342611668,CAT 125GS,A00,515974,Rahimi; Babak,16,0,20,4
1713342612697,CAT 125R,A00,515980,Staff,12,0,20,8
1713342612697,CAT 125R,B00,515981,Tosun; Adriana,19,0,20,1
1713342612697,CAT 125R,C00,515987,Hyland; Tina Mae,0,5,20,20
1713342612697,CAT 125R,D00,515988,Bronstein; Phoebe Malan,16,0,20,4
1713342613728,CENG 15,A01,488699,Drews; Aaron,25,0,25,0
1713342614756,CENG 100,A00,505196,Opatkiewicz; Justin Paul,25,0,25,0
1713342615782,CGS 2A,A01,489598,Staff,32,0,35,3
1713342616812,CGS 112,A00,489599,Staff,15,0,15,0
1713342617839,CGS 119,A00,489603,Staff,10,0,10,0
1713342618866,CGS 120,A00,489604,Staff,13,0,15,2
1713342619892,CGS 150,A00,489607,Staff,15,0,15,0
1713342620918,CHEM 6A,A01,488715,Staff,97,0,100,3
1713342621946,CHEM 6B,A01,488719,Piercy; Marc Anthony,99,0,100,1
1713342622977,CHEM 6C,A01,488723,Albizati; Kim F.,93,0,100,7
1713342624015,CHEM 7L,A01,488728,Schurmeier; Kimberly,18,0,24,6
1713342624015,CHEM 7L,A02,488730,Schurmeier; Kimberly,23,0,24,1
1713342624015,CHEM 7L,A03,488734,Schurmeier; Kimberly,20,0,24,4
1713342624015,CHEM 7L,A04,488763,Schurmeier; Kimberly,23,0,24,1
1713342624015,CHEM 7L,B01,488798,Schurmeier; Kimberly,16,0,24,8
1713342624015,CHEM 7L,B02,488801,Schurmeier; Kimberly,22,0,24,2
1713342624015,CHEM 7L,B03,488808,Schurmeier; Kimberly,22,0,24,2
1713342624015,CHEM 7L,B04,488811,Schurmeier; Kimberly,24,0,24,0
1713342625046,CHEM 11,A01,488897,Stallings; Dontarie M,94,0,100,6
1713342626072,CHEM 40A,A01,488913,Albizati; Kim F.,83,0,100,17
1713342627107,CHEM 40B,A01,488920,Weizman; Haim,42,0,50,8
1713342627107,CHEM 40B,A02,488938,Weizman; Haim,43,0,50,7
1713342628134,CHEM 41A,A01,489029,Klosterman; Jeremy K,57,0,60,3
1713342629164,CHEM 41C,A01,500436,Tor; Yitzhak,54,0,60,6
1713342630194,CHEM 43A,A01,500426,Weizman; Haim,0,1,24,24
1713342630194,CHEM 43A,A02,500430,Weizman; Haim,6,0,24,18
1713342630194,CHEM 43A,B01,514041,Klosterman; Jeremy K,14,0,24,10
1713342630194,CHEM 43A,B02,514047,Klosterman; Jeremy K,23,0,24,1
1713342631225,CHEM 108,A01,489140,Jennings; Patricia A.,6,0,24,18
1713342631225,CHEM 108,A02,489142,Jennings; Patricia A.,14,0,24,10
1713342632252,CHEM 114A,A01,489147,Stallings; Dontarie M,65,0,100,35
1713342633278,CHIN 169A,A00,489171,Wang; Xiao,19,0,20,1
1713342635337,COGS 3,A01,518827,Boyle; Mary E. T.,25,0,40,15
1713342636362,COGS 11,A01,489175,Staff,27,0,30,3
1713342637386,COGS 14A,A01,518829,Staff,50,0,60,10
1713342638413,COGS 14B,A01,489177,Hoffman; Drew Ellen,62,0,75,13
1713342639437,COGS 100,A01,489181,Allen; Michael Gordon,62,0,75,13
1713342640463,COGS 101A,A01,489183,Staff,45,0,60,15
1713342641491,COGS 101B,A01,489185,Allen; Michael Gordon,6,0,30,24
1713342642524,COGS 101C,A01,526786,Staff,23,0,30,7
1713342644581,COGS 107A,A01,489189,Boyle; Mary E. T.,16,0,35,19
1713342645612,COGS 107B,A01,627144,Mooshagian; Eric Frederick,59,0,60,1
1713342646643,COGS 118A,A01,489191,Staff,0,46,40,40
1713342648698,COGS 171GS,A01,489194,Pineda; Jaime A,19,0,28,9
1713342649723,COGS 172,A01,489196,Staff,1,0,30,29
1713342650749,COGS 174GS,A01,489264,Pineda; Jaime A,19,0,28,9
1713342651774,COGS 180,A01,627150,Staff,28,0,30,2
1713342652804,COGS 186,A01,489274,Staff,0,2,30,30
1713342653830,COMM 10,A01,489276,Staff,23,0,25,2
1713342653830,COMM 10,A02,489303,Staff,23,0,25,2
1713342654857,COMM 100A,A01,489312,Staff,14,0,25,11
1713342654857,COMM 100A,A02,489313,Staff,24,0,25,1
1713342655886,COMM 106T,A00,512540,Staff,33,0,35,2
1713342656916,COMM 107,A00,489347,Staff,27,0,35,8
1713342657944,COMM 109P,A00,489358,Staff,31,0,35,4
1713342658974,COMM 132,A00,489361,McKenna; Denise,27,0,30,3
1713342660003,COMM 146,A00,489362,Halm; Gavin Patrick,26,0,30,4
1713342661037,COMM 190,A00,489363,Abuelhiga; Soraya Jill,17,0,23,6
1713342662068,CSE 8A,A50,489366,Staff,21,0,25,4
1713342662068,CSE 8A,A51,489367,Staff,24,0,25,1
1713342663095,CSE 11,A01,489398,Cao; Yingjun,72,0,100,28
1713342664122,CSE 12,A01,489487,Staff,43,0,50,7
1713342665153,CSE 20,A01,489497,Staff,47,0,50,3
1713342666197,CSE 21,A01,489517,Braun; Oliver,42,0,50,8
1713342667221,CSE 101,A01,489524,Braun; Oliver,0,33,50,50
1713342668257,CSE 105,A01,512594,Jones; Miles E,72,0,100,28
1713342668257,CSE 105,B01,512598,Jones; Miles E,51,0,100,49
1713342669286,CSE 140,A01,489538,Staff,40,0,50,10
1713342670316,CSE 141,A01,489550,Eldon; John,67,0,100,33
1713342671347,CSE 141L,A01,489571,Eldon; John,65,0,100,35
1713342672376,CSE 151A,A01,489583,Solares; Edwin A,140,0,200,60
1713342673408,CSE 175,A01,510886,Kumar; Rakesh,30,0,30,0
1713342674435,CSE 190,A00,516828,Dubnov; Shlomo,37,0,49,12
1713342675494,DOC 100D,A00,489667,Pass; Natalye Joann,19,0,25,6
1713342676519,DSC 10,A01,624268,Staff,72,0,75,3
1713342677545,DSC 20,A01,624476,Staff,50,0,50,0
1713342678571,DSC 40A,A01,624608,Staff,39,0,40,1
1713342679604,DSGN 1,A01,489179,Rill; Bryan,32,0,50,18
1713342680631,ECE 17,A01,490489,Sahay; Rajeev,18,0,30,12
1713342681661,ECE 65,A50,490492,Staff,11,0,20,9
1713342681661,ECE 65,A51,490493,Staff,18,0,20,2
1713342682691,ECON 1,A01,489715,Famulari; Melissa,67,0,70,3
1713342683723,ECON 2,A01,489717,Levkoff; Steven B.,67,0,70,3
1713342684750,ECON 3,A01,489948,Staff,70,0,70,0
1713342686811,ECON 5,A01,490103,Staff,27,0,30,3
1713342686811,ECON 5,B01,626281,Dai; Yinlin,45,0,45,0
1713342687840,ECON 100A,A01,490127,Famulari; Melissa,62,0,70,8
1713342688865,ECON 100B,A01,490129,Staff,64,0,70,6
1713342689891,ECON 109,A01,490187,Shishkin; Denis,27,0,35,8
1713342690917,ECON 110A,A01,490190,Levkoff; Steven B.,59,0,70,11
1713342691943,ECON 120A,A01,490245,Dai; Yinlin,59,0,70,11
1713342692969,ECON 120B,A01,490247,Nieto-Barthaburu; Augusto,40,0,70,30
1713342693996,ECON 120C,A01,490253,Sun; Yixiao,30,0,35,5
1713342693996,ECON 120C,B01,490255,Sun; Yixiao,34,0,35,1
1713342695022,ECON 129,A00,490256,Eckert; Fabian Paul,22,0,35,13
1713342696048,ECON 131,A00,490257,Nieto-Barthaburu; Augusto,0,6,35,35
1713342697135,ECON 138,A00,490258,Bharadwaj; Prashant,13,0,35,22
1713342697135,ECON 138,B00,490259,Bharadwaj; Prashant,15,0,35,20
1713342698165,ECON 159,A00,490260,Hendrickson; Gerald M.,0,9,0,0
1713342699194,ECON 178,A01,553995,Zhu; Ying,24,0,35,11
1713342700225,EDS 40,A01,512576,Black; Alison Michelle,20,0,20,0
1713342701256,EDS 107,A01,515848,Staff,30,0,30,0
1713342702284,EDS 110R,A01,490262,Staff,26,0,30,4
1713342703316,EDS 112,A01,490264,Chapman; Thandeka K,40,0,50,10
1713342704343,EDS 113,A00,490266,Staff,25,0,30,5
1713342705368,EDS 118,A00,490267,Warstadt; Melissa Fawn,18,0,30,12
1713342706398,EDS 124BR,A00,490268,Eguchi; Emi,4,0,25,21
1713342706398,EDS 124BR,B00,490269,Eguchi; Emi,23,0,25,2
1713342707425,EDS 126,A01,490271,Jones; Makeba,43,0,50,7
1713342708453,EDS 135,A01,490316,Staff,19,0,20,1
1713342709480,ENVR 142GS,A00,519514,Chang; Edmond Yi-Teh,26,0,28,2
1713342710506,ETHN 103,A00,490504,Staff,25,0,36,11
1713342711533,ETHN 103A,A00,490505,Man; Simeon S,3,0,9,6
1713342712564,ETHN 109,A00,490506,Staff,28,0,30,2
1713342713591,ETHN 118,A00,490507,Staff,35,0,36,1
1713342714617,ETHN 119,A00,490508,Staff,32,0,36,4
1713342715649,ETHN 121R,A00,490518,Choi; Esther Min,21,0,36,15
1713342716679,ETHN 127,A00,490528,Staff,14,0,15,1
1713342717711,ETHN 139,A00,490573,Staff,10,0,10,0
1713342718740,ETHN 150,A00,490575,Staff,15,0,15,0
1713342719771,GLBH 20,A00,491705,Elwardani; Nile Regina,38,0,40,2
1713342720797,GLBH 101,A00,491706,Staff,20,0,20,0
1713342721823,GLBH 111,A01,491708,Burgos; Jose L.,15,0,15,0
1713342722850,GLBH 146,A00,491709,Staff,8,0,20,12
1713342723875,GLBH 148,A00,491710,Olivas Hernandez; Olga Lid,10,0,20,10
1713342724903,GLBH 150,A00,491711,Sloane; Julia Kathryn,19,0,20,1
1713342725933,HIEA 131,A00,491760,Staff,28,0,32,4
1713342726957,HIEA 153,A00,491762,Staff,28,0,30,2
1713342727987,HIEU 124,A00,491811,Staff,26,0,32,6
1713342729027,HIEU 124GS,A00,491812,Markman; Kristina,27,0,28,1
1713342730053,HIEU 147,A00,491813,Staff,30,0,32,2
1713342731080,HIEU 149GS,A00,491816,Caldwell; Michael Alan,28,0,28,0
1713342732105,HILD 2C,A01,491713,Hendrickson; Gerald M.,26,0,30,4
1713342733130,HILD 7B,A01,491715,Kwak; Nancy,0,2,30,30
1713342734157,HILD 10,A01,491717,Staff,9,0,20,11
1713342735183,HILD 30GS,A00,491719,Edington; Claire Ellen,23,0,28,5
1713342736213,HINE 109,A00,491818,Shafir; Nir,26,0,32,6
1713342737238,HINE 128,A00,491821,Shafir; Nir,30,0,32,2
1713342738264,HISC 117,A00,491830,Staff,27,0,32,5
1713342739293,HIUS 103,A00,491834,Man; Simeon S,14,0,23,9
1713342740322,HIUS 108B,A00,491835,Staff,27,0,30,3
1713342741348,HIUS 141,A00,491836,Hendrickson; Gerald M.,28,0,32,4
1713342742373,HIUS 149,A00,491839,Staff,24,0,32,8
1713342743399,HUM 3,A01,512617,Crum; Matthew Stephen,42,0,50,8
1713342743399,HUM 3,A02,512618,Crum; Matthew Stephen,48,0,50,2
1713342744430,HUM 3GS,A00,512663,Markman; Kristina,0,0,0,1
1713342744430,HUM 3GS,B00,512664,Staff,0,0,0,0
1713342745461,HUM 4,A01,512620,West; Geoffrey Scott,24,0,50,26
1713342746493,HUM 4GS,A00,512666,Lyon; Antony J.,0,0,0,5
1713342747518,HUM 4R,A01,512625,Watkins; Eric,49,0,50,1
1713342748550,HUM 5,A01,512649,Zavodny; Tatiana Sophia,20,0,50,30
1713342748550,HUM 5,B01,512661,Zroka; Ryan Edward,48,0,50,2
1713342749577,INTL 190,A00,490577,Segui; Alan S,0,0,0,5
1713342750604,JAPN 20AR,A01,491267,Ross; Kayoko F,7,0,20,13
1713342751629,JAPN 180,A00,491285,Berman; Michael David,33,0,40,7
1713342752665,LATI 50,A01,502536,Kokinis; Troy Andreas,16,0,22,6
1713342752665,LATI 50,A02,502551,Kokinis; Troy Andreas,22,0,22,0
1713342752665,LATI 50,A03,502650,Kokinis; Troy Andreas,22,0,22,0
1713342752665,LATI 50,A04,502909,Kokinis; Troy Andreas,21,0,22,1
1713342753690,LATI 160,A01,502920,Kokinis; Troy Andreas,30,0,30,0
1713342754723,LIFR 1A,A00,490494,Van Moer; Vinciane G,17,0,20,3
1713342755747,LIFR 1AX,A00,490495,Van Moer; Vinciane G,17,0,20,3
1713342756773,LIFR 1B,A00,490496,Van Moer; Vinciane G,17,0,20,3
1713342757797,LIFR 1BX,A00,490497,Van Moer; Vinciane G,17,0,20,3
1713342758833,LIGN 8,A00,505198,McIntosh; Justin Daniel,134,0,150,16
1713342759861,LIGN 9GS,A00,491239,Lott; Margaret S.,18,0,20,2
1713342760889,LIGN 101,A01,505200,McIntosh; Justin Daniel,22,0,30,8
1713342761914,LIGN 120,A01,491244,Staff,22,0,30,8
1713342762941,LIGN 149GS,A00,491245,Lott; Margaret S.,18,0,20,2
1713342763967,LIGN 170,A00,491247,Staff,22,0,30,8
1713342764996,LISP 1D,A00,490498,Munoz Sanchez; Alicia,8,0,14,6
1713342764996,LISP 1D,B00,490499,Munoz Sanchez; Alicia,4,0,14,10
1713342764996,LISP 1D,C00,490500,Munoz Sanchez; Alicia,7,0,14,7
1713342764996,LISP 1D,D00,490501,Munoz Sanchez; Alicia,10,0,14,4
1713342766023,LISP 1DX,A00,490502,Munoz Sanchez; Alicia,11,0,28,17
1713342766023,LISP 1DX,B00,490503,Munoz Sanchez; Alicia,16,0,28,12
1713342768076,LTAM 110,A00,491847,Staff,22,0,25,3
1713342769101,LTCS 119,A00,491848,Staff,11,0,15,4
1713342770131,LTCS 130,A00,491849,Staff,24,0,25,1
1713342772188,LTEA 120C,A00,491852,Staff,32,0,40,8
1713342773219,LTEN 130GS,A00,491853,Lyon; Antony J.,23,0,28,5
1713342774243,LTEN 148,A00,491855,Staff,23,0,25,2
1713342775269,LTEN 159,A00,491856,Staff,20,0,25,5
1713342776300,LTEN 180,A00,491857,Staff,8,0,15,7
1713342778357,LTSP 123GS,A00,505928,Bessett; Ryan Matthew,24,0,28,4
1713342779383,LTSP 174GS,A00,506037,Bessett; Ryan Matthew,24,0,28,4
1713342781441,LTWR 102,A00,491861,Staff,9,0,15,6
1713342782467,LTWR 106,A00,491862,Staff,8,0,15,7
1713342783502,MAE 11,A00,490930,Bahadori; Mohammad Yousef,94,0,100,6
1713342784536,MAE 30A,A00,490931,Qi; Huihui,37,0,40,3
1713342785566,MAE 101A,A00,491036,Sadeghizadeh; Zahra,91,0,100,9
1713342786593,MAE 101C,A00,491037,Seshadri; Kalyanasundaram,63,0,100,37
1713342787619,MAE 113,A00,491040,Seshadri; Kalyanasundaram,64,0,80,16
1713342788650,MAE 131A,A00,491041,Ghazinejad; Maziar,37,0,40,3
1713342789676,MAE 142,A00,491053,Staff,39,0,40,1
1713342790701,MAE 143A,A00,491054,Staff,29,0,50,21
1713342791734,MAE 150,A00,491092,Truong; Phuong Thi Ngoc,23,0,35,12
1713342792766,MATH 3C,A01,494031,Pardo Guerra; Sebastian,30,0,30,0
1713342792766,MATH 3C,A02,494032,Pardo Guerra; Sebastian,29,0,30,1
1713342793794,MATH 10A,A01,494034,Staff,27,0,30,3
1713342793794,MATH 10A,A02,494035,Staff,28,0,30,2
1713342793794,MATH 10A,B01,494037,Staff,27,0,30,3
1713342793794,MATH 10A,B02,494038,Staff,29,0,30,1
1713342794823,MATH 10B,A01,494040,Habib; Yousaf,22,0,30,8
1713342794823,MATH 10B,A02,494041,Habib; Yousaf,28,0,30,2
1713342794823,MATH 10B,A03,494042,Habib; Yousaf,29,0,30,1
1713342794823,MATH 10B,A04,494043,Habib; Yousaf,30,0,30,0
1713342794823,MATH 10B,B01,494045,Habib; Yousaf,25,0,30,5
1713342794823,MATH 10B,B02,494046,Habib; Yousaf,30,0,30,0
1713342794823,MATH 10B,B03,494047,Habib; Yousaf,30,0,30,0
1713342794823,MATH 10B,B04,494048,Habib; Yousaf,30,0,30,0
1713342795853,MATH 18,A01,494050,Kemp; Todd Aahron,25,0,30,5
1713342795853,MATH 18,A02,494051,Kemp; Todd Aahron,29,0,30,1
1713342795853,MATH 18,B01,494054,Kemp; Todd Aahron,25,0,30,5
1713342795853,MATH 18,B02,494055,Kemp; Todd Aahron,29,0,30,1
1713342796881,MATH 20A,A01,494059,Suk; Andrew Hoon,30,0,30,0
1713342797909,MATH 20B,A01,494061,Briones; Jor-el Thomas Caparas,33,0,35,2
1713342797909,MATH 20B,B01,494063,Bach; Quang Tran,34,0,35,1
1713342798938,MATH 20C,A01,494065,Staff,28,0,30,2
1713342798938,MATH 20C,A02,494066,Staff,30,0,30,0
1713342798938,MATH 20C,A03,494067,Staff,30,0,30,0
1713342798938,MATH 20C,A04,494068,Staff,30,0,30,0
1713342798938,MATH 20C,B01,494070,Zhang; Ming,24,0,30,6
1713342798938,MATH 20C,B02,494071,Zhang; Ming,27,0,30,3
1713342798938,MATH 20C,B03,494072,Zhang; Ming,29,0,30,1
1713342798938,MATH 20C,B04,494073,Zhang; Ming,29,0,30,1
1713342799969,MATH 20D,A01,494075,Staff,22,0,30,8
1713342799969,MATH 20D,A02,494076,Staff,29,0,30,1
1713342801050,MATH 20E,A01,494079,Staff,24,0,30,6
1713342801050,MATH 20E,A02,494080,Staff,26,0,30,4
1713342801050,MATH 20E,B01,494082,Staff,25,0,30,5
1713342801050,MATH 20E,B02,494083,Staff,25,0,30,5
1713342802079,MATH 103A,A01,494085,Aliabadi Sr.; Mohsen,12,0,30,18
1713342802079,MATH 103A,A02,494086,Aliabadi Sr.; Mohsen,28,0,30,2
1713342802079,MATH 103A,B01,494088,Aliabadi Sr.; Mohsen,20,0,30,10
1713342802079,MATH 103A,B02,494089,Aliabadi Sr.; Mohsen,27,0,30,3
1713342803106,MATH 109,A01,494091,Staff,30,0,30,0
1713342803106,MATH 109,A02,494092,Staff,29,0,30,1
1713342803106,MATH 109,B01,494094,Staff,27,0,30,3
1713342803106,MATH 109,B02,494095,Staff,29,0,30,1
1713342804135,MATH 142A,A01,494097,Chow; Bennett,13,0,30,17
1713342804135,MATH 142A,A02,494098,Chow; Bennett,23,0,30,7
1713342804135,MATH 142A,B01,494100,Chow; Bennett,19,0,30,11
1713342804135,MATH 142A,B02,494101,Chow; Bennett,29,0,30,1
1713342806191,MATH 168A,A01,516677,Dumitriu; Ioana,16,0,35,19
1713342807221,MATH 170A,A01,516679,Dumitriu; Ioana,18,0,30,12
1713342807221,MATH 170A,A02,516680,Dumitriu; Ioana,28,0,30,2
1713342808254,MATH 193A,A01,494107,Staff,12,0,30,18
1713342808254,MATH 193A,A02,494108,Staff,18,0,30,12
1713342808254,MATH 193A,A03,494109,Staff,29,0,30,1
1713342808254,MATH 193A,A04,494110,Staff,22,0,30,8
1713342811345,MGT 16,A00,491930,McKay; Michael J,92,0,98,6
1713342812372,MGT 18,A00,491992,McKay; Michael J,96,0,98,2
1713342813402,MGT 71,A00,492003,Staff,63,0,98,35
1713342814433,MGT 103,A00,505209,Eberhard; Craig A,80,0,98,18
1713342815464,MGT 131A,A00,505210,Anderson; John Charles,89,0,98,9
1713342817520,MGT 153,A00,492077,Perols; Johan Lars,16,0,90,74
1713342820604,MGT 164,A00,492222,McKay; Mary A,91,0,98,7
1713342821637,MGT 172,A00,492245,Staff,59,0,60,1
1713342821637,MGT 172,B00,505526,Hedges; Kathleen,65,0,98,33
1713342822664,MGT 181,A00,505669,Dunn; Louis Jean,78,0,98,20
1713342823693,MMW 14,A01,494399,Staff,15,0,28,13
1713342823693,MMW 14,A02,494400,Staff,25,0,28,3
1713342823693,MMW 14,A03,494401,Staff,28,0,28,0
1713342823693,MMW 14,A04,494402,Staff,28,0,28,0
1713342823693,MMW 14,B01,494404,Carreras; Maria Victoria,8,0,28,20
1713342823693,MMW 14,B02,494405,Carreras; Maria Victoria,25,0,28,3
1713342823693,MMW 14,B03,494406,Carreras; Maria Victoria,27,0,28,1
1713342823693,MMW 14,B04,494407,Carreras; Maria Victoria,28,0,28,0
1713342824719,MMW 14GS,A00,506250,Chang; Edmond Yi-Teh,0,0,0,0
1713342825746,MMW 121R,A01,494415,Adamiak; Patrick John,10,0,28,18
1713342825746,MMW 121R,A02,494416,Adamiak; Patrick John,24,0,28,4
1713342826770,MUS 1A,A01,494113,Staff,12,0,25,13
1713342826770,MUS 1A,A02,494114,Staff,24,0,25,1
1713342827796,MUS 4,A01,494116,Staff,23,0,25,2
1713342827796,MUS 4,A02,494117,Staff,22,0,25,3
1713342828827,MUS 5R,A01,494236,Dubnov; Shlomo,4,0,25,21
1713342828827,MUS 5R,A02,494237,Dubnov; Shlomo,25,0,25,0
1713342829858,MUS 6,A01,494122,Staff,9,0,25,16
1713342829858,MUS 6,A02,494123,Staff,23,0,25,2
1713342830890,MUS 7,A01,494125,Staff,16,0,25,9
1713342830890,MUS 7,A02,494126,Staff,24,0,25,1
1713342831916,MUS 11,A01,494128,Staff,23,0,25,2
1713342831916,MUS 11,A02,494129,Staff,24,0,25,1
1713342832942,MUS 13,A01,494131,Staff,25,0,25,0
1713342832942,MUS 13,A02,494132,Staff,25,0,25,0
1713342833969,MUS 15,A01,494134,Staff,16,0,25,9
1713342833969,MUS 15,A02,494135,Staff,25,0,25,0
1713342833969,MUS 15,B01,494137,Staff,24,0,25,1
1713342834996,MUS 80,A00,494232,Staff,24,0,25,1
1713342834996,MUS 80,B00,494233,Staff,25,0,25,0
1713342834996,MUS 80,C00,494234,Staff,23,0,25,2
1713342836023,MUS 95C,A00,494141,Staff,69,0,75,6
1713342837048,MUS 114,A00,494142,Staff,39,0,50,11
1713342838075,NANO 15,A01,490636,Drews; Aaron,7,0,7,0
1713342839103,PHIL 1,A00,490578,Grush; Rick Scott,49,0,50,1
1713342840133,PHIL 10,A01,490580,Grush; Rick Scott,33,0,35,2
1713342840133,PHIL 10,A02,490586,Grush; Rick Scott,32,0,35,3
1713342841164,PHIL 27,A01,490591,Staff,22,0,25,3
1713342841164,PHIL 27,A02,490592,Staff,25,0,25,0
1713342841164,PHIL 27,A03,490593,Staff,25,0,25,0
1713342841164,PHIL 27,A04,490598,Staff,25,0,25,0
1713342842190,PHIL 32,A01,490611,Staff,20,0,20,0
1713342842190,PHIL 32,A02,490618,Staff,20,0,20,0
1713342843216,PHIL 90,A00,490624,Staff,40,0,40,0
1713342844246,PHIL 136,A00,490627,Cohen; Jonathan David,37,0,40,3
1713342845276,PHIL 155,A00,490634,Staff,62,0,70,8
1713342846301,PHYS 1A,A00,491610,Staff,245,0,250,5
1713342847333,PHYS 1AL,001,491616,Tsai; Philbert S,27,0,30,3
1713342847333,PHYS 1AL,002,491618,Tsai; Philbert S,30,0,30,0
1713342848361,PHYS 1B,A00,491623,Staff,235,0,250,15
1713342849387,PHYS 1BL,001,491626,Tsai; Philbert S,18,0,30,12
1713342849387,PHYS 1BL,002,491628,Tsai; Philbert S,26,0,30,4
1713342850413,PHYS 1C,A00,491632,Staff,212,0,245,33
1713342851442,PHYS 1CL,001,491635,Tsai; Philbert S,3,0,30,27
1713342851442,PHYS 1CL,002,491643,Tsai; Philbert S,22,0,30,8
1713342852469,PHYS 2AR,A01,491651,Meyertholen; Andrew D.,44,0,50,6
1713342853496,PHYS 2B,A01,491659,Staff,105,0,115,10
1713342854523,PHYS 2BL,A01,491685,Staff,21,0,24,3
1713342854523,PHYS 2BL,A02,491700,Staff,21,0,24,3
1713342855547,PHYS 2C,A01,505161,Staff,101,0,115,14
1713342856574,PHYS 4A,A01,491704,Grinstein; Benjamin,99,0,100,1
1713342857602,POLI 5D,A01,494144,Staff,3,0,5,2
1713342857602,POLI 5D,B01,626283,Dai; Yinlin,5,0,5,0
1713342858630,POLI 12,A00,494145,Staff,43,0,45,2
1713342859662,POLI 13R,A00,494146,Forman; Fonna,45,0,50,5
1713342860693,POLI 27,A01,494148,Staff,54,0,60,6
1713342861724,POLI 30,A00,494149,Staff,49,0,50,1
1713342862752,POLI 100DA,A00,494150,Staff,20,0,25,5
1713342864804,POLI 100I,A00,494152,Staff,27,0,30,3
1713342865831,POLI 104B,A00,494153,Smith; Glenn Chatmas,53,0,55,2
1713342866861,POLI 104F,A00,494154,Staff,28,0,30,2
1713342867891,POLI 104I,A00,494155,Smith; Glenn Chatmas,29,0,30,1
1713342868918,POLI 110C,A00,494156,Ingham; Sean,23,0,25,2
1713342869943,POLI 117R,A00,494157,Forman; Fonna,5,0,20,15
1713342870970,POLI 118,A00,494158,Ingham; Sean,21,0,25,4
1713342871998,POLI 120H,A00,494159,Fisk; David Lee,39,0,45,6
1713342873024,POLI 131CR,A00,494160,Hoston; Germaine,35,0,45,10
1713342874051,POLI 133J,A00,494161,Staff,31,0,35,4
1713342875081,POLI 135,A00,494162,Fisk; David Lee,33,0,35,2
1713342876107,POLI 140A,A00,494164,Staff,18,0,30,12
1713342877133,POLI 142I,A00,494165,Staff,30,0,30,0
1713342878161,POLI 144D,A00,494166,Staff,22,0,25,3
1713342879187,POLI 151,A00,494167,Staff,30,0,30,0
1713342880212,POLI 153,A00,494168,Staff,33,0,35,2
1713342881239,POLI 160AA,A00,494169,Staff,33,0,40,7
1713342882268,POLI 162,A00,494170,Mignozzetti; Umberto,18,0,25,7
1713342883299,POLI 171,A00,494171,Mignozzetti; Umberto,18,0,25,7
1713342884325,PSYC 1,A00,494172,Staff,95,0,100,5
1713342885352,PSYC 2,A00,494173,Moranton; Nirelia Melbina-,34,0,50,16
1713342886382,PSYC 3,A00,494174,Staff,29,0,30,1
1713342887407,PSYC 6,A00,494175,Staff,17,0,20,3
1713342888432,PSYC 60,A01,494177,Staff,37,0,45,8
1713342889463,PSYC 70,A01,505724,Geller; Emma Harlan,42,0,45,3
1713342890491,PSYC 101,A00,494180,Heyman; Gail D.,84,0,100,16
1713342891516,PSYC 105,A00,494181,Geller; Emma Harlan,51,0,90,39
1713342892542,PSYC 106,A00,494182,Dobkins; Karen R.,26,0,45,19
1713342893567,PSYC 108,A00,494183,Adrian; Julia Anna,89,0,100,11
1713342894593,PSYC 114,A01,494185,Winkielman; Piotr,0,4,30,30
1713342895629,PSYC 122,A00,494186,Moranton; Nirelia Melbina-,27,0,50,23
1713342896661,PSYC 124,A00,494187,Chapman; Eddie Nathaniel,69,0,80,11
1713342897691,PSYC 131,A00,494188,Anagnostaras; Stephan,40,0,80,40
1713342898721,PSYC 144,A00,494189,Staff,1,1,50,49
1713342899747,PSYC 154,A00,494190,Lacefield; Katharine I,105,0,180,75
1713342900770,PSYC 162,A00,494191,Wixted; John T,70,0,100,30
1713342901796,PSYC 172,A00,494192,Gorman; Michael R.,36,0,45,9
1713342902829,PSYC 178,A00,494193,Glaser; Dale,33,0,45,12
1713342903867,PSYC 193,A00,505725,Chapman; Eddie Nathaniel,20,0,20,0
1713342904954,RELI 145GS,A00,519817,Rahimi; Babak,17,0,20,3
1713342905979,SE 101A,A01,490862,Chadha; Mayank,23,0,25,2
1713342907006,SE 101C,A01,490924,Krysl; Petr,15,0,20,5
1713342908040,SE 110A,A01,490928,Staff,19,0,20,1
1713342909066,SE 130A,A00,490929,Morrison; Machel Leigh,54,0,70,16
1713342910315,SIO 1,A01,519325,Staff,39,0,40,1
1713342911344,SIO 30,A01,519327,Staff,38,0,40,2
1713342912370,SIO 40,A00,519328,Staff,39,0,40,1
1713342913395,SIO 46GS,A00,519819,Cook; Geoffrey W,15,0,25,10
1713342914422,SIO 109R,A00,494197,Forman; Fonna,0,3,20,20
1713342915447,SIO 121GS,A00,519827,Cook; Geoffrey W,15,0,25,10
1713342916478,SIO 132,A01,519330,Staff,38,0,40,2
1713342917508,SIO 133,A01,519397,Staff,37,0,40,3
1713342918532,SIO 139,A00,519396,Kacev; David,29,0,40,11
1713342919561,SOCI 1,A01,494199,Thorpe; Charles Robert,21,0,30,9
1713342919561,SOCI 1,A02,494200,Thorpe; Charles Robert,30,0,30,0
1713342919561,SOCI 1,A03,494201,Thorpe; Charles Robert,29,0,30,1
1713342919561,SOCI 1,A04,494202,Thorpe; Charles Robert,29,0,30,1
1713342919561,SOCI 1,A05,494203,Thorpe; Charles Robert,29,0,30,1
1713342919561,SOCI 1,A06,494204,Thorpe; Charles Robert,30,0,30,0
1713342919561,SOCI 1,A07,494205,Thorpe; Charles Robert,28,0,30,2
1713342920586,SOCI 60,A01,494207,Staff,33,0,40,7
1713342920586,SOCI 60,A02,494208,Staff,39,0,40,1
1713342921613,SOCI 100,A01,494210,Payne; Christine Anna,25,0,30,5
1713342921613,SOCI 100,A02,494211,Payne; Christine Anna,26,0,30,4
1713342922641,SOCI 109M,A00,494212,Staff,20,0,20,0
1713342923670,SOCI 110,A00,494213,Staff,34,0,40,6
1713342925727,SOCI 118E,A00,494215,Ng; Kwai,37,0,40,3
1713342926758,SOCI 125,A00,494216,Calderon-Zaks; Michael Aar,39,0,45,6
1713342927783,SOCI 126,A01,494218,Jones; Makeba,3,0,5,2
1713342928809,SOCI 131,A00,494219,Thorpe; Charles Robert,26,0,30,4
1713342930864,SOCI 135,A00,494221,Payne; Christine Anna,28,0,50,22
1713342931891,SOCI 136E,A00,626690,Ruiz; Jonathan Joseph,24,0,25,1
1713342932918,SOCI 138GS,A00,494222,Navon; Daniel,23,0,28,5
1713342934968,SOCI 145,A00,494224,Staff,40,0,45,5
1713342935997,SOCI 153,A00,494225,Staff,28,0,30,2
1713342937024,SOCI 160E,A00,494226,Ng; Kwai,27,0,40,13
1713342938050,SOCI 180,A00,494227,Staff,29,0,30,1
1713342939075,SOCI 189GS,A00,494228,Ribas Norris; Janet Vanesa,11,0,11,0
1713342940104,SOCI 190GS,A00,553232,Ribas Norris; Janet Vanesa,11,0,11,0
1713342941131,SOMI 220,A00,627178,Schneid; Stephen David,30,0,30,0
1713342942158,SYN 2,001,490768,Staff,13,0,15,2
1713342942158,SYN 2,002,490769,Staff,14,0,15,1
1713342942158,SYN 2,004,490775,Staff,0,0,0,0
1713342942158,SYN 2,003,490774,Staff,0,0,0,0
1713342942158,SYN 2,005,490776,Staff,0,0,0,0
1713342943191,SYN 2R,001,490779,Staff,10,0,15,5
1713342943191,SYN 2R,002,514635,Staff,14,0,15,1
1713342944217,SYN 100,A01,490783,Staff,8,0,20,12
1713342944217,SYN 100,B01,490787,Staff,10,0,20,10
1713342944217,SYN 100,C01,490789,Staff,10,0,20,10
1713342945242,SYN 150,A00,490817,Staff,14,0,15,1
1713342945242,SYN 150,B00,514610,Staff,15,0,15,0
1713342946277,TDAC 1,A00,492753,Walsh; Kim C.,19,0,20,1
1713342946277,TDAC 1,B00,492754,Harting; Carla Kelso,18,0,20,2
1713342946277,TDAC 1,C00,513995,Salovey; Todd,15,0,20,5
1713342947309,TDAC 101,A00,492766,Harting; Carla Kelso,17,0,20,3
1713342948338,TDAC 102,A00,492768,Basso; Beatrice,19,0,20,1
1713342949367,TDDE 111,A00,492769,Staff,25,0,25,0
1713342950393,TDDE 131,A00,492770,Staff,15,0,15,0
1713342950393,TDDE 131,B00,492771,Staff,15,0,15,0
1713342951419,TDDE 131GS,A00,523716,Guirguis; Mark C,23,0,28,5
1713342952456,TDGE 1,A01,492756,Salovey; Todd,56,0,60,4
1713342953482,TDGE 5,A01,492758,Staff,23,0,25,2
1713342954506,TDGE 10,A00,492759,Fulton; Julia,203,0,220,17
1713342955533,TDGE 11,A00,492760,Castro; Robert Jess,198,0,200,2
1713342957593,TDGE 124,A00,492772,Fulton; Julia,180,0,220,40
1713342958630,TDGE 125,A00,492773,Meyer; Ursula,38,0,50,12
1713342958630,TDGE 125,B00,492774,Staff,49,0,50,1
1713342958630,TDGE 125,C00,523565,Staff,48,0,50,2
1713342959661,TDGE 125GS,A00,523580,Guirguis; Mark C,23,0,28,5
1713342960687,TDGE 127,A00,492775,Havis; Allan,32,0,50,18
1713342961714,TDHT 101,A00,492776,Staff,34,0,35,1
1713342962742,TDMV 1,A00,492762,Caligagan; Maria T.,29,0,30,1
1713342962742,TDMV 1,B00,492763,Arcidiacono; Kristin,26,0,30,4
1713342963775,TDMV 2,A00,492764,Weinberg; Sadie,27,0,30,3
1713342964802,TDMV 3,A00,492765,Mack; Kara Shanai',37,0,40,3
1713342965828,TDMV 138,A00,492777,Mack; Kara Shanai',32,0,40,8
1713342966858,TDMV 140,A00,492778,Lima; Paulo Henrique,40,0,40,0
1713342967884,TDMV 142,A00,492779,Caligagan; Maria T.,33,0,40,7
1713342967884,TDMV 142,B00,492780,Caligagan; Tony,37,0,40,3
1713342968911,TDMV 143,A00,492781,Fyall; Daunte Edward,39,0,40,1
1713342969937,USP 1,A01,492401,Kwak; Nancy,27,0,35,8
1713342970965,USP 2,A01,492453,Hinds; Juli Beth,35,0,35,0
1713342971994,USP 3,A01,492516,Staff,28,0,35,7
1713342973025,USP 4,A00,492522,McTague; Sarah,16,0,25,9
1713342974051,USP 100,A00,492523,Staff,32,0,35,3
1713342975077,USP 101,A00,492524,Staff,13,0,15,2
1713342976105,USP 105,A00,492525,Staff,21,0,25,4
1713342977131,USP 151,A00,492526,Shenkman; Michael Thomas,32,0,35,3
1713342978157,USP 170,A00,492545,Hinds; Juli Beth,33,0,35,2
1713342979187,USP 171GS,A00,492608,Bussell; Mirle Rabinowitz,24,0,28,4
1713342980220,USP 183GS,A00,492613,Peerson; Susan,24,0,28,4
1713342981254,VIS 30,A01,490693,Yoldas; Pinar,19,0,22,3
1713342981254,VIS 30,A02,490694,Yoldas; Pinar,18,0,22,4
1713342982281,VIS 83,A00,490695,Kester; Grant,63,0,75,12
1713342983306,VIS 105D,A00,490696,Staff,22,0,25,3
1713342984331,VIS 124CN,A00,490699,Rose; Jordan M,64,0,75,11
1713342985361,VIS 125GS,A00,511221,Williams; Alena J,21,0,22,1
1713342986387,VIS 128D,A00,490700,Staff,73,0,75,2
1713342987413,VIS 151,A01,490717,Staff,33,0,34,1
1713342987413,VIS 151,A02,490766,Staff,32,0,34,2
1713342988439,VIS 154GS,A00,511972,Williams; Alena J,21,0,22,1
1713342989466,VIS 160A,A00,490767,Stone; Patricia,7,0,10,3
1713342990491,WCWP 10A,A00,490638,Staff,14,0,15,1
1713342990491,WCWP 10A,B00,490640,Staff,15,0,15,0
1713342991518,WCWP 10B,A00,490641,Staff,0,0,0,0
1713342991518,WCWP 10B,B00,490642,Staff,14,0,15,1
1713342991518,WCWP 10B,C00,490644,Staff,13,0,15,2
1713342991518,WCWP 10B,D00,490647,Staff,0,0,0,0
1713342992544,WCWP 100,A00,490655,Staff,0,0,0,0
1713342992544,WCWP 100,B00,490687,Staff,10,0,15,5
1713342994691,ANAR 153,A00,487222,Braswell; Geoffrey E.,53,0,60,7
1713342995719,ANBI 134,A00,487223,Staff,5,0,20,15
1713342996749,ANBI 143GS,A00,487224,Noel; Geoffroy Pierre Jean,18,0,24,6
1713342997778,ANBI 144GS,A00,519548,Noel; Geoffroy Pierre Jean,18,0,24,6
1713342998805,ANSC 101,A00,487225,Staff,17,0,20,3
1713342999835,ANSC 125,A00,487227,Brenner; Suzanne A,38,0,40,2
1713343001891,ANSC 146,A00,487229,Staff,35,0,40,5
1713343002917,ANSC 148,A00,487230,Olivas Hernandez; Olga Lid,39,0,40,1
1713343003950,ANSC 150,A00,504165,Sloane; Julia Kathryn,18,0,20,2
1713343004979,ANSC 180,A00,487232,Staff,14,0,15,1
1713343006011,ANSC 188,A00,627155,Staff,37,0,40,3
1713343007037,ANTH 5,A00,519529,Semendeferi; Ekaterini,15,0,15,0
1713343008063,ANTH 10,A00,487219,Staff,58,0,60,2
1713343009145,ANTH 23,A01,487221,Staff,17,0,20,3
1713343010171,ANTH 102,A00,487233,Wilder; Linnea Lorene,50,0,60,10
1713343011197,ANTH 103,A00,487234,Varma; Saiba,54,0,60,6
1713343012221,ANTH 105,A00,487235,Stewart; Alexander B,54,0,60,6
1713343013245,BENG 100,A01,516685,Taylor Amos; Alyssa C,25,0,30,5
1713343014273,BIBC 102,A01,491316,Flagg; Matthew Paul,5,0,88,83
1713343014273,BIBC 102,A02,491366,Flagg; Matthew Paul,78,0,88,10
1713343015304,BIBC 103,A01,491486,Boumechache; Miyyada,16,0,24,8
1713343015304,BIBC 103,A02,491487,Boumechache; Miyyada,24,0,24,0
1713343016336,BICD 100,A01,516882,Staff,73,0,75,2
1713343016336,BICD 100,A02,516890,Staff,69,0,75,6
1713343017364,BICD 102GS,A00,491488,Lo; Stanley M.,26,0,28,2
1713343018390,BIEB 136GS,A00,516940,Holway; David A. & Shurin; Jonathan,18,0,24,6
1713343019418,BIEB 137GS,A01,517034,Holway; David A. & Shurin; Jonathan,18,0,24,6
1713343020443,BIEB 138GS,A01,491492,Pirino; Giorgia,21,0,28,7
1713343021469,BILD 1,A01,491296,Staff,60,0,63,3
1713343021469,BILD 1,A02,491297,Staff,63,0,63,0
1713343022495,BILD 4,A01,517099,Gonzalez Gamboa; Ivonne,22,0,24,2
1713343022495,BILD 4,A02,517100,Gonzalez Gamboa; Ivonne,24,0,24,0
1713343023517,BILD 60GS,A00,491309,Lo; Stanley M.,26,0,28,2
1713343024543,BIMM 100,A01,517136,Staff,82,0,100,18
1713343025569,BIMM 110,A01,517182,Staff,52,0,100,48
1713343026596,BIMM 120,A01,517228,Pickett; Brooke Elizabeth,28,0,63,35
1713343026596,BIMM 120,A02,517240,Pickett; Brooke Elizabeth,44,0,63,19
1713343027622,BIMM 132GS,A01,491498,Pirino; Giorgia,21,0,28,7
1713343028649,BIMM 143,A01,491589,Bozinovic; Goran,12,0,40,28
1713343029676,BIPN 100,A01,491594,Armour; Jon Christopher,83,0,100,17
1713343030708,BIPN 140,A01,491602,Marino; Marc J,23,0,50,27
1713343032760,CAT 125,A00,515973,Staff,18,0,20,2
1713343033786,CAT 125GS,A00,515974,Rahimi; Babak,16,0,20,4
1713343034822,CAT 125R,A00,515980,Staff,12,0,20,8
1713343034822,CAT 125R,B00,515981,Tosun; Adriana,19,0,20,1
1713343034822,CAT 125R,C00,515987,Hyland; Tina Mae,0,5,20,20
1713343034822,CAT 125R,D00,515988,Bronstein; Phoebe Malan,16,0,20,4
1713343035853,CENG 15,A01,488699,Drews; Aaron,25,0,25,0
1713343036885,CENG 100,A00,505196,Opatkiewicz; Justin Paul,25,0,25,0
1713343037910,CGS 2A,A01,489598,Staff,32,0,35,3
1713343038935,CGS 112,A00,489599,Staff,15,0,15,0
1713343039965,CGS 119,A00,489603,Staff,10,0,10,0
1713343040991,CGS 120,A00,489604,Staff,13,0,15,2
1713343042018,CGS 150,A00,489607,Staff,15,0,15,0
1713343043053,CHEM 6A,A01,488715,Staff,97,0,100,3
1713343044089,CHEM 6B,A01,488719,Piercy; Marc Anthony,99,0,100,1
1713343045116,CHEM 6C,A01,488723,Albizati; Kim F.,93,0,100,7
1713343046152,CHEM 7L,A01,488728,Schurmeier; Kimberly,18,0,24,6
1713343046152,CHEM 7L,A02,488730,Schurmeier; Kimberly,23,0,24,1
1713343046152,CHEM 7L,A03,488734,Schurmeier; Kimberly,20,0,24,4
1713343046152,CHEM 7L,A04,488763,Schurmeier; Kimberly,23,0,24,1
1713343046152,CHEM 7L,B01,488798,Schurmeier; Kimberly,16,0,24,8
1713343046152,CHEM 7L,B02,488801,Schurmeier; Kimberly,22,0,24,2
1713343046152,CHEM 7L,B03,488808,Schurmeier; Kimberly,22,0,24,2
1713343046152,CHEM 7L,B04,488811,Schurmeier; Kimberly,24,0,24,0
1713343047181,CHEM 11,A01,488897,Stallings; Dontarie M,94,0,100,6
1713343048208,CHEM 40A,A01,488913,Albizati; Kim F.,83,0,100,17
1713343049236,CHEM 40B,A01,488920,Weizman; Haim,42,0,50,8
1713343049236,CHEM 40B,A02,488938,Weizman; Haim,43,0,50,7
1713343050267,CHEM 41A,A01,489029,Klosterman; Jeremy K,57,0,60,3
1713343051299,CHEM 41C,A01,500436,Tor; Yitzhak,54,0,60,6
1713343052328,CHEM 43A,A01,500426,Weizman; Haim,0,1,24,24
1713343052328,CHEM 43A,A02,500430,Weizman; Haim,6,0,24,18
1713343052328,CHEM 43A,B01,514041,Klosterman; Jeremy K,14,0,24,10
1713343052328,CHEM 43A,B02,514047,Klosterman; Jeremy K,23,0,24,1
1713343053362,CHEM 108,A01,489140,Jennings; Patricia A.,6,0,24,18
1713343053362,CHEM 108,A02,489142,Jennings; Patricia A.,14,0,24,10
1713343054388,CHEM 114A,A01,489147,Stallings; Dontarie M,65,0,100,35
1713343055419,CHIN 169A,A00,489171,Wang; Xiao,19,0,20,1
1713343057475,COGS 3,A01,518827,Boyle; Mary E. T.,25,0,40,15
1713343058506,COGS 11,A01,489175,Staff,27,0,30,3
1713343059531,COGS 14A,A01,518829,Staff,50,0,60,10
1713343060558,COGS 14B,A01,489177,Hoffman; Drew Ellen,62,0,75,13
1713343061590,COGS 100,A01,489181,Allen; Michael Gordon,62,0,75,13
1713343062617,COGS 101A,A01,489183,Staff,45,0,60,15
1713343063644,COGS 101B,A01,489185,Allen; Michael Gordon,6,0,30,24
1713343064673,COGS 101C,A01,526786,Staff,23,0,30,7
1713343066729,COGS 107A,A01,489189,Boyle; Mary E. T.,16,0,35,19
1713343067757,COGS 107B,A01,627144,Mooshagian; Eric Frederick,59,0,60,1
1713343068784,COGS 118A,A01,489191,Staff,0,46,40,40
1713343070841,COGS 171GS,A01,489194,Pineda; Jaime A,19,0,28,9
1713343071872,COGS 172,A01,489196,Staff,1,0,30,29
1713343072897,COGS 174GS,A01,489264,Pineda; Jaime A,19,0,28,9
1713343073926,COGS 180,A01,627150,Staff,28,0,30,2
1713343074952,COGS 186,A01,489274,Staff,0,2,30,30
1713343075981,COMM 10,A01,489276,Staff,23,0,25,2
1713343075981,COMM 10,A02,489303,Staff,23,0,25,2
1713343077007,COMM 100A,A01,489312,Staff,14,0,25,11
1713343077007,COMM 100A,A02,489313,Staff,24,0,25,1
1713343078038,COMM 106T,A00,512540,Staff,33,0,35,2
1713343079063,COMM 107,A00,489347,Staff,27,0,35,8
1713343080087,COMM 109P,A00,489358,Staff,31,0,35,4
1713343081114,COMM 132,A00,489361,McKenna; Denise,27,0,30,3
1713343082146,COMM 146,A00,489362,Halm; Gavin Patrick,26,0,30,4
1713343083178,COMM 190,A00,489363,Abuelhiga; Soraya Jill,17,0,23,6
1713343084278,CSE 8A,A50,489366,Staff,21,0,25,4
1713343084278,CSE 8A,A51,489367,Staff,24,0,25,1
1713343085310,CSE 11,A01,489398,Cao; Yingjun,72,0,100,28
1713343086337,CSE 12,A01,489487,Staff,43,0,50,7
1713343087366,CSE 20,A01,489497,Staff,47,0,50,3
1713343088397,CSE 21,A01,489517,Braun; Oliver,42,0,50,8
1713343089422,CSE 101,A01,489524,Braun; Oliver,0,33,50,50
1713343090455,CSE 105,A01,512594,Jones; Miles E,72,0,100,28
1713343090455,CSE 105,B01,512598,Jones; Miles E,51,0,100,49
1713343091481,CSE 140,A01,489538,Staff,40,0,50,10
1713343092507,CSE 141,A01,489550,Eldon; John,67,0,100,33
1713343093538,CSE 141L,A01,489571,Eldon; John,65,0,100,35
1713343094563,CSE 151A,A01,489583,Solares; Edwin A,140,0,200,60
1713343095589,CSE 175,A01,510886,Kumar; Rakesh,30,0,30,0
1713343096622,CSE 190,A00,516828,Dubnov; Shlomo,37,0,49,12
1713343097653,DOC 100D,A00,489667,Pass; Natalye Joann,19,0,25,6
1713343098679,DSC 10,A01,624268,Staff,72,0,75,3
1713343099705,DSC 20,A01,624476,Staff,50,0,50,0
1713343100730,DSC 40A,A01,624608,Staff,39,0,40,1
1713343101755,DSGN 1,A01,489179,Rill; Bryan,32,0,50,18
1713343102784,ECE 17,A01,490489,Sahay; Rajeev,18,0,30,12
1713343103816,ECE 65,A50,490492,Staff,11,0,20,9
1713343103816,ECE 65,A51,490493,Staff,18,0,20,2
1713343104845,ECON 1,A01,489715,Famulari; Melissa,67,0,70,3
1713343105873,ECON 2,A01,489717,Levkoff; Steven B.,67,0,70,3
1713343106905,ECON 3,A01,489948,Staff,70,0,70,0
1713343108964,ECON 5,A01,490103,Staff,27,0,30,3
1713343108964,ECON 5,B01,626281,Dai; Yinlin,45,0,45,0
1713343109991,ECON 100A,A01,490127,Famulari; Melissa,62,0,70,8
1713343111018,ECON 100B,A01,490129,Staff,64,0,70,6
1713343112055,ECON 109,A01,490187,Shishkin; Denis,27,0,35,8
1713343113134,ECON 110A,A01,490190,Levkoff; Steven B.,59,0,70,11
1713343114160,ECON 120A,A01,490245,Dai; Yinlin,59,0,70,11
1713343115189,ECON 120B,A01,490247,Nieto-Barthaburu; Augusto,40,0,70,30
1713343116223,ECON 120C,A01,490253,Sun; Yixiao,30,0,35,5
1713343116223,ECON 120C,B01,490255,Sun; Yixiao,34,0,35,1
1713343117252,ECON 129,A00,490256,Eckert; Fabian Paul,22,0,35,13
1713343118285,ECON 131,A00,490257,Nieto-Barthaburu; Augusto,0,6,35,35
1713343119311,ECON 138,A00,490258,Bharadwaj; Prashant,13,0,35,22
1713343119311,ECON 138,B00,490259,Bharadwaj; Prashant,15,0,35,20
1713343120344,ECON 159,A00,490260,Hendrickson; Gerald M.,0,9,0,0
1713343121380,ECON 178,A01,553995,Zhu; Ying,24,0,35,11
1713343122408,EDS 40,A01,512576,Black; Alison Michelle,20,0,20,0
1713343123432,EDS 107,A01,515848,Staff,30,0,30,0
1713343124463,EDS 110R,A01,490262,Staff,26,0,30,4
1713343125488,EDS 112,A01,490264,Chapman; Thandeka K,40,0,50,10
1713343126514,EDS 113,A00,490266,Staff,25,0,30,5
1713343127540,EDS 118,A00,490267,Warstadt; Melissa Fawn,18,0,30,12
1713343128566,EDS 124BR,A00,490268,Eguchi; Emi,4,0,25,21
1713343128566,EDS 124BR,B00,490269,Eguchi; Emi,23,0,25,2
1713343129592,EDS 126,A01,490271,Jones; Makeba,43,0,50,7
1713343130624,EDS 135,A01,490316,Staff,19,0,20,1
1713343131651,ENVR 142GS,A00,519514,Chang; Edmond Yi-Teh,26,0,28,2
1713343132678,ETHN 103,A00,490504,Staff,25,0,36,11
1713343133705,ETHN 103A,A00,490505,Man; Simeon S,3,0,9,6
1713343134730,ETHN 109,A00,490506,Staff,28,0,30,2
1713343135759,ETHN 118,A00,490507,Staff,35,0,36,1
1713343136785,ETHN 119,A00,490508,Staff,32,0,36,4
1713343137812,ETHN 121R,A00,490518,Choi; Esther Min,21,0,36,15
1713343138844,ETHN 127,A00,490528,Staff,14,0,15,1
1713343139873,ETHN 139,A00,490573,Staff,10,0,10,0
1713343140914,ETHN 150,A00,490575,Staff,15,0,15,0
1713343141949,GLBH 20,A00,491705,Elwardani; Nile Regina,38,0,40,2
1713343142975,GLBH 101,A00,491706,Staff,20,0,20,0
1713343144000,GLBH 111,A01,491708,Burgos; Jose L.,15,0,15,0
1713343145026,GLBH 146,A00,491709,Staff,8,0,20,12
1713343146057,GLBH 148,A00,491710,Olivas Hernandez; Olga Lid,10,0,20,10
1713343147085,GLBH 150,A00,491711,Sloane; Julia Kathryn,19,0,20,1
1713343148115,HIEA 131,A00,491760,Staff,28,0,32,4
1713343149146,HIEA 153,A00,491762,Staff,28,0,30,2
1713343150171,HIEU 124,A00,491811,Staff,26,0,32,6
1713343151198,HIEU 124GS,A00,491812,Markman; Kristina,27,0,28,1
1713343152224,HIEU 147,A00,491813,Staff,30,0,32,2
1713343153251,HIEU 149GS,A00,491816,Caldwell; Michael Alan,28,0,28,0
1713343154283,HILD 2C,A01,491713,Hendrickson; Gerald M.,26,0,30,4
1713343155308,HILD 7B,A01,491715,Kwak; Nancy,0,2,30,30
1713343156333,HILD 10,A01,491717,Staff,9,0,20,11
1713343157421,HILD 30GS,A00,491719,Edington; Claire Ellen,23,0,28,5
1713343158448,HINE 109,A00,491818,Shafir; Nir,26,0,32,6
1713343159479,HINE 128,A00,491821,Shafir; Nir,30,0,32,2
1713343160509,HISC 117,A00,491830,Staff,27,0,32,5
1713343161536,HIUS 103,A00,491834,Man; Simeon S,14,0,23,9
1713343162562,HIUS 108B,A00,491835,Staff,27,0,30,3
1713343163586,HIUS 141,A00,491836,Hendrickson; Gerald M.,28,0,32,4
1713343164613,HIUS 149,A00,491839,Staff,24,0,32,8
1713343165639,HUM 3,A01,512617,Crum; Matthew Stephen,42,0,50,8
1713343165639,HUM 3,A02,512618,Crum; Matthew Stephen,48,0,50,2
1713343166665,HUM 3GS,A00,512663,Markman; Kristina,0,0,0,1
1713343166665,HUM 3GS,B00,512664,Staff,0,0,0,0
1713343167692,HUM 4,A01,512620,West; Geoffrey Scott,24,0,50,26
1713343168718,HUM 4GS,A00,512666,Lyon; Antony J.,0,0,0,5
1713343169744,HUM 4R,A01,512625,Watkins; Eric,49,0,50,1
1713343170779,HUM 5,A01,512649,Zavodny; Tatiana Sophia,20,0,50,30
1713343170779,HUM 5,B01,512661,Zroka; Ryan Edward,48,0,50,2
1713343171810,INTL 190,A00,490577,Segui; Alan S,0,0,0,5
1713343172843,JAPN 20AR,A01,491267,Ross; Kayoko F,7,0,20,13
1713343173876,JAPN 180,A00,491285,Berman; Michael David,33,0,40,7
1713343174902,LATI 50,A01,502536,Kokinis; Troy Andreas,16,0,22,6
1713343174902,LATI 50,A02,502551,Kokinis; Troy Andreas,22,0,22,0
1713343174902,LATI 50,A03,502650,Kokinis; Troy Andreas,22,0,22,0
1713343174902,LATI 50,A04,502909,Kokinis; Troy Andreas,21,0,22,1
1713343175929,LATI 160,A01,502920,Kokinis; Troy Andreas,30,0,30,0
1713343176962,LIFR 1A,A00,490494,Van Moer; Vinciane G,17,0,20,3
1713343177989,LIFR 1AX,A00,490495,Van Moer; Vinciane G,17,0,20,3
1713343179019,LIFR 1B,A00,490496,Van Moer; Vinciane G,17,0,20,3
1713343180046,LIFR 1BX,A00,490497,Van Moer; Vinciane G,17,0,20,3
1713343181072,LIGN 8,A00,505198,McIntosh; Justin Daniel,134,0,150,16
1713343182097,LIGN 9GS,A00,491239,Lott; Margaret S.,18,0,20,2
1713343183122,LIGN 101,A01,505200,McIntosh; Justin Daniel,22,0,30,8
1713343184157,LIGN 120,A01,491244,Staff,22,0,30,8
1713343185181,LIGN 149GS,A00,491245,Lott; Margaret S.,18,0,20,2
1713343186211,LIGN 170,A00,491247,Staff,22,0,30,8
1713343187238,LISP 1D,A00,490498,Munoz Sanchez; Alicia,8,0,14,6
1713343187238,LISP 1D,B00,490499,Munoz Sanchez; Alicia,4,0,14,10
1713343187238,LISP 1D,C00,490500,Munoz Sanchez; Alicia,7,0,14,7
1713343187238,LISP 1D,D00,490501,Munoz Sanchez; Alicia,10,0,14,4
1713343188269,LISP 1DX,A00,490502,Munoz Sanchez; Alicia,11,0,28,17
1713343188269,LISP 1DX,B00,490503,Munoz Sanchez; Alicia,16,0,28,12
1713343190324,LTAM 110,A00,491847,Staff,22,0,25,3
1713343191350,LTCS 119,A00,491848,Staff,11,0,15,4
1713343192378,LTCS 130,A00,491849,Staff,24,0,25,1
1713343194427,LTEA 120C,A00,491852,Staff,32,0,40,8
1713343195452,LTEN 130GS,A00,491853,Lyon; Antony J.,23,0,28,5
1713343196481,LTEN 148,A00,491855,Staff,23,0,25,2
1713343197505,LTEN 159,A00,491856,Staff,20,0,25,5
1713343198533,LTEN 180,A00,491857,Staff,8,0,15,7
1713343200585,LTSP 123GS,A00,505928,Bessett; Ryan Matthew,24,0,28,4
1713343201618,LTSP 174GS,A00,506037,Bessett; Ryan Matthew,24,0,28,4
1713343203673,LTWR 102,A00,491861,Staff,9,0,15,6
1713343204699,LTWR 106,A00,491862,Staff,8,0,15,7
1713343205735,MAE 11,A00,490930,Bahadori; Mohammad Yousef,94,0,100,6
1713343206762,MAE 30A,A00,490931,Qi; Huihui,37,0,40,3
1713343207797,MAE 101A,A00,491036,Sadeghizadeh; Zahra,91,0,100,9
1713343208822,MAE 101C,A00,491037,Seshadri; Kalyanasundaram,63,0,100,37
1713343209848,MAE 113,A00,491040,Seshadri; Kalyanasundaram,64,0,80,16
1713343210874,MAE 131A,A00,491041,Ghazinejad; Maziar,37,0,40,3
1713343211900,MAE 142,A00,491053,Staff,39,0,40,1
1713343212924,MAE 143A,A00,491054,Staff,29,0,50,21
1713343213951,MAE 150,A00,491092,Truong; Phuong Thi Ngoc,23,0,35,12
1713343214978,MATH 3C,A01,494031,Pardo Guerra; Sebastian,30,0,30,0
1713343214978,MATH 3C,A02,494032,Pardo Guerra; Sebastian,29,0,30,1
1713343216004,MATH 10A,A01,494034,Staff,27,0,30,3
1713343216004,MATH 10A,A02,494035,Staff,28,0,30,2
1713343216004,MATH 10A,B01,494037,Staff,27,0,30,3
1713343216004,MATH 10A,B02,494038,Staff,29,0,30,1
1713343217092,MATH 10B,A01,494040,Habib; Yousaf,22,0,30,8
1713343217092,MATH 10B,A02,494041,Habib; Yousaf,28,0,30,2
1713343217092,MATH 10B,A03,494042,Habib; Yousaf,29,0,30,1
1713343217092,MATH 10B,A04,494043,Habib; Yousaf,30,0,30,0
1713343217092,MATH 10B,B01,494045,Habib; Yousaf,25,0,30,5
1713343217092,MATH 10B,B02,494046,Habib; Yousaf,30,0,30,0
1713343217092,MATH 10B,B03,494047,Habib; Yousaf,30,0,30,0
1713343217092,MATH 10B,B04,494048,Habib; Yousaf,30,0,30,0
1713343218126,MATH 18,A01,494050,Kemp; Todd Aahron,25,0,30,5
1713343218126,MATH 18,A02,494051,Kemp; Todd Aahron,29,0,30,1
1713343218126,MATH 18,B01,494054,Kemp; Todd Aahron,25,0,30,5
1713343218126,MATH 18,B02,494055,Kemp; Todd Aahron,29,0,30,1
1713343219153,MATH 20A,A01,494059,Suk; Andrew Hoon,30,0,30,0
1713343220178,MATH 20B,A01,494061,Briones; Jor-el Thomas Caparas,33,0,35,2
1713343220178,MATH 20B,B01,494063,Bach; Quang Tran,34,0,35,1
1713343221216,MATH 20C,A01,494065,Staff,28,0,30,2
1713343221216,MATH 20C,A02,494066,Staff,30,0,30,0
1713343221216,MATH 20C,A03,494067,Staff,30,0,30,0
1713343221216,MATH 20C,A04,494068,Staff,30,0,30,0
1713343221216,MATH 20C,B01,494070,Zhang; Ming,24,0,30,6
1713343221216,MATH 20C,B02,494071,Zhang; Ming,27,0,30,3
1713343221216,MATH 20C,B03,494072,Zhang; Ming,29,0,30,1
1713343221216,MATH 20C,B04,494073,Zhang; Ming,29,0,30,1
1713343222242,MATH 20D,A01,494075,Staff,22,0,30,8
1713343222242,MATH 20D,A02,494076,Staff,29,0,30,1
1713343223279,MATH 20E,A01,494079,Staff,24,0,30,6
1713343223279,MATH 20E,A02,494080,Staff,26,0,30,4
1713343223279,MATH 20E,B01,494082,Staff,25,0,30,5
1713343223279,MATH 20E,B02,494083,Staff,25,0,30,5
1713343224316,MATH 103A,A01,494085,Aliabadi Sr.; Mohsen,12,0,30,18
1713343224316,MATH 103A,A02,494086,Aliabadi Sr.; Mohsen,28,0,30,2
1713343224316,MATH 103A,B01,494088,Aliabadi Sr.; Mohsen,20,0,30,10
1713343224316,MATH 103A,B02,494089,Aliabadi Sr.; Mohsen,27,0,30,3
1713343225344,MATH 109,A01,494091,Staff,30,0,30,0
1713343225344,MATH 109,A02,494092,Staff,29,0,30,1
1713343225344,MATH 109,B01,494094,Staff,27,0,30,3
1713343225344,MATH 109,B02,494095,Staff,29,0,30,1
1713343226380,MATH 142A,A01,494097,Chow; Bennett,13,0,30,17
1713343226380,MATH 142A,A02,494098,Chow; Bennett,23,0,30,7
1713343226380,MATH 142A,B01,494100,Chow; Bennett,19,0,30,11
1713343226380,MATH 142A,B02,494101,Chow; Bennett,29,0,30,1
1713343228439,MATH 168A,A01,516677,Dumitriu; Ioana,16,0,35,19
1713343229466,MATH 170A,A01,516679,Dumitriu; Ioana,18,0,30,12
1713343229466,MATH 170A,A02,516680,Dumitriu; Ioana,28,0,30,2
1713343230493,MATH 193A,A01,494107,Staff,12,0,30,18
1713343230493,MATH 193A,A02,494108,Staff,18,0,30,12
1713343230493,MATH 193A,A03,494109,Staff,29,0,30,1
1713343230493,MATH 193A,A04,494110,Staff,22,0,30,8
1713343233586,MGT 16,A00,491930,McKay; Michael J,92,0,98,6
1713343234612,MGT 18,A00,491992,McKay; Michael J,96,0,98,2
1713343235638,MGT 71,A00,492003,Staff,63,0,98,35
1713343236663,MGT 103,A00,505209,Eberhard; Craig A,80,0,98,18
1713343237691,MGT 131A,A00,505210,Anderson; John Charles,89,0,98,9
1713343239747,MGT 153,A00,492077,Perols; Johan Lars,16,0,90,74
1713343242838,MGT 164,A00,492222,McKay; Mary A,91,0,98,7
1713343243871,MGT 172,A00,492245,Staff,59,0,60,1
1713343243871,MGT 172,B00,505526,Hedges; Kathleen,65,0,98,33
1713343244897,MGT 181,A00,505669,Dunn; Louis Jean,78,0,98,20
1713343245925,MMW 14,A01,494399,Staff,15,0,28,13
1713343245925,MMW 14,A02,494400,Staff,25,0,28,3
1713343245925,MMW 14,A03,494401,Staff,28,0,28,0
1713343245925,MMW 14,A04,494402,Staff,28,0,28,0
1713343245925,MMW 14,B01,494404,Carreras; Maria Victoria,8,0,28,20
1713343245925,MMW 14,B02,494405,Carreras; Maria Victoria,25,0,28,3
1713343245925,MMW 14,B03,494406,Carreras; Maria Victoria,27,0,28,1
1713343245925,MMW 14,B04,494407,Carreras; Maria Victoria,28,0,28,0
1713343246950,MMW 14GS,A00,506250,Chang; Edmond Yi-Teh,0,0,0,0
1713343247976,MMW 121R,A01,494415,Adamiak; Patrick John,10,0,28,18
1713343247976,MMW 121R,A02,494416,Adamiak; Patrick John,24,0,28,4
1713343249005,MUS 1A,A01,494113,Staff,12,0,25,13
1713343249005,MUS 1A,A02,494114,Staff,24,0,25,1
1713343250031,MUS 4,A01,494116,Staff,23,0,25,2
1713343250031,MUS 4,A02,494117,Staff,22,0,25,3
1713343251065,MUS 5R,A01,494236,Dubnov; Shlomo,4,0,25,21
1713343251065,MUS 5R,A02,494237,Dubnov; Shlomo,25,0,25,0
1713343252089,MUS 6,A01,494122,Staff,9,0,25,16
1713343252089,MUS 6,A02,494123,Staff,23,0,25,2
1713343253122,MUS 7,A01,494125,Staff,16,0,25,9
1713343253122,MUS 7,A02,494126,Staff,24,0,25,1
1713343254152,MUS 11,A01,494128,Staff,23,0,25,2
1713343254152,MUS 11,A02,494129,Staff,24,0,25,1
1713343255177,MUS 13,A01,494131,Staff,25,0,25,0
1713343255177,MUS 13,A02,494132,Staff,25,0,25,0
1713343256201,MUS 15,A01,494134,Staff,16,0,25,9
1713343256201,MUS 15,A02,494135,Staff,25,0,25,0
1713343256201,MUS 15,B01,494137,Staff,24,0,25,1
1713343257231,MUS 80,A00,494232,Staff,24,0,25,1
1713343257231,MUS 80,B00,494233,Staff,25,0,25,0
1713343257231,MUS 80,C00,494234,Staff,23,0,25,2
1713343258256,MUS 95C,A00,494141,Staff,69,0,75,6
1713343259288,MUS 114,A00,494142,Staff,39,0,50,11
1713343260321,NANO 15,A01,490636,Drews; Aaron,7,0,7,0
1713343261350,PHIL 1,A00,490578,Grush; Rick Scott,49,0,50,1
1713343262380,PHIL 10,A01,490580,Grush; Rick Scott,33,0,35,2
1713343262380,PHIL 10,A02,490586,Grush; Rick Scott,32,0,35,3
1713343263412,PHIL 27,A01,490591,Staff,22,0,25,3
1713343263412,PHIL 27,A02,490592,Staff,25,0,25,0
1713343263412,PHIL 27,A03,490593,Staff,25,0,25,0
1713343263412,PHIL 27,A04,490598,Staff,25,0,25,0
1713343264438,PHIL 32,A01,490611,Staff,20,0,20,0
1713343264438,PHIL 32,A02,490618,Staff,20,0,20,0
1713343265465,PHIL 90,A00,490624,Staff,40,0,40,0
1713343266506,PHIL 136,A00,490627,Cohen; Jonathan David,37,0,40,3
1713343267538,PHIL 155,A00,490634,Staff,62,0,70,8
1713343268575,PHYS 1A,A00,491610,Staff,245,0,250,5
1713343269602,PHYS 1AL,001,491616,Tsai; Philbert S,27,0,30,3
1713343269602,PHYS 1AL,002,491618,Tsai; Philbert S,30,0,30,0
1713343270630,PHYS 1B,A00,491623,Staff,235,0,250,15
1713343271656,PHYS 1BL,001,491626,Tsai; Philbert S,18,0,30,12
1713343271656,PHYS 1BL,002,491628,Tsai; Philbert S,26,0,30,4
1713343272681,PHYS 1C,A00,491632,Staff,212,0,245,33
1713343273708,PHYS 1CL,001,491635,Tsai; Philbert S,3,0,30,27
1713343273708,PHYS 1CL,002,491643,Tsai; Philbert S,22,0,30,8
1713343274736,PHYS 2AR,A01,491651,Meyertholen; Andrew D.,44,0,50,6
1713343275770,PHYS 2B,A01,491659,Staff,105,0,115,10
1713343276803,PHYS 2BL,A01,491685,Staff,21,0,24,3
1713343276803,PHYS 2BL,A02,491700,Staff,21,0,24,3
1713343277830,PHYS 2C,A01,505161,Staff,101,0,115,14
1713343278858,PHYS 4A,A01,491704,Grinstein; Benjamin,99,0,100,1
1713343279892,POLI 5D,A01,494144,Staff,3,0,5,2
1713343279892,POLI 5D,B01,626283,Dai; Yinlin,5,0,5,0
1713343280917,POLI 12,A00,494145,Staff,43,0,45,2
1713343281944,POLI 13R,A00,494146,Forman; Fonna,45,0,50,5
1713343282969,POLI 27,A01,494148,Staff,54,0,60,6
1713343283995,POLI 30,A00,494149,Staff,49,0,50,1
1713343285021,POLI 100DA,A00,494150,Staff,20,0,25,5
1713343287079,POLI 100I,A00,494152,Staff,27,0,30,3
1713343288105,POLI 104B,A00,494153,Smith; Glenn Chatmas,53,0,55,2
1713343289130,POLI 104F,A00,494154,Staff,28,0,30,2
1713343290157,POLI 104I,A00,494155,Smith; Glenn Chatmas,29,0,30,1
1713343291191,POLI 110C,A00,494156,Ingham; Sean,23,0,25,2
1713343292217,POLI 117R,A00,494157,Forman; Fonna,5,0,20,15
1713343293247,POLI 118,A00,494158,Ingham; Sean,21,0,25,4
1713343294273,POLI 120H,A00,494159,Fisk; David Lee,39,0,45,6
1713343295302,POLI 131CR,A00,494160,Hoston; Germaine,35,0,45,10
1713343296326,POLI 133J,A00,494161,Staff,31,0,35,4
1713343297353,POLI 135,A00,494162,Fisk; David Lee,33,0,35,2
1713343298383,POLI 140A,A00,494164,Staff,18,0,30,12
1713343299407,POLI 142I,A00,494165,Staff,30,0,30,0
1713343300435,POLI 144D,A00,494166,Staff,22,0,25,3
1713343301466,POLI 151,A00,494167,Staff,30,0,30,0
1713343302490,POLI 153,A00,494168,Staff,33,0,35,2
1713343303518,POLI 160AA,A00,494169,Staff,33,0,40,7
1713343304544,POLI 162,A00,494170,Mignozzetti; Umberto,18,0,25,7
1713343305569,POLI 171,A00,494171,Mignozzetti; Umberto,18,0,25,7
1713343306601,PSYC 1,A00,494172,Staff,95,0,100,5
1713343307634,PSYC 2,A00,494173,Moranton; Nirelia Melbina-,34,0,50,16
1713343308663,PSYC 3,A00,494174,Staff,29,0,30,1
1713343309695,PSYC 6,A00,494175,Staff,17,0,20,3
1713343310726,PSYC 60,A01,494177,Staff,37,0,45,8
1713343311755,PSYC 70,A01,505724,Geller; Emma Harlan,42,0,45,3
1713343312785,PSYC 101,A00,494180,Heyman; Gail D.,83,0,100,17
1713343313816,PSYC 105,A00,494181,Geller; Emma Harlan,51,0,90,39
1713343314843,PSYC 106,A00,494182,Dobkins; Karen R.,26,0,45,19
1713343315875,PSYC 108,A00,494183,Adrian; Julia Anna,89,0,100,11
1713343316900,PSYC 114,A01,494185,Winkielman; Piotr,0,4,30,30
1713343317926,PSYC 122,A00,494186,Moranton; Nirelia Melbina-,27,0,50,23
1713343318952,PSYC 124,A00,494187,Chapman; Eddie Nathaniel,69,0,80,11
1713343319978,PSYC 131,A00,494188,Anagnostaras; Stephan,39,0,80,41
1713343321057,PSYC 144,A00,494189,Staff,1,1,50,49
1713343322084,PSYC 154,A00,494190,Lacefield; Katharine I,105,0,180,75
1713343323110,PSYC 162,A00,494191,Wixted; John T,70,0,100,30
1713343324141,PSYC 172,A00,494192,Gorman; Michael R.,36,0,45,9
1713343325172,PSYC 178,A00,494193,Glaser; Dale,33,0,45,12
1713343326198,PSYC 193,A00,505725,Chapman; Eddie Nathaniel,20,0,20,0
1713343327224,RELI 145GS,A00,519817,Rahimi; Babak,17,0,20,3
1713343328257,SE 101A,A01,490862,Chadha; Mayank,23,0,25,2
1713343329288,SE 101C,A01,490924,Krysl; Petr,15,0,20,5
1713343330314,SE 110A,A01,490928,Staff,19,0,20,1
1713343331339,SE 130A,A00,490929,Morrison; Machel Leigh,54,0,70,16
1713343332366,SIO 1,A01,519325,Staff,39,0,40,1
1713343333395,SIO 30,A01,519327,Staff,38,0,40,2
1713343334426,SIO 40,A00,519328,Staff,39,0,40,1
1713343335451,SIO 46GS,A00,519819,Cook; Geoffrey W,15,0,25,10
1713343336477,SIO 109R,A00,494197,Forman; Fonna,0,3,20,20
1713343337502,SIO 121GS,A00,519827,Cook; Geoffrey W,15,0,25,10
1713343338528,SIO 132,A01,519330,Staff,38,0,40,2
1713343339557,SIO 133,A01,519397,Staff,37,0,40,3
1713343340589,SIO 139,A00,519396,Kacev; David,29,0,40,11
1713343341670,SOCI 1,A01,494199,Thorpe; Charles Robert,21,0,30,9
1713343341670,SOCI 1,A02,494200,Thorpe; Charles Robert,30,0,30,0
1713343341670,SOCI 1,A03,494201,Thorpe; Charles Robert,29,0,30,1
1713343341670,SOCI 1,A04,494202,Thorpe; Charles Robert,29,0,30,1
1713343341670,SOCI 1,A05,494203,Thorpe; Charles Robert,29,0,30,1
1713343341670,SOCI 1,A06,494204,Thorpe; Charles Robert,30,0,30,0
1713343341670,SOCI 1,A07,494205,Thorpe; Charles Robert,28,0,30,2
1713343342697,SOCI 60,A01,494207,Staff,33,0,40,7
1713343342697,SOCI 60,A02,494208,Staff,39,0,40,1
1713343343724,SOCI 100,A01,494210,Payne; Christine Anna,25,0,30,5
1713343343724,SOCI 100,A02,494211,Payne; Christine Anna,26,0,30,4
1713343344748,SOCI 109M,A00,494212,Staff,20,0,20,0
1713343345775,SOCI 110,A00,494213,Staff,34,0,40,6
1713343347833,SOCI 118E,A00,494215,Ng; Kwai,37,0,40,3
1713343348865,SOCI 125,A00,494216,Calderon-Zaks; Michael Aar,39,0,45,6
1713343349892,SOCI 126,A01,494218,Jones; Makeba,3,0,5,2
1713343350918,SOCI 131,A00,494219,Thorpe; Charles Robert,26,0,30,4
1713343352969,SOCI 135,A00,494221,Payne; Christine Anna,28,0,50,22
1713343354001,SOCI 136E,A00,626690,Ruiz; Jonathan Joseph,24,0,25,1
1713343355033,SOCI 138GS,A00,494222,Navon; Daniel,23,0,28,5
1713343357083,SOCI 145,A00,494224,Staff,40,0,45,5
1713343358108,SOCI 153,A00,494225,Staff,28,0,30,2
1713343359142,SOCI 160E,A00,494226,Ng; Kwai,27,0,40,13
1713343360168,SOCI 180,A00,494227,Staff,29,0,30,1
1713343361194,SOCI 189GS,A00,494228,Ribas Norris; Janet Vanesa,11,0,11,0
1713343362226,SOCI 190GS,A00,553232,Ribas Norris; Janet Vanesa,11,0,11,0
1713343363254,SOMI 220,A00,627178,Schneid; Stephen David,30,0,30,0
1713343364287,SYN 2,001,490768,Staff,13,0,15,2
1713343364287,SYN 2,002,490769,Staff,14,0,15,1
1713343364287,SYN 2,004,490775,Staff,0,0,0,0
1713343364287,SYN 2,003,490774,Staff,0,0,0,0
1713343364287,SYN 2,005,490776,Staff,0,0,0,0
1713343365312,SYN 2R,001,490779,Staff,10,0,15,5
1713343365312,SYN 2R,002,514635,Staff,14,0,15,1
1713343366339,SYN 100,A01,490783,Staff,8,0,20,12
1713343366339,SYN 100,B01,490787,Staff,10,0,20,10
1713343366339,SYN 100,C01,490789,Staff,10,0,20,10
1713343367364,SYN 150,A00,490817,Staff,14,0,15,1
1713343367364,SYN 150,B00,514610,Staff,15,0,15,0
1713343368391,TDAC 1,A00,492753,Walsh; Kim C.,19,0,20,1
1713343368391,TDAC 1,B00,492754,Harting; Carla Kelso,18,0,20,2
1713343368391,TDAC 1,C00,513995,Salovey; Todd,15,0,20,5
1713343369416,TDAC 101,A00,492766,Harting; Carla Kelso,17,0,20,3
1713343370449,TDAC 102,A00,492768,Basso; Beatrice,19,0,20,1
1713343371474,TDDE 111,A00,492769,Staff,25,0,25,0
1713343372503,TDDE 131,A00,492770,Staff,15,0,15,0
1713343372503,TDDE 131,B00,492771,Staff,15,0,15,0
1713343373534,TDDE 131GS,A00,523716,Guirguis; Mark C,23,0,28,5
1713343374560,TDGE 1,A01,492756,Salovey; Todd,56,0,60,4
1713343375590,TDGE 5,A01,492758,Staff,23,0,25,2
1713343376620,TDGE 10,A00,492759,Fulton; Julia,203,0,220,17
1713343377650,TDGE 11,A00,492760,Castro; Robert Jess,198,0,200,2
1713343379701,TDGE 124,A00,492772,Fulton; Julia,180,0,220,40
1713343380728,TDGE 125,A00,492773,Meyer; Ursula,38,0,50,12
1713343380728,TDGE 125,B00,492774,Staff,49,0,50,1
1713343380728,TDGE 125,C00,523565,Staff,48,0,50,2
1713343381760,TDGE 125GS,A00,523580,Guirguis; Mark C,23,0,28,5
1713343382793,TDGE 127,A00,492775,Havis; Allan,33,0,50,17
1713343383818,TDHT 101,A00,492776,Staff,34,0,35,1
1713343384845,TDMV 1,A00,492762,Caligagan; Maria T.,29,0,30,1
1713343384845,TDMV 1,B00,492763,Arcidiacono; Kristin,26,0,30,4
1713343385871,TDMV 2,A00,492764,Weinberg; Sadie,27,0,30,3
1713343386898,TDMV 3,A00,492765,Mack; Kara Shanai',37,0,40,3
1713343387924,TDMV 138,A00,492777,Mack; Kara Shanai',32,0,40,8
1713343388949,TDMV 140,A00,492778,Lima; Paulo Henrique,40,0,40,0
1713343389975,TDMV 142,A00,492779,Caligagan; Maria T.,33,0,40,7
1713343389975,TDMV 142,B00,492780,Caligagan; Tony,37,0,40,3
1713343391001,TDMV 143,A00,492781,Fyall; Daunte Edward,39,0,40,1
1713343392033,USP 1,A01,492401,Kwak; Nancy,27,0,35,8
1713343393064,USP 2,A01,492453,Hinds; Juli Beth,35,0,35,0
1713343394089,USP 3,A01,492516,Staff,28,0,35,7
1713343395115,USP 4,A00,492522,McTague; Sarah,16,0,25,9
1713343396141,USP 100,A00,492523,Staff,32,0,35,3
1713343397166,USP 101,A00,492524,Staff,13,0,15,2
1713343398197,USP 105,A00,492525,Staff,21,0,25,4
1713343399227,USP 151,A00,492526,Shenkman; Michael Thomas,32,0,35,3
1713343400259,USP 170,A00,492545,Hinds; Juli Beth,33,0,35,2
1713343401284,USP 171GS,A00,492608,Bussell; Mirle Rabinowitz,24,0,28,4
1713343402314,USP 183GS,A00,492613,Peerson; Susan,24,0,28,4
1713343403349,VIS 30,A01,490693,Yoldas; Pinar,19,0,22,3
1713343403349,VIS 30,A02,490694,Yoldas; Pinar,18,0,22,4
1713343404379,VIS 83,A00,490695,Kester; Grant,63,0,75,12
1713343405409,VIS 105D,A00,490696,Staff,22,0,25,3
1713343406438,VIS 124CN,A00,490699,Rose; Jordan M,64,0,75,11
1713343407469,VIS 125GS,A00,511221,Williams; Alena J,21,0,22,1
1713343408501,VIS 128D,A00,490700,Staff,73,0,75,2
1713343409531,VIS 151,A01,490717,Staff,33,0,34,1
1713343409531,VIS 151,A02,490766,Staff,32,0,34,2
1713343410560,VIS 154GS,A00,511972,Williams; Alena J,21,0,22,1
1713343411587,VIS 160A,A00,490767,Stone; Patricia,7,0,10,3
1713343412614,WCWP 10A,A00,490638,Staff,14,0,15,1
1713343412614,WCWP 10A,B00,490640,Staff,15,0,15,0
1713343413643,WCWP 10B,A00,490641,Staff,0,0,0,0
1713343413643,WCWP 10B,B00,490642,Staff,14,0,15,1
1713343413643,WCWP 10B,C00,490644,Staff,13,0,15,2
1713343413643,WCWP 10B,D00,490647,Staff,0,0,0,0
1713343414669,WCWP 100,A00,490655,Staff,0,0,0,0
1713343414669,WCWP 100,B00,490687,Staff,10,0,15,5
1713343416776,ANAR 153,A00,487222,Braswell; Geoffrey E.,53,0,60,7
1713343417805,ANBI 134,A00,487223,Staff,5,0,20,15
1713343418836,ANBI 143GS,A00,487224,Noel; Geoffroy Pierre Jean,18,0,24,6
1713343419862,ANBI 144GS,A00,519548,Noel; Geoffroy Pierre Jean,18,0,24,6
1713343420893,ANSC 101,A00,487225,Staff,17,0,20,3
1713343421927,ANSC 125,A00,487227,Brenner; Suzanne A,38,0,40,2
1713343423982,ANSC 146,A00,487229,Staff,35,0,40,5
1713343425064,ANSC 148,A00,487230,Olivas Hernandez; Olga Lid,39,0,40,1
1713343426093,ANSC 150,A00,504165,Sloane; Julia Kathryn,18,0,20,2
1713343427123,ANSC 180,A00,487232,Staff,14,0,15,1
1713343428150,ANSC 188,A00,627155,Staff,37,0,40,3
1713343429181,ANTH 5,A00,519529,Semendeferi; Ekaterini,15,0,15,0
1713343430207,ANTH 10,A00,487219,Staff,58,0,60,2
1713343431234,ANTH 23,A01,487221,Staff,17,0,20,3
1713343432266,ANTH 102,A00,487233,Wilder; Linnea Lorene,50,0,60,10
1713343433293,ANTH 103,A00,487234,Varma; Saiba,54,0,60,6
1713343434322,ANTH 105,A00,487235,Stewart; Alexander B,54,0,60,6
1713343435358,BENG 100,A01,516685,Taylor Amos; Alyssa C,25,0,30,5
1713343436397,BIBC 102,A01,491316,Flagg; Matthew Paul,5,0,88,83
1713343436397,BIBC 102,A02,491366,Flagg; Matthew Paul,78,0,88,10
1713343437429,BIBC 103,A01,491486,Boumechache; Miyyada,16,0,24,8
1713343437429,BIBC 103,A02,491487,Boumechache; Miyyada,24,0,24,0
1713343438464,BICD 100,A01,516882,Staff,73,0,75,2
1713343438464,BICD 100,A02,516890,Staff,69,0,75,6
1713343439496,BICD 102GS,A00,491488,Lo; Stanley M.,26,0,28,2
1713343440521,BIEB 136GS,A00,516940,Holway; David A. & Shurin; Jonathan,18,0,24,6
1713343441548,BIEB 137GS,A01,517034,Holway; David A. & Shurin; Jonathan,18,0,24,6
1713343442576,BIEB 138GS,A01,491492,Pirino; Giorgia,21,0,28,7
1713343443604,BILD 1,A01,491296,Staff,60,0,63,3
1713343443604,BILD 1,A02,491297,Staff,63,0,63,0
1713343444640,BILD 4,A01,517099,Gonzalez Gamboa; Ivonne,22,0,24,2
1713343444640,BILD 4,A02,517100,Gonzalez Gamboa; Ivonne,24,0,24,0
1713343445668,BILD 60GS,A00,491309,Lo; Stanley M.,26,0,28,2
1713343446699,BIMM 100,A01,517136,Staff,82,0,100,18
1713343447725,BIMM 110,A01,517182,Staff,52,0,100,48
1713343448753,BIMM 120,A01,517228,Pickett; Brooke Elizabeth,28,0,63,35
1713343448753,BIMM 120,A02,517240,Pickett; Brooke Elizabeth,44,0,63,19
1713343449778,BIMM 132GS,A01,491498,Pirino; Giorgia,21,0,28,7
1713343450807,BIMM 143,A01,491589,Bozinovic; Goran,12,0,40,28
1713343451844,BIPN 100,A01,491594,Armour; Jon Christopher,83,0,100,17
1713343452870,BIPN 140,A01,491602,Marino; Marc J,23,0,50,27
1713343454932,CAT 125,A00,515973,Staff,18,0,20,2
1713343455963,CAT 125GS,A00,515974,Rahimi; Babak,16,0,20,4
1713343456992,CAT 125R,A00,515980,Staff,12,0,20,8
1713343456992,CAT 125R,B00,515981,Tosun; Adriana,19,0,20,1
1713343456992,CAT 125R,C00,515987,Hyland; Tina Mae,0,5,20,20
1713343456992,CAT 125R,D00,515988,Bronstein; Phoebe Malan,16,0,20,4
1713343458019,CENG 15,A01,488699,Drews; Aaron,25,0,25,0
1713343459054,CENG 100,A00,505196,Opatkiewicz; Justin Paul,25,0,25,0
1713343460081,CGS 2A,A01,489598,Staff,32,0,35,3
1713343461106,CGS 112,A00,489599,Staff,15,0,15,0
1713343462158,CGS 119,A00,489603,Staff,10,0,10,0
1713343463187,CGS 120,A00,489604,Staff,13,0,15,2
1713343464213,CGS 150,A00,489607,Staff,15,0,15,0
1713343465245,CHEM 6A,A01,488715,Staff,97,0,100,3
1713343466273,CHEM 6B,A01,488719,Piercy; Marc Anthony,99,0,100,1
1713343467309,CHEM 6C,A01,488723,Albizati; Kim F.,93,0,100,7
1713343468346,CHEM 7L,A01,488728,Schurmeier; Kimberly,18,0,24,6
1713343468346,CHEM 7L,A02,488730,Schurmeier; Kimberly,23,0,24,1
1713343468346,CHEM 7L,A03,488734,Schurmeier; Kimberly,20,0,24,4
1713343468346,CHEM 7L,A04,488763,Schurmeier; Kimberly,23,0,24,1
1713343468346,CHEM 7L,B01,488798,Schurmeier; Kimberly,16,0,24,8
1713343468346,CHEM 7L,B02,488801,Schurmeier; Kimberly,22,0,24,2
1713343468346,CHEM 7L,B03,488808,Schurmeier; Kimberly,22,0,24,2
1713343468346,CHEM 7L,B04,488811,Schurmeier; Kimberly,24,0,24,0
1713343469377,CHEM 11,A01,488897,Stallings; Dontarie M,94,0,100,6
1713343470402,CHEM 40A,A01,488913,Albizati; Kim F.,83,0,100,17
1713343471436,CHEM 40B,A01,488920,Weizman; Haim,42,0,50,8
1713343471436,CHEM 40B,A02,488938,Weizman; Haim,43,0,50,7
1713343472463,CHEM 41A,A01,489029,Klosterman; Jeremy K,57,0,60,3
1713343473494,CHEM 41C,A01,500436,Tor; Yitzhak,54,0,60,6
1713343474523,CHEM 43A,A01,500426,Weizman; Haim,0,1,24,24
1713343474523,CHEM 43A,A02,500430,Weizman; Haim,6,0,24,18
1713343474523,CHEM 43A,B01,514041,Klosterman; Jeremy K,14,0,24,10
1713343474523,CHEM 43A,B02,514047,Klosterman; Jeremy K,23,0,24,1
1713343475557,CHEM 108,A01,489140,Jennings; Patricia A.,6,0,24,18
1713343475557,CHEM 108,A02,489142,Jennings; Patricia A.,14,0,24,10
1713343476585,CHEM 114A,A01,489147,Stallings; Dontarie M,65,0,100,35
1713343477612,CHIN 169A,A00,489171,Wang; Xiao,19,0,20,1
1713343479665,COGS 3,A01,518827,Boyle; Mary E. T.,25,0,40,15
1713343480692,COGS 11,A01,489175,Staff,27,0,30,3
1713343481716,COGS 14A,A01,518829,Staff,50,0,60,10
1713343482745,COGS 14B,A01,489177,Hoffman; Drew Ellen,62,0,75,13
1713343483777,COGS 100,A01,489181,Allen; Michael Gordon,62,0,75,13
1713343484807,COGS 101A,A01,489183,Staff,45,0,60,15
1713343485831,COGS 101B,A01,489185,Allen; Michael Gordon,6,0,30,24
1713343486861,COGS 101C,A01,526786,Staff,23,0,30,7
1713343488912,COGS 107A,A01,489189,Boyle; Mary E. T.,16,0,35,19
1713343489947,COGS 107B,A01,627144,Mooshagian; Eric Frederick,59,0,60,1
1713343490973,COGS 118A,A01,489191,Staff,0,46,40,40
1713343493030,COGS 171GS,A01,489194,Pineda; Jaime A,19,0,28,9
1713343494059,COGS 172,A01,489196,Staff,1,0,30,29
1713343495085,COGS 174GS,A01,489264,Pineda; Jaime A,19,0,28,9
1713343496114,COGS 180,A01,627150,Staff,28,0,30,2
1713343497139,COGS 186,A01,489274,Staff,0,2,30,30
1713343498170,COMM 10,A01,489276,Staff,23,0,25,2
1713343498170,COMM 10,A02,489303,Staff,23,0,25,2
1713343499201,COMM 100A,A01,489312,Staff,14,0,25,11
1713343499201,COMM 100A,A02,489313,Staff,24,0,25,1
1713343500233,COMM 106T,A00,512540,Staff,33,0,35,2
1713343501264,COMM 107,A00,489347,Staff,27,0,35,8
1713343502292,COMM 109P,A00,489358,Staff,31,0,35,4
1713343503319,COMM 132,A00,489361,McKenna; Denise,27,0,30,3
1713343504351,COMM 146,A00,489362,Halm; Gavin Patrick,26,0,30,4
1713343505379,COMM 190,A00,489363,Abuelhiga; Soraya Jill,17,0,23,6
1713343506406,CSE 8A,A50,489366,Staff,21,0,25,4
1713343506406,CSE 8A,A51,489367,Staff,24,0,25,1
1713343507433,CSE 11,A01,489398,Cao; Yingjun,72,0,100,28
1713343508464,CSE 12,A01,489487,Staff,43,0,50,7
1713343509489,CSE 20,A01,489497,Staff,47,0,50,3
1713343510585,CSE 21,A01,489517,Braun; Oliver,42,0,50,8
1713343511617,CSE 101,A01,489524,Braun; Oliver,0,33,50,50
1713343512651,CSE 105,A01,512594,Jones; Miles E,72,0,100,28
1713343512651,CSE 105,B01,512598,Jones; Miles E,51,0,100,49
1713343513678,CSE 140,A01,489538,Staff,39,0,50,11
1713343514714,CSE 141,A01,489550,Eldon; John,67,0,100,33
1713343515741,CSE 141L,A01,489571,Eldon; John,65,0,100,35
1713343516774,CSE 151A,A01,489583,Solares; Edwin A,140,0,200,60
1713343517810,CSE 175,A01,510886,Kumar; Rakesh,30,0,30,0
1713343518838,CSE 190,A00,516828,Dubnov; Shlomo,37,0,49,12
1713343519866,DOC 100D,A00,489667,Pass; Natalye Joann,19,0,25,6
1713343520898,DSC 10,A01,624268,Staff,72,0,75,3
1713343521925,DSC 20,A01,624476,Staff,50,0,50,0
1713343522954,DSC 40A,A01,624608,Staff,39,0,40,1
1713343523985,DSGN 1,A01,489179,Rill; Bryan,32,0,50,18
1713343525014,ECE 17,A01,490489,Sahay; Rajeev,18,0,30,12
1713343526047,ECE 65,A50,490492,Staff,11,0,20,9
1713343526047,ECE 65,A51,490493,Staff,18,0,20,2
1713343527082,ECON 1,A01,489715,Famulari; Melissa,67,0,70,3
1713343528110,ECON 2,A01,489717,Levkoff; Steven B.,67,0,70,3
1713343529196,ECON 3,A01,489948,Staff,70,0,70,0
1713343531260,ECON 5,A01,490103,Staff,27,0,30,3
1713343531260,ECON 5,B01,626281,Dai; Yinlin,45,0,45,0
1713343532294,ECON 100A,A01,490127,Famulari; Melissa,62,0,70,8
1713343533322,ECON 100B,A01,490129,Staff,64,0,70,6
1713343534348,ECON 109,A01,490187,Shishkin; Denis,27,0,35,8
1713343535376,ECON 110A,A01,490190,Levkoff; Steven B.,59,0,70,11
1713343536407,ECON 120A,A01,490245,Dai; Yinlin,59,0,70,11
1713343537441,ECON 120B,A01,490247,Nieto-Barthaburu; Augusto,40,0,70,30
1713343538467,ECON 120C,A01,490253,Sun; Yixiao,30,0,35,5
1713343538467,ECON 120C,B01,490255,Sun; Yixiao,34,0,35,1
1713343539497,ECON 129,A00,490256,Eckert; Fabian Paul,22,0,35,13
1713343540524,ECON 131,A00,490257,Nieto-Barthaburu; Augusto,0,6,35,35
1713343541560,ECON 138,A00,490258,Bharadwaj; Prashant,13,0,35,22
1713343541560,ECON 138,B00,490259,Bharadwaj; Prashant,15,0,35,20
1713343542593,ECON 159,A00,490260,Hendrickson; Gerald M.,0,9,0,0
1713343543620,ECON 178,A01,553995,Zhu; Ying,24,0,35,11
1713343544648,EDS 40,A01,512576,Black; Alison Michelle,20,0,20,0
1713343545675,EDS 107,A01,515848,Staff,30,0,30,0
1713343546701,EDS 110R,A01,490262,Staff,26,0,30,4
1713343547727,EDS 112,A01,490264,Chapman; Thandeka K,40,0,50,10
1713343548754,EDS 113,A00,490266,Staff,25,0,30,5
1713343549780,EDS 118,A00,490267,Warstadt; Melissa Fawn,18,0,30,12
1713343550811,EDS 124BR,A00,490268,Eguchi; Emi,4,0,25,21
1713343550811,EDS 124BR,B00,490269,Eguchi; Emi,23,0,25,2
1713343551838,EDS 126,A01,490271,Jones; Makeba,43,0,50,7
1713343552865,EDS 135,A01,490316,Staff,19,0,20,1
1713343553896,ENVR 142GS,A00,519514,Chang; Edmond Yi-Teh,26,0,28,2
1713343554923,ETHN 103,A00,490504,Staff,25,0,36,11
1713343555953,ETHN 103A,A00,490505,Man; Simeon S,3,0,9,6
1713343556980,ETHN 109,A00,490506,Staff,28,0,30,2
1713343558013,ETHN 118,A00,490507,Staff,35,0,36,1
1713343559039,ETHN 119,A00,490508,Staff,32,0,36,4
1713343560196,ETHN 121R,A00,490518,Choi; Esther Min,21,0,36,15
1713343561222,ETHN 127,A00,490528,Staff,14,0,15,1
1713343562247,ETHN 139,A00,490573,Staff,10,0,10,0
1713343563281,ETHN 150,A00,490575,Staff,15,0,15,0
1713343564308,GLBH 20,A00,491705,Elwardani; Nile Regina,38,0,40,2
1713343565335,GLBH 101,A00,491706,Staff,20,0,20,0
1713343566362,GLBH 111,A01,491708,Burgos; Jose L.,15,0,15,0
1713343567387,GLBH 146,A00,491709,Staff,8,0,20,12
1713343568414,GLBH 148,A00,491710,Olivas Hernandez; Olga Lid,10,0,20,10
1713343569439,GLBH 150,A00,491711,Sloane; Julia Kathryn,19,0,20,1
1713343570465,HIEA 131,A00,491760,Staff,28,0,32,4
1713343571490,HIEA 153,A00,491762,Staff,28,0,30,2
1713343572520,HIEU 124,A00,491811,Staff,26,0,32,6
1713343573547,HIEU 124GS,A00,491812,Markman; Kristina,27,0,28,1
1713343574578,HIEU 147,A00,491813,Staff,30,0,32,2
1713343575605,HIEU 149GS,A00,491816,Caldwell; Michael Alan,28,0,28,0
1713343576633,HILD 2C,A01,491713,Hendrickson; Gerald M.,26,0,30,4
1713343577659,HILD 7B,A01,491715,Kwak; Nancy,0,2,30,30
1713343578685,HILD 10,A01,491717,Staff,9,0,20,11
1713343579715,HILD 30GS,A00,491719,Edington; Claire Ellen,23,0,28,5
1713343580743,HINE 109,A00,491818,Shafir; Nir,26,0,32,6
1713343581769,HINE 128,A00,491821,Shafir; Nir,30,0,32,2
1713343582809,HISC 117,A00,491830,Staff,27,0,32,5
1713343583835,HIUS 103,A00,491834,Man; Simeon S,14,0,23,9
1713343584864,HIUS 108B,A00,491835,Staff,27,0,30,3
1713343585891,HIUS 141,A00,491836,Hendrickson; Gerald M.,28,0,32,4
1713343586919,HIUS 149,A00,491839,Staff,24,0,32,8
1713343587946,HUM 3,A01,512617,Crum; Matthew Stephen,42,0,50,8
1713343587946,HUM 3,A02,512618,Crum; Matthew Stephen,48,0,50,2
1713343588972,HUM 3GS,A00,512663,Markman; Kristina,0,0,0,1
1713343588972,HUM 3GS,B00,512664,Staff,0,0,0,0
1713343589999,HUM 4,A01,512620,West; Geoffrey Scott,23,0,50,27
1713343591025,HUM 4GS,A00,512666,Lyon; Antony J.,0,0,0,5
1713343592053,HUM 4R,A01,512625,Watkins; Eric,49,0,50,1
1713343593081,HUM 5,A01,512649,Zavodny; Tatiana Sophia,20,0,50,30
1713343593081,HUM 5,B01,512661,Zroka; Ryan Edward,48,0,50,2
1713343594110,INTL 190,A00,490577,Segui; Alan S,0,0,0,5
1713343595138,JAPN 20AR,A01,491267,Ross; Kayoko F,7,0,20,13
1713343596172,JAPN 180,A00,491285,Berman; Michael David,33,0,40,7
1713343597200,LATI 50,A01,502536,Kokinis; Troy Andreas,16,0,22,6
1713343597200,LATI 50,A02,502551,Kokinis; Troy Andreas,22,0,22,0
1713343597200,LATI 50,A03,502650,Kokinis; Troy Andreas,22,0,22,0
1713343597200,LATI 50,A04,502909,Kokinis; Troy Andreas,21,0,22,1
1713343598227,LATI 160,A01,502920,Kokinis; Troy Andreas,30,0,30,0
1713343599258,LIFR 1A,A00,490494,Van Moer; Vinciane G,17,0,20,3
1713343600289,LIFR 1AX,A00,490495,Van Moer; Vinciane G,17,0,20,3
1713343601318,LIFR 1B,A00,490496,Van Moer; Vinciane G,17,0,20,3
1713343602348,LIFR 1BX,A00,490497,Van Moer; Vinciane G,17,0,20,3
1713343603374,LIGN 8,A00,505198,McIntosh; Justin Daniel,134,0,150,16
1713343604405,LIGN 9GS,A00,491239,Lott; Margaret S.,18,0,20,2
1713343605431,LIGN 101,A01,505200,McIntosh; Justin Daniel,22,0,30,8
1713343606458,LIGN 120,A01,491244,Staff,22,0,30,8
1713343607484,LIGN 149GS,A00,491245,Lott; Margaret S.,18,0,20,2
1713343608508,LIGN 170,A00,491247,Staff,22,0,30,8
1713343609534,LISP 1D,A00,490498,Munoz Sanchez; Alicia,8,0,14,6
1713343609534,LISP 1D,B00,490499,Munoz Sanchez; Alicia,4,0,14,10
1713343609534,LISP 1D,C00,490500,Munoz Sanchez; Alicia,7,0,14,7
1713343609534,LISP 1D,D00,490501,Munoz Sanchez; Alicia,10,0,14,4
1713343610561,LISP 1DX,A00,490502,Munoz Sanchez; Alicia,11,0,28,17
1713343610561,LISP 1DX,B00,490503,Munoz Sanchez; Alicia,16,0,28,12
1713343612614,LTAM 110,A00,491847,Staff,22,0,25,3
1713343613638,LTCS 119,A00,491848,Staff,11,0,15,4
1713343614668,LTCS 130,A00,491849,Staff,24,0,25,1
1713343616725,LTEA 120C,A00,491852,Staff,32,0,40,8
1713343617751,LTEN 130GS,A00,491853,Lyon; Antony J.,23,0,28,5
1713343618778,LTEN 148,A00,491855,Staff,23,0,25,2
1713343619804,LTEN 159,A00,491856,Staff,20,0,25,5
1713343620833,LTEN 180,A00,491857,Staff,8,0,15,7
1713343622883,LTSP 123GS,A00,505928,Bessett; Ryan Matthew,24,0,28,4
1713343623913,LTSP 174GS,A00,506037,Bessett; Ryan Matthew,24,0,28,4
1713343625971,LTWR 102,A00,491861,Staff,9,0,15,6
1713343626996,LTWR 106,A00,491862,Staff,8,0,15,7
1713343628026,MAE 11,A00,490930,Bahadori; Mohammad Yousef,94,0,100,6
1713343629060,MAE 30A,A00,490931,Qi; Huihui,37,0,40,3
1713343630094,MAE 101A,A00,491036,Sadeghizadeh; Zahra,91,0,100,9
1713343631128,MAE 101C,A00,491037,Seshadri; Kalyanasundaram,63,0,100,37
1713343632155,MAE 113,A00,491040,Seshadri; Kalyanasundaram,64,0,80,16
1713343633238,MAE 131A,A00,491041,Ghazinejad; Maziar,37,0,40,3
1713343634266,MAE 142,A00,491053,Staff,39,0,40,1
1713343635291,MAE 143A,A00,491054,Staff,29,0,50,21
1713343636323,MAE 150,A00,491092,Truong; Phuong Thi Ngoc,23,0,35,12
1713343637349,MATH 3C,A01,494031,Pardo Guerra; Sebastian,30,0,30,0
1713343637349,MATH 3C,A02,494032,Pardo Guerra; Sebastian,29,0,30,1
1713343638375,MATH 10A,A01,494034,Staff,27,0,30,3
1713343638375,MATH 10A,A02,494035,Staff,28,0,30,2
1713343638375,MATH 10A,B01,494037,Staff,27,0,30,3
1713343638375,MATH 10A,B02,494038,Staff,29,0,30,1
1713343639405,MATH 10B,A01,494040,Habib; Yousaf,22,0,30,8
1713343639405,MATH 10B,A02,494041,Habib; Yousaf,28,0,30,2
1713343639405,MATH 10B,A03,494042,Habib; Yousaf,29,0,30,1
1713343639405,MATH 10B,A04,494043,Habib; Yousaf,30,0,30,0
1713343639405,MATH 10B,B01,494045,Habib; Yousaf,25,0,30,5
1713343639405,MATH 10B,B02,494046,Habib; Yousaf,30,0,30,0
1713343639405,MATH 10B,B03,494047,Habib; Yousaf,30,0,30,0
1713343639405,MATH 10B,B04,494048,Habib; Yousaf,30,0,30,0
1713343640433,MATH 18,A01,494050,Kemp; Todd Aahron,25,0,30,5
1713343640433,MATH 18,A02,494051,Kemp; Todd Aahron,29,0,30,1
1713343640433,MATH 18,B01,494054,Kemp; Todd Aahron,25,0,30,5
1713343640433,MATH 18,B02,494055,Kemp; Todd Aahron,29,0,30,1
1713343641460,MATH 20A,A01,494059,Suk; Andrew Hoon,30,0,30,0
1713343642487,MATH 20B,A01,494061,Briones; Jor-el Thomas Caparas,33,0,35,2
1713343642487,MATH 20B,B01,494063,Bach; Quang Tran,34,0,35,1
1713343643517,MATH 20C,A01,494065,Staff,28,0,30,2
1713343643517,MATH 20C,A02,494066,Staff,30,0,30,0
1713343643517,MATH 20C,A03,494067,Staff,30,0,30,0
1713343643517,MATH 20C,A04,494068,Staff,30,0,30,0
1713343643517,MATH 20C,B01,494070,Zhang; Ming,24,0,30,6
1713343643517,MATH 20C,B02,494071,Zhang; Ming,27,0,30,3
1713343643517,MATH 20C,B03,494072,Zhang; Ming,29,0,30,1
1713343643517,MATH 20C,B04,494073,Zhang; Ming,29,0,30,1
1713343644543,MATH 20D,A01,494075,Staff,22,0,30,8
1713343644543,MATH 20D,A02,494076,Staff,29,0,30,1
1713343645573,MATH 20E,A01,494079,Staff,24,0,30,6
1713343645573,MATH 20E,A02,494080,Staff,26,0,30,4
1713343645573,MATH 20E,B01,494082,Staff,25,0,30,5
1713343645573,MATH 20E,B02,494083,Staff,25,0,30,5
1713343646598,MATH 103A,A01,494085,Aliabadi Sr.; Mohsen,12,0,30,18
1713343646598,MATH 103A,A02,494086,Aliabadi Sr.; Mohsen,28,0,30,2
1713343646598,MATH 103A,B01,494088,Aliabadi Sr.; Mohsen,20,0,30,10
1713343646598,MATH 103A,B02,494089,Aliabadi Sr.; Mohsen,27,0,30,3
1713343647631,MATH 109,A01,494091,Staff,30,0,30,0
1713343647631,MATH 109,A02,494092,Staff,29,0,30,1
1713343647631,MATH 109,B01,494094,Staff,27,0,30,3
1713343647631,MATH 109,B02,494095,Staff,29,0,30,1
1713343648661,MATH 142A,A01,494097,Chow; Bennett,13,0,30,17
1713343648661,MATH 142A,A02,494098,Chow; Bennett,23,0,30,7
1713343648661,MATH 142A,B01,494100,Chow; Bennett,19,0,30,11
1713343648661,MATH 142A,B02,494101,Chow; Bennett,29,0,30,1
1713343650713,MATH 168A,A01,516677,Dumitriu; Ioana,16,0,35,19
1713343651740,MATH 170A,A01,516679,Dumitriu; Ioana,18,0,30,12
1713343651740,MATH 170A,A02,516680,Dumitriu; Ioana,28,0,30,2
1713343652768,MATH 193A,A01,494107,Staff,12,0,30,18
1713343652768,MATH 193A,A02,494108,Staff,18,0,30,12
1713343652768,MATH 193A,A03,494109,Staff,29,0,30,1
1713343652768,MATH 193A,A04,494110,Staff,22,0,30,8
1713343655862,MGT 16,A00,491930,McKay; Michael J,92,0,98,6
1713343656888,MGT 18,A00,491992,McKay; Michael J,96,0,98,2
1713343657916,MGT 71,A00,492003,Staff,63,0,98,35
1713343658948,MGT 103,A00,505209,Eberhard; Craig A,80,0,98,18
1713343659978,MGT 131A,A00,505210,Anderson; John Charles,89,0,98,9
1713343662036,MGT 153,A00,492077,Perols; Johan Lars,16,0,90,74
1713343665124,MGT 164,A00,492222,McKay; Mary A,91,0,98,7
1713343666153,MGT 172,A00,492245,Staff,59,0,60,1
1713343666153,MGT 172,B00,505526,Hedges; Kathleen,65,0,98,33
1713343667186,MGT 181,A00,505669,Dunn; Louis Jean,78,0,98,20
1713343668216,MMW 14,A01,494399,Staff,15,0,28,13
1713343668216,MMW 14,A02,494400,Staff,25,0,28,3
1713343668216,MMW 14,A03,494401,Staff,28,0,28,0
1713343668216,MMW 14,A04,494402,Staff,28,0,28,0
1713343668216,MMW 14,B01,494404,Carreras; Maria Victoria,8,0,28,20
1713343668216,MMW 14,B02,494405,Carreras; Maria Victoria,25,0,28,3
1713343668216,MMW 14,B03,494406,Carreras; Maria Victoria,27,0,28,1
1713343668216,MMW 14,B04,494407,Carreras; Maria Victoria,28,0,28,0
1713343669243,MMW 14GS,A00,506250,Chang; Edmond Yi-Teh,0,0,0,0
1713343670270,MMW 121R,A01,494415,Adamiak; Patrick John,10,0,28,18
1713343670270,MMW 121R,A02,494416,Adamiak; Patrick John,24,0,28,4
1713343671296,MUS 1A,A01,494113,Staff,12,0,25,13
1713343671296,MUS 1A,A02,494114,Staff,24,0,25,1
1713343672328,MUS 4,A01,494116,Staff,23,0,25,2
1713343672328,MUS 4,A02,494117,Staff,22,0,25,3
1713343673364,MUS 5R,A01,494236,Dubnov; Shlomo,4,0,25,21
1713343673364,MUS 5R,A02,494237,Dubnov; Shlomo,25,0,25,0
1713343674397,MUS 6,A01,494122,Staff,9,0,25,16
1713343674397,MUS 6,A02,494123,Staff,23,0,25,2
1713343675423,MUS 7,A01,494125,Staff,16,0,25,9
1713343675423,MUS 7,A02,494126,Staff,24,0,25,1
1713343676450,MUS 11,A01,494128,Staff,23,0,25,2
1713343676450,MUS 11,A02,494129,Staff,24,0,25,1
1713343677476,MUS 13,A01,494131,Staff,25,0,25,0
1713343677476,MUS 13,A02,494132,Staff,25,0,25,0
1713343678509,MUS 15,A01,494134,Staff,16,0,25,9
1713343678509,MUS 15,A02,494135,Staff,25,0,25,0
1713343678509,MUS 15,B01,494137,Staff,24,0,25,1
1713343679541,MUS 80,A00,494232,Staff,24,0,25,1
1713343679541,MUS 80,B00,494233,Staff,25,0,25,0
1713343679541,MUS 80,C00,494234,Staff,23,0,25,2
1713343680573,MUS 95C,A00,494141,Staff,69,0,75,6
1713343681598,MUS 114,A00,494142,Staff,39,0,50,11
1713343682635,NANO 15,A01,490636,Drews; Aaron,7,0,7,0
1713343683662,PHIL 1,A00,490578,Grush; Rick Scott,49,0,50,1
1713343684688,PHIL 10,A01,490580,Grush; Rick Scott,33,0,35,2
1713343684688,PHIL 10,A02,490586,Grush; Rick Scott,32,0,35,3
1713343685715,PHIL 27,A01,490591,Staff,22,0,25,3
1713343685715,PHIL 27,A02,490592,Staff,25,0,25,0
1713343685715,PHIL 27,A03,490593,Staff,25,0,25,0
1713343685715,PHIL 27,A04,490598,Staff,25,0,25,0
1713343686741,PHIL 32,A01,490611,Staff,20,0,20,0
1713343686741,PHIL 32,A02,490618,Staff,20,0,20,0
1713343687768,PHIL 90,A00,490624,Staff,40,0,40,0
1713343688796,PHIL 136,A00,490627,Cohen; Jonathan David,37,0,40,3
1713343689822,PHIL 155,A00,490634,Staff,62,0,70,8
1713343690860,PHYS 1A,A00,491610,Staff,245,0,250,5
1713343691886,PHYS 1AL,001,491616,Tsai; Philbert S,27,0,30,3
1713343691886,PHYS 1AL,002,491618,Tsai; Philbert S,30,0,30,0
1713343692911,PHYS 1B,A00,491623,Staff,235,0,250,15
1713343693936,PHYS 1BL,001,491626,Tsai; Philbert S,18,0,30,12
1713343693936,PHYS 1BL,002,491628,Tsai; Philbert S,26,0,30,4
1713343694962,PHYS 1C,A00,491632,Staff,212,0,245,33
1713343695989,PHYS 1CL,001,491635,Tsai; Philbert S,3,0,30,27
1713343695989,PHYS 1CL,002,491643,Tsai; Philbert S,22,0,30,8
1713343697016,PHYS 2AR,A01,491651,Meyertholen; Andrew D.,44,0,50,6
1713343698048,PHYS 2B,A01,491659,Staff,105,0,115,10
1713343699077,PHYS 2BL,A01,491685,Staff,21,0,24,3
1713343699077,PHYS 2BL,A02,491700,Staff,21,0,24,3
1713343700104,PHYS 2C,A01,505161,Staff,101,0,115,14
1713343701131,PHYS 4A,A01,491704,Grinstein; Benjamin,99,0,100,1
1713343702165,POLI 5D,A01,494144,Staff,3,0,5,2
1713343702165,POLI 5D,B01,626283,Dai; Yinlin,5,0,5,0
1713343703194,POLI 12,A00,494145,Staff,43,0,45,2
1713343704224,POLI 13R,A00,494146,Forman; Fonna,45,0,50,5
1713343705255,POLI 27,A01,494148,Staff,54,0,60,6
1713343706281,POLI 30,A00,494149,Staff,49,0,50,1
1713343707310,POLI 100DA,A00,494150,Staff,20,0,25,5
1713343709366,POLI 100I,A00,494152,Staff,27,0,30,3
1713343710393,POLI 104B,A00,494153,Smith; Glenn Chatmas,53,0,55,2
1713343711426,POLI 104F,A00,494154,Staff,28,0,30,2
1713343712452,POLI 104I,A00,494155,Smith; Glenn Chatmas,29,0,30,1
1713343713477,POLI 110C,A00,494156,Ingham; Sean,23,0,25,2
1713343714504,POLI 117R,A00,494157,Forman; Fonna,5,0,20,15
1713343715532,POLI 118,A00,494158,Ingham; Sean,21,0,25,4
1713343716557,POLI 120H,A00,494159,Fisk; David Lee,39,0,45,6
1713343717587,POLI 131CR,A00,494160,Hoston; Germaine,35,0,45,10
1713343718620,POLI 133J,A00,494161,Staff,31,0,35,4
1713343719647,POLI 135,A00,494162,Fisk; David Lee,33,0,35,2
1713343720679,POLI 140A,A00,494164,Staff,18,0,30,12
1713343721705,POLI 142I,A00,494165,Staff,30,0,30,0
1713343722737,POLI 144D,A00,494166,Staff,22,0,25,3
1713343723763,POLI 151,A00,494167,Staff,30,0,30,0
1713343724791,POLI 153,A00,494168,Staff,33,0,35,2
1713343725816,POLI 160AA,A00,494169,Staff,33,0,40,7
1713343726841,POLI 162,A00,494170,Mignozzetti; Umberto,18,0,25,7
1713343727866,POLI 171,A00,494171,Mignozzetti; Umberto,18,0,25,7
1713343728893,PSYC 1,A00,494172,Staff,95,0,100,5
1713343729920,PSYC 2,A00,494173,Moranton; Nirelia Melbina-,34,0,50,16
1713343730945,PSYC 3,A00,494174,Staff,29,0,30,1
1713343731975,PSYC 6,A00,494175,Staff,17,0,20,3
1713343733001,PSYC 60,A01,494177,Staff,37,0,45,8
1713343734028,PSYC 70,A01,505724,Geller; Emma Harlan,42,0,45,3
1713343735060,PSYC 101,A00,494180,Heyman; Gail D.,83,0,100,17
1713343736088,PSYC 105,A00,494181,Geller; Emma Harlan,51,0,90,39
1713343737171,PSYC 106,A00,494182,Dobkins; Karen R.,26,0,45,19
1713343738197,PSYC 108,A00,494183,Adrian; Julia Anna,89,0,100,11
1713343739224,PSYC 114,A01,494185,Winkielman; Piotr,0,4,30,30
1713343740266,PSYC 122,A00,494186,Moranton; Nirelia Melbina-,27,0,50,23
1713343741293,PSYC 124,A00,494187,Chapman; Eddie Nathaniel,69,0,80,11
1713343742319,PSYC 131,A00,494188,Anagnostaras; Stephan,39,0,80,41
1713343743354,PSYC 144,A00,494189,Staff,1,1,50,49
1713343744384,PSYC 154,A00,494190,Lacefield; Katharine I,105,0,180,75
1713343745412,PSYC 162,A00,494191,Wixted; John T,70,0,100,30
1713343746440,PSYC 172,A00,494192,Gorman; Michael R.,36,0,45,9
1713343747473,PSYC 178,A00,494193,Glaser; Dale,32,0,45,13
1713343748500,PSYC 193,A00,505725,Chapman; Eddie Nathaniel,20,0,20,0
1713343749530,RELI 145GS,A00,519817,Rahimi; Babak,17,0,20,3
1713343750555,SE 101A,A01,490862,Chadha; Mayank,23,0,25,2
1713343751583,SE 101C,A01,490924,Krysl; Petr,15,0,20,5
1713343752613,SE 110A,A01,490928,Staff,19,0,20,1
1713343753639,SE 130A,A00,490929,Morrison; Machel Leigh,54,0,70,16
1713343754666,SIO 1,A01,519325,Staff,39,0,40,1
1713343755696,SIO 30,A01,519327,Staff,38,0,40,2
1713343756728,SIO 40,A00,519328,Staff,39,0,40,1
1713343757760,SIO 46GS,A00,519819,Cook; Geoffrey W,15,0,25,10
1713343758787,SIO 109R,A00,494197,Forman; Fonna,0,3,20,20
1713343759816,SIO 121GS,A00,519827,Cook; Geoffrey W,15,0,25,10
1713343760843,SIO 132,A01,519330,Staff,38,0,40,2
1713343761869,SIO 133,A01,519397,Staff,37,0,40,3
1713343762896,SIO 139,A00,519396,Kacev; David,29,0,40,11
1713343763932,SOCI 1,A01,494199,Thorpe; Charles Robert,21,0,30,9
1713343763932,SOCI 1,A02,494200,Thorpe; Charles Robert,30,0,30,0
1713343763932,SOCI 1,A03,494201,Thorpe; Charles Robert,29,0,30,1
1713343763932,SOCI 1,A04,494202,Thorpe; Charles Robert,29,0,30,1
1713343763932,SOCI 1,A05,494203,Thorpe; Charles Robert,29,0,30,1
1713343763932,SOCI 1,A06,494204,Thorpe; Charles Robert,30,0,30,0
1713343763932,SOCI 1,A07,494205,Thorpe; Charles Robert,28,0,30,2
1713343764959,SOCI 60,A01,494207,Staff,33,0,40,7
1713343764959,SOCI 60,A02,494208,Staff,39,0,40,1
1713343765998,SOCI 100,A01,494210,Payne; Christine Anna,25,0,30,5
1713343765998,SOCI 100,A02,494211,Payne; Christine Anna,26,0,30,4
1713343767024,SOCI 109M,A00,494212,Staff,20,0,20,0
1713343768050,SOCI 110,A00,494213,Staff,34,0,40,6
1713343770117,SOCI 118E,A00,494215,Ng; Kwai,37,0,40,3
1713343771144,SOCI 125,A00,494216,Calderon-Zaks; Michael Aar,39,0,45,6
1713343772174,SOCI 126,A01,494218,Jones; Makeba,3,0,5,2
1713343773197,SOCI 131,A00,494219,Thorpe; Charles Robert,26,0,30,4
1713343775259,SOCI 135,A00,494221,Payne; Christine Anna,28,0,50,22
1713343776288,SOCI 136E,A00,626690,Ruiz; Jonathan Joseph,24,0,25,1
1713343777314,SOCI 138GS,A00,494222,Navon; Daniel,23,0,28,5
1713343779369,SOCI 145,A00,494224,Staff,40,0,45,5
1713343780398,SOCI 153,A00,494225,Staff,28,0,30,2
1713343781429,SOCI 160E,A00,494226,Ng; Kwai,27,0,40,13
1713343782456,SOCI 180,A00,494227,Staff,29,0,30,1
1713343783485,SOCI 189GS,A00,494228,Ribas Norris; Janet Vanesa,11,0,11,0
1713343784512,SOCI 190GS,A00,553232,Ribas Norris; Janet Vanesa,11,0,11,0
1713343785542,SOMI 220,A00,627178,Schneid; Stephen David,30,0,30,0
1713343786580,SYN 2,001,490768,Staff,13,0,15,2
1713343786580,SYN 2,002,490769,Staff,14,0,15,1
1713343786580,SYN 2,004,490775,Staff,0,0,0,0
1713343786580,SYN 2,003,490774,Staff,0,0,0,0
1713343786580,SYN 2,005,490776,Staff,0,0,0,0
1713343787606,SYN 2R,001,490779,Staff,10,0,15,5
1713343787606,SYN 2R,002,514635,Staff,14,0,15,1
1713343788633,SYN 100,A01,490783,Staff,8,0,20,12
1713343788633,SYN 100,B01,490787,Staff,10,0,20,10
1713343788633,SYN 100,C01,490789,Staff,10,0,20,10
1713343789656,SYN 150,A00,490817,Staff,14,0,15,1
1713343789656,SYN 150,B00,514610,Staff,15,0,15,0
1713343790686,TDAC 1,A00,492753,Walsh; Kim C.,19,0,20,1
1713343790686,TDAC 1,B00,492754,Harting; Carla Kelso,18,0,20,2
1713343790686,TDAC 1,C00,513995,Salovey; Todd,15,0,20,5
1713343791714,TDAC 101,A00,492766,Harting; Carla Kelso,17,0,20,3
1713343792741,TDAC 102,A00,492768,Basso; Beatrice,19,0,20,1
1713343793767,TDDE 111,A00,492769,Staff,25,0,25,0
1713343794797,TDDE 131,A00,492770,Staff,15,0,15,0
1713343794797,TDDE 131,B00,492771,Staff,15,0,15,0
1713343795824,TDDE 131GS,A00,523716,Guirguis; Mark C,23,0,28,5
1713343796855,TDGE 1,A01,492756,Salovey; Todd,56,0,60,4
1713343797885,TDGE 5,A01,492758,Staff,23,0,25,2
1713343798911,TDGE 10,A00,492759,Fulton; Julia,203,0,220,17
1713343799939,TDGE 11,A00,492760,Castro; Robert Jess,198,0,200,2
1713343801993,TDGE 124,A00,492772,Fulton; Julia,180,0,220,40
1713343803022,TDGE 125,A00,492773,Meyer; Ursula,38,0,50,12
1713343803022,TDGE 125,B00,492774,Staff,49,0,50,1
1713343803022,TDGE 125,C00,523565,Staff,48,0,50,2
1713343804054,TDGE 125GS,A00,523580,Guirguis; Mark C,23,0,28,5
1713343805080,TDGE 127,A00,492775,Havis; Allan,33,0,50,17
1713343806105,TDHT 101,A00,492776,Staff,34,0,35,1
1713343807134,TDMV 1,A00,492762,Caligagan; Maria T.,29,0,30,1
1713343807134,TDMV 1,B00,492763,Arcidiacono; Kristin,26,0,30,4
1713343808168,TDMV 2,A00,492764,Weinberg; Sadie,27,0,30,3
1713343809199,TDMV 3,A00,492765,Mack; Kara Shanai',37,0,40,3
1713343810228,TDMV 138,A00,492777,Mack; Kara Shanai',32,0,40,8
1713343811259,TDMV 140,A00,492778,Lima; Paulo Henrique,40,0,40,0
1713343812285,TDMV 142,A00,492779,Caligagan; Maria T.,33,0,40,7
1713343812285,TDMV 142,B00,492780,Caligagan; Tony,37,0,40,3
1713343813310,TDMV 143,A00,492781,Fyall; Daunte Edward,39,0,40,1
1713343814343,USP 1,A01,492401,Kwak; Nancy,27,0,35,8
1713343815372,USP 2,A01,492453,Hinds; Juli Beth,35,0,35,0
1713343816398,USP 3,A01,492516,Staff,28,0,35,7
1713343817425,USP 4,A00,492522,McTague; Sarah,16,0,25,9
1713343818452,USP 100,A00,492523,Staff,32,0,35,3
1713343819480,USP 101,A00,492524,Staff,13,0,15,2
1713343820510,USP 105,A00,492525,Staff,21,0,25,4
1713343821536,USP 151,A00,492526,Shenkman; Michael Thomas,32,0,35,3
1713343822569,USP 170,A00,492545,Hinds; Juli Beth,33,0,35,2
1713343823594,USP 171GS,A00,492608,Bussell; Mirle Rabinowitz,24,0,28,4
1713343824619,USP 183GS,A00,492613,Peerson; Susan,24,0,28,4
1713343825646,VIS 30,A01,490693,Yoldas; Pinar,19,0,22,3
1713343825646,VIS 30,A02,490694,Yoldas; Pinar,18,0,22,4
1713343826670,VIS 83,A00,490695,Kester; Grant,63,0,75,12
1713343827695,VIS 105D,A00,490696,Staff,22,0,25,3
1713343828722,VIS 124CN,A00,490699,Rose; Jordan M,64,0,75,11
1713343829749,VIS 125GS,A00,511221,Williams; Alena J,21,0,22,1
1713343830776,VIS 128D,A00,490700,Staff,73,0,75,2
1713343831802,VIS 151,A01,490717,Staff,33,0,34,1
1713343831802,VIS 151,A02,490766,Staff,32,0,34,2
1713343832833,VIS 154GS,A00,511972,Williams; Alena J,21,0,22,1
1713343833870,VIS 160A,A00,490767,Stone; Patricia,7,0,10,3
1713343834901,WCWP 10A,A00,490638,Staff,14,0,15,1
1713343834901,WCWP 10A,B00,490640,Staff,15,0,15,0
1713343835929,WCWP 10B,A00,490641,Staff,0,0,0,0
1713343835929,WCWP 10B,B00,490642,Staff,14,0,15,1
1713343835929,WCWP 10B,C00,490644,Staff,13,0,15,2
1713343835929,WCWP 10B,D00,490647,Staff,0,0,0,0
1713343836955,WCWP 100,A00,490655,Staff,0,0,0,0
1713343836955,WCWP 100,B00,490687,Staff,10,0,15,5
1713343839063,ANAR 153,A00,487222,Braswell; Geoffrey E.,53,0,60,7
1713343840094,ANBI 134,A00,487223,Staff,5,0,20,15
1713343841178,ANBI 143GS,A00,487224,Noel; Geoffroy Pierre Jean,18,0,24,6
1713343842205,ANBI 144GS,A00,519548,Noel; Geoffroy Pierre Jean,18,0,24,6
1713343843236,ANSC 101,A00,487225,Staff,17,0,20,3
1713343844265,ANSC 125,A00,487227,Brenner; Suzanne A,38,0,40,2
1713343846316,ANSC 146,A00,487229,Staff,35,0,40,5
1713343847347,ANSC 148,A00,487230,Olivas Hernandez; Olga Lid,39,0,40,1
1713343848376,ANSC 150,A00,504165,Sloane; Julia Kathryn,18,0,20,2
1713343849409,ANSC 180,A00,487232,Staff,14,0,15,1
1713343850435,ANSC 188,A00,627155,Staff,37,0,40,3
1713343851466,ANTH 5,A00,519529,Semendeferi; Ekaterini,15,0,15,0
1713343852493,ANTH 10,A00,487219,Staff,58,0,60,2
1713343853523,ANTH 23,A01,487221,Staff,17,0,20,3
1713343854554,ANTH 102,A00,487233,Wilder; Linnea Lorene,50,0,60,10
1713343855587,ANTH 103,A00,487234,Varma; Saiba,54,0,60,6
1713343856621,ANTH 105,A00,487235,Stewart; Alexander B,54,0,60,6
1713343857649,BENG 100,A01,516685,Taylor Amos; Alyssa C,25,0,30,5
1713343858678,BIBC 102,A01,491316,Flagg; Matthew Paul,5,0,88,83
1713343858678,BIBC 102,A02,491366,Flagg; Matthew Paul,78,0,88,10
1713343859708,BIBC 103,A01,491486,Boumechache; Miyyada,16,0,24,8
1713343859708,BIBC 103,A02,491487,Boumechache; Miyyada,24,0,24,0
1713343860734,BICD 100,A01,516882,Staff,73,0,75,2
1713343860734,BICD 100,A02,516890,Staff,69,0,75,6
1713343861769,BICD 102GS,A00,491488,Lo; Stanley M.,26,0,28,2
1713343862796,BIEB 136GS,A00,516940,Holway; David A. & Shurin; Jonathan,18,0,24,6
1713343863822,BIEB 137GS,A01,517034,Holway; David A. & Shurin; Jonathan,18,0,24,6
1713343864853,BIEB 138GS,A01,491492,Pirino; Giorgia,21,0,28,7
1713343865885,BILD 1,A01,491296,Staff,60,0,63,3
1713343865885,BILD 1,A02,491297,Staff,63,0,63,0
1713343866912,BILD 4,A01,517099,Gonzalez Gamboa; Ivonne,22,0,24,2
1713343866912,BILD 4,A02,517100,Gonzalez Gamboa; Ivonne,24,0,24,0
1713343867936,BILD 60GS,A00,491309,Lo; Stanley M.,26,0,28,2
1713343868964,BIMM 100,A01,517136,Staff,82,0,100,18
1713343869991,BIMM 110,A01,517182,Staff,52,0,100,48
1713343871026,BIMM 120,A01,517228,Pickett; Brooke Elizabeth,28,0,63,35
1713343871026,BIMM 120,A02,517240,Pickett; Brooke Elizabeth,44,0,63,19
1713343872061,BIMM 132GS,A01,491498,Pirino; Giorgia,21,0,28,7
1713343873099,BIMM 143,A01,491589,Bozinovic; Goran,12,0,40,28
1713343874134,BIPN 100,A01,491594,Armour; Jon Christopher,83,0,100,17
1713343875161,BIPN 140,A01,491602,Marino; Marc J,23,0,50,27
1713343877223,CAT 125,A00,515973,Staff,18,0,20,2
1713343878248,CAT 125GS,A00,515974,Rahimi; Babak,16,0,20,4
1713343879282,CAT 125R,A00,515980,Staff,12,0,20,8
1713343879282,CAT 125R,B00,515981,Tosun; Adriana,19,0,20,1
1713343879282,CAT 125R,C00,515987,Hyland; Tina Mae,0,5,20,20
1713343879282,CAT 125R,D00,515988,Bronstein; Phoebe Malan,16,0,20,4
1713343880309,CENG 15,A01,488699,Drews; Aaron,25,0,25,0
1713343881335,CENG 100,A00,505196,Opatkiewicz; Justin Paul,25,0,25,0
1713343882371,CGS 2A,A01,489598,Staff,32,0,35,3
1713343883394,CGS 112,A00,489599,Staff,15,0,15,0
1713343884421,CGS 119,A00,489603,Staff,10,0,10,0
1713343885447,CGS 120,A00,489604,Staff,13,0,15,2
1713343886476,CGS 150,A00,489607,Staff,15,0,15,0
1713343887503,CHEM 6A,A01,488715,Staff,97,0,100,3
1713343888530,CHEM 6B,A01,488719,Piercy; Marc Anthony,99,0,100,1
1713343889562,CHEM 6C,A01,488723,Albizati; Kim F.,93,0,100,7
1713343890590,CHEM 7L,A01,488728,Schurmeier; Kimberly,18,0,24,6
1713343890590,CHEM 7L,A02,488730,Schurmeier; Kimberly,23,0,24,1
1713343890590,CHEM 7L,A03,488734,Schurmeier; Kimberly,20,0,24,4
1713343890590,CHEM 7L,A04,488763,Schurmeier; Kimberly,23,0,24,1
1713343890590,CHEM 7L,B01,488798,Schurmeier; Kimberly,16,0,24,8
1713343890590,CHEM 7L,B02,488801,Schurmeier; Kimberly,22,0,24,2
1713343890590,CHEM 7L,B03,488808,Schurmeier; Kimberly,22,0,24,2
1713343890590,CHEM 7L,B04,488811,Schurmeier; Kimberly,24,0,24,0
1713343891617,CHEM 11,A01,488897,Stallings; Dontarie M,94,0,100,6
1713343892643,CHEM 40A,A01,488913,Albizati; Kim F.,83,0,100,17
1713343893675,CHEM 40B,A01,488920,Weizman; Haim,42,0,50,8
1713343893675,CHEM 40B,A02,488938,Weizman; Haim,43,0,50,7
1713343894716,CHEM 41A,A01,489029,Klosterman; Jeremy K,57,0,60,3
1713343895742,CHEM 41C,A01,500436,Tor; Yitzhak,54,0,60,6
1713343896767,CHEM 43A,A01,500426,Weizman; Haim,0,1,24,24
1713343896767,CHEM 43A,A02,500430,Weizman; Haim,6,0,24,18
1713343896767,CHEM 43A,B01,514041,Klosterman; Jeremy K,14,0,24,10
1713343896767,CHEM 43A,B02,514047,Klosterman; Jeremy K,23,0,24,1
1713343897795,CHEM 108,A01,489140,Jennings; Patricia A.,6,0,24,18
1713343897795,CHEM 108,A02,489142,Jennings; Patricia A.,14,0,24,10
1713343898828,CHEM 114A,A01,489147,Stallings; Dontarie M,65,0,100,35
1713343899859,CHIN 169A,A00,489171,Wang; Xiao,19,0,20,1
1713343901910,COGS 3,A01,518827,Boyle; Mary E. T.,25,0,40,15
1713343902937,COGS 11,A01,489175,Staff,27,0,30,3
1713343903964,COGS 14A,A01,518829,Staff,50,0,60,10
1713343904997,COGS 14B,A01,489177,Hoffman; Drew Ellen,62,0,75,13
1713343906023,COGS 100,A01,489181,Allen; Michael Gordon,62,0,75,13
1713343907048,COGS 101A,A01,489183,Staff,45,0,60,15
1713343908077,COGS 101B,A01,489185,Allen; Michael Gordon,6,0,30,24
1713343909103,COGS 101C,A01,526786,Staff,23,0,30,7
1713343911160,COGS 107A,A01,489189,Boyle; Mary E. T.,16,0,35,19
1713343912193,COGS 107B,A01,627144,Mooshagian; Eric Frederick,59,0,60,1
1713343913223,COGS 118A,A01,489191,Staff,0,46,40,40
1713343915275,COGS 171GS,A01,489194,Pineda; Jaime A,19,0,28,9
1713343916302,COGS 172,A01,489196,Staff,1,0,30,29
1713343917326,COGS 174GS,A01,489264,Pineda; Jaime A,19,0,28,9
1713343918358,COGS 180,A01,627150,Staff,28,0,30,2
1713343919384,COGS 186,A01,489274,Staff,0,3,30,30
1713343920412,COMM 10,A01,489276,Staff,23,0,25,2
1713343920412,COMM 10,A02,489303,Staff,23,0,25,2
1713343921443,COMM 100A,A01,489312,Staff,14,0,25,11
1713343921443,COMM 100A,A02,489313,Staff,24,0,25,1
1713343922469,COMM 106T,A00,512540,Staff,33,0,35,2
1713343923500,COMM 107,A00,489347,Staff,27,0,35,8
1713343924525,COMM 109P,A00,489358,Staff,31,0,35,4
1713343925555,COMM 132,A00,489361,McKenna; Denise,27,0,30,3
1713343926583,COMM 146,A00,489362,Halm; Gavin Patrick,26,0,30,4
1713343927610,COMM 190,A00,489363,Abuelhiga; Soraya Jill,17,0,23,6
1713343928638,CSE 8A,A50,489366,Staff,21,0,25,4
1713343928638,CSE 8A,A51,489367,Staff,24,0,25,1
1713343929663,CSE 11,A01,489398,Cao; Yingjun,72,0,100,28
1713343930696,CSE 12,A01,489487,Staff,43,0,50,7
1713343931727,CSE 20,A01,489497,Staff,47,0,50,3
1713343932754,CSE 21,A01,489517,Braun; Oliver,42,0,50,8
1713343933790,CSE 101,A01,489524,Braun; Oliver,0,33,50,50
1713343934818,CSE 105,A01,512594,Jones; Miles E,72,0,100,28
1713343934818,CSE 105,B01,512598,Jones; Miles E,51,0,100,49
1713343935864,CSE 140,A01,489538,Staff,39,0,50,11
1713343936891,CSE 141,A01,489550,Eldon; John,67,0,100,33
1713343937916,CSE 141L,A01,489571,Eldon; John,65,0,100,35
1713343938944,CSE 151A,A01,489583,Solares; Edwin A,140,0,200,60
1713343939974,CSE 175,A01,510886,Kumar; Rakesh,30,0,30,0
1713343941000,CSE 190,A00,516828,Dubnov; Shlomo,37,0,49,12
1713343942026,DOC 100D,A00,489667,Pass; Natalye Joann,19,0,25,6
1713343943052,DSC 10,A01,624268,Staff,72,0,75,3
1713343944083,DSC 20,A01,624476,Staff,50,0,50,0
1713343945178,DSC 40A,A01,624608,Staff,39,0,40,1
1713343946204,DSGN 1,A01,489179,Rill; Bryan,32,0,50,18
1713343947242,ECE 17,A01,490489,Sahay; Rajeev,18,0,30,12
1713343948268,ECE 65,A50,490492,Staff,11,0,20,9
1713343948268,ECE 65,A51,490493,Staff,18,0,20,2
1713343949296,ECON 1,A01,489715,Famulari; Melissa,67,0,70,3
1713343950325,ECON 2,A01,489717,Levkoff; Steven B.,67,0,70,3
1713343951351,ECON 3,A01,489948,Staff,70,0,70,0
1713343953405,ECON 5,A01,490103,Staff,27,0,30,3
1713343953405,ECON 5,B01,626281,Dai; Yinlin,45,0,45,0
1713343954430,ECON 100A,A01,490127,Famulari; Melissa,62,0,70,8
1713343955456,ECON 100B,A01,490129,Staff,64,0,70,6
1713343956491,ECON 109,A01,490187,Shishkin; Denis,27,0,35,8
1713343957516,ECON 110A,A01,490190,Levkoff; Steven B.,59,0,70,11
1713343958542,ECON 120A,A01,490245,Dai; Yinlin,59,0,70,11
1713343959569,ECON 120B,A01,490247,Nieto-Barthaburu; Augusto,40,0,70,30
1713343960601,ECON 120C,A01,490253,Sun; Yixiao,30,0,35,5
1713343960601,ECON 120C,B01,490255,Sun; Yixiao,34,0,35,1
1713343961627,ECON 129,A00,490256,Eckert; Fabian Paul,22,0,35,13
1713343962659,ECON 131,A00,490257,Nieto-Barthaburu; Augusto,0,6,35,35
1713343963693,ECON 138,A00,490258,Bharadwaj; Prashant,13,0,35,22
1713343963693,ECON 138,B00,490259,Bharadwaj; Prashant,15,0,35,20
1713343964726,ECON 159,A00,490260,Hendrickson; Gerald M.,0,9,0,0
1713343965754,ECON 178,A01,553995,Zhu; Ying,24,0,35,11
1713343966782,EDS 40,A01,512576,Black; Alison Michelle,20,0,20,0
1713343967808,EDS 107,A01,515848,Staff,30,0,30,0
1713343968834,EDS 110R,A01,490262,Staff,26,0,30,4
1713343969863,EDS 112,A01,490264,Chapman; Thandeka K,40,0,50,10
1713343970889,EDS 113,A00,490266,Staff,25,0,30,5
1713343971915,EDS 118,A00,490267,Warstadt; Melissa Fawn,18,0,30,12
1713343972940,EDS 124BR,A00,490268,Eguchi; Emi,4,0,25,21
1713343972940,EDS 124BR,B00,490269,Eguchi; Emi,23,0,25,2
1713343973967,EDS 126,A01,490271,Jones; Makeba,43,0,50,7
1713343975000,EDS 135,A01,490316,Staff,19,0,20,1
1713343976030,ENVR 142GS,A00,519514,Chang; Edmond Yi-Teh,26,0,28,2
1713343977058,ETHN 103,A00,490504,Staff,25,0,36,11
1713343978090,ETHN 103A,A00,490505,Man; Simeon S,3,0,9,6
1713343979116,ETHN 109,A00,490506,Staff,28,0,30,2
1713343980145,ETHN 118,A00,490507,Staff,35,0,36,1
1713343981171,ETHN 119,A00,490508,Staff,32,0,36,4
1713343982196,ETHN 121R,A00,490518,Choi; Esther Min,21,0,36,15
1713343983231,ETHN 127,A00,490528,Staff,14,0,15,1
1713343984258,ETHN 139,A00,490573,Staff,10,0,10,0
1713343985287,ETHN 150,A00,490575,Staff,15,0,15,0
1713343986326,GLBH 20,A00,491705,Elwardani; Nile Regina,38,0,40,2
1713343987356,GLBH 101,A00,491706,Staff,20,0,20,0
1713343988390,GLBH 111,A01,491708,Burgos; Jose L.,15,0,15,0
1713343989414,GLBH 146,A00,491709,Staff,8,0,20,12
1713343990441,GLBH 148,A00,491710,Olivas Hernandez; Olga Lid,10,0,20,10
1713343991471,GLBH 150,A00,491711,Sloane; Julia Kathryn,19,0,20,1
1713343992496,HIEA 131,A00,491760,Staff,28,0,32,4
1713343993521,HIEA 153,A00,491762,Staff,28,0,30,2
1713343994547,HIEU 124,A00,491811,Staff,26,0,32,6
1713343995583,HIEU 124GS,A00,491812,Markman; Kristina,27,0,28,1
1713343996610,HIEU 147,A00,491813,Staff,30,0,32,2
1713343997636,HIEU 149GS,A00,491816,Caldwell; Michael Alan,28,0,28,0
1713343998662,HILD 2C,A01,491713,Hendrickson; Gerald M.,26,0,30,4
1713343999689,HILD 7B,A01,491715,Kwak; Nancy,0,2,30,30
1713344000717,HILD 10,A01,491717,Staff,9,0,20,11
1713344001743,HILD 30GS,A00,491719,Edington; Claire Ellen,23,0,28,5
1713344002768,HINE 109,A00,491818,Shafir; Nir,26,0,32,6
1713344003794,HINE 128,A00,491821,Shafir; Nir,30,0,32,2
1713344004820,HISC 117,A00,491830,Staff,27,0,32,5
1713344005850,HIUS 103,A00,491834,Man; Simeon S,14,0,23,9
1713344006875,HIUS 108B,A00,491835,Staff,27,0,30,3
1713344007903,HIUS 141,A00,491836,Hendrickson; Gerald M.,28,0,32,4
1713344008929,HIUS 149,A00,491839,Staff,24,0,32,8
1713344009956,HUM 3,A01,512617,Crum; Matthew Stephen,42,0,50,8
1713344009956,HUM 3,A02,512618,Crum; Matthew Stephen,48,0,50,2
1713344010991,HUM 3GS,A00,512663,Markman; Kristina,0,0,0,1
1713344010991,HUM 3GS,B00,512664,Staff,0,0,0,0
1713344012019,HUM 4,A01,512620,West; Geoffrey Scott,23,0,50,27
1713344013048,HUM 4GS,A00,512666,Lyon; Antony J.,0,0,0,5
1713344014084,HUM 4R,A01,512625,Watkins; Eric,49,0,50,1
1713344015113,HUM 5,A01,512649,Zavodny; Tatiana Sophia,20,0,50,30
1713344015113,HUM 5,B01,512661,Zroka; Ryan Edward,48,0,50,2
1713344016141,INTL 190,A00,490577,Segui; Alan S,0,0,0,5
1713344017169,JAPN 20AR,A01,491267,Ross; Kayoko F,7,0,20,13
1713344018199,JAPN 180,A00,491285,Berman; Michael David,33,0,40,7
1713344019226,LATI 50,A01,502536,Kokinis; Troy Andreas,16,0,22,6
1713344019226,LATI 50,A02,502551,Kokinis; Troy Andreas,22,0,22,0
1713344019226,LATI 50,A03,502650,Kokinis; Troy Andreas,22,0,22,0
1713344019226,LATI 50,A04,502909,Kokinis; Troy Andreas,21,0,22,1
1713344020260,LATI 160,A01,502920,Kokinis; Troy Andreas,30,0,30,0
1713344021288,LIFR 1A,A00,490494,Van Moer; Vinciane G,17,0,20,3
1713344022317,LIFR 1AX,A00,490495,Van Moer; Vinciane G,17,0,20,3
1713344023343,LIFR 1B,A00,490496,Van Moer; Vinciane G,17,0,20,3
1713344024370,LIFR 1BX,A00,490497,Van Moer; Vinciane G,17,0,20,3
1713344025398,LIGN 8,A00,505198,McIntosh; Justin Daniel,134,0,150,16
1713344026424,LIGN 9GS,A00,491239,Lott; Margaret S.,18,0,20,2
1713344027453,LIGN 101,A01,505200,McIntosh; Justin Daniel,22,0,30,8
1713344028486,LIGN 120,A01,491244,Staff,22,0,30,8
1713344029513,LIGN 149GS,A00,491245,Lott; Margaret S.,18,0,20,2
1713344030547,LIGN 170,A00,491247,Staff,22,0,30,8
1713344031580,LISP 1D,A00,490498,Munoz Sanchez; Alicia,8,0,14,6
1713344031580,LISP 1D,B00,490499,Munoz Sanchez; Alicia,4,0,14,10
1713344031580,LISP 1D,C00,490500,Munoz Sanchez; Alicia,7,0,14,7
1713344031580,LISP 1D,D00,490501,Munoz Sanchez; Alicia,10,0,14,4
1713344032608,LISP 1DX,A00,490502,Munoz Sanchez; Alicia,11,0,28,17
1713344032608,LISP 1DX,B00,490503,Munoz Sanchez; Alicia,16,0,28,12
1713344034671,LTAM 110,A00,491847,Staff,22,0,25,3
1713344035698,LTCS 119,A00,491848,Staff,11,0,15,4
1713344036728,LTCS 130,A00,491849,Staff,24,0,25,1
1713344038792,LTEA 120C,A00,491852,Staff,32,0,40,8
1713344039820,LTEN 130GS,A00,491853,Lyon; Antony J.,23,0,28,5
1713344040874,LTEN 148,A00,491855,Staff,23,0,25,2
1713344041914,LTEN 159,A00,491856,Staff,20,0,25,5
1713344042941,LTEN 180,A00,491857,Staff,8,0,15,7
1713344045008,LTSP 123GS,A00,505928,Bessett; Ryan Matthew,24,0,28,4
1713344046039,LTSP 174GS,A00,506037,Bessett; Ryan Matthew,24,0,28,4
1713344048094,LTWR 102,A00,491861,Staff,9,0,15,6
1713344049193,LTWR 106,A00,491862,Staff,8,0,15,7
1713344050227,MAE 11,A00,490930,Bahadori; Mohammad Yousef,94,0,100,6
1713344051260,MAE 30A,A00,490931,Qi; Huihui,37,0,40,3
1713344052288,MAE 101A,A00,491036,Sadeghizadeh; Zahra,91,0,100,9
1713344053320,MAE 101C,A00,491037,Seshadri; Kalyanasundaram,63,0,100,37
1713344054348,MAE 113,A00,491040,Seshadri; Kalyanasundaram,64,0,80,16
1713344055375,MAE 131A,A00,491041,Ghazinejad; Maziar,37,0,40,3
1713344056403,MAE 142,A00,491053,Staff,39,0,40,1
1713344057432,MAE 143A,A00,491054,Staff,29,0,50,21
1713344058466,MAE 150,A00,491092,Truong; Phuong Thi Ngoc,23,0,35,12
1713344059494,MATH 3C,A01,494031,Pardo Guerra; Sebastian,30,0,30,0
1713344059494,MATH 3C,A02,494032,Pardo Guerra; Sebastian,29,0,30,1
1713344060523,MATH 10A,A01,494034,Staff,27,0,30,3
1713344060523,MATH 10A,A02,494035,Staff,28,0,30,2
1713344060523,MATH 10A,B01,494037,Staff,27,0,30,3
1713344060523,MATH 10A,B02,494038,Staff,29,0,30,1
1713344061551,MATH 10B,A01,494040,Habib; Yousaf,22,0,30,8
1713344061551,MATH 10B,A02,494041,Habib; Yousaf,28,0,30,2
1713344061551,MATH 10B,A03,494042,Habib; Yousaf,29,0,30,1
1713344061551,MATH 10B,A04,494043,Habib; Yousaf,30,0,30,0
1713344061551,MATH 10B,B01,494045,Habib; Yousaf,25,0,30,5
1713344061551,MATH 10B,B02,494046,Habib; Yousaf,30,0,30,0
1713344061551,MATH 10B,B03,494047,Habib; Yousaf,30,0,30,0
1713344061551,MATH 10B,B04,494048,Habib; Yousaf,30,0,30,0
1713344062587,MATH 18,A01,494050,Kemp; Todd Aahron,25,0,30,5
1713344062587,MATH 18,A02,494051,Kemp; Todd Aahron,29,0,30,1
1713344062587,MATH 18,B01,494054,Kemp; Todd Aahron,25,0,30,5
1713344062587,MATH 18,B02,494055,Kemp; Todd Aahron,29,0,30,1
1713344063623,MATH 20A,A01,494059,Suk; Andrew Hoon,30,0,30,0
1713344064649,MATH 20B,A01,494061,Briones; Jor-el Thomas Caparas,33,0,35,2
1713344064649,MATH 20B,B01,494063,Bach; Quang Tran,34,0,35,1
1713344065679,MATH 20C,A01,494065,Staff,28,0,30,2
1713344065679,MATH 20C,A02,494066,Staff,30,0,30,0
1713344065679,MATH 20C,A03,494067,Staff,30,0,30,0
1713344065679,MATH 20C,A04,494068,Staff,30,0,30,0
1713344065679,MATH 20C,B01,494070,Zhang; Ming,24,0,30,6
1713344065679,MATH 20C,B02,494071,Zhang; Ming,27,0,30,3
1713344065679,MATH 20C,B03,494072,Zhang; Ming,29,0,30,1
1713344065679,MATH 20C,B04,494073,Zhang; Ming,29,0,30,1
1713344066706,MATH 20D,A01,494075,Staff,22,0,30,8
1713344066706,MATH 20D,A02,494076,Staff,29,0,30,1
1713344067739,MATH 20E,A01,494079,Staff,24,0,30,6
1713344067739,MATH 20E,A02,494080,Staff,26,0,30,4
1713344067739,MATH 20E,B01,494082,Staff,25,0,30,5
1713344067739,MATH 20E,B02,494083,Staff,25,0,30,5
1713344068772,MATH 103A,A01,494085,Aliabadi Sr.; Mohsen,12,0,30,18
1713344068772,MATH 103A,A02,494086,Aliabadi Sr.; Mohsen,28,0,30,2
1713344068772,MATH 103A,B01,494088,Aliabadi Sr.; Mohsen,20,0,30,10
1713344068772,MATH 103A,B02,494089,Aliabadi Sr.; Mohsen,27,0,30,3
1713344069800,MATH 109,A01,494091,Staff,30,0,30,0
1713344069800,MATH 109,A02,494092,Staff,29,0,30,1
1713344069800,MATH 109,B01,494094,Staff,27,0,30,3
1713344069800,MATH 109,B02,494095,Staff,29,0,30,1
1713344070828,MATH 142A,A01,494097,Chow; Bennett,13,0,30,17
1713344070828,MATH 142A,A02,494098,Chow; Bennett,23,0,30,7
1713344070828,MATH 142A,B01,494100,Chow; Bennett,19,0,30,11
1713344070828,MATH 142A,B02,494101,Chow; Bennett,29,0,30,1
1713344072886,MATH 168A,A01,516677,Dumitriu; Ioana,16,0,35,19
1713344073914,MATH 170A,A01,516679,Dumitriu; Ioana,18,0,30,12
1713344073914,MATH 170A,A02,516680,Dumitriu; Ioana,28,0,30,2
1713344074947,MATH 193A,A01,494107,Staff,12,0,30,18
1713344074947,MATH 193A,A02,494108,Staff,18,0,30,12
1713344074947,MATH 193A,A03,494109,Staff,29,0,30,1
1713344074947,MATH 193A,A04,494110,Staff,22,0,30,8
1713344078032,MGT 16,A00,491930,McKay; Michael J,92,0,98,6
1713344079059,MGT 18,A00,491992,McKay; Michael J,96,0,98,2
1713344080089,MGT 71,A00,492003,Staff,63,0,98,35
1713344081116,MGT 103,A00,505209,Eberhard; Craig A,80,0,98,18
1713344082150,MGT 131A,A00,505210,Anderson; John Charles,89,0,98,9
1713344084214,MGT 153,A00,492077,Perols; Johan Lars,15,0,90,75
1713344087296,MGT 164,A00,492222,McKay; Mary A,91,0,98,7
1713344088322,MGT 172,A00,492245,Staff,59,0,60,1
1713344088322,MGT 172,B00,505526,Hedges; Kathleen,65,0,98,33
1713344089349,MGT 181,A00,505669,Dunn; Louis Jean,78,0,98,20
1713344090382,MMW 14,A01,494399,Staff,15,0,28,13
1713344090382,MMW 14,A02,494400,Staff,25,0,28,3
1713344090382,MMW 14,A03,494401,Staff,28,0,28,0
1713344090382,MMW 14,A04,494402,Staff,28,0,28,0
1713344090382,MMW 14,B01,494404,Carreras; Maria Victoria,8,0,28,20
1713344090382,MMW 14,B02,494405,Carreras; Maria Victoria,25,0,28,3
1713344090382,MMW 14,B03,494406,Carreras; Maria Victoria,27,0,28,1
1713344090382,MMW 14,B04,494407,Carreras; Maria Victoria,28,0,28,0
1713344091408,MMW 14GS,A00,506250,Chang; Edmond Yi-Teh,0,0,0,0
1713344092434,MMW 121R,A01,494415,Adamiak; Patrick John,10,0,28,18
1713344092434,MMW 121R,A02,494416,Adamiak; Patrick John,24,0,28,4
1713344093460,MUS 1A,A01,494113,Staff,12,0,25,13
1713344093460,MUS 1A,A02,494114,Staff,24,0,25,1
1713344094484,MUS 4,A01,494116,Staff,23,0,25,2
1713344094484,MUS 4,A02,494117,Staff,22,0,25,3
1713344095512,MUS 5R,A01,494236,Dubnov; Shlomo,4,0,25,21
1713344095512,MUS 5R,A02,494237,Dubnov; Shlomo,25,0,25,0
1713344096539,MUS 6,A01,494122,Staff,9,0,25,16
1713344096539,MUS 6,A02,494123,Staff,23,0,25,2
1713344097573,MUS 7,A01,494125,Staff,16,0,25,9
1713344097573,MUS 7,A02,494126,Staff,24,0,25,1
1713344098606,MUS 11,A01,494128,Staff,23,0,25,2
1713344098606,MUS 11,A02,494129,Staff,24,0,25,1
1713344099634,MUS 13,A01,494131,Staff,25,0,25,0
1713344099634,MUS 13,A02,494132,Staff,25,0,25,0
1713344100680,MUS 15,A01,494134,Staff,16,0,25,9
1713344100680,MUS 15,A02,494135,Staff,25,0,25,0
1713344100680,MUS 15,B01,494137,Staff,24,0,25,1
1713344101712,MUS 80,A00,494232,Staff,24,0,25,1
1713344101712,MUS 80,B00,494233,Staff,25,0,25,0
1713344101712,MUS 80,C00,494234,Staff,23,0,25,2
1713344102744,MUS 95C,A00,494141,Staff,69,0,75,6
1713344103771,MUS 114,A00,494142,Staff,39,0,50,11
1713344104808,NANO 15,A01,490636,Drews; Aaron,7,0,7,0
1713344105852,PHIL 1,A00,490578,Grush; Rick Scott,49,0,50,1
1713344106879,PHIL 10,A01,490580,Grush; Rick Scott,33,0,35,2
1713344106879,PHIL 10,A02,490586,Grush; Rick Scott,32,0,35,3
1713344107914,PHIL 27,A01,490591,Staff,22,0,25,3
1713344107914,PHIL 27,A02,490592,Staff,25,0,25,0
1713344107914,PHIL 27,A03,490593,Staff,25,0,25,0
1713344107914,PHIL 27,A04,490598,Staff,25,0,25,0
1713344108955,PHIL 32,A01,490611,Staff,20,0,20,0
1713344108955,PHIL 32,A02,490618,Staff,20,0,20,0
1713344109987,PHIL 90,A00,490624,Staff,40,0,40,0
1713344111018,PHIL 136,A00,490627,Cohen; Jonathan David,37,0,40,3
1713344112047,PHIL 155,A00,490634,Staff,62,0,70,8
1713344113081,PHYS 1A,A00,491610,Staff,245,0,250,5
1713344114113,PHYS 1AL,001,491616,Tsai; Philbert S,27,0,30,3
1713344114113,PHYS 1AL,002,491618,Tsai; Philbert S,30,0,30,0
1713344115148,PHYS 1B,A00,491623,Staff,235,0,250,15
1713344116181,PHYS 1BL,001,491626,Tsai; Philbert S,18,0,30,12
1713344116181,PHYS 1BL,002,491628,Tsai; Philbert S,26,0,30,4
1713344117213,PHYS 1C,A00,491632,Staff,212,0,245,33
1713344118252,PHYS 1CL,001,491635,Tsai; Philbert S,3,0,30,27
1713344118252,PHYS 1CL,002,491643,Tsai; Philbert S,22,0,30,8
1713344119279,PHYS 2AR,A01,491651,Meyertholen; Andrew D.,44,0,50,6
1713344120310,PHYS 2B,A01,491659,Staff,105,0,115,10
1713344121335,PHYS 2BL,A01,491685,Staff,21,0,24,3
1713344121335,PHYS 2BL,A02,491700,Staff,21,0,24,3
1713344122380,PHYS 2C,A01,505161,Staff,101,0,115,14
1713344123406,PHYS 4A,A01,491704,Grinstein; Benjamin,99,0,100,1
1713344124443,POLI 5D,A01,494144,Staff,3,0,5,2
1713344124443,POLI 5D,B01,626283,Dai; Yinlin,5,0,5,0
1713344125470,POLI 12,A00,494145,Staff,43,0,45,2
1713344126496,POLI 13R,A00,494146,Forman; Fonna,45,0,50,5
1713344127522,POLI 27,A01,494148,Staff,54,0,60,6
1713344128548,POLI 30,A00,494149,Staff,49,0,50,1
1713344129575,POLI 100DA,A00,494150,Staff,20,0,25,5
1713344131626,POLI 100I,A00,494152,Staff,27,0,30,3
1713344132652,POLI 104B,A00,494153,Smith; Glenn Chatmas,53,0,55,2
1713344133682,POLI 104F,A00,494154,Staff,28,0,30,2
1713344134721,POLI 104I,A00,494155,Smith; Glenn Chatmas,29,0,30,1
1713344135747,POLI 110C,A00,494156,Ingham; Sean,23,0,25,2
1713344136779,POLI 117R,A00,494157,Forman; Fonna,5,0,20,15
1713344137805,POLI 118,A00,494158,Ingham; Sean,21,0,25,4
1713344138832,POLI 120H,A00,494159,Fisk; David Lee,39,0,45,6
1713344139862,POLI 131CR,A00,494160,Hoston; Germaine,35,0,45,10
1713344140893,POLI 133J,A00,494161,Staff,31,0,35,4
1713344141920,POLI 135,A00,494162,Fisk; David Lee,33,0,35,2
1713344142946,POLI 140A,A00,494164,Staff,18,0,30,12
1713344143970,POLI 142I,A00,494165,Staff,30,0,30,0
1713344144997,POLI 144D,A00,494166,Staff,22,0,25,3
1713344146023,POLI 151,A00,494167,Staff,30,0,30,0
1713344147050,POLI 153,A00,494168,Staff,33,0,35,2
1713344148076,POLI 160AA,A00,494169,Staff,33,0,40,7
1713344149111,POLI 162,A00,494170,Mignozzetti; Umberto,18,0,25,7
1713344150138,POLI 171,A00,494171,Mignozzetti; Umberto,18,0,25,7
1713344151165,PSYC 1,A00,494172,Staff,95,0,100,5
1713344152196,PSYC 2,A00,494173,Moranton; Nirelia Melbina-,34,0,50,16
1713344153276,PSYC 3,A00,494174,Staff,29,0,30,1
1713344154300,PSYC 6,A00,494175,Staff,17,0,20,3
1713344155326,PSYC 60,A01,494177,Staff,37,0,45,8
1713344156352,PSYC 70,A01,505724,Geller; Emma Harlan,42,0,45,3
1713344157384,PSYC 101,A00,494180,Heyman; Gail D.,83,0,100,17
1713344158410,PSYC 105,A00,494181,Geller; Emma Harlan,51,0,90,39
1713344159436,PSYC 106,A00,494182,Dobkins; Karen R.,26,0,45,19
1713344160463,PSYC 108,A00,494183,Adrian; Julia Anna,89,0,100,11
1713344161495,PSYC 114,A01,494185,Winkielman; Piotr,0,4,30,30
1713344162529,PSYC 122,A00,494186,Moranton; Nirelia Melbina-,27,0,50,23
1713344163554,PSYC 124,A00,494187,Chapman; Eddie Nathaniel,69,0,80,11
1713344164580,PSYC 131,A00,494188,Anagnostaras; Stephan,39,0,80,41
1713344165605,PSYC 144,A00,494189,Staff,1,1,50,49
1713344166631,PSYC 154,A00,494190,Lacefield; Katharine I,105,0,180,75
1713344167662,PSYC 162,A00,494191,Wixted; John T,70,0,100,30
1713344168693,PSYC 172,A00,494192,Gorman; Michael R.,36,0,45,9
1713344169720,PSYC 178,A00,494193,Glaser; Dale,32,0,45,13
1713344170751,PSYC 193,A00,505725,Chapman; Eddie Nathaniel,20,0,20,0
1713344171778,RELI 145GS,A00,519817,Rahimi; Babak,17,0,20,3
1713344172805,SE 101A,A01,490862,Chadha; Mayank,23,0,25,2
1713344173833,SE 101C,A01,490924,Krysl; Petr,15,0,20,5
1713344174861,SE 110A,A01,490928,Staff,19,0,20,1
1713344175898,SE 130A,A00,490929,Morrison; Machel Leigh,54,0,70,16
1713344176930,SIO 1,A01,519325,Staff,39,0,40,1
1713344177958,SIO 30,A01,519327,Staff,38,0,40,2
1713344178987,SIO 40,A00,519328,Staff,39,0,40,1
1713344180019,SIO 46GS,A00,519819,Cook; Geoffrey W,15,0,25,10
1713344181048,SIO 109R,A00,494197,Forman; Fonna,0,3,20,20
1713344182081,SIO 121GS,A00,519827,Cook; Geoffrey W,15,0,25,10
1713344183112,SIO 132,A01,519330,Staff,38,0,40,2
1713344184143,SIO 133,A01,519397,Staff,37,0,40,3
1713344185169,SIO 139,A00,519396,Kacev; David,29,0,40,11
1713344186203,SOCI 1,A01,494199,Thorpe; Charles Robert,21,0,30,9
1713344186203,SOCI 1,A02,494200,Thorpe; Charles Robert,30,0,30,0
1713344186203,SOCI 1,A03,494201,Thorpe; Charles Robert,29,0,30,1
1713344186203,SOCI 1,A04,494202,Thorpe; Charles Robert,29,0,30,1
1713344186203,SOCI 1,A05,494203,Thorpe; Charles Robert,29,0,30,1
1713344186203,SOCI 1,A06,494204,Thorpe; Charles Robert,30,0,30,0
1713344186203,SOCI 1,A07,494205,Thorpe; Charles Robert,28,0,30,2
1713344187234,SOCI 60,A01,494207,Staff,33,0,40,7
1713344187234,SOCI 60,A02,494208,Staff,39,0,40,1
1713344188262,SOCI 100,A01,494210,Payne; Christine Anna,25,0,30,5
1713344188262,SOCI 100,A02,494211,Payne; Christine Anna,26,0,30,4
1713344189295,SOCI 109M,A00,494212,Staff,20,0,20,0
1713344190327,SOCI 110,A00,494213,Staff,34,0,40,6
1713344192381,SOCI 118E,A00,494215,Ng; Kwai,37,0,40,3
1713344193409,SOCI 125,A00,494216,Calderon-Zaks; Michael Aar,39,0,45,6
1713344194436,SOCI 126,A01,494218,Jones; Makeba,3,0,5,2
1713344195466,SOCI 131,A00,494219,Thorpe; Charles Robert,26,0,30,4
1713344197528,SOCI 135,A00,494221,Payne; Christine Anna,28,0,50,22
1713344198555,SOCI 136E,A00,626690,Ruiz; Jonathan Joseph,24,0,25,1
1713344199588,SOCI 138GS,A00,494222,Navon; Daniel,23,0,28,5
1713344201640,SOCI 145,A00,494224,Staff,40,0,45,5
1713344202671,SOCI 153,A00,494225,Staff,28,0,30,2
1713344203702,SOCI 160E,A00,494226,Ng; Kwai,27,0,40,13
1713344204727,SOCI 180,A00,494227,Staff,29,0,30,1
1713344205753,SOCI 189GS,A00,494228,Ribas Norris; Janet Vanesa,11,0,11,0
1713344206783,SOCI 190GS,A00,553232,Ribas Norris; Janet Vanesa,11,0,11,0
1713344207817,SOMI 220,A00,627178,Schneid; Stephen David,30,0,30,0
1713344208844,SYN 2,001,490768,Staff,13,0,15,2
1713344208844,SYN 2,002,490769,Staff,14,0,15,1
1713344208844,SYN 2,004,490775,Staff,0,0,0,0
1713344208844,SYN 2,003,490774,Staff,0,0,0,0
1713344208844,SYN 2,005,490776,Staff,0,0,0,0
1713344209876,SYN 2R,001,490779,Staff,10,0,15,5
1713344209876,SYN 2R,002,514635,Staff,14,0,15,1
1713344210904,SYN 100,A01,490783,Staff,8,0,20,12
1713344210904,SYN 100,B01,490787,Staff,10,0,20,10
1713344210904,SYN 100,C01,490789,Staff,10,0,20,10
1713344211933,SYN 150,A00,490817,Staff,14,0,15,1
1713344211933,SYN 150,B00,514610,Staff,15,0,15,0
1713344212963,TDAC 1,A00,492753,Walsh; Kim C.,19,0,20,1
1713344212963,TDAC 1,B00,492754,Harting; Carla Kelso,18,0,20,2
1713344212963,TDAC 1,C00,513995,Salovey; Todd,15,0,20,5
1713344213997,TDAC 101,A00,492766,Harting; Carla Kelso,17,0,20,3
1713344215032,TDAC 102,A00,492768,Basso; Beatrice,19,0,20,1
1713344216059,TDDE 111,A00,492769,Staff,25,0,25,0
1713344217091,TDDE 131,A00,492770,Staff,15,0,15,0
1713344217091,TDDE 131,B00,492771,Staff,15,0,15,0
1713344218116,TDDE 131GS,A00,523716,Guirguis; Mark C,23,0,28,5
1713344219147,TDGE 1,A01,492756,Salovey; Todd,56,0,60,4
1713344220178,TDGE 5,A01,492758,Staff,23,0,25,2
1713344221205,TDGE 10,A00,492759,Fulton; Julia,203,0,220,17
1713344222237,TDGE 11,A00,492760,Castro; Robert Jess,198,0,200,2
1713344224293,TDGE 124,A00,492772,Fulton; Julia,180,0,220,40
1713344225320,TDGE 125,A00,492773,Meyer; Ursula,38,0,50,12
1713344225320,TDGE 125,B00,492774,Staff,49,0,50,1
1713344225320,TDGE 125,C00,523565,Staff,48,0,50,2
1713344226352,TDGE 125GS,A00,523580,Guirguis; Mark C,23,0,28,5
1713344227377,TDGE 127,A00,492775,Havis; Allan,33,0,50,17
1713344228404,TDHT 101,A00,492776,Staff,34,0,35,1
1713344229430,TDMV 1,A00,492762,Caligagan; Maria T.,29,0,30,1
1713344229430,TDMV 1,B00,492763,Arcidiacono; Kristin,26,0,30,4
1713344230463,TDMV 2,A00,492764,Weinberg; Sadie,27,0,30,3
1713344231490,TDMV 3,A00,492765,Mack; Kara Shanai',37,0,40,3
1713344232513,TDMV 138,A00,492777,Mack; Kara Shanai',32,0,40,8
1713344233537,TDMV 140,A00,492778,Lima; Paulo Henrique,40,0,40,0
1713344234564,TDMV 142,A00,492779,Caligagan; Maria T.,33,0,40,7
1713344234564,TDMV 142,B00,492780,Caligagan; Tony,37,0,40,3
1713344235589,TDMV 143,A00,492781,Fyall; Daunte Edward,39,0,40,1
1713344236622,USP 1,A01,492401,Kwak; Nancy,27,0,35,8
1713344237650,USP 2,A01,492453,Hinds; Juli Beth,35,0,35,0
1713344238677,USP 3,A01,492516,Staff,28,0,35,7
1713344239702,USP 4,A00,492522,McTague; Sarah,16,0,25,9
1713344240732,USP 100,A00,492523,Staff,32,0,35,3
1713344241758,USP 101,A00,492524,Staff,13,0,15,2
1713344242785,USP 105,A00,492525,Staff,21,0,25,4
1713344243813,USP 151,A00,492526,Shenkman; Michael Thomas,32,0,35,3
1713344244839,USP 170,A00,492545,Hinds; Juli Beth,33,0,35,2
1713344245865,USP 171GS,A00,492608,Bussell; Mirle Rabinowitz,24,0,28,4
1713344246895,USP 183GS,A00,492613,Peerson; Susan,24,0,28,4
1713344247923,VIS 30,A01,490693,Yoldas; Pinar,19,0,22,3
1713344247923,VIS 30,A02,490694,Yoldas; Pinar,18,0,22,4
1713344248951,VIS 83,A00,490695,Kester; Grant,63,0,75,12
1713344249978,VIS 105D,A00,490696,Staff,22,0,25,3
1713344251005,VIS 124CN,A00,490699,Rose; Jordan M,64,0,75,11
1713344252029,VIS 125GS,A00,511221,Williams; Alena J,21,0,22,1
1713344253056,VIS 128D,A00,490700,Staff,73,0,75,2
1713344254082,VIS 151,A01,490717,Staff,33,0,34,1
1713344254082,VIS 151,A02,490766,Staff,32,0,34,2
1713344255108,VIS 154GS,A00,511972,Williams; Alena J,21,0,22,1
1713344256136,VIS 160A,A00,490767,Stone; Patricia,7,0,10,3
1713344257223,WCWP 10A,A00,490638,Staff,14,0,15,1
1713344257223,WCWP 10A,B00,490640,Staff,15,0,15,0
1713344258250,WCWP 10B,A00,490641,Staff,0,0,0,0
1713344258250,WCWP 10B,B00,490642,Staff,14,0,15,1
1713344258250,WCWP 10B,C00,490644,Staff,13,0,15,2
1713344258250,WCWP 10B,D00,490647,Staff,0,0,0,0
1713344259279,WCWP 100,A00,490655,Staff,0,0,0,0
1713344259279,WCWP 100,B00,490687,Staff,10,0,15,5
1713344261441,ANAR 153,A00,487222,Braswell; Geoffrey E.,53,0,60,7
1713344262473,ANBI 134,A00,487223,Staff,5,0,20,15
1713344263505,ANBI 143GS,A00,487224,Noel; Geoffroy Pierre Jean,18,0,24,6
1713344264531,ANBI 144GS,A00,519548,Noel; Geoffroy Pierre Jean,18,0,24,6
1713344265556,ANSC 101,A00,487225,Staff,17,0,20,3
1713344266583,ANSC 125,A00,487227,Brenner; Suzanne A,38,0,40,2
1713344268642,ANSC 146,A00,487229,Staff,35,0,40,5
1713344269673,ANSC 148,A00,487230,Olivas Hernandez; Olga Lid,39,0,40,1
1713344270702,ANSC 150,A00,504165,Sloane; Julia Kathryn,18,0,20,2
1713344271728,ANSC 180,A00,487232,Staff,14,0,15,1
1713344272758,ANSC 188,A00,627155,Staff,37,0,40,3
1713344273788,ANTH 5,A00,519529,Semendeferi; Ekaterini,15,0,15,0
1713344274816,ANTH 10,A00,487219,Staff,58,0,60,2
1713344275849,ANTH 23,A01,487221,Staff,17,0,20,3
1713344276875,ANTH 102,A00,487233,Wilder; Linnea Lorene,50,0,60,10
1713344277908,ANTH 103,A00,487234,Varma; Saiba,54,0,60,6
1713344278936,ANTH 105,A00,487235,Stewart; Alexander B,54,0,60,6
1713344279971,BENG 100,A01,516685,Taylor Amos; Alyssa C,25,0,30,5
1713344280998,BIBC 102,A01,491316,Flagg; Matthew Paul,5,0,88,83
1713344280998,BIBC 102,A02,491366,Flagg; Matthew Paul,78,0,88,10
1713344282030,BIBC 103,A01,491486,Boumechache; Miyyada,16,0,24,8
1713344282030,BIBC 103,A02,491487,Boumechache; Miyyada,24,0,24,0
1713344283059,BICD 100,A01,516882,Staff,73,0,75,2
1713344283059,BICD 100,A02,516890,Staff,69,0,75,6
1713344284087,BICD 102GS,A00,491488,Lo; Stanley M.,26,0,28,2
1713344285114,BIEB 136GS,A00,516940,Holway; David A. & Shurin; Jonathan,18,0,24,6
1713344286140,BIEB 137GS,A01,517034,Holway; David A. & Shurin; Jonathan,18,0,24,6
1713344287165,BIEB 138GS,A01,491492,Pirino; Giorgia,21,0,28,7
1713344288191,BILD 1,A01,491296,Staff,60,0,63,3
1713344288191,BILD 1,A02,491297,Staff,63,0,63,0
1713344289217,BILD 4,A01,517099,Gonzalez Gamboa; Ivonne,22,0,24,2
1713344289217,BILD 4,A02,517100,Gonzalez Gamboa; Ivonne,24,0,24,0
1713344290250,BILD 60GS,A00,491309,Lo; Stanley M.,26,0,28,2
1713344291277,BIMM 100,A01,517136,Staff,82,0,100,18
1713344292308,BIMM 110,A01,517182,Staff,52,0,100,48
1713344293339,BIMM 120,A01,517228,Pickett; Brooke Elizabeth,28,0,63,35
1713344293339,BIMM 120,A02,517240,Pickett; Brooke Elizabeth,44,0,63,19
1713344294371,BIMM 132GS,A01,491498,Pirino; Giorgia,21,0,28,7
1713344295399,BIMM 143,A01,491589,Bozinovic; Goran,12,0,40,28
1713344296431,BIPN 100,A01,491594,Armour; Jon Christopher,83,0,100,17
1713344297462,BIPN 140,A01,491602,Marino; Marc J,23,0,50,27
1713344299516,CAT 125,A00,515973,Staff,18,0,20,2
1713344300547,CAT 125GS,A00,515974,Rahimi; Babak,16,0,20,4
1713344301572,CAT 125R,A00,515980,Staff,12,0,20,8
1713344301572,CAT 125R,B00,515981,Tosun; Adriana,19,0,20,1
1713344301572,CAT 125R,C00,515987,Hyland; Tina Mae,0,5,20,20
1713344301572,CAT 125R,D00,515988,Bronstein; Phoebe Malan,16,0,20,4
1713344302598,CENG 15,A01,488699,Drews; Aaron,25,0,25,0
1713344303625,CENG 100,A00,505196,Opatkiewicz; Justin Paul,25,0,25,0
1713344304653,CGS 2A,A01,489598,Staff,32,0,35,3
1713344305677,CGS 112,A00,489599,Staff,15,0,15,0
1713344306706,CGS 119,A00,489603,Staff,10,0,10,0
1713344307734,CGS 120,A00,489604,Staff,13,0,15,2
1713344308760,CGS 150,A00,489607,Staff,15,0,15,0
1713344309792,CHEM 6A,A01,488715,Staff,97,0,100,3
1713344310836,CHEM 6B,A01,488719,Piercy; Marc Anthony,99,0,100,1
1713344311863,CHEM 6C,A01,488723,Albizati; Kim F.,93,0,100,7
1713344312900,CHEM 7L,A01,488728,Schurmeier; Kimberly,18,0,24,6
1713344312900,CHEM 7L,A02,488730,Schurmeier; Kimberly,23,0,24,1
1713344312900,CHEM 7L,A03,488734,Schurmeier; Kimberly,20,0,24,4
1713344312900,CHEM 7L,A04,488763,Schurmeier; Kimberly,23,0,24,1
1713344312900,CHEM 7L,B01,488798,Schurmeier; Kimberly,16,0,24,8
1713344312900,CHEM 7L,B02,488801,Schurmeier; Kimberly,22,0,24,2
1713344312900,CHEM 7L,B03,488808,Schurmeier; Kimberly,22,0,24,2
1713344312900,CHEM 7L,B04,488811,Schurmeier; Kimberly,24,0,24,0
1713344313927,CHEM 11,A01,488897,Stallings; Dontarie M,94,0,100,6
1713344314954,CHEM 40A,A01,488913,Albizati; Kim F.,83,0,100,17
1713344315981,CHEM 40B,A01,488920,Weizman; Haim,42,0,50,8
1713344315981,CHEM 40B,A02,488938,Weizman; Haim,43,0,50,7
1713344317013,CHEM 41A,A01,489029,Klosterman; Jeremy K,57,0,60,3
1713344318040,CHEM 41C,A01,500436,Tor; Yitzhak,54,0,60,6
1713344319079,CHEM 43A,A01,500426,Weizman; Haim,0,1,24,24
1713344319079,CHEM 43A,A02,500430,Weizman; Haim,6,0,24,18
1713344319079,CHEM 43A,B01,514041,Klosterman; Jeremy K,14,0,24,10
1713344319079,CHEM 43A,B02,514047,Klosterman; Jeremy K,23,0,24,1
1713344320110,CHEM 108,A01,489140,Jennings; Patricia A.,6,0,24,18
1713344320110,CHEM 108,A02,489142,Jennings; Patricia A.,14,0,24,10
1713344321138,CHEM 114A,A01,489147,Stallings; Dontarie M,65,0,100,35
1713344322165,CHIN 169A,A00,489171,Wang; Xiao,19,0,20,1
1713344324221,COGS 3,A01,518827,Boyle; Mary E. T.,25,0,40,15
1713344325246,COGS 11,A01,489175,Staff,27,0,30,3
1713344326277,COGS 14A,A01,518829,Staff,50,0,60,10
1713344327303,COGS 14B,A01,489177,Hoffman; Drew Ellen,62,0,75,13
1713344328332,COGS 100,A01,489181,Allen; Michael Gordon,62,0,75,13
1713344329358,COGS 101A,A01,489183,Staff,45,0,60,15
1713344330385,COGS 101B,A01,489185,Allen; Michael Gordon,6,0,30,24
1713344331419,COGS 101C,A01,526786,Staff,23,0,30,7
1713344333472,COGS 107A,A01,489189,Boyle; Mary E. T.,16,0,35,19
1713344334501,COGS 107B,A01,627144,Mooshagian; Eric Frederick,59,0,60,1
1713344335528,COGS 118A,A01,489191,Staff,0,46,40,40
1713344337579,COGS 171GS,A01,489194,Pineda; Jaime A,19,0,28,9
1713344338605,COGS 172,A01,489196,Staff,1,0,30,29
1713344339635,COGS 174GS,A01,489264,Pineda; Jaime A,19,0,28,9
1713344340665,COGS 180,A01,627150,Staff,28,0,30,2
1713344341691,COGS 186,A01,489274,Staff,0,3,30,30
1713344342718,COMM 10,A01,489276,Staff,23,0,25,2
1713344342718,COMM 10,A02,489303,Staff,23,0,25,2
1713344343744,COMM 100A,A01,489312,Staff,14,0,25,11
1713344343744,COMM 100A,A02,489313,Staff,24,0,25,1
1713344344771,COMM 106T,A00,512540,Staff,33,0,35,2
1713344345801,COMM 107,A00,489347,Staff,27,0,35,8
1713344346832,COMM 109P,A00,489358,Staff,31,0,35,4
1713344347865,COMM 132,A00,489361,McKenna; Denise,27,0,30,3
1713344348897,COMM 146,A00,489362,Halm; Gavin Patrick,26,0,30,4
1713344349924,COMM 190,A00,489363,Abuelhiga; Soraya Jill,17,0,23,6
1713344350953,CSE 8A,A50,489366,Staff,21,0,25,4
1713344350953,CSE 8A,A51,489367,Staff,24,0,25,1
1713344351981,CSE 11,A01,489398,Cao; Yingjun,72,0,100,28
1713344353010,CSE 12,A01,489487,Staff,43,0,50,7
1713344354039,CSE 20,A01,489497,Staff,47,0,50,3
1713344355066,CSE 21,A01,489517,Braun; Oliver,42,0,50,8
1713344356097,CSE 101,A01,489524,Braun; Oliver,0,33,50,50
1713344357126,CSE 105,A01,512594,Jones; Miles E,72,0,100,28
1713344357126,CSE 105,B01,512598,Jones; Miles E,51,0,100,49
1713344358153,CSE 140,A01,489538,Staff,39,0,50,11
1713344359182,CSE 141,A01,489550,Eldon; John,67,0,100,33
1713344360214,CSE 141L,A01,489571,Eldon; John,65,0,100,35
1713344361303,CSE 151A,A01,489583,Solares; Edwin A,139,0,200,61
1713344362333,CSE 175,A01,510886,Kumar; Rakesh,30,0,30,0
1713344363360,CSE 190,A00,516828,Dubnov; Shlomo,37,0,49,12
1713344364387,DOC 100D,A00,489667,Pass; Natalye Joann,19,0,25,6
1713344365414,DSC 10,A01,624268,Staff,72,0,75,3
1713344366445,DSC 20,A01,624476,Staff,50,0,50,0
1713344367473,DSC 40A,A01,624608,Staff,39,0,40,1
1713344368500,DSGN 1,A01,489179,Rill; Bryan,32,0,50,18
1713344369527,ECE 17,A01,490489,Sahay; Rajeev,18,0,30,12
1713344370557,ECE 65,A50,490492,Staff,11,0,20,9
1713344370557,ECE 65,A51,490493,Staff,18,0,20,2
1713344371583,ECON 1,A01,489715,Famulari; Melissa,67,0,70,3
1713344372612,ECON 2,A01,489717,Levkoff; Steven B.,67,0,70,3
1713344373644,ECON 3,A01,489948,Staff,70,0,70,0
1713344375707,ECON 5,A01,490103,Staff,27,0,30,3
1713344375707,ECON 5,B01,626281,Dai; Yinlin,45,0,45,0
1713344376734,ECON 100A,A01,490127,Famulari; Melissa,62,0,70,8
1713344377768,ECON 100B,A01,490129,Staff,64,0,70,6
1713344378800,ECON 109,A01,490187,Shishkin; Denis,27,0,35,8
1713344379826,ECON 110A,A01,490190,Levkoff; Steven B.,59,0,70,11
1713344380853,ECON 120A,A01,490245,Dai; Yinlin,59,0,70,11
1713344381881,ECON 120B,A01,490247,Nieto-Barthaburu; Augusto,40,0,70,30
1713344382919,ECON 120C,A01,490253,Sun; Yixiao,30,0,35,5
1713344382919,ECON 120C,B01,490255,Sun; Yixiao,34,0,35,1
1713344383952,ECON 129,A00,490256,Eckert; Fabian Paul,22,0,35,13
1713344384977,ECON 131,A00,490257,Nieto-Barthaburu; Augusto,0,6,35,35
1713344386006,ECON 138,A00,490258,Bharadwaj; Prashant,13,0,35,22
1713344386006,ECON 138,B00,490259,Bharadwaj; Prashant,15,0,35,20
1713344387039,ECON 159,A00,490260,Hendrickson; Gerald M.,0,9,0,0
1713344388075,ECON 178,A01,553995,Zhu; Ying,24,0,35,11
1713344389109,EDS 40,A01,512576,Black; Alison Michelle,20,0,20,0
1713344390141,EDS 107,A01,515848,Staff,30,0,30,0
1713344391167,EDS 110R,A01,490262,Staff,26,0,30,4
1713344392200,EDS 112,A01,490264,Chapman; Thandeka K,40,0,50,10
1713344393226,EDS 113,A00,490266,Staff,25,0,30,5
1713344394260,EDS 118,A00,490267,Warstadt; Melissa Fawn,18,0,30,12
1713344395286,EDS 124BR,A00,490268,Eguchi; Emi,4,0,25,21
1713344395286,EDS 124BR,B00,490269,Eguchi; Emi,23,0,25,2
1713344396317,EDS 126,A01,490271,Jones; Makeba,43,0,50,7
1713344397343,EDS 135,A01,490316,Staff,19,0,20,1
1713344398369,ENVR 142GS,A00,519514,Chang; Edmond Yi-Teh,26,0,28,2
1713344399397,ETHN 103,A00,490504,Staff,25,0,36,11
1713344400424,ETHN 103A,A00,490505,Man; Simeon S,3,0,9,6
1713344401449,ETHN 109,A00,490506,Staff,28,0,30,2
1713344402480,ETHN 118,A00,490507,Staff,35,0,36,1
1713344403506,ETHN 119,A00,490508,Staff,32,0,36,4
1713344405862,ETHN 121R,A00,490518,Choi; Esther Min,21,0,36,15
1713344406886,ETHN 127,A00,490528,Staff,14,0,15,1
1713344407914,ETHN 139,A00,490573,Staff,10,0,10,0
1713344408943,ETHN 150,A00,490575,Staff,15,0,15,0
1713344409980,GLBH 20,A00,491705,Elwardani; Nile Regina,38,0,40,2
1713344411013,GLBH 101,A00,491706,Staff,20,0,20,0
1713344412046,GLBH 111,A01,491708,Burgos; Jose L.,15,0,15,0
1713344413072,GLBH 146,A00,491709,Staff,8,0,20,12
1713344414096,GLBH 148,A00,491710,Olivas Hernandez; Olga Lid,10,0,20,10
1713344415127,GLBH 150,A00,491711,Sloane; Julia Kathryn,19,0,20,1
1713344416157,HIEA 131,A00,491760,Staff,28,0,32,4
1713344417182,HIEA 153,A00,491762,Staff,28,0,30,2
1713344418211,HIEU 124,A00,491811,Staff,26,0,32,6
1713344419240,HIEU 124GS,A00,491812,Markman; Kristina,27,0,28,1
1713344420266,HIEU 147,A00,491813,Staff,30,0,32,2
1713344421292,HIEU 149GS,A00,491816,Caldwell; Michael Alan,28,0,28,0
1713344422318,HILD 2C,A01,491713,Hendrickson; Gerald M.,26,0,30,4
1713344423346,HILD 7B,A01,491715,Kwak; Nancy,0,2,30,30
1713344424374,HILD 10,A01,491717,Staff,9,0,20,11
1713344425398,HILD 30GS,A00,491719,Edington; Claire Ellen,23,0,28,5
1713344426424,HINE 109,A00,491818,Shafir; Nir,26,0,32,6
1713344427452,HINE 128,A00,491821,Shafir; Nir,30,0,32,2
1713344428479,HISC 117,A00,491830,Staff,27,0,32,5
1713344429504,HIUS 103,A00,491834,Man; Simeon S,14,0,23,9
1713344430534,HIUS 108B,A00,491835,Staff,27,0,30,3
1713344431560,HIUS 141,A00,491836,Hendrickson; Gerald M.,28,0,32,4
1713344432590,HIUS 149,A00,491839,Staff,24,0,32,8
1713344433617,HUM 3,A01,512617,Crum; Matthew Stephen,42,0,50,8
1713344433617,HUM 3,A02,512618,Crum; Matthew Stephen,48,0,50,2
1713344434644,HUM 3GS,A00,512663,Markman; Kristina,0,0,0,1
1713344434644,HUM 3GS,B00,512664,Staff,0,0,0,0
1713344435670,HUM 4,A01,512620,West; Geoffrey Scott,23,0,50,27
1713344436702,HUM 4GS,A00,512666,Lyon; Antony J.,0,0,0,5
1713344437731,HUM 4R,A01,512625,Watkins; Eric,49,0,50,1
1713344438764,HUM 5,A01,512649,Zavodny; Tatiana Sophia,20,0,50,30
1713344438764,HUM 5,B01,512661,Zroka; Ryan Edward,48,0,50,2
1713344439796,INTL 190,A00,490577,Segui; Alan S,0,0,0,5
1713344440827,JAPN 20AR,A01,491267,Ross; Kayoko F,7,0,20,13
1713344441859,JAPN 180,A00,491285,Berman; Michael David,33,0,40,7
1713344442984,LATI 50,A01,502536,Kokinis; Troy Andreas,16,0,22,6
1713344442984,LATI 50,A02,502551,Kokinis; Troy Andreas,22,0,22,0
1713344442984,LATI 50,A03,502650,Kokinis; Troy Andreas,22,0,22,0
1713344442984,LATI 50,A04,502909,Kokinis; Troy Andreas,21,0,22,1
1713344444016,LATI 160,A01,502920,Kokinis; Troy Andreas,30,0,30,0
1713344445050,LIFR 1A,A00,490494,Van Moer; Vinciane G,17,0,20,3
1713344446076,LIFR 1AX,A00,490495,Van Moer; Vinciane G,17,0,20,3
1713344447104,LIFR 1B,A00,490496,Van Moer; Vinciane G,17,0,20,3
1713344448135,LIFR 1BX,A00,490497,Van Moer; Vinciane G,17,0,20,3
1713344449161,LIGN 8,A00,505198,McIntosh; Justin Daniel,134,0,150,16
1713344450187,LIGN 9GS,A00,491239,Lott; Margaret S.,18,0,20,2
1713344451216,LIGN 101,A01,505200,McIntosh; Justin Daniel,22,0,30,8
1713344452242,LIGN 120,A01,491244,Staff,22,0,30,8
1713344453266,LIGN 149GS,A00,491245,Lott; Margaret S.,18,0,20,2
1713344454296,LIGN 170,A00,491247,Staff,22,0,30,8
1713344455323,LISP 1D,A00,490498,Munoz Sanchez; Alicia,8,0,14,6
1713344455323,LISP 1D,B00,490499,Munoz Sanchez; Alicia,4,0,14,10
1713344455323,LISP 1D,C00,490500,Munoz Sanchez; Alicia,7,0,14,7
1713344455323,LISP 1D,D00,490501,Munoz Sanchez; Alicia,10,0,14,4
1713344456348,LISP 1DX,A00,490502,Munoz Sanchez; Alicia,11,0,28,17
1713344456348,LISP 1DX,B00,490503,Munoz Sanchez; Alicia,16,0,28,12
1713344458403,LTAM 110,A00,491847,Staff,22,0,25,3
1713344459434,LTCS 119,A00,491848,Staff,11,0,15,4
1713344460471,LTCS 130,A00,491849,Staff,24,0,25,1
1713344462538,LTEA 120C,A00,491852,Staff,32,0,40,8
1713344463564,LTEN 130GS,A00,491853,Lyon; Antony J.,23,0,28,5
1713344464597,LTEN 148,A00,491855,Staff,23,0,25,2
1713344465624,LTEN 159,A00,491856,Staff,20,0,25,5
1713344466727,LTEN 180,A00,491857,Staff,8,0,15,7
1713344468778,LTSP 123GS,A00,505928,Bessett; Ryan Matthew,24,0,28,4
1713344469804,LTSP 174GS,A00,506037,Bessett; Ryan Matthew,24,0,28,4
1713344471858,LTWR 102,A00,491861,Staff,9,0,15,6
1713344472890,LTWR 106,A00,491862,Staff,8,0,15,7
1713344473917,MAE 11,A00,490930,Bahadori; Mohammad Yousef,94,0,100,6
1713344474945,MAE 30A,A00,490931,Qi; Huihui,37,0,40,3
1713344475971,MAE 101A,A00,491036,Sadeghizadeh; Zahra,91,0,100,9
1713344477003,MAE 101C,A00,491037,Seshadri; Kalyanasundaram,63,0,100,37
1713344478034,MAE 113,A00,491040,Seshadri; Kalyanasundaram,64,0,80,16
1713344479057,MAE 131A,A00,491041,Ghazinejad; Maziar,37,0,40,3
1713344480084,MAE 142,A00,491053,Staff,39,0,40,1
1713344481117,MAE 143A,A00,491054,Staff,29,0,50,21
1713344482145,MAE 150,A00,491092,Truong; Phuong Thi Ngoc,23,0,35,12
1713344483172,MATH 3C,A01,494031,Pardo Guerra; Sebastian,30,0,30,0
1713344483172,MATH 3C,A02,494032,Pardo Guerra; Sebastian,29,0,30,1
1713344484201,MATH 10A,A01,494034,Staff,27,0,30,3
1713344484201,MATH 10A,A02,494035,Staff,28,0,30,2
1713344484201,MATH 10A,B01,494037,Staff,27,0,30,3
1713344484201,MATH 10A,B02,494038,Staff,29,0,30,1
1713344485238,MATH 10B,A01,494040,Habib; Yousaf,22,0,30,8
1713344485238,MATH 10B,A02,494041,Habib; Yousaf,28,0,30,2
1713344485238,MATH 10B,A03,494042,Habib; Yousaf,29,0,30,1
1713344485238,MATH 10B,A04,494043,Habib; Yousaf,30,0,30,0
1713344485238,MATH 10B,B01,494045,Habib; Yousaf,25,0,30,5
1713344485238,MATH 10B,B02,494046,Habib; Yousaf,30,0,30,0
1713344485238,MATH 10B,B03,494047,Habib; Yousaf,30,0,30,0
1713344485238,MATH 10B,B04,494048,Habib; Yousaf,30,0,30,0
1713344486276,MATH 18,A01,494050,Kemp; Todd Aahron,25,0,30,5
1713344486276,MATH 18,A02,494051,Kemp; Todd Aahron,29,0,30,1
1713344486276,MATH 18,B01,494054,Kemp; Todd Aahron,25,0,30,5
1713344486276,MATH 18,B02,494055,Kemp; Todd Aahron,29,0,30,1
1713344487302,MATH 20A,A01,494059,Suk; Andrew Hoon,30,0,30,0
1713344488327,MATH 20B,A01,494061,Briones; Jor-el Thomas Caparas,33,0,35,2
1713344488327,MATH 20B,B01,494063,Bach; Quang Tran,34,0,35,1
1713344489359,MATH 20C,A01,494065,Staff,28,0,30,2
1713344489359,MATH 20C,A02,494066,Staff,30,0,30,0
1713344489359,MATH 20C,A03,494067,Staff,30,0,30,0
1713344489359,MATH 20C,A04,494068,Staff,30,0,30,0
1713344489359,MATH 20C,B01,494070,Zhang; Ming,24,0,30,6
1713344489359,MATH 20C,B02,494071,Zhang; Ming,27,0,30,3
1713344489359,MATH 20C,B03,494072,Zhang; Ming,29,0,30,1
1713344489359,MATH 20C,B04,494073,Zhang; Ming,29,0,30,1
1713344490384,MATH 20D,A01,494075,Staff,22,0,30,8
1713344490384,MATH 20D,A02,494076,Staff,29,0,30,1
1713344491410,MATH 20E,A01,494079,Staff,24,0,30,6
1713344491410,MATH 20E,A02,494080,Staff,26,0,30,4
1713344491410,MATH 20E,B01,494082,Staff,25,0,30,5
1713344491410,MATH 20E,B02,494083,Staff,25,0,30,5
1713344492443,MATH 103A,A01,494085,Aliabadi Sr.; Mohsen,12,0,30,18
1713344492443,MATH 103A,A02,494086,Aliabadi Sr.; Mohsen,28,0,30,2
1713344492443,MATH 103A,B01,494088,Aliabadi Sr.; Mohsen,20,0,30,10
1713344492443,MATH 103A,B02,494089,Aliabadi Sr.; Mohsen,27,0,30,3
1713344493470,MATH 109,A01,494091,Staff,30,0,30,0
1713344493470,MATH 109,A02,494092,Staff,29,0,30,1
1713344493470,MATH 109,B01,494094,Staff,27,0,30,3
1713344493470,MATH 109,B02,494095,Staff,29,0,30,1
1713344494499,MATH 142A,A01,494097,Chow; Bennett,13,0,30,17
1713344494499,MATH 142A,A02,494098,Chow; Bennett,23,0,30,7
1713344494499,MATH 142A,B01,494100,Chow; Bennett,19,0,30,11
1713344494499,MATH 142A,B02,494101,Chow; Bennett,29,0,30,1
1713344496550,MATH 168A,A01,516677,Dumitriu; Ioana,16,0,35,19
1713344497582,MATH 170A,A01,516679,Dumitriu; Ioana,18,0,30,12
1713344497582,MATH 170A,A02,516680,Dumitriu; Ioana,28,0,30,2
1713344498607,MATH 193A,A01,494107,Staff,12,0,30,18
1713344498607,MATH 193A,A02,494108,Staff,18,0,30,12
1713344498607,MATH 193A,A03,494109,Staff,29,0,30,1
1713344498607,MATH 193A,A04,494110,Staff,22,0,30,8
1713344501692,MGT 16,A00,491930,McKay; Michael J,92,0,98,6
1713344502716,MGT 18,A00,491992,McKay; Michael J,96,0,98,2
1713344503748,MGT 71,A00,492003,Staff,63,0,98,35
1713344504781,MGT 103,A00,505209,Eberhard; Craig A,80,0,98,18
1713344505814,MGT 131A,A00,505210,Anderson; John Charles,89,0,98,9
1713344507875,MGT 153,A00,492077,Perols; Johan Lars,15,0,90,75
1713344510958,MGT 164,A00,492222,McKay; Mary A,91,0,98,7
1713344511985,MGT 172,A00,492245,Staff,59,0,60,1
1713344511985,MGT 172,B00,505526,Hedges; Kathleen,65,0,98,33
1713344513020,MGT 181,A00,505669,Dunn; Louis Jean,78,0,98,20
1713344514045,MMW 14,A01,494399,Staff,15,0,28,13
1713344514045,MMW 14,A02,494400,Staff,25,0,28,3
1713344514045,MMW 14,A03,494401,Staff,28,0,28,0
1713344514045,MMW 14,A04,494402,Staff,28,0,28,0
1713344514045,MMW 14,B01,494404,Carreras; Maria Victoria,8,0,28,20
1713344514045,MMW 14,B02,494405,Carreras; Maria Victoria,25,0,28,3
1713344514045,MMW 14,B03,494406,Carreras; Maria Victoria,27,0,28,1
1713344514045,MMW 14,B04,494407,Carreras; Maria Victoria,28,0,28,0
1713344515072,MMW 14GS,A00,506250,Chang; Edmond Yi-Teh,0,0,0,0
1713344516096,MMW 121R,A01,494415,Adamiak; Patrick John,10,0,28,18
1713344516096,MMW 121R,A02,494416,Adamiak; Patrick John,24,0,28,4
1713344517128,MUS 1A,A01,494113,Staff,12,0,25,13
1713344517128,MUS 1A,A02,494114,Staff,24,0,25,1
1713344518157,MUS 4,A01,494116,Staff,23,0,25,2
1713344518157,MUS 4,A02,494117,Staff,22,0,25,3
1713344519185,MUS 5R,A01,494236,Dubnov; Shlomo,4,0,25,21
1713344519185,MUS 5R,A02,494237,Dubnov; Shlomo,25,0,25,0
1713344520212,MUS 6,A01,494122,Staff,9,0,25,16
1713344520212,MUS 6,A02,494123,Staff,23,0,25,2
1713344521238,MUS 7,A01,494125,Staff,16,0,25,9
1713344521238,MUS 7,A02,494126,Staff,24,0,25,1
1713344522264,MUS 11,A01,494128,Staff,23,0,25,2
1713344522264,MUS 11,A02,494129,Staff,24,0,25,1
1713344523289,MUS 13,A01,494131,Staff,25,0,25,0
1713344523289,MUS 13,A02,494132,Staff,25,0,25,0
1713344524316,MUS 15,A01,494134,Staff,16,0,25,9
1713344524316,MUS 15,A02,494135,Staff,25,0,25,0
1713344524316,MUS 15,B01,494137,Staff,24,0,25,1
1713344525344,MUS 80,A00,494232,Staff,24,0,25,1
1713344525344,MUS 80,B00,494233,Staff,25,0,25,0
1713344525344,MUS 80,C00,494234,Staff,23,0,25,2
1713344526371,MUS 95C,A00,494141,Staff,69,0,75,6
1713344527402,MUS 114,A00,494142,Staff,39,0,50,11
1713344528430,NANO 15,A01,490636,Drews; Aaron,7,0,7,0
1713344529456,PHIL 1,A00,490578,Grush; Rick Scott,49,0,50,1
1713344530486,PHIL 10,A01,490580,Grush; Rick Scott,33,0,35,2
1713344530486,PHIL 10,A02,490586,Grush; Rick Scott,32,0,35,3
1713344531512,PHIL 27,A01,490591,Staff,22,0,25,3
1713344531512,PHIL 27,A02,490592,Staff,25,0,25,0
1713344531512,PHIL 27,A03,490593,Staff,25,0,25,0
1713344531512,PHIL 27,A04,490598,Staff,25,0,25,0
1713344532537,PHIL 32,A01,490611,Staff,20,0,20,0
1713344532537,PHIL 32,A02,490618,Staff,20,0,20,0
1713344533563,PHIL 90,A00,490624,Staff,40,0,40,0
1713344534589,PHIL 136,A00,490627,Cohen; Jonathan David,37,0,40,3
1713344535619,PHIL 155,A00,490634,Staff,62,0,70,8
1713344536645,PHYS 1A,A00,491610,Staff,245,0,250,5
1713344537671,PHYS 1AL,001,491616,Tsai; Philbert S,27,0,30,3
1713344537671,PHYS 1AL,002,491618,Tsai; Philbert S,30,0,30,0
1713344538702,PHYS 1B,A00,491623,Staff,235,0,250,15
1713344539730,PHYS 1BL,001,491626,Tsai; Philbert S,18,0,30,12
1713344539730,PHYS 1BL,002,491628,Tsai; Philbert S,26,0,30,4
1713344540756,PHYS 1C,A00,491632,Staff,211,0,245,34
1713344541784,PHYS 1CL,001,491635,Tsai; Philbert S,2,0,30,28
1713344541784,PHYS 1CL,002,491643,Tsai; Philbert S,22,0,30,8
1713344542811,PHYS 2AR,A01,491651,Meyertholen; Andrew D.,44,0,50,6
1713344543841,PHYS 2B,A01,491659,Staff,105,0,115,10
1713344544871,PHYS 2BL,A01,491685,Staff,21,0,24,3
1713344544871,PHYS 2BL,A02,491700,Staff,21,0,24,3
1713344545898,PHYS 2C,A01,505161,Staff,101,0,115,14
1713344546930,PHYS 4A,A01,491704,Grinstein; Benjamin,99,0,100,1
1713344547967,POLI 5D,A01,494144,Staff,3,0,5,2
1713344547967,POLI 5D,B01,626283,Dai; Yinlin,5,0,5,0
1713344548993,POLI 12,A00,494145,Staff,43,0,45,2
1713344550024,POLI 13R,A00,494146,Forman; Fonna,45,0,50,5
1713344551057,POLI 27,A01,494148,Staff,54,0,60,6
1713344552082,POLI 30,A00,494149,Staff,49,0,50,1
1713344553109,POLI 100DA,A00,494150,Staff,20,0,25,5
1713344555166,POLI 100I,A00,494152,Staff,27,0,30,3
1713344556193,POLI 104B,A00,494153,Smith; Glenn Chatmas,53,0,55,2
1713344557218,POLI 104F,A00,494154,Staff,28,0,30,2
1713344558244,POLI 104I,A00,494155,Smith; Glenn Chatmas,29,0,30,1
1713344559279,POLI 110C,A00,494156,Ingham; Sean,23,0,25,2
1713344560307,POLI 117R,A00,494157,Forman; Fonna,5,0,20,15
1713344561334,POLI 118,A00,494158,Ingham; Sean,21,0,25,4
1713344562362,POLI 120H,A00,494159,Fisk; David Lee,39,0,45,6
1713344563391,POLI 131CR,A00,494160,Hoston; Germaine,35,0,45,10
1713344564417,POLI 133J,A00,494161,Staff,31,0,35,4
1713344565442,POLI 135,A00,494162,Fisk; David Lee,33,0,35,2
1713344566472,POLI 140A,A00,494164,Staff,18,0,30,12
1713344567503,POLI 142I,A00,494165,Staff,30,0,30,0
1713344568530,POLI 144D,A00,494166,Staff,22,0,25,3
1713344569562,POLI 151,A00,494167,Staff,30,0,30,0
1713344570647,POLI 153,A00,494168,Staff,33,0,35,2
1713344571676,POLI 160AA,A00,494169,Staff,33,0,40,7
1713344572702,POLI 162,A00,494170,Mignozzetti; Umberto,18,0,25,7
1713344573728,POLI 171,A00,494171,Mignozzetti; Umberto,18,0,25,7
1713344574754,PSYC 1,A00,494172,Staff,95,0,100,5
1713344575780,PSYC 2,A00,494173,Moranton; Nirelia Melbina-,33,0,50,17
1713344576809,PSYC 3,A00,494174,Staff,29,0,30,1
1713344577835,PSYC 6,A00,494175,Staff,17,0,20,3
1713344578865,PSYC 60,A01,494177,Staff,37,0,45,8
1713344579893,PSYC 70,A01,505724,Geller; Emma Harlan,42,0,45,3
1713344580928,PSYC 101,A00,494180,Heyman; Gail D.,83,0,100,17
1713344581961,PSYC 105,A00,494181,Geller; Emma Harlan,51,0,90,39
1713344582993,PSYC 106,A00,494182,Dobkins; Karen R.,26,0,45,19
1713344584025,PSYC 108,A00,494183,Adrian; Julia Anna,89,0,100,11
1713344585058,PSYC 114,A01,494185,Winkielman; Piotr,0,4,30,30
1713344586087,PSYC 122,A00,494186,Moranton; Nirelia Melbina-,27,0,50,23
1713344587113,PSYC 124,A00,494187,Chapman; Eddie Nathaniel,69,0,80,11
1713344588140,PSYC 131,A00,494188,Anagnostaras; Stephan,39,0,80,41
1713344589171,PSYC 144,A00,494189,Staff,1,1,50,49
1713344590202,PSYC 154,A00,494190,Lacefield; Katharine I,105,0,180,75
1713344591227,PSYC 162,A00,494191,Wixted; John T,70,0,100,30
1713344592258,PSYC 172,A00,494192,Gorman; Michael R.,36,0,45,9
1713344593284,PSYC 178,A00,494193,Glaser; Dale,32,0,45,13
1713344594317,PSYC 193,A00,505725,Chapman; Eddie Nathaniel,20,0,20,0
1713344595349,RELI 145GS,A00,519817,Rahimi; Babak,17,0,20,3
1713344596383,SE 101A,A01,490862,Chadha; Mayank,23,0,25,2
1713344597416,SE 101C,A01,490924,Krysl; Petr,15,0,20,5
1713344598441,SE 110A,A01,490928,Staff,19,0,20,1
1713344599470,SE 130A,A00,490929,Morrison; Machel Leigh,54,0,70,16
1713344600503,SIO 1,A01,519325,Staff,39,0,40,1
1713344601528,SIO 30,A01,519327,Staff,38,0,40,2
1713344602559,SIO 40,A00,519328,Staff,39,0,40,1
1713344603585,SIO 46GS,A00,519819,Cook; Geoffrey W,15,0,25,10
1713344604618,SIO 109R,A00,494197,Forman; Fonna,0,3,20,20
1713344605641,SIO 121GS,A00,519827,Cook; Geoffrey W,15,0,25,10
1713344606669,SIO 132,A01,519330,Staff,38,0,40,2
1713344607700,SIO 133,A01,519397,Staff,37,0,40,3
1713344608728,SIO 139,A00,519396,Kacev; David,29,0,40,11
1713344609757,SOCI 1,A01,494199,Thorpe; Charles Robert,21,0,30,9
1713344609757,SOCI 1,A02,494200,Thorpe; Charles Robert,30,0,30,0
1713344609757,SOCI 1,A03,494201,Thorpe; Charles Robert,29,0,30,1
1713344609757,SOCI 1,A04,494202,Thorpe; Charles Robert,29,0,30,1
1713344609757,SOCI 1,A05,494203,Thorpe; Charles Robert,29,0,30,1
1713344609757,SOCI 1,A06,494204,Thorpe; Charles Robert,30,0,30,0
1713344609757,SOCI 1,A07,494205,Thorpe; Charles Robert,28,0,30,2
1713344610791,SOCI 60,A01,494207,Staff,33,0,40,7
1713344610791,SOCI 60,A02,494208,Staff,39,0,40,1
1713344611822,SOCI 100,A01,494210,Payne; Christine Anna,25,0,30,5
1713344611822,SOCI 100,A02,494211,Payne; Christine Anna,26,0,30,4
1713344612852,SOCI 109M,A00,494212,Staff,20,0,20,0
1713344613879,SOCI 110,A00,494213,Staff,34,0,40,6
1713344615943,SOCI 118E,A00,494215,Ng; Kwai,37,0,40,3
1713344616973,SOCI 125,A00,494216,Calderon-Zaks; Michael Aar,39,0,45,6
1713344618004,SOCI 126,A01,494218,Jones; Makeba,3,0,5,2
1713344619028,SOCI 131,A00,494219,Thorpe; Charles Robert,26,0,30,4
1713344621088,SOCI 135,A00,494221,Payne; Christine Anna,28,0,50,22
1713344622122,SOCI 136E,A00,626690,Ruiz; Jonathan Joseph,24,0,25,1
1713344623148,SOCI 138GS,A00,494222,Navon; Daniel,23,0,28,5
1713344625201,SOCI 145,A00,494224,Staff,40,0,45,5
1713344626228,SOCI 153,A00,494225,Staff,28,0,30,2
1713344627253,SOCI 160E,A00,494226,Ng; Kwai,27,0,40,13
1713344628283,SOCI 180,A00,494227,Staff,29,0,30,1
1713344629310,SOCI 189GS,A00,494228,Ribas Norris; Janet Vanesa,11,0,11,0
1713344630336,SOCI 190GS,A00,553232,Ribas Norris; Janet Vanesa,11,0,11,0
1713344631362,SOMI 220,A00,627178,Schneid; Stephen David,30,0,30,0
1713344632395,SYN 2,001,490768,Staff,13,0,15,2
1713344632395,SYN 2,002,490769,Staff,14,0,15,1
1713344632395,SYN 2,004,490775,Staff,0,0,0,0
1713344632395,SYN 2,003,490774,Staff,0,0,0,0
1713344632395,SYN 2,005,490776,Staff,0,0,0,0
1713344633421,SYN 2R,001,490779,Staff,10,0,15,5
1713344633421,SYN 2R,002,514635,Staff,14,0,15,1
1713344634452,SYN 100,A01,490783,Staff,8,0,20,12
1713344634452,SYN 100,B01,490787,Staff,10,0,20,10
1713344634452,SYN 100,C01,490789,Staff,10,0,20,10
1713344635478,SYN 150,A00,490817,Staff,14,0,15,1
1713344635478,SYN 150,B00,514610,Staff,15,0,15,0
1713344636514,TDAC 1,A00,492753,Walsh; Kim C.,19,0,20,1
1713344636514,TDAC 1,B00,492754,Harting; Carla Kelso,18,0,20,2
1713344636514,TDAC 1,C00,513995,Salovey; Todd,15,0,20,5
1713344637540,TDAC 101,A00,492766,Harting; Carla Kelso,17,0,20,3
1713344638567,TDAC 102,A00,492768,Basso; Beatrice,19,0,20,1
1713344639597,TDDE 111,A00,492769,Staff,25,0,25,0
1713344640627,TDDE 131,A00,492770,Staff,15,0,15,0
1713344640627,TDDE 131,B00,492771,Staff,15,0,15,0
1713344641652,TDDE 131GS,A00,523716,Guirguis; Mark C,23,0,28,5
1713344642681,TDGE 1,A01,492756,Salovey; Todd,56,0,60,4
1713344643708,TDGE 5,A01,492758,Staff,23,0,25,2
1713344644731,TDGE 10,A00,492759,Fulton; Julia,203,0,220,17
1713344645763,TDGE 11,A00,492760,Castro; Robert Jess,198,0,200,2
1713344647818,TDGE 124,A00,492772,Fulton; Julia,180,0,220,40
1713344648851,TDGE 125,A00,492773,Meyer; Ursula,38,0,50,12
1713344648851,TDGE 125,B00,492774,Staff,49,0,50,1
1713344648851,TDGE 125,C00,523565,Staff,48,0,50,2
1713344649878,TDGE 125GS,A00,523580,Guirguis; Mark C,23,0,28,5
1713344650911,TDGE 127,A00,492775,Havis; Allan,33,0,50,17
1713344651936,TDHT 101,A00,492776,Staff,34,0,35,1
1713344652963,TDMV 1,A00,492762,Caligagan; Maria T.,29,0,30,1
1713344652963,TDMV 1,B00,492763,Arcidiacono; Kristin,26,0,30,4
1713344653988,TDMV 2,A00,492764,Weinberg; Sadie,27,0,30,3
1713344655015,TDMV 3,A00,492765,Mack; Kara Shanai',37,0,40,3
1713344656041,TDMV 138,A00,492777,Mack; Kara Shanai',32,0,40,8
1713344657067,TDMV 140,A00,492778,Lima; Paulo Henrique,40,0,40,0
1713344658097,TDMV 142,A00,492779,Caligagan; Maria T.,33,0,40,7
1713344658097,TDMV 142,B00,492780,Caligagan; Tony,37,0,40,3
1713344659126,TDMV 143,A00,492781,Fyall; Daunte Edward,39,0,40,1
1713344660150,USP 1,A01,492401,Kwak; Nancy,27,0,35,8
1713344661178,USP 2,A01,492453,Hinds; Juli Beth,35,0,35,0
1713344662203,USP 3,A01,492516,Staff,28,0,35,7
1713344663233,USP 4,A00,492522,McTague; Sarah,16,0,25,9
1713344664258,USP 100,A00,492523,Staff,32,0,35,3
1713344665284,USP 101,A00,492524,Staff,13,0,15,2
1713344666310,USP 105,A00,492525,Staff,21,0,25,4
1713344667335,USP 151,A00,492526,Shenkman; Michael Thomas,32,0,35,3
1713344668367,USP 170,A00,492545,Hinds; Juli Beth,33,0,35,2
1713344669393,USP 171GS,A00,492608,Bussell; Mirle Rabinowitz,24,0,28,4
1713344670422,USP 183GS,A00,492613,Peerson; Susan,24,0,28,4
1713344671453,VIS 30,A01,490693,Yoldas; Pinar,19,0,22,3
1713344671453,VIS 30,A02,490694,Yoldas; Pinar,18,0,22,4
1713344672483,VIS 83,A00,490695,Kester; Grant,63,0,75,12
1713344673509,VIS 105D,A00,490696,Staff,22,0,25,3
1713344674605,VIS 124CN,A00,490699,Rose; Jordan M,64,0,75,11
1713344675629,VIS 125GS,A00,511221,Williams; Alena J,21,0,22,1
1713344676659,VIS 128D,A00,490700,Staff,73,0,75,2
1713344677684,VIS 151,A01,490717,Staff,33,0,34,1
1713344677684,VIS 151,A02,490766,Staff,32,0,34,2
1713344678713,VIS 154GS,A00,511972,Williams; Alena J,21,0,22,1
1713344679739,VIS 160A,A00,490767,Stone; Patricia,7,0,10,3
1713344680767,WCWP 10A,A00,490638,Staff,14,0,15,1
1713344680767,WCWP 10A,B00,490640,Staff,15,0,15,0
1713344681796,WCWP 10B,A00,490641,Staff,0,0,0,0
1713344681796,WCWP 10B,B00,490642,Staff,14,0,15,1
1713344681796,WCWP 10B,C00,490644,Staff,13,0,15,2
1713344681796,WCWP 10B,D00,490647,Staff,0,0,0,0
1713344682822,WCWP 100,A00,490655,Staff,0,0,0,0
1713344682822,WCWP 100,B00,490687,Staff,10,0,15,5
1713344684927,ANAR 153,A00,487222,Braswell; Geoffrey E.,53,0,60,7
1713344685954,ANBI 134,A00,487223,Staff,5,0,20,15
1713344686983,ANBI 143GS,A00,487224,Noel; Geoffroy Pierre Jean,18,0,24,6
1713344688007,ANBI 144GS,A00,519548,Noel; Geoffroy Pierre Jean,18,0,24,6
1713344689036,ANSC 101,A00,487225,Staff,17,0,20,3
1713344690067,ANSC 125,A00,487227,Brenner; Suzanne A,38,0,40,2
1713344692127,ANSC 146,A00,487229,Staff,35,0,40,5
1713344693158,ANSC 148,A00,487230,Olivas Hernandez; Olga Lid,39,0,40,1
1713344694185,ANSC 150,A00,504165,Sloane; Julia Kathryn,18,0,20,2
1713344695210,ANSC 180,A00,487232,Staff,14,0,15,1
1713344696240,ANSC 188,A00,627155,Staff,37,0,40,3
1713344697265,ANTH 5,A00,519529,Semendeferi; Ekaterini,15,0,15,0
1713344698300,ANTH 10,A00,487219,Staff,58,0,60,2
1713344699329,ANTH 23,A01,487221,Staff,17,0,20,3
1713344700362,ANTH 102,A00,487233,Wilder; Linnea Lorene,50,0,60,10
1713344701389,ANTH 103,A00,487234,Varma; Saiba,54,0,60,6
1713344702419,ANTH 105,A00,487235,Stewart; Alexander B,54,0,60,6
1713344703447,BENG 100,A01,516685,Taylor Amos; Alyssa C,25,0,30,5
1713344704474,BIBC 102,A01,491316,Flagg; Matthew Paul,5,0,88,83
1713344704474,BIBC 102,A02,491366,Flagg; Matthew Paul,78,0,88,10
1713344705501,BIBC 103,A01,491486,Boumechache; Miyyada,16,0,24,8
1713344705501,BIBC 103,A02,491487,Boumechache; Miyyada,24,0,24,0
1713344706532,BICD 100,A01,516882,Staff,73,0,75,2
1713344706532,BICD 100,A02,516890,Staff,69,0,75,6
1713344707555,BICD 102GS,A00,491488,Lo; Stanley M.,26,0,28,2
1713344708586,BIEB 136GS,A00,516940,Holway; David A. & Shurin; Jonathan,18,0,24,6
1713344709611,BIEB 137GS,A01,517034,Holway; David A. & Shurin; Jonathan,18,0,24,6
1713344710639,BIEB 138GS,A01,491492,Pirino; Giorgia,21,0,28,7
1713344711670,BILD 1,A01,491296,Staff,60,0,63,3
1713344711670,BILD 1,A02,491297,Staff,63,0,63,0
1713344712704,BILD 4,A01,517099,Gonzalez Gamboa; Ivonne,22,0,24,2
1713344712704,BILD 4,A02,517100,Gonzalez Gamboa; Ivonne,24,0,24,0
1713344713728,BILD 60GS,A00,491309,Lo; Stanley M.,26,0,28,2
1713344714756,BIMM 100,A01,517136,Staff,82,0,100,18
1713344715782,BIMM 110,A01,517182,Staff,52,0,100,48
1713344716810,BIMM 120,A01,517228,Pickett; Brooke Elizabeth,28,0,63,35
1713344716810,BIMM 120,A02,517240,Pickett; Brooke Elizabeth,44,0,63,19
1713344717842,BIMM 132GS,A01,491498,Pirino; Giorgia,21,0,28,7
1713344718875,BIMM 143,A01,491589,Bozinovic; Goran,12,0,40,28
1713344719901,BIPN 100,A01,491594,Armour; Jon Christopher,83,0,100,17
1713344720934,BIPN 140,A01,491602,Marino; Marc J,23,0,50,27
1713344722990,CAT 125,A00,515973,Staff,18,0,20,2
1713344724020,CAT 125GS,A00,515974,Rahimi; Babak,16,0,20,4
1713344725048,CAT 125R,A00,515980,Staff,12,0,20,8
1713344725048,CAT 125R,B00,515981,Tosun; Adriana,19,0,20,1
1713344725048,CAT 125R,C00,515987,Hyland; Tina Mae,0,5,20,20
1713344725048,CAT 125R,D00,515988,Bronstein; Phoebe Malan,16,0,20,4
1713344726084,CENG 15,A01,488699,Drews; Aaron,25,0,25,0
1713344727111,CENG 100,A00,505196,Opatkiewicz; Justin Paul,25,0,25,0
1713344728139,CGS 2A,A01,489598,Staff,32,0,35,3
1713344729165,CGS 112,A00,489599,Staff,15,0,15,0
1713344730193,CGS 119,A00,489603,Staff,10,0,10,0
1713344731219,CGS 120,A00,489604,Staff,13,0,15,2
1713344732249,CGS 150,A00,489607,Staff,15,0,15,0
1713344733277,CHEM 6A,A01,488715,Staff,97,0,100,3
1713344734303,CHEM 6B,A01,488719,Piercy; Marc Anthony,99,0,100,1
1713344735329,CHEM 6C,A01,488723,Albizati; Kim F.,93,0,100,7
1713344736359,CHEM 7L,A01,488728,Schurmeier; Kimberly,18,0,24,6
1713344736359,CHEM 7L,A02,488730,Schurmeier; Kimberly,23,0,24,1
1713344736359,CHEM 7L,A03,488734,Schurmeier; Kimberly,20,0,24,4
1713344736359,CHEM 7L,A04,488763,Schurmeier; Kimberly,23,0,24,1
1713344736359,CHEM 7L,B01,488798,Schurmeier; Kimberly,16,0,24,8
1713344736359,CHEM 7L,B02,488801,Schurmeier; Kimberly,22,0,24,2
1713344736359,CHEM 7L,B03,488808,Schurmeier; Kimberly,22,0,24,2
1713344736359,CHEM 7L,B04,488811,Schurmeier; Kimberly,24,0,24,0
1713344737389,CHEM 11,A01,488897,Stallings; Dontarie M,94,0,100,6
1713344738415,CHEM 40A,A01,488913,Albizati; Kim F.,83,0,100,17
1713344739447,CHEM 40B,A01,488920,Weizman; Haim,42,0,50,8
1713344739447,CHEM 40B,A02,488938,Weizman; Haim,43,0,50,7
1713344740477,CHEM 41A,A01,489029,Klosterman; Jeremy K,57,0,60,3
1713344741507,CHEM 41C,A01,500436,Tor; Yitzhak,54,0,60,6
1713344742537,CHEM 43A,A01,500426,Weizman; Haim,0,1,24,24
1713344742537,CHEM 43A,A02,500430,Weizman; Haim,6,0,24,18
1713344742537,CHEM 43A,B01,514041,Klosterman; Jeremy K,14,0,24,10
1713344742537,CHEM 43A,B02,514047,Klosterman; Jeremy K,23,0,24,1
1713344743566,CHEM 108,A01,489140,Jennings; Patricia A.,6,0,24,18
1713344743566,CHEM 108,A02,489142,Jennings; Patricia A.,14,0,24,10
1713344744591,CHEM 114A,A01,489147,Stallings; Dontarie M,65,0,100,35
1713344745628,CHIN 169A,A00,489171,Wang; Xiao,19,0,20,1
1713344747683,COGS 3,A01,518827,Boyle; Mary E. T.,25,0,40,15
1713344748715,COGS 11,A01,489175,Staff,27,0,30,3
1713344749798,COGS 14A,A01,518829,Staff,50,0,60,10
1713344750831,COGS 14B,A01,489177,Hoffman; Drew Ellen,62,0,75,13
1713344751856,COGS 100,A01,489181,Allen; Michael Gordon,62,0,75,13
1713344752881,COGS 101A,A01,489183,Staff,45,0,60,15
1713344753906,COGS 101B,A01,489185,Allen; Michael Gordon,6,0,30,24
1713344754936,COGS 101C,A01,526786,Staff,23,0,30,7
1713344756991,COGS 107A,A01,489189,Boyle; Mary E. T.,16,0,35,19
1713344758018,COGS 107B,A01,627144,Mooshagian; Eric Frederick,59,0,60,1
1713344759042,COGS 118A,A01,489191,Staff,0,46,40,40
1713344761095,COGS 171GS,A01,489194,Pineda; Jaime A,19,0,28,9
1713344762122,COGS 172,A01,489196,Staff,1,0,30,29
1713344763152,COGS 174GS,A01,489264,Pineda; Jaime A,19,0,28,9
1713344764182,COGS 180,A01,627150,Staff,28,0,30,2
1713344765206,COGS 186,A01,489274,Staff,0,3,30,30
1713344766232,COMM 10,A01,489276,Staff,23,0,25,2
1713344766232,COMM 10,A02,489303,Staff,23,0,25,2
1713344767259,COMM 100A,A01,489312,Staff,14,0,25,11
1713344767259,COMM 100A,A02,489313,Staff,24,0,25,1
1713344768297,COMM 106T,A00,512540,Staff,33,0,35,2
1713344769321,COMM 107,A00,489347,Staff,27,0,35,8
1713344770344,COMM 109P,A00,489358,Staff,31,0,35,4
1713344771371,COMM 132,A00,489361,McKenna; Denise,27,0,30,3
1713344772399,COMM 146,A00,489362,Halm; Gavin Patrick,26,0,30,4
1713344773425,COMM 190,A00,489363,Abuelhiga; Soraya Jill,17,0,23,6
1713344774460,CSE 8A,A50,489366,Staff,21,0,25,4
1713344774460,CSE 8A,A51,489367,Staff,24,0,25,1
1713344775491,CSE 11,A01,489398,Cao; Yingjun,72,0,100,28
1713344776523,CSE 12,A01,489487,Staff,43,0,50,7
1713344777550,CSE 20,A01,489497,Staff,47,0,50,3
1713344778636,CSE 21,A01,489517,Braun; Oliver,42,0,50,8
1713344779663,CSE 101,A01,489524,Braun; Oliver,0,34,50,50
1713344780699,CSE 105,A01,512594,Jones; Miles E,72,0,100,28
1713344780699,CSE 105,B01,512598,Jones; Miles E,51,0,100,49
1713344781725,CSE 140,A01,489538,Staff,39,0,50,11
1713344782754,CSE 141,A01,489550,Eldon; John,67,0,100,33
1713344783779,CSE 141L,A01,489571,Eldon; John,65,0,100,35
1713344784804,CSE 151A,A01,489583,Solares; Edwin A,139,0,200,61
1713344785834,CSE 175,A01,510886,Kumar; Rakesh,30,0,30,0
1713344786860,CSE 190,A00,516828,Dubnov; Shlomo,37,0,49,12
1713344787886,DOC 100D,A00,489667,Pass; Natalye Joann,19,0,25,6
1713344788912,DSC 10,A01,624268,Staff,72,0,75,3
1713344789936,DSC 20,A01,624476,Staff,50,0,50,0
1713344790960,DSC 40A,A01,624608,Staff,39,0,40,1
1713344791986,DSGN 1,A01,489179,Rill; Bryan,32,0,50,18
1713344793013,ECE 17,A01,490489,Sahay; Rajeev,18,0,30,12
1713344794039,ECE 65,A50,490492,Staff,11,0,20,9
1713344794039,ECE 65,A51,490493,Staff,18,0,20,2
1713344795066,ECON 1,A01,489715,Famulari; Melissa,67,0,70,3
1713344796097,ECON 2,A01,489717,Levkoff; Steven B.,67,0,70,3
1713344797124,ECON 3,A01,489948,Staff,70,0,70,0
1713344799186,ECON 5,A01,490103,Staff,27,0,30,3
1713344799186,ECON 5,B01,626281,Dai; Yinlin,45,0,45,0
1713344800212,ECON 100A,A01,490127,Famulari; Melissa,62,0,70,8
1713344801237,ECON 100B,A01,490129,Staff,64,0,70,6
1713344802265,ECON 109,A01,490187,Shishkin; Denis,27,0,35,8
1713344803301,ECON 110A,A01,490190,Levkoff; Steven B.,59,0,70,11
1713344804334,ECON 120A,A01,490245,Dai; Yinlin,59,0,70,11
1713344805363,ECON 120B,A01,490247,Nieto-Barthaburu; Augusto,40,0,70,30
1713344806394,ECON 120C,A01,490253,Sun; Yixiao,30,0,35,5
1713344806394,ECON 120C,B01,490255,Sun; Yixiao,34,0,35,1
1713344807423,ECON 129,A00,490256,Eckert; Fabian Paul,22,0,35,13
1713344808453,ECON 131,A00,490257,Nieto-Barthaburu; Augusto,0,6,35,35
1713344809480,ECON 138,A00,490258,Bharadwaj; Prashant,13,0,35,22
1713344809480,ECON 138,B00,490259,Bharadwaj; Prashant,15,0,35,20
1713344810507,ECON 159,A00,490260,Hendrickson; Gerald M.,0,9,0,0
1713344811547,ECON 178,A01,553995,Zhu; Ying,24,0,35,11
1713344812579,EDS 40,A01,512576,Black; Alison Michelle,20,0,20,0
1713344813606,EDS 107,A01,515848,Staff,30,0,30,0
1713344814634,EDS 110R,A01,490262,Staff,26,0,30,4
1713344815665,EDS 112,A01,490264,Chapman; Thandeka K,40,0,50,10
1713344816694,EDS 113,A00,490266,Staff,25,0,30,5
1713344817725,EDS 118,A00,490267,Warstadt; Melissa Fawn,18,0,30,12
1713344818751,EDS 124BR,A00,490268,Eguchi; Emi,4,0,25,21
1713344818751,EDS 124BR,B00,490269,Eguchi; Emi,23,0,25,2
1713344819777,EDS 126,A01,490271,Jones; Makeba,43,0,50,7
1713344820803,EDS 135,A01,490316,Staff,19,0,20,1
1713344821830,ENVR 142GS,A00,519514,Chang; Edmond Yi-Teh,26,0,28,2
1713344822860,ETHN 103,A00,490504,Staff,25,0,36,11
1713344823894,ETHN 103A,A00,490505,Man; Simeon S,3,0,9,6
1713344824920,ETHN 109,A00,490506,Staff,28,0,30,2
1713344825945,ETHN 118,A00,490507,Staff,35,0,36,1
1713344826975,ETHN 119,A00,490508,Staff,32,0,36,4
1713344828003,ETHN 121R,A00,490518,Choi; Esther Min,21,0,36,15
1713344829033,ETHN 127,A00,490528,Staff,14,0,15,1
1713344830059,ETHN 139,A00,490573,Staff,10,0,10,0
1713344831085,ETHN 150,A00,490575,Staff,15,0,15,0
1713344832118,GLBH 20,A00,491705,Elwardani; Nile Regina,38,0,40,2
1713344833148,GLBH 101,A00,491706,Staff,20,0,20,0
1713344834181,GLBH 111,A01,491708,Burgos; Jose L.,15,0,15,0
1713344835205,GLBH 146,A00,491709,Staff,8,0,20,12
1713344836236,GLBH 148,A00,491710,Olivas Hernandez; Olga Lid,10,0,20,10
1713344837264,GLBH 150,A00,491711,Sloane; Julia Kathryn,19,0,20,1
1713344838294,HIEA 131,A00,491760,Staff,28,0,32,4
1713344839321,HIEA 153,A00,491762,Staff,28,0,30,2
1713344840345,HIEU 124,A00,491811,Staff,26,0,32,6
1713344841377,HIEU 124GS,A00,491812,Markman; Kristina,27,0,28,1
1713344842401,HIEU 147,A00,491813,Staff,30,0,32,2
1713344843427,HIEU 149GS,A00,491816,Caldwell; Michael Alan,28,0,28,0
1713344844454,HILD 2C,A01,491713,Hendrickson; Gerald M.,26,0,30,4
1713344845484,HILD 7B,A01,491715,Kwak; Nancy,0,2,30,30
1713344846516,HILD 10,A01,491717,Staff,9,0,20,11
1713344847546,HILD 30GS,A00,491719,Edington; Claire Ellen,23,0,28,5
1713344848574,HINE 109,A00,491818,Shafir; Nir,26,0,32,6
1713344849599,HINE 128,A00,491821,Shafir; Nir,30,0,32,2
1713344850625,HISC 117,A00,491830,Staff,27,0,32,5
1713344851651,HIUS 103,A00,491834,Man; Simeon S,14,0,23,9
1713344852679,HIUS 108B,A00,491835,Staff,27,0,30,3
1713344853704,HIUS 141,A00,491836,Hendrickson; Gerald M.,28,0,32,4
1713344854733,HIUS 149,A00,491839,Staff,24,0,32,8
1713344855764,HUM 3,A01,512617,Crum; Matthew Stephen,42,0,50,8
1713344855764,HUM 3,A02,512618,Crum; Matthew Stephen,48,0,50,2
1713344856788,HUM 3GS,A00,512663,Markman; Kristina,0,0,0,1
1713344856788,HUM 3GS,B00,512664,Staff,0,0,0,0
1713344857814,HUM 4,A01,512620,West; Geoffrey Scott,23,0,50,27
1713344858844,HUM 4GS,A00,512666,Lyon; Antony J.,0,0,0,5
1713344859876,HUM 4R,A01,512625,Watkins; Eric,49,0,50,1
1713344860903,HUM 5,A01,512649,Zavodny; Tatiana Sophia,20,0,50,30
1713344860903,HUM 5,B01,512661,Zroka; Ryan Edward,48,0,50,2
1713344861933,INTL 190,A00,490577,Segui; Alan S,0,0,0,5
1713344862967,JAPN 20AR,A01,491267,Ross; Kayoko F,7,0,20,13
1713344863997,JAPN 180,A00,491285,Berman; Michael David,33,0,40,7
1713344865025,LATI 50,A01,502536,Kokinis; Troy Andreas,16,0,22,6
1713344865025,LATI 50,A02,502551,Kokinis; Troy Andreas,22,0,22,0
1713344865025,LATI 50,A03,502650,Kokinis; Troy Andreas,22,0,22,0
1713344865025,LATI 50,A04,502909,Kokinis; Troy Andreas,21,0,22,1
1713344866051,LATI 160,A01,502920,Kokinis; Troy Andreas,30,0,30,0
1713344867077,LIFR 1A,A00,490494,Van Moer; Vinciane G,17,0,20,3
1713344868106,LIFR 1AX,A00,490495,Van Moer; Vinciane G,17,0,20,3
1713344869131,LIFR 1B,A00,490496,Van Moer; Vinciane G,17,0,20,3
1713344870157,LIFR 1BX,A00,490497,Van Moer; Vinciane G,17,0,20,3
1713344871186,LIGN 8,A00,505198,McIntosh; Justin Daniel,134,0,150,16
1713344872218,LIGN 9GS,A00,491239,Lott; Margaret S.,18,0,20,2
1713344873248,LIGN 101,A01,505200,McIntosh; Justin Daniel,22,0,30,8
1713344874278,LIGN 120,A01,491244,Staff,22,0,30,8
1713344875304,LIGN 149GS,A00,491245,Lott; Margaret S.,18,0,20,2
1713344876329,LIGN 170,A00,491247,Staff,22,0,30,8
1713344877356,LISP 1D,A00,490498,Munoz Sanchez; Alicia,8,0,14,6
1713344877356,LISP 1D,B00,490499,Munoz Sanchez; Alicia,4,0,14,10
1713344877356,LISP 1D,C00,490500,Munoz Sanchez; Alicia,7,0,14,7
1713344877356,LISP 1D,D00,490501,Munoz Sanchez; Alicia,10,0,14,4
1713344878385,LISP 1DX,A00,490502,Munoz Sanchez; Alicia,11,0,28,17
1713344878385,LISP 1DX,B00,490503,Munoz Sanchez; Alicia,16,0,28,12
1713344880436,LTAM 110,A00,491847,Staff,22,0,25,3
1713344881463,LTCS 119,A00,491848,Staff,11,0,15,4
1713344882549,LTCS 130,A00,491849,Staff,24,0,25,1
1713344884605,LTEA 120C,A00,491852,Staff,32,0,40,8
1713344885632,LTEN 130GS,A00,491853,Lyon; Antony J.,23,0,28,5
1713344886658,LTEN 148,A00,491855,Staff,23,0,25,2
1713344887683,LTEN 159,A00,491856,Staff,20,0,25,5
1713344888714,LTEN 180,A00,491857,Staff,8,0,15,7
1713344890766,LTSP 123GS,A00,505928,Bessett; Ryan Matthew,24,0,28,4
1713344891791,LTSP 174GS,A00,506037,Bessett; Ryan Matthew,24,0,28,4
1713344893842,LTWR 102,A00,491861,Staff,9,0,15,6
1713344894869,LTWR 106,A00,491862,Staff,8,0,15,7
1713344895906,MAE 11,A00,490930,Bahadori; Mohammad Yousef,94,0,100,6
1713344896934,MAE 30A,A00,490931,Qi; Huihui,37,0,40,3
1713344897965,MAE 101A,A00,491036,Sadeghizadeh; Zahra,91,0,100,9
1713344898990,MAE 101C,A00,491037,Seshadri; Kalyanasundaram,63,0,100,37
1713344900020,MAE 113,A00,491040,Seshadri; Kalyanasundaram,64,0,80,16
1713344901051,MAE 131A,A00,491041,Ghazinejad; Maziar,37,0,40,3
1713344902080,MAE 142,A00,491053,Staff,39,0,40,1
1713344903106,MAE 143A,A00,491054,Staff,29,0,50,21
1713344904133,MAE 150,A00,491092,Truong; Phuong Thi Ngoc,23,0,35,12
1713344905162,MATH 3C,A01,494031,Pardo Guerra; Sebastian,30,0,30,0
1713344905162,MATH 3C,A02,494032,Pardo Guerra; Sebastian,29,0,30,1
1713344906195,MATH 10A,A01,494034,Staff,27,0,30,3
1713344906195,MATH 10A,A02,494035,Staff,28,0,30,2
1713344906195,MATH 10A,B01,494037,Staff,27,0,30,3
1713344906195,MATH 10A,B02,494038,Staff,29,0,30,1
1713344907225,MATH 10B,A01,494040,Habib; Yousaf,22,0,30,8
1713344907225,MATH 10B,A02,494041,Habib; Yousaf,28,0,30,2
1713344907225,MATH 10B,A03,494042,Habib; Yousaf,29,0,30,1
1713344907225,MATH 10B,A04,494043,Habib; Yousaf,30,0,30,0
1713344907225,MATH 10B,B01,494045,Habib; Yousaf,25,0,30,5
1713344907225,MATH 10B,B02,494046,Habib; Yousaf,30,0,30,0
1713344907225,MATH 10B,B03,494047,Habib; Yousaf,30,0,30,0
1713344907225,MATH 10B,B04,494048,Habib; Yousaf,30,0,30,0
1713344908260,MATH 18,A01,494050,Kemp; Todd Aahron,25,0,30,5
1713344908260,MATH 18,A02,494051,Kemp; Todd Aahron,29,0,30,1
1713344908260,MATH 18,B01,494054,Kemp; Todd Aahron,25,0,30,5
1713344908260,MATH 18,B02,494055,Kemp; Todd Aahron,29,0,30,1
1713344909292,MATH 20A,A01,494059,Suk; Andrew Hoon,30,0,30,0
1713344910324,MATH 20B,A01,494061,Briones; Jor-el Thomas Caparas,33,0,35,2
1713344910324,MATH 20B,B01,494063,Bach; Quang Tran,34,0,35,1
1713344911353,MATH 20C,A01,494065,Staff,28,0,30,2
1713344911353,MATH 20C,A02,494066,Staff,30,0,30,0
1713344911353,MATH 20C,A03,494067,Staff,30,0,30,0
1713344911353,MATH 20C,A04,494068,Staff,30,0,30,0
1713344911353,MATH 20C,B01,494070,Zhang; Ming,23,0,30,7
1713344911353,MATH 20C,B02,494071,Zhang; Ming,27,0,30,3
1713344911353,MATH 20C,B03,494072,Zhang; Ming,29,0,30,1
1713344911353,MATH 20C,B04,494073,Zhang; Ming,29,0,30,1
1713344912383,MATH 20D,A01,494075,Staff,22,0,30,8
1713344912383,MATH 20D,A02,494076,Staff,29,0,30,1
1713344913409,MATH 20E,A01,494079,Staff,24,0,30,6
1713344913409,MATH 20E,A02,494080,Staff,26,0,30,4
1713344913409,MATH 20E,B01,494082,Staff,25,0,30,5
1713344913409,MATH 20E,B02,494083,Staff,25,0,30,5
1713344914436,MATH 103A,A01,494085,Aliabadi Sr.; Mohsen,12,0,30,18
1713344914436,MATH 103A,A02,494086,Aliabadi Sr.; Mohsen,28,0,30,2
1713344914436,MATH 103A,B01,494088,Aliabadi Sr.; Mohsen,20,0,30,10
1713344914436,MATH 103A,B02,494089,Aliabadi Sr.; Mohsen,27,0,30,3
1713344915463,MATH 109,A01,494091,Staff,30,0,30,0
1713344915463,MATH 109,A02,494092,Staff,29,0,30,1
1713344915463,MATH 109,B01,494094,Staff,27,0,30,3
1713344915463,MATH 109,B02,494095,Staff,29,0,30,1
1713344916489,MATH 142A,A01,494097,Chow; Bennett,13,0,30,17
1713344916489,MATH 142A,A02,494098,Chow; Bennett,23,0,30,7
1713344916489,MATH 142A,B01,494100,Chow; Bennett,19,0,30,11
1713344916489,MATH 142A,B02,494101,Chow; Bennett,29,0,30,1
1713344918547,MATH 168A,A01,516677,Dumitriu; Ioana,16,0,35,19
1713344919573,MATH 170A,A01,516679,Dumitriu; Ioana,18,0,30,12
1713344919573,MATH 170A,A02,516680,Dumitriu; Ioana,28,0,30,2
1713344920600,MATH 193A,A01,494107,Staff,12,0,30,18
1713344920600,MATH 193A,A02,494108,Staff,18,0,30,12
1713344920600,MATH 193A,A03,494109,Staff,29,0,30,1
1713344920600,MATH 193A,A04,494110,Staff,22,0,30,8
1713344923684,MGT 16,A00,491930,McKay; Michael J,92,0,98,6
1713344924710,MGT 18,A00,491992,McKay; Michael J,96,0,98,2
1713344925738,MGT 71,A00,492003,Staff,63,0,98,35
1713344926765,MGT 103,A00,505209,Eberhard; Craig A,80,0,98,18
1713344927793,MGT 131A,A00,505210,Anderson; John Charles,89,0,98,9
1713344929849,MGT 153,A00,492077,Perols; Johan Lars,15,0,90,75
1713344932930,MGT 164,A00,492222,McKay; Mary A,91,0,98,7
1713344933963,MGT 172,A00,492245,Staff,59,0,60,1
1713344933963,MGT 172,B00,505526,Hedges; Kathleen,65,0,98,33
1713344934989,MGT 181,A00,505669,Dunn; Louis Jean,78,0,98,20
1713344936023,MMW 14,A01,494399,Staff,15,0,28,13
1713344936023,MMW 14,A02,494400,Staff,25,0,28,3
1713344936023,MMW 14,A03,494401,Staff,28,0,28,0
1713344936023,MMW 14,A04,494402,Staff,28,0,28,0
1713344936023,MMW 14,B01,494404,Carreras; Maria Victoria,8,0,28,20
1713344936023,MMW 14,B02,494405,Carreras; Maria Victoria,25,0,28,3
1713344936023,MMW 14,B03,494406,Carreras; Maria Victoria,27,0,28,1
1713344936023,MMW 14,B04,494407,Carreras; Maria Victoria,28,0,28,0
1713344937053,MMW 14GS,A00,506250,Chang; Edmond Yi-Teh,0,0,0,0
1713344938083,MMW 121R,A01,494415,Adamiak; Patrick John,10,0,28,18
1713344938083,MMW 121R,A02,494416,Adamiak; Patrick John,24,0,28,4
1713344939110,MUS 1A,A01,494113,Staff,12,0,25,13
1713344939110,MUS 1A,A02,494114,Staff,24,0,25,1
1713344940135,MUS 4,A01,494116,Staff,23,0,25,2
1713344940135,MUS 4,A02,494117,Staff,22,0,25,3
1713344941162,MUS 5R,A01,494236,Dubnov; Shlomo,4,0,25,21
1713344941162,MUS 5R,A02,494237,Dubnov; Shlomo,25,0,25,0
1713344942189,MUS 6,A01,494122,Staff,9,0,25,16
1713344942189,MUS 6,A02,494123,Staff,23,0,25,2
1713344943220,MUS 7,A01,494125,Staff,16,0,25,9
1713344943220,MUS 7,A02,494126,Staff,24,0,25,1
1713344944246,MUS 11,A01,494128,Staff,23,0,25,2
1713344944246,MUS 11,A02,494129,Staff,24,0,25,1
1713344945272,MUS 13,A01,494131,Staff,25,0,25,0
1713344945272,MUS 13,A02,494132,Staff,25,0,25,0
1713344946297,MUS 15,A01,494134,Staff,16,0,25,9
1713344946297,MUS 15,A02,494135,Staff,25,0,25,0
1713344946297,MUS 15,B01,494137,Staff,24,0,25,1
1713344947327,MUS 80,A00,494232,Staff,24,0,25,1
1713344947327,MUS 80,B00,494233,Staff,25,0,25,0
1713344947327,MUS 80,C00,494234,Staff,23,0,25,2
1713344948353,MUS 95C,A00,494141,Staff,69,0,75,6
1713344949376,MUS 114,A00,494142,Staff,39,0,50,11
1713344950405,NANO 15,A01,490636,Drews; Aaron,7,0,7,0
1713344951432,PHIL 1,A00,490578,Grush; Rick Scott,49,0,50,1
1713344952456,PHIL 10,A01,490580,Grush; Rick Scott,33,0,35,2
1713344952456,PHIL 10,A02,490586,Grush; Rick Scott,32,0,35,3
1713344953488,PHIL 27,A01,490591,Staff,22,0,25,3
1713344953488,PHIL 27,A02,490592,Staff,25,0,25,0
1713344953488,PHIL 27,A03,490593,Staff,25,0,25,0
1713344953488,PHIL 27,A04,490598,Staff,25,0,25,0
1713344954513,PHIL 32,A01,490611,Staff,20,0,20,0
1713344954513,PHIL 32,A02,490618,Staff,20,0,20,0
1713344955539,PHIL 90,A00,490624,Staff,40,0,40,0
1713344956565,PHIL 136,A00,490627,Cohen; Jonathan David,37,0,40,3
1713344957592,PHIL 155,A00,490634,Staff,62,0,70,8
1713344958622,PHYS 1A,A00,491610,Staff,245,0,250,5
1713344959649,PHYS 1AL,001,491616,Tsai; Philbert S,27,0,30,3
1713344959649,PHYS 1AL,002,491618,Tsai; Philbert S,30,0,30,0
1713344960678,PHYS 1B,A00,491623,Staff,235,0,250,15
1713344961708,PHYS 1BL,001,491626,Tsai; Philbert S,18,0,30,12
1713344961708,PHYS 1BL,002,491628,Tsai; Philbert S,26,0,30,4
1713344962733,PHYS 1C,A00,491632,Staff,211,0,245,34
1713344963759,PHYS 1CL,001,491635,Tsai; Philbert S,2,0,30,28
1713344963759,PHYS 1CL,002,491643,Tsai; Philbert S,22,0,30,8
1713344964792,PHYS 2AR,A01,491651,Meyertholen; Andrew D.,44,0,50,6
1713344965823,PHYS 2B,A01,491659,Staff,105,0,115,10
1713344966849,PHYS 2BL,A01,491685,Staff,21,0,24,3
1713344966849,PHYS 2BL,A02,491700,Staff,21,0,24,3
1713344967875,PHYS 2C,A01,505161,Staff,101,0,115,14
1713344968900,PHYS 4A,A01,491704,Grinstein; Benjamin,99,0,100,1
1713344969933,POLI 5D,A01,494144,Staff,3,0,5,2
1713344969933,POLI 5D,B01,626283,Dai; Yinlin,5,0,5,0
1713344970964,POLI 12,A00,494145,Staff,43,0,45,2
1713344971991,POLI 13R,A00,494146,Forman; Fonna,45,0,50,5
1713344973016,POLI 27,A01,494148,Staff,54,0,60,6
1713344974045,POLI 30,A00,494149,Staff,49,0,50,1
1713344975074,POLI 100DA,A00,494150,Staff,20,0,25,5
1713344977127,POLI 100I,A00,494152,Staff,27,0,30,3
1713344978153,POLI 104B,A00,494153,Smith; Glenn Chatmas,53,0,55,2
1713344979178,POLI 104F,A00,494154,Staff,28,0,30,2
1713344980203,POLI 104I,A00,494155,Smith; Glenn Chatmas,29,0,30,1
1713344981229,POLI 110C,A00,494156,Ingham; Sean,23,0,25,2
1713344982254,POLI 117R,A00,494157,Forman; Fonna,5,0,20,15
1713344983279,POLI 118,A00,494158,Ingham; Sean,21,0,25,4
1713344984310,POLI 120H,A00,494159,Fisk; David Lee,39,0,45,6
1713344985338,POLI 131CR,A00,494160,Hoston; Germaine,35,0,45,10
1713344986417,POLI 133J,A00,494161,Staff,31,0,35,4
1713344987442,POLI 135,A00,494162,Fisk; David Lee,33,0,35,2
1713344988471,POLI 140A,A00,494164,Staff,18,0,30,12
1713344989497,POLI 142I,A00,494165,Staff,30,0,30,0
1713344990524,POLI 144D,A00,494166,Staff,22,0,25,3
1713344991550,POLI 151,A00,494167,Staff,30,0,30,0
1713344992575,POLI 153,A00,494168,Staff,33,0,35,2
1713344993605,POLI 160AA,A00,494169,Staff,33,0,40,7
1713344994635,POLI 162,A00,494170,Mignozzetti; Umberto,17,0,25,8
1713344995663,POLI 171,A00,494171,Mignozzetti; Umberto,18,0,25,7
1713344996692,PSYC 1,A00,494172,Staff,95,0,100,5
1713344997718,PSYC 2,A00,494173,Moranton; Nirelia Melbina-,33,0,50,17
1713344998746,PSYC 3,A00,494174,Staff,29,0,30,1
1713344999775,PSYC 6,A00,494175,Staff,17,0,20,3
1713345000801,PSYC 60,A01,494177,Staff,37,0,45,8
1713345001828,PSYC 70,A01,505724,Geller; Emma Harlan,42,0,45,3
1713345002856,PSYC 101,A00,494180,Heyman; Gail D.,83,0,100,17
1713345003894,PSYC 105,A00,494181,Geller; Emma Harlan,51,0,90,39
1713345004920,PSYC 106,A00,494182,Dobkins; Karen R.,26,0,45,19
1713345005950,PSYC 108,A00,494183,Adrian; Julia Anna,89,0,100,11
1713345006977,PSYC 114,A01,494185,Winkielman; Piotr,0,4,30,30
1713345008009,PSYC 122,A00,494186,Moranton; Nirelia Melbina-,27,0,50,23
1713345009035,PSYC 124,A00,494187,Chapman; Eddie Nathaniel,69,0,80,11
1713345010060,PSYC 131,A00,494188,Anagnostaras; Stephan,39,0,80,41
1713345011086,PSYC 144,A00,494189,Staff,1,1,50,49
1713345012113,PSYC 154,A00,494190,Lacefield; Katharine I,105,0,180,75
1713345013145,PSYC 162,A00,494191,Wixted; John T,70,0,100,30
1713345014169,PSYC 172,A00,494192,Gorman; Michael R.,36,0,45,9
1713345015199,PSYC 178,A00,494193,Glaser; Dale,32,0,45,13
1713345016225,PSYC 193,A00,505725,Chapman; Eddie Nathaniel,20,0,20,0
1713345017255,RELI 145GS,A00,519817,Rahimi; Babak,17,0,20,3
1713345018283,SE 101A,A01,490862,Chadha; Mayank,23,0,25,2
1713345019315,SE 101C,A01,490924,Krysl; Petr,15,0,20,5
1713345020341,SE 110A,A01,490928,Staff,19,0,20,1
1713345021375,SE 130A,A00,490929,Morrison; Machel Leigh,54,0,70,16
1713345022402,SIO 1,A01,519325,Staff,39,0,40,1
1713345023430,SIO 30,A01,519327,Staff,38,0,40,2
1713345024458,SIO 40,A00,519328,Staff,39,0,40,1
1713345025484,SIO 46GS,A00,519819,Cook; Geoffrey W,15,0,25,10
1713345026510,SIO 109R,A00,494197,Forman; Fonna,0,3,20,20
1713345027539,SIO 121GS,A00,519827,Cook; Geoffrey W,15,0,25,10
1713345028565,SIO 132,A01,519330,Staff,38,0,40,2
1713345029596,SIO 133,A01,519397,Staff,37,0,40,3
1713345030625,SIO 139,A00,519396,Kacev; David,29,0,40,11
1713345031660,SOCI 1,A01,494199,Thorpe; Charles Robert,21,0,30,9
1713345031660,SOCI 1,A02,494200,Thorpe; Charles Robert,30,0,30,0
1713345031660,SOCI 1,A03,494201,Thorpe; Charles Robert,29,0,30,1
1713345031660,SOCI 1,A04,494202,Thorpe; Charles Robert,29,0,30,1
1713345031660,SOCI 1,A05,494203,Thorpe; Charles Robert,29,0,30,1
1713345031660,SOCI 1,A06,494204,Thorpe; Charles Robert,30,0,30,0
1713345031660,SOCI 1,A07,494205,Thorpe; Charles Robert,28,0,30,2
1713345032687,SOCI 60,A01,494207,Staff,33,0,40,7
1713345032687,SOCI 60,A02,494208,Staff,39,0,40,1
1713345033713,SOCI 100,A01,494210,Payne; Christine Anna,25,0,30,5
1713345033713,SOCI 100,A02,494211,Payne; Christine Anna,26,0,30,4
1713345034739,SOCI 109M,A00,494212,Staff,20,0,20,0
1713345035770,SOCI 110,A00,494213,Staff,34,0,40,6
1713345037828,SOCI 118E,A00,494215,Ng; Kwai,37,0,40,3
1713345038859,SOCI 125,A00,494216,Calderon-Zaks; Michael Aar,39,0,45,6
1713345039890,SOCI 126,A01,494218,Jones; Makeba,3,0,5,2
1713345040915,SOCI 131,A00,494219,Thorpe; Charles Robert,26,0,30,4
1713345042967,SOCI 135,A00,494221,Payne; Christine Anna,28,0,50,22
1713345044001,SOCI 136E,A00,626690,Ruiz; Jonathan Joseph,24,0,25,1
1713345045031,SOCI 138GS,A00,494222,Navon; Daniel,23,0,28,5
1713345047088,SOCI 145,A00,494224,Staff,40,0,45,5
1713345048114,SOCI 153,A00,494225,Staff,28,0,30,2
1713345049139,SOCI 160E,A00,494226,Ng; Kwai,27,0,40,13
1713345050171,SOCI 180,A00,494227,Staff,29,0,30,1
1713345051202,SOCI 189GS,A00,494228,Ribas Norris; Janet Vanesa,11,0,11,0
1713345052232,SOCI 190GS,A00,553232,Ribas Norris; Janet Vanesa,11,0,11,0
1713345053263,SOMI 220,A00,627178,Schneid; Stephen David,30,0,30,0
1713345054290,SYN 2,001,490768,Staff,13,0,15,2
1713345054290,SYN 2,002,490769,Staff,14,0,15,1
1713345054290,SYN 2,004,490775,Staff,0,0,0,0
1713345054290,SYN 2,003,490774,Staff,0,0,0,0
1713345054290,SYN 2,005,490776,Staff,0,0,0,0
1713345055317,SYN 2R,001,490779,Staff,10,0,15,5
1713345055317,SYN 2R,002,514635,Staff,14,0,15,1
1713345056345,SYN 100,A01,490783,Staff,8,0,20,12
1713345056345,SYN 100,B01,490787,Staff,10,0,20,10
1713345056345,SYN 100,C01,490789,Staff,10,0,20,10
1713345057372,SYN 150,A00,490817,Staff,14,0,15,1
1713345057372,SYN 150,B00,514610,Staff,15,0,15,0
1713345058409,TDAC 1,A00,492753,Walsh; Kim C.,19,0,20,1
1713345058409,TDAC 1,B00,492754,Harting; Carla Kelso,18,0,20,2
1713345058409,TDAC 1,C00,513995,Salovey; Todd,15,0,20,5
1713345059437,TDAC 101,A00,492766,Harting; Carla Kelso,17,0,20,3
1713345060462,TDAC 102,A00,492768,Basso; Beatrice,19,0,20,1
1713345061489,TDDE 111,A00,492769,Staff,25,0,25,0
1713345062515,TDDE 131,A00,492770,Staff,15,0,15,0
1713345062515,TDDE 131,B00,492771,Staff,15,0,15,0
1713345063541,TDDE 131GS,A00,523716,Guirguis; Mark C,23,0,28,5
1713345064575,TDGE 1,A01,492756,Salovey; Todd,56,0,60,4
1713345065601,TDGE 5,A01,492758,Staff,23,0,25,2
1713345066627,TDGE 10,A00,492759,Fulton; Julia,203,0,220,17
1713345067659,TDGE 11,A00,492760,Castro; Robert Jess,198,0,200,2
1713345069715,TDGE 124,A00,492772,Fulton; Julia,180,0,220,40
1713345070743,TDGE 125,A00,492773,Meyer; Ursula,38,0,50,12
1713345070743,TDGE 125,B00,492774,Staff,49,0,50,1
1713345070743,TDGE 125,C00,523565,Staff,48,0,50,2
1713345071769,TDGE 125GS,A00,523580,Guirguis; Mark C,23,0,28,5
1713345072801,TDGE 127,A00,492775,Havis; Allan,33,0,50,17
1713345073832,TDHT 101,A00,492776,Staff,34,0,35,1
1713345074859,TDMV 1,A00,492762,Caligagan; Maria T.,29,0,30,1
1713345074859,TDMV 1,B00,492763,Arcidiacono; Kristin,26,0,30,4
1713345075886,TDMV 2,A00,492764,Weinberg; Sadie,27,0,30,3
1713345076916,TDMV 3,A00,492765,Mack; Kara Shanai',37,0,40,3
1713345077947,TDMV 138,A00,492777,Mack; Kara Shanai',32,0,40,8
1713345078979,TDMV 140,A00,492778,Lima; Paulo Henrique,40,0,40,0
1713345080007,TDMV 142,A00,492779,Caligagan; Maria T.,33,0,40,7
1713345080007,TDMV 142,B00,492780,Caligagan; Tony,37,0,40,3
1713345081033,TDMV 143,A00,492781,Fyall; Daunte Edward,39,0,40,1
1713345082067,USP 1,A01,492401,Kwak; Nancy,27,0,35,8
1713345083097,USP 2,A01,492453,Hinds; Juli Beth,35,0,35,0
1713345084121,USP 3,A01,492516,Staff,28,0,35,7
1713345085150,USP 4,A00,492522,McTague; Sarah,16,0,25,9
1713345086177,USP 100,A00,492523,Staff,32,0,35,3
1713345087202,USP 101,A00,492524,Staff,13,0,15,2
1713345088229,USP 105,A00,492525,Staff,21,0,25,4
1713345089256,USP 151,A00,492526,Shenkman; Michael Thomas,32,0,35,3
1713345090339,USP 170,A00,492545,Hinds; Juli Beth,33,0,35,2
1713345091369,USP 171GS,A00,492608,Bussell; Mirle Rabinowitz,24,0,28,4
1713345092400,USP 183GS,A00,492613,Peerson; Susan,24,0,28,4
1713345093426,VIS 30,A01,490693,Yoldas; Pinar,19,0,22,3
1713345093426,VIS 30,A02,490694,Yoldas; Pinar,18,0,22,4
1713345094453,VIS 83,A00,490695,Kester; Grant,63,0,75,12
1713345095479,VIS 105D,A00,490696,Staff,22,0,25,3
1713345096505,VIS 124CN,A00,490699,Rose; Jordan M,64,0,75,11
1713345097532,VIS 125GS,A00,511221,Williams; Alena J,21,0,22,1
1713345098558,VIS 128D,A00,490700,Staff,73,0,75,2
1713345099586,VIS 151,A01,490717,Staff,33,0,34,1
1713345099586,VIS 151,A02,490766,Staff,32,0,34,2
1713345100616,VIS 154GS,A00,511972,Williams; Alena J,21,0,22,1
1713345101641,VIS 160A,A00,490767,Stone; Patricia,7,0,10,3
1713345102667,WCWP 10A,A00,490638,Staff,14,0,15,1
1713345102667,WCWP 10A,B00,490640,Staff,15,0,15,0
1713345103698,WCWP 10B,A00,490641,Staff,0,0,0,0
1713345103698,WCWP 10B,B00,490642,Staff,14,0,15,1
1713345103698,WCWP 10B,C00,490644,Staff,13,0,15,2
1713345103698,WCWP 10B,D00,490647,Staff,0,0,0,0
1713345104724,WCWP 100,A00,490655,Staff,0,0,0,0
1713345104724,WCWP 100,B00,490687,Staff,10,0,15,5
1713345106860,ANAR 153,A00,487222,Braswell; Geoffrey E.,53,0,60,7
1713345107890,ANBI 134,A00,487223,Staff,5,0,20,15
1713345108916,ANBI 143GS,A00,487224,Noel; Geoffroy Pierre Jean,18,0,24,6
1713345109943,ANBI 144GS,A00,519548,Noel; Geoffroy Pierre Jean,18,0,24,6
1713345110969,ANSC 101,A00,487225,Staff,17,0,20,3
1713345112000,ANSC 125,A00,487227,Brenner; Suzanne A,38,0,40,2
1713345114052,ANSC 146,A00,487229,Staff,35,0,40,5
1713345115080,ANSC 148,A00,487230,Olivas Hernandez; Olga Lid,39,0,40,1
1713345116107,ANSC 150,A00,504165,Sloane; Julia Kathryn,18,0,20,2
1713345117137,ANSC 180,A00,487232,Staff,14,0,15,1
1713345118164,ANSC 188,A00,627155,Staff,37,0,40,3
1713345119195,ANTH 5,A00,519529,Semendeferi; Ekaterini,15,0,15,0
1713345120222,ANTH 10,A00,487219,Staff,58,0,60,2
1713345121249,ANTH 23,A01,487221,Staff,17,0,20,3
1713345122281,ANTH 102,A00,487233,Wilder; Linnea Lorene,50,0,60,10
1713345123305,ANTH 103,A00,487234,Varma; Saiba,54,0,60,6
1713345124330,ANTH 105,A00,487235,Stewart; Alexander B,54,0,60,6
1713345125362,BENG 100,A01,516685,Taylor Amos; Alyssa C,25,0,30,5
1713345126395,BIBC 102,A01,491316,Flagg; Matthew Paul,5,0,88,83
1713345126395,BIBC 102,A02,491366,Flagg; Matthew Paul,78,0,88,10
1713345127427,BIBC 103,A01,491486,Boumechache; Miyyada,16,0,24,8
1713345127427,BIBC 103,A02,491487,Boumechache; Miyyada,24,0,24,0
1713345128461,BICD 100,A01,516882,Staff,73,0,75,2
1713345128461,BICD 100,A02,516890,Staff,69,0,75,6
1713345129492,BICD 102GS,A00,491488,Lo; Stanley M.,26,0,28,2
1713345130519,BIEB 136GS,A00,516940,Holway; David A. & Shurin; Jonathan,18,0,24,6
1713345131546,BIEB 137GS,A01,517034,Holway; David A. & Shurin; Jonathan,18,0,24,6
1713345132577,BIEB 138GS,A01,491492,Pirino; Giorgia,21,0,28,7
1713345133604,BILD 1,A01,491296,Staff,60,0,63,3
1713345133604,BILD 1,A02,491297,Staff,63,0,63,0
1713345134632,BILD 4,A01,517099,Gonzalez Gamboa; Ivonne,22,0,24,2
1713345134632,BILD 4,A02,517100,Gonzalez Gamboa; Ivonne,24,0,24,0
1713345135658,BILD 60GS,A00,491309,Lo; Stanley M.,26,0,28,2
1713345136685,BIMM 100,A01,517136,Staff,82,0,100,18
1713345137716,BIMM 110,A01,517182,Staff,52,0,100,48
1713345138743,BIMM 120,A01,517228,Pickett; Brooke Elizabeth,28,0,63,35
1713345138743,BIMM 120,A02,517240,Pickett; Brooke Elizabeth,44,0,63,19
1713345139775,BIMM 132GS,A01,491498,Pirino; Giorgia,21,0,28,7
1713345140802,BIMM 143,A01,491589,Bozinovic; Goran,12,0,40,28
1713345141834,BIPN 100,A01,491594,Armour; Jon Christopher,83,0,100,17
1713345142866,BIPN 140,A01,491602,Marino; Marc J,23,0,50,27
1713345144918,CAT 125,A00,515973,Staff,18,0,20,2
1713345145945,CAT 125GS,A00,515974,Rahimi; Babak,16,0,20,4
1713345146974,CAT 125R,A00,515980,Staff,12,0,20,8
1713345146974,CAT 125R,B00,515981,Tosun; Adriana,19,0,20,1
1713345146974,CAT 125R,C00,515987,Hyland; Tina Mae,0,5,20,20
1713345146974,CAT 125R,D00,515988,Bronstein; Phoebe Malan,16,0,20,4
1713345148001,CENG 15,A01,488699,Drews; Aaron,25,0,25,0
1713345149028,CENG 100,A00,505196,Opatkiewicz; Justin Paul,25,0,25,0
1713345150058,CGS 2A,A01,489598,Staff,32,0,35,3
1713345151087,CGS 112,A00,489599,Staff,15,0,15,0
1713345152114,CGS 119,A00,489603,Staff,10,0,10,0
1713345153142,CGS 120,A00,489604,Staff,13,0,15,2
1713345154167,CGS 150,A00,489607,Staff,15,0,15,0
1713345155194,CHEM 6A,A01,488715,Staff,97,0,100,3
1713345156222,CHEM 6B,A01,488719,Piercy; Marc Anthony,99,0,100,1
1713345157247,CHEM 6C,A01,488723,Albizati; Kim F.,93,0,100,7
1713345158288,CHEM 7L,A01,488728,Schurmeier; Kimberly,18,0,24,6
1713345158288,CHEM 7L,A02,488730,Schurmeier; Kimberly,23,0,24,1
1713345158288,CHEM 7L,A03,488734,Schurmeier; Kimberly,20,0,24,4
1713345158288,CHEM 7L,A04,488763,Schurmeier; Kimberly,23,0,24,1
1713345158288,CHEM 7L,B01,488798,Schurmeier; Kimberly,16,0,24,8
1713345158288,CHEM 7L,B02,488801,Schurmeier; Kimberly,22,0,24,2
1713345158288,CHEM 7L,B03,488808,Schurmeier; Kimberly,22,0,24,2
1713345158288,CHEM 7L,B04,488811,Schurmeier; Kimberly,24,0,24,0
1713345159314,CHEM 11,A01,488897,Stallings; Dontarie M,94,0,100,6
1713345160340,CHEM 40A,A01,488913,Albizati; Kim F.,83,0,100,17
1713345161368,CHEM 40B,A01,488920,Weizman; Haim,42,0,50,8
1713345161368,CHEM 40B,A02,488938,Weizman; Haim,43,0,50,7
1713345162399,CHEM 41A,A01,489029,Klosterman; Jeremy K,57,0,60,3
1713345163428,CHEM 41C,A01,500436,Tor; Yitzhak,54,0,60,6
1713345164465,CHEM 43A,A01,500426,Weizman; Haim,0,1,24,24
1713345164465,CHEM 43A,A02,500430,Weizman; Haim,6,0,24,18
1713345164465,CHEM 43A,B01,514041,Klosterman; Jeremy K,14,0,24,10
1713345164465,CHEM 43A,B02,514047,Klosterman; Jeremy K,23,0,24,1
1713345165492,CHEM 108,A01,489140,Jennings; Patricia A.,6,0,24,18
1713345165492,CHEM 108,A02,489142,Jennings; Patricia A.,14,0,24,10
1713345166525,CHEM 114A,A01,489147,Stallings; Dontarie M,65,0,100,35
1713345167552,CHIN 169A,A00,489171,Wang; Xiao,19,0,20,1
1713345169609,COGS 3,A01,518827,Boyle; Mary E. T.,25,0,40,15
1713345170634,COGS 11,A01,489175,Staff,27,0,30,3
1713345171661,COGS 14A,A01,518829,Staff,50,0,60,10
1713345172693,COGS 14B,A01,489177,Hoffman; Drew Ellen,62,0,75,13
1713345173724,COGS 100,A01,489181,Allen; Michael Gordon,62,0,75,13
1713345174753,COGS 101A,A01,489183,Staff,45,0,60,15
1713345175779,COGS 101B,A01,489185,Allen; Michael Gordon,6,0,30,24
1713345176810,COGS 101C,A01,526786,Staff,23,0,30,7
1713345178867,COGS 107A,A01,489189,Boyle; Mary E. T.,16,0,35,19
1713345179896,COGS 107B,A01,627144,Mooshagian; Eric Frederick,59,0,60,1
1713345180925,COGS 118A,A01,489191,Staff,0,46,40,40
1713345182987,COGS 171GS,A01,489194,Pineda; Jaime A,19,0,28,9
1713345184014,COGS 172,A01,489196,Staff,1,0,30,29
1713345185040,COGS 174GS,A01,489264,Pineda; Jaime A,19,0,28,9
1713345186065,COGS 180,A01,627150,Staff,28,0,30,2
1713345187091,COGS 186,A01,489274,Staff,0,3,30,30
1713345188121,COMM 10,A01,489276,Staff,23,0,25,2
1713345188121,COMM 10,A02,489303,Staff,23,0,25,2
1713345189145,COMM 100A,A01,489312,Staff,14,0,25,11
1713345189145,COMM 100A,A02,489313,Staff,24,0,25,1
1713345190172,COMM 106T,A00,512540,Staff,33,0,35,2
1713345191197,COMM 107,A00,489347,Staff,27,0,35,8
1713345192223,COMM 109P,A00,489358,Staff,31,0,35,4
1713345193249,COMM 132,A00,489361,McKenna; Denise,27,0,30,3
1713345194341,COMM 146,A00,489362,Halm; Gavin Patrick,26,0,30,4
1713345195366,COMM 190,A00,489363,Abuelhiga; Soraya Jill,17,0,23,6
1713345196395,CSE 8A,A50,489366,Staff,21,0,25,4
1713345196395,CSE 8A,A51,489367,Staff,24,0,25,1
1713345197428,CSE 11,A01,489398,Cao; Yingjun,72,0,100,28
1713345198459,CSE 12,A01,489487,Staff,43,0,50,7
1713345199488,CSE 20,A01,489497,Staff,47,0,50,3
1713345200520,CSE 21,A01,489517,Braun; Oliver,42,0,50,8
1713345201550,CSE 101,A01,489524,Braun; Oliver,0,34,50,50
1713345202583,CSE 105,A01,512594,Jones; Miles E,72,0,100,28
1713345202583,CSE 105,B01,512598,Jones; Miles E,51,0,100,49
1713345203608,CSE 140,A01,489538,Staff,39,0,50,11
1713345204640,CSE 141,A01,489550,Eldon; John,67,0,100,33
1713345205671,CSE 141L,A01,489571,Eldon; John,65,0,100,35
1713345206703,CSE 151A,A01,489583,Solares; Edwin A,139,0,200,61
1713345207735,CSE 175,A01,510886,Kumar; Rakesh,30,0,30,0
1713345208766,CSE 190,A00,516828,Dubnov; Shlomo,37,0,49,12
1713345209797,DOC 100D,A00,489667,Pass; Natalye Joann,19,0,25,6
1713345210825,DSC 10,A01,624268,Staff,72,0,75,3
1713345211855,DSC 20,A01,624476,Staff,50,0,50,0
1713345212885,DSC 40A,A01,624608,Staff,39,0,40,1
1713345213916,DSGN 1,A01,489179,Rill; Bryan,32,0,50,18
1713345214943,ECE 17,A01,490489,Sahay; Rajeev,18,0,30,12
1713345215970,ECE 65,A50,490492,Staff,11,0,20,9
1713345215970,ECE 65,A51,490493,Staff,18,0,20,2
1713345217005,ECON 1,A01,489715,Famulari; Melissa,67,0,70,3
1713345218033,ECON 2,A01,489717,Levkoff; Steven B.,67,0,70,3
1713345219060,ECON 3,A01,489948,Staff,70,0,70,0
1713345221126,ECON 5,A01,490103,Staff,27,0,30,3
1713345221126,ECON 5,B01,626281,Dai; Yinlin,45,0,45,0
1713345222157,ECON 100A,A01,490127,Famulari; Melissa,62,0,70,8
1713345223183,ECON 100B,A01,490129,Staff,64,0,70,6
1713345224214,ECON 109,A01,490187,Shishkin; Denis,27,0,35,8
1713345225242,ECON 110A,A01,490190,Levkoff; Steven B.,59,0,70,11
1713345226268,ECON 120A,A01,490245,Dai; Yinlin,59,0,70,11
1713345227296,ECON 120B,A01,490247,Nieto-Barthaburu; Augusto,40,0,70,30
1713345228324,ECON 120C,A01,490253,Sun; Yixiao,30,0,35,5
1713345228324,ECON 120C,B01,490255,Sun; Yixiao,34,0,35,1
1713345229351,ECON 129,A00,490256,Eckert; Fabian Paul,22,0,35,13
1713345230383,ECON 131,A00,490257,Nieto-Barthaburu; Augusto,0,6,35,35
1713345231410,ECON 138,A00,490258,Bharadwaj; Prashant,13,0,35,22
1713345231410,ECON 138,B00,490259,Bharadwaj; Prashant,15,0,35,20
1713345232438,ECON 159,A00,490260,Hendrickson; Gerald M.,0,9,0,0
1713345233473,ECON 178,A01,553995,Zhu; Ying,24,0,35,11
1713345234504,EDS 40,A01,512576,Black; Alison Michelle,20,0,20,0
1713345235535,EDS 107,A01,515848,Staff,30,0,30,0
1713345236568,EDS 110R,A01,490262,Staff,26,0,30,4
1713345237595,EDS 112,A01,490264,Chapman; Thandeka K,40,0,50,10
1713345238621,EDS 113,A00,490266,Staff,25,0,30,5
1713345239648,EDS 118,A00,490267,Warstadt; Melissa Fawn,18,0,30,12
1713345240677,EDS 124BR,A00,490268,Eguchi; Emi,4,0,25,21
1713345240677,EDS 124BR,B00,490269,Eguchi; Emi,23,0,25,2
1713345241708,EDS 126,A01,490271,Jones; Makeba,43,0,50,7
1713345242738,EDS 135,A01,490316,Staff,19,0,20,1
1713345243765,ENVR 142GS,A00,519514,Chang; Edmond Yi-Teh,26,0,28,2
1713345244791,ETHN 103,A00,490504,Staff,24,0,36,12
1713345245822,ETHN 103A,A00,490505,Man; Simeon S,3,0,9,6
1713345246852,ETHN 109,A00,490506,Staff,28,0,30,2
1713345247879,ETHN 118,A00,490507,Staff,35,0,36,1
1713345248906,ETHN 119,A00,490508,Staff,32,0,36,4
1713345249931,ETHN 121R,A00,490518,Choi; Esther Min,21,0,36,15
1713345250958,ETHN 127,A00,490528,Staff,14,0,15,1
1713345251982,ETHN 139,A00,490573,Staff,10,0,10,0
1713345253008,ETHN 150,A00,490575,Staff,15,0,15,0
1713345254041,GLBH 20,A00,491705,Elwardani; Nile Regina,38,0,40,2
1713345255067,GLBH 101,A00,491706,Staff,20,0,20,0
1713345256093,GLBH 111,A01,491708,Burgos; Jose L.,15,0,15,0
1713345257119,GLBH 146,A00,491709,Staff,8,0,20,12
1713345258150,GLBH 148,A00,491710,Olivas Hernandez; Olga Lid,10,0,20,10
1713345259176,GLBH 150,A00,491711,Sloane; Julia Kathryn,19,0,20,1
1713345260200,HIEA 131,A00,491760,Staff,28,0,32,4
1713345261232,HIEA 153,A00,491762,Staff,28,0,30,2
1713345262257,HIEU 124,A00,491811,Staff,26,0,32,6
1713345263284,HIEU 124GS,A00,491812,Markman; Kristina,27,0,28,1
1713345264309,HIEU 147,A00,491813,Staff,30,0,32,2
1713345265334,HIEU 149GS,A00,491816,Caldwell; Michael Alan,28,0,28,0
1713345266362,HILD 2C,A01,491713,Hendrickson; Gerald M.,26,0,30,4
1713345267420,HILD 7B,A01,491715,Kwak; Nancy,0,2,30,30
1713345268446,HILD 10,A01,491717,Staff,9,0,20,11
1713345269472,HILD 30GS,A00,491719,Edington; Claire Ellen,23,0,28,5
1713345270497,HINE 109,A00,491818,Shafir; Nir,26,0,32,6
1713345271524,HINE 128,A00,491821,Shafir; Nir,30,0,32,2
1713345272550,HISC 117,A00,491830,Staff,27,0,32,5
1713345273577,HIUS 103,A00,491834,Man; Simeon S,14,0,23,9
1713345274603,HIUS 108B,A00,491835,Staff,27,0,30,3
1713345275633,HIUS 141,A00,491836,Hendrickson; Gerald M.,28,0,32,4
1713345276664,HIUS 149,A00,491839,Staff,24,0,32,8
1713345277691,HUM 3,A01,512617,Crum; Matthew Stephen,42,0,50,8
1713345277691,HUM 3,A02,512618,Crum; Matthew Stephen,48,0,50,2
1713345278724,HUM 3GS,A00,512663,Markman; Kristina,0,0,0,1
1713345278724,HUM 3GS,B00,512664,Staff,0,0,0,0
1713345279750,HUM 4,A01,512620,West; Geoffrey Scott,23,0,50,27
1713345280775,HUM 4GS,A00,512666,Lyon; Antony J.,0,0,0,5
1713345281802,HUM 4R,A01,512625,Watkins; Eric,49,0,50,1
1713345282832,HUM 5,A01,512649,Zavodny; Tatiana Sophia,20,0,50,30
1713345282832,HUM 5,B01,512661,Zroka; Ryan Edward,48,0,50,2
1713345283875,INTL 190,A00,490577,Segui; Alan S,0,0,0,5
1713345284904,JAPN 20AR,A01,491267,Ross; Kayoko F,7,0,20,13
1713345285928,JAPN 180,A00,491285,Berman; Michael David,33,0,40,7
1713345286963,LATI 50,A01,502536,Kokinis; Troy Andreas,16,0,22,6
1713345286963,LATI 50,A02,502551,Kokinis; Troy Andreas,22,0,22,0
1713345286963,LATI 50,A03,502650,Kokinis; Troy Andreas,22,0,22,0
1713345286963,LATI 50,A04,502909,Kokinis; Troy Andreas,21,0,22,1
1713345287995,LATI 160,A01,502920,Kokinis; Troy Andreas,30,0,30,0
1713345289020,LIFR 1A,A00,490494,Van Moer; Vinciane G,17,0,20,3
1713345290050,LIFR 1AX,A00,490495,Van Moer; Vinciane G,17,0,20,3
1713345291079,LIFR 1B,A00,490496,Van Moer; Vinciane G,17,0,20,3
1713345292105,LIFR 1BX,A00,490497,Van Moer; Vinciane G,17,0,20,3
1713345293132,LIGN 8,A00,505198,McIntosh; Justin Daniel,134,0,150,16
1713345294158,LIGN 9GS,A00,491239,Lott; Margaret S.,18,0,20,2
1713345295190,LIGN 101,A01,505200,McIntosh; Justin Daniel,22,0,30,8
1713345296220,LIGN 120,A01,491244,Staff,22,0,30,8
1713345297244,LIGN 149GS,A00,491245,Lott; Margaret S.,18,0,20,2
1713345298325,LIGN 170,A00,491247,Staff,22,0,30,8
1713345299351,LISP 1D,A00,490498,Munoz Sanchez; Alicia,8,0,14,6
1713345299351,LISP 1D,B00,490499,Munoz Sanchez; Alicia,4,0,14,10
1713345299351,LISP 1D,C00,490500,Munoz Sanchez; Alicia,7,0,14,7
1713345299351,LISP 1D,D00,490501,Munoz Sanchez; Alicia,10,0,14,4
1713345300381,LISP 1DX,A00,490502,Munoz Sanchez; Alicia,11,0,28,17
1713345300381,LISP 1DX,B00,490503,Munoz Sanchez; Alicia,16,0,28,12
1713345302434,LTAM 110,A00,491847,Staff,22,0,25,3
1713345303462,LTCS 119,A00,491848,Staff,11,0,15,4
1713345304488,LTCS 130,A00,491849,Staff,24,0,25,1
1713345306541,LTEA 120C,A00,491852,Staff,32,0,40,8
1713345307572,LTEN 130GS,A00,491853,Lyon; Antony J.,23,0,28,5
1713345308601,LTEN 148,A00,491855,Staff,23,0,25,2
1713345309628,LTEN 159,A00,491856,Staff,20,0,25,5
1713345310657,LTEN 180,A00,491857,Staff,8,0,15,7
1713345312708,LTSP 123GS,A00,505928,Bessett; Ryan Matthew,24,0,28,4
1713345313734,LTSP 174GS,A00,506037,Bessett; Ryan Matthew,24,0,28,4
1713345315790,LTWR 102,A00,491861,Staff,9,0,15,6
1713345316813,LTWR 106,A00,491862,Staff,8,0,15,7
1713345317844,MAE 11,A00,490930,Bahadori; Mohammad Yousef,94,0,100,6
1713345318872,MAE 30A,A00,490931,Qi; Huihui,37,0,40,3
1713345319899,MAE 101A,A00,491036,Sadeghizadeh; Zahra,91,0,100,9
1713345320926,MAE 101C,A00,491037,Seshadri; Kalyanasundaram,63,0,100,37
1713345321950,MAE 113,A00,491040,Seshadri; Kalyanasundaram,64,0,80,16
1713345322975,MAE 131A,A00,491041,Ghazinejad; Maziar,37,0,40,3
1713345324002,MAE 142,A00,491053,Staff,39,0,40,1
1713345325029,MAE 143A,A00,491054,Staff,29,0,50,21
1713345326054,MAE 150,A00,491092,Truong; Phuong Thi Ngoc,23,0,35,12
1713345327087,MATH 3C,A01,494031,Pardo Guerra; Sebastian,30,0,30,0
1713345327087,MATH 3C,A02,494032,Pardo Guerra; Sebastian,29,0,30,1
1713345328113,MATH 10A,A01,494034,Staff,27,0,30,3
1713345328113,MATH 10A,A02,494035,Staff,28,0,30,2
1713345328113,MATH 10A,B01,494037,Staff,27,0,30,3
1713345328113,MATH 10A,B02,494038,Staff,29,0,30,1
1713345329143,MATH 10B,A01,494040,Habib; Yousaf,22,0,30,8
1713345329143,MATH 10B,A02,494041,Habib; Yousaf,28,0,30,2
1713345329143,MATH 10B,A03,494042,Habib; Yousaf,29,0,30,1
1713345329143,MATH 10B,A04,494043,Habib; Yousaf,30,0,30,0
1713345329143,MATH 10B,B01,494045,Habib; Yousaf,25,0,30,5
1713345329143,MATH 10B,B02,494046,Habib; Yousaf,30,0,30,0
1713345329143,MATH 10B,B03,494047,Habib; Yousaf,30,0,30,0
1713345329143,MATH 10B,B04,494048,Habib; Yousaf,30,0,30,0
1713345330176,MATH 18,A01,494050,Kemp; Todd Aahron,25,0,30,5
1713345330176,MATH 18,A02,494051,Kemp; Todd Aahron,29,0,30,1
1713345330176,MATH 18,B01,494054,Kemp; Todd Aahron,25,0,30,5
1713345330176,MATH 18,B02,494055,Kemp; Todd Aahron,29,0,30,1
1713345331204,MATH 20A,A01,494059,Suk; Andrew Hoon,30,0,30,0
1713345332230,MATH 20B,A01,494061,Briones; Jor-el Thomas Caparas,33,0,35,2
1713345332230,MATH 20B,B01,494063,Bach; Quang Tran,34,0,35,1
1713345333260,MATH 20C,A01,494065,Staff,28,0,30,2
1713345333260,MATH 20C,A02,494066,Staff,30,0,30,0
1713345333260,MATH 20C,A03,494067,Staff,30,0,30,0
1713345333260,MATH 20C,A04,494068,Staff,30,0,30,0
1713345333260,MATH 20C,B01,494070,Zhang; Ming,23,0,30,7
1713345333260,MATH 20C,B02,494071,Zhang; Ming,27,0,30,3
1713345333260,MATH 20C,B03,494072,Zhang; Ming,29,0,30,1
1713345333260,MATH 20C,B04,494073,Zhang; Ming,29,0,30,1
1713345334287,MATH 20D,A01,494075,Staff,22,0,30,8
1713345334287,MATH 20D,A02,494076,Staff,29,0,30,1
1713345335319,MATH 20E,A01,494079,Staff,24,0,30,6
1713345335319,MATH 20E,A02,494080,Staff,26,0,30,4
1713345335319,MATH 20E,B01,494082,Staff,25,0,30,5
1713345335319,MATH 20E,B02,494083,Staff,25,0,30,5
1713345336352,MATH 103A,A01,494085,Aliabadi Sr.; Mohsen,12,0,30,18
1713345336352,MATH 103A,A02,494086,Aliabadi Sr.; Mohsen,28,0,30,2
1713345336352,MATH 103A,B01,494088,Aliabadi Sr.; Mohsen,20,0,30,10
1713345336352,MATH 103A,B02,494089,Aliabadi Sr.; Mohsen,27,0,30,3
1713345337379,MATH 109,A01,494091,Staff,30,0,30,0
1713345337379,MATH 109,A02,494092,Staff,29,0,30,1
1713345337379,MATH 109,B01,494094,Staff,27,0,30,3
1713345337379,MATH 109,B02,494095,Staff,29,0,30,1
1713345338409,MATH 142A,A01,494097,Chow; Bennett,13,0,30,17
1713345338409,MATH 142A,A02,494098,Chow; Bennett,23,0,30,7
1713345338409,MATH 142A,B01,494100,Chow; Bennett,19,0,30,11
1713345338409,MATH 142A,B02,494101,Chow; Bennett,29,0,30,1
1713345340460,MATH 168A,A01,516677,Dumitriu; Ioana,16,0,35,19
1713345341491,MATH 170A,A01,516679,Dumitriu; Ioana,18,0,30,12
1713345341491,MATH 170A,A02,516680,Dumitriu; Ioana,28,0,30,2
1713345342515,MATH 193A,A01,494107,Staff,12,0,30,18
1713345342515,MATH 193A,A02,494108,Staff,18,0,30,12
1713345342515,MATH 193A,A03,494109,Staff,29,0,30,1
1713345342515,MATH 193A,A04,494110,Staff,22,0,30,8
1713345345601,MGT 16,A00,491930,McKay; Michael J,92,0,98,6
1713345346628,MGT 18,A00,491992,McKay; Michael J,96,0,98,2
1713345347654,MGT 71,A00,492003,Staff,63,0,98,35
1713345348685,MGT 103,A00,505209,Eberhard; Craig A,80,0,98,18
1713345349709,MGT 131A,A00,505210,Anderson; John Charles,89,0,98,9
1713345351760,MGT 153,A00,492077,Perols; Johan Lars,15,0,90,75
1713345354846,MGT 164,A00,492222,McKay; Mary A,91,0,98,7
1713345355872,MGT 172,A00,492245,Staff,59,0,60,1
1713345355872,MGT 172,B00,505526,Hedges; Kathleen,65,0,98,33
1713345356905,MGT 181,A00,505669,Dunn; Louis Jean,78,0,98,20
1713345357932,MMW 14,A01,494399,Staff,15,0,28,13
1713345357932,MMW 14,A02,494400,Staff,25,0,28,3
1713345357932,MMW 14,A03,494401,Staff,28,0,28,0
1713345357932,MMW 14,A04,494402,Staff,28,0,28,0
1713345357932,MMW 14,B01,494404,Carreras; Maria Victoria,8,0,28,20
1713345357932,MMW 14,B02,494405,Carreras; Maria Victoria,25,0,28,3
1713345357932,MMW 14,B03,494406,Carreras; Maria Victoria,27,0,28,1
1713345357932,MMW 14,B04,494407,Carreras; Maria Victoria,28,0,28,0
1713345358960,MMW 14GS,A00,506250,Chang; Edmond Yi-Teh,0,0,0,0
1713345359990,MMW 121R,A01,494415,Adamiak; Patrick John,10,0,28,18
1713345359990,MMW 121R,A02,494416,Adamiak; Patrick John,24,0,28,4
1713345361016,MUS 1A,A01,494113,Staff,12,0,25,13
1713345361016,MUS 1A,A02,494114,Staff,24,0,25,1
1713345362051,MUS 4,A01,494116,Staff,23,0,25,2
1713345362051,MUS 4,A02,494117,Staff,22,0,25,3
1713345363088,MUS 5R,A01,494236,Dubnov; Shlomo,4,0,25,21
1713345363088,MUS 5R,A02,494237,Dubnov; Shlomo,25,0,25,0
1713345364114,MUS 6,A01,494122,Staff,9,0,25,16
1713345364114,MUS 6,A02,494123,Staff,23,0,25,2
1713345365139,MUS 7,A01,494125,Staff,16,0,25,9
1713345365139,MUS 7,A02,494126,Staff,24,0,25,1
1713345366165,MUS 11,A01,494128,Staff,23,0,25,2
1713345366165,MUS 11,A02,494129,Staff,24,0,25,1
1713345367194,MUS 13,A01,494131,Staff,25,0,25,0
1713345367194,MUS 13,A02,494132,Staff,25,0,25,0
1713345368220,MUS 15,A01,494134,Staff,16,0,25,9
1713345368220,MUS 15,A02,494135,Staff,25,0,25,0
1713345368220,MUS 15,B01,494137,Staff,24,0,25,1
1713345369252,MUS 80,A00,494232,Staff,24,0,25,1
1713345369252,MUS 80,B00,494233,Staff,25,0,25,0
1713345369252,MUS 80,C00,494234,Staff,23,0,25,2
1713345370277,MUS 95C,A00,494141,Staff,69,0,75,6
1713345371303,MUS 114,A00,494142,Staff,39,0,50,11
1713345372331,NANO 15,A01,490636,Drews; Aaron,7,0,7,0
1713345373365,PHIL 1,A00,490578,Grush; Rick Scott,49,0,50,1
1713345374393,PHIL 10,A01,490580,Grush; Rick Scott,33,0,35,2
1713345374393,PHIL 10,A02,490586,Grush; Rick Scott,32,0,35,3
1713345375423,PHIL 27,A01,490591,Staff,22,0,25,3
1713345375423,PHIL 27,A02,490592,Staff,25,0,25,0
1713345375423,PHIL 27,A03,490593,Staff,25,0,25,0
1713345375423,PHIL 27,A04,490598,Staff,25,0,25,0
1713345376452,PHIL 32,A01,490611,Staff,20,0,20,0
1713345376452,PHIL 32,A02,490618,Staff,20,0,20,0
1713345377478,PHIL 90,A00,490624,Staff,40,0,40,0
1713345378504,PHIL 136,A00,490627,Cohen; Jonathan David,37,0,40,3
1713345379529,PHIL 155,A00,490634,Staff,62,0,70,8
1713345380556,PHYS 1A,A00,491610,Staff,245,0,250,5
1713345381585,PHYS 1AL,001,491616,Tsai; Philbert S,27,0,30,3
1713345381585,PHYS 1AL,002,491618,Tsai; Philbert S,30,0,30,0
1713345382612,PHYS 1B,A00,491623,Staff,235,0,250,15
1713345383638,PHYS 1BL,001,491626,Tsai; Philbert S,18,0,30,12
1713345383638,PHYS 1BL,002,491628,Tsai; Philbert S,26,0,30,4
1713345384664,PHYS 1C,A00,491632,Staff,211,0,245,34
1713345385694,PHYS 1CL,001,491635,Tsai; Philbert S,2,0,30,28
1713345385694,PHYS 1CL,002,491643,Tsai; Philbert S,22,0,30,8
1713345386723,PHYS 2AR,A01,491651,Meyertholen; Andrew D.,44,0,50,6
1713345387752,PHYS 2B,A01,491659,Staff,105,0,115,10
1713345388782,PHYS 2BL,A01,491685,Staff,21,0,24,3
1713345388782,PHYS 2BL,A02,491700,Staff,21,0,24,3
1713345389809,PHYS 2C,A01,505161,Staff,101,0,115,14
1713345390837,PHYS 4A,A01,491704,Grinstein; Benjamin,99,0,100,1
1713345391868,POLI 5D,A01,494144,Staff,3,0,5,2
1713345391868,POLI 5D,B01,626283,Dai; Yinlin,5,0,5,0
1713345392893,POLI 12,A00,494145,Staff,43,0,45,2
1713345393918,POLI 13R,A00,494146,Forman; Fonna,45,0,50,5
1713345394942,POLI 27,A01,494148,Staff,54,0,60,6
1713345395968,POLI 30,A00,494149,Staff,49,0,50,1
1713345396994,POLI 100DA,A00,494150,Staff,20,0,25,5
1713345399050,POLI 100I,A00,494152,Staff,27,0,30,3
1713345400076,POLI 104B,A00,494153,Smith; Glenn Chatmas,53,0,55,2
1713345401101,POLI 104F,A00,494154,Staff,28,0,30,2
1713345402186,POLI 104I,A00,494155,Smith; Glenn Chatmas,29,0,30,1
1713345403214,POLI 110C,A00,494156,Ingham; Sean,23,0,25,2
1713345404245,POLI 117R,A00,494157,Forman; Fonna,5,0,20,15
1713345405270,POLI 118,A00,494158,Ingham; Sean,21,0,25,4
1713345406296,POLI 120H,A00,494159,Fisk; David Lee,39,0,45,6
1713345407323,POLI 131CR,A00,494160,Hoston; Germaine,35,0,45,10
1713345408351,POLI 133J,A00,494161,Staff,31,0,35,4
1713345409380,POLI 135,A00,494162,Fisk; David Lee,33,0,35,2
1713345410408,POLI 140A,A00,494164,Staff,18,0,30,12
1713345411436,POLI 142I,A00,494165,Staff,30,0,30,0
1713345412463,POLI 144D,A00,494166,Staff,22,0,25,3
1713345413493,POLI 151,A00,494167,Staff,30,0,30,0
1713345414518,POLI 153,A00,494168,Staff,33,0,35,2
1713345415543,POLI 160AA,A00,494169,Staff,33,0,40,7
1713345416570,POLI 162,A00,494170,Mignozzetti; Umberto,17,0,25,8
1713345417600,POLI 171,A00,494171,Mignozzetti; Umberto,18,0,25,7
1713345418626,PSYC 1,A00,494172,Staff,95,0,100,5
1713345419651,PSYC 2,A00,494173,Moranton; Nirelia Melbina-,33,0,50,17
1713345420680,PSYC 3,A00,494174,Staff,29,0,30,1
1713345421706,PSYC 6,A00,494175,Staff,17,0,20,3
1713345422731,PSYC 60,A01,494177,Staff,37,0,45,8
1713345423757,PSYC 70,A01,505724,Geller; Emma Harlan,42,0,45,3
1713345424782,PSYC 101,A00,494180,Heyman; Gail D.,83,0,100,17
1713345425808,PSYC 105,A00,494181,Geller; Emma Harlan,51,0,90,39
1713345426834,PSYC 106,A00,494182,Dobkins; Karen R.,26,0,45,19
1713345427865,PSYC 108,A00,494183,Adrian; Julia Anna,89,0,100,11
1713345428891,PSYC 114,A01,494185,Winkielman; Piotr,0,4,30,30
1713345429917,PSYC 122,A00,494186,Moranton; Nirelia Melbina-,27,0,50,23
1713345430942,PSYC 124,A00,494187,Chapman; Eddie Nathaniel,69,0,80,11
1713345431968,PSYC 131,A00,494188,Anagnostaras; Stephan,39,0,80,41
1713345432994,PSYC 144,A00,494189,Staff,1,1,50,49
1713345434018,PSYC 154,A00,494190,Lacefield; Katharine I,105,0,180,75
1713345435044,PSYC 162,A00,494191,Wixted; John T,70,0,100,30
1713345436069,PSYC 172,A00,494192,Gorman; Michael R.,36,0,45,9
1713345437093,PSYC 178,A00,494193,Glaser; Dale,32,0,45,13
1713345438119,PSYC 193,A00,505725,Chapman; Eddie Nathaniel,20,0,20,0
1713345439146,RELI 145GS,A00,519817,Rahimi; Babak,17,0,20,3
1713345440177,SE 101A,A01,490862,Chadha; Mayank,23,0,25,2
1713345441203,SE 101C,A01,490924,Krysl; Petr,15,0,20,5
1713345442234,SE 110A,A01,490928,Staff,19,0,20,1
1713345443263,SE 130A,A00,490929,Morrison; Machel Leigh,54,0,70,16
1713345444295,SIO 1,A01,519325,Staff,39,0,40,1
1713345445319,SIO 30,A01,519327,Staff,38,0,40,2
1713345446348,SIO 40,A00,519328,Staff,39,0,40,1
1713345447373,SIO 46GS,A00,519819,Cook; Geoffrey W,15,0,25,10
1713345448403,SIO 109R,A00,494197,Forman; Fonna,0,3,20,20
1713345449433,SIO 121GS,A00,519827,Cook; Geoffrey W,15,0,25,10
1713345450462,SIO 132,A01,519330,Staff,38,0,40,2
1713345451489,SIO 133,A01,519397,Staff,37,0,40,3
1713345452514,SIO 139,A00,519396,Kacev; David,29,0,40,11
1713345453541,SOCI 1,A01,494199,Thorpe; Charles Robert,21,0,30,9
1713345453541,SOCI 1,A02,494200,Thorpe; Charles Robert,30,0,30,0
1713345453541,SOCI 1,A03,494201,Thorpe; Charles Robert,29,0,30,1
1713345453541,SOCI 1,A04,494202,Thorpe; Charles Robert,29,0,30,1
1713345453541,SOCI 1,A05,494203,Thorpe; Charles Robert,29,0,30,1
1713345453541,SOCI 1,A06,494204,Thorpe; Charles Robert,30,0,30,0
1713345453541,SOCI 1,A07,494205,Thorpe; Charles Robert,28,0,30,2
1713345454569,SOCI 60,A01,494207,Staff,33,0,40,7
1713345454569,SOCI 60,A02,494208,Staff,39,0,40,1
1713345455596,SOCI 100,A01,494210,Payne; Christine Anna,25,0,30,5
1713345455596,SOCI 100,A02,494211,Payne; Christine Anna,26,0,30,4
1713345456622,SOCI 109M,A00,494212,Staff,20,0,20,0
1713345457650,SOCI 110,A00,494213,Staff,34,0,40,6
1713345459707,SOCI 118E,A00,494215,Ng; Kwai,37,0,40,3
1713345460738,SOCI 125,A00,494216,Calderon-Zaks; Michael Aar,39,0,45,6
1713345461764,SOCI 126,A01,494218,Jones; Makeba,3,0,5,2
1713345462791,SOCI 131,A00,494219,Thorpe; Charles Robert,26,0,30,4
1713345464842,SOCI 135,A00,494221,Payne; Christine Anna,28,0,50,22
1713345465869,SOCI 136E,A00,626690,Ruiz; Jonathan Joseph,24,0,25,1
1713345466898,SOCI 138GS,A00,494222,Navon; Daniel,23,0,28,5
1713345468952,SOCI 145,A00,494224,Staff,40,0,45,5
1713345469981,SOCI 153,A00,494225,Staff,28,0,30,2
1713345471005,SOCI 160E,A00,494226,Ng; Kwai,27,0,40,13
1713345472034,SOCI 180,A00,494227,Staff,29,0,30,1
1713345473062,SOCI 189GS,A00,494228,Ribas Norris; Janet Vanesa,11,0,11,0
1713345474093,SOCI 190GS,A00,553232,Ribas Norris; Janet Vanesa,11,0,11,0
1713345475125,SOMI 220,A00,627178,Schneid; Stephen David,30,0,30,0
1713345476151,SYN 2,001,490768,Staff,13,0,15,2
1713345476151,SYN 2,002,490769,Staff,14,0,15,1
1713345476151,SYN 2,004,490775,Staff,0,0,0,0
1713345476151,SYN 2,003,490774,Staff,0,0,0,0
1713345476151,SYN 2,005,490776,Staff,0,0,0,0
1713345477180,SYN 2R,001,490779,Staff,10,0,15,5
1713345477180,SYN 2R,002,514635,Staff,14,0,15,1
1713345478208,SYN 100,A01,490783,Staff,8,0,20,12
1713345478208,SYN 100,B01,490787,Staff,10,0,20,10
1713345478208,SYN 100,C01,490789,Staff,10,0,20,10
1713345479237,SYN 150,A00,490817,Staff,14,0,15,1
1713345479237,SYN 150,B00,514610,Staff,15,0,15,0
1713345480267,TDAC 1,A00,492753,Walsh; Kim C.,19,0,20,1
1713345480267,TDAC 1,B00,492754,Harting; Carla Kelso,18,0,20,2
1713345480267,TDAC 1,C00,513995,Salovey; Todd,15,0,20,5
1713345481293,TDAC 101,A00,492766,Harting; Carla Kelso,17,0,20,3
1713345482321,TDAC 102,A00,492768,Basso; Beatrice,19,0,20,1
1713345483347,TDDE 111,A00,492769,Staff,25,0,25,0
1713345484373,TDDE 131,A00,492770,Staff,15,0,15,0
1713345484373,TDDE 131,B00,492771,Staff,15,0,15,0
1713345485399,TDDE 131GS,A00,523716,Guirguis; Mark C,23,0,28,5
1713345486427,TDGE 1,A01,492756,Salovey; Todd,56,0,60,4
1713345487456,TDGE 5,A01,492758,Staff,23,0,25,2
1713345488482,TDGE 10,A00,492759,Fulton; Julia,203,0,220,17
1713345489506,TDGE 11,A00,492760,Castro; Robert Jess,198,0,200,2
1713345491558,TDGE 124,A00,492772,Fulton; Julia,180,0,220,40
1713345492589,TDGE 125,A00,492773,Meyer; Ursula,38,0,50,12
1713345492589,TDGE 125,B00,492774,Staff,49,0,50,1
1713345492589,TDGE 125,C00,523565,Staff,48,0,50,2
1713345493619,TDGE 125GS,A00,523580,Guirguis; Mark C,23,0,28,5
1713345494643,TDGE 127,A00,492775,Havis; Allan,33,0,50,17
1713345495669,TDHT 101,A00,492776,Staff,34,0,35,1
1713345496697,TDMV 1,A00,492762,Caligagan; Maria T.,29,0,30,1
1713345496697,TDMV 1,B00,492763,Arcidiacono; Kristin,26,0,30,4
1713345497729,TDMV 2,A00,492764,Weinberg; Sadie,27,0,30,3
1713345498759,TDMV 3,A00,492765,Mack; Kara Shanai',37,0,40,3
1713345499784,TDMV 138,A00,492777,Mack; Kara Shanai',32,0,40,8
1713345500810,TDMV 140,A00,492778,Lima; Paulo Henrique,40,0,40,0
1713345501837,TDMV 142,A00,492779,Caligagan; Maria T.,33,0,40,7
1713345501837,TDMV 142,B00,492780,Caligagan; Tony,37,0,40,3
1713345502866,TDMV 143,A00,492781,Fyall; Daunte Edward,39,0,40,1
1713345503892,USP 1,A01,492401,Kwak; Nancy,27,0,35,8
1713345504917,USP 2,A01,492453,Hinds; Juli Beth,35,0,35,0
1713345505996,USP 3,A01,492516,Staff,28,0,35,7
1713345507023,USP 4,A00,492522,McTague; Sarah,16,0,25,9
1713345508053,USP 100,A00,492523,Staff,32,0,35,3
1713345509083,USP 101,A00,492524,Staff,13,0,15,2
1713345510111,USP 105,A00,492525,Staff,21,0,25,4
1713345511137,USP 151,A00,492526,Shenkman; Michael Thomas,32,0,35,3
1713345512167,USP 170,A00,492545,Hinds; Juli Beth,32,0,35,3
1713345513200,USP 171GS,A00,492608,Bussell; Mirle Rabinowitz,24,0,28,4
1713345514228,USP 183GS,A00,492613,Peerson; Susan,24,0,28,4
1713345515256,VIS 30,A01,490693,Yoldas; Pinar,19,0,22,3
1713345515256,VIS 30,A02,490694,Yoldas; Pinar,18,0,22,4
1713345516283,VIS 83,A00,490695,Kester; Grant,63,0,75,12
1713345517307,VIS 105D,A00,490696,Staff,22,0,25,3
1713345518337,VIS 124CN,A00,490699,Rose; Jordan M,64,0,75,11
1713345519363,VIS 125GS,A00,511221,Williams; Alena J,21,0,22,1
1713345520393,VIS 128D,A00,490700,Staff,73,0,75,2
1713345521421,VIS 151,A01,490717,Staff,33,0,34,1
1713345521421,VIS 151,A02,490766,Staff,32,0,34,2
1713345522445,VIS 154GS,A00,511972,Williams; Alena J,21,0,22,1
1713345523471,VIS 160A,A00,490767,Stone; Patricia,7,0,10,3
1713345524496,WCWP 10A,A00,490638,Staff,14,0,15,1
1713345524496,WCWP 10A,B00,490640,Staff,15,0,15,0
1713345525521,WCWP 10B,A00,490641,Staff,0,0,0,0
1713345525521,WCWP 10B,B00,490642,Staff,14,0,15,1
1713345525521,WCWP 10B,C00,490644,Staff,13,0,15,2
1713345525521,WCWP 10B,D00,490647,Staff,0,0,0,0
1713345526549,WCWP 100,A00,490655,Staff,0,0,0,0
1713345526549,WCWP 100,B00,490687,Staff,10,0,15,5
1713345528656,ANAR 153,A00,487222,Braswell; Geoffrey E.,53,0,60,7
1713345529685,ANBI 134,A00,487223,Staff,5,0,20,15
1713345530714,ANBI 143GS,A00,487224,Noel; Geoffroy Pierre Jean,18,0,24,6
1713345531741,ANBI 144GS,A00,519548,Noel; Geoffroy Pierre Jean,18,0,24,6
1713345532767,ANSC 101,A00,487225,Staff,17,0,20,3
1713345533801,ANSC 125,A00,487227,Brenner; Suzanne A,38,0,40,2
1713345535857,ANSC 146,A00,487229,Staff,35,0,40,5
1713345536882,ANSC 148,A00,487230,Olivas Hernandez; Olga Lid,39,0,40,1
1713345537916,ANSC 150,A00,504165,Sloane; Julia Kathryn,18,0,20,2
1713345538942,ANSC 180,A00,487232,Staff,14,0,15,1
1713345539971,ANSC 188,A00,627155,Staff,37,0,40,3
1713345541005,ANTH 5,A00,519529,Semendeferi; Ekaterini,15,0,15,0
1713345542032,ANTH 10,A00,487219,Staff,58,0,60,2
1713345543059,ANTH 23,A01,487221,Staff,17,0,20,3
1713345544084,ANTH 102,A00,487233,Wilder; Linnea Lorene,50,0,60,10
1713345545109,ANTH 103,A00,487234,Varma; Saiba,54,0,60,6
1713345546135,ANTH 105,A00,487235,Stewart; Alexander B,54,0,60,6
1713345547166,BENG 100,A01,516685,Taylor Amos; Alyssa C,25,0,30,5
1713345548235,BIBC 102,A01,491316,Flagg; Matthew Paul,5,0,88,83
1713345548235,BIBC 102,A02,491366,Flagg; Matthew Paul,78,0,88,10
1713345549260,BIBC 103,A01,491486,Boumechache; Miyyada,16,0,24,8
1713345549260,BIBC 103,A02,491487,Boumechache; Miyyada,24,0,24,0
1713345550288,BICD 100,A01,516882,Staff,73,0,75,2
1713345550288,BICD 100,A02,516890,Staff,69,0,75,6
1713345551316,BICD 102GS,A00,491488,Lo; Stanley M.,26,0,28,2
1713345552343,BIEB 136GS,A00,516940,Holway; David A. & Shurin; Jonathan,18,0,24,6
1713345553369,BIEB 137GS,A01,517034,Holway; David A. & Shurin; Jonathan,18,0,24,6
1713345554397,BIEB 138GS,A01,491492,Pirino; Giorgia,21,0,28,7
1713345555427,BILD 1,A01,491296,Staff,60,0,63,3
1713345555427,BILD 1,A02,491297,Staff,63,0,63,0
1713345556461,BILD 4,A01,517099,Gonzalez Gamboa; Ivonne,22,0,24,2
1713345556461,BILD 4,A02,517100,Gonzalez Gamboa; Ivonne,24,0,24,0
1713345557488,BILD 60GS,A00,491309,Lo; Stanley M.,26,0,28,2
1713345558518,BIMM 100,A01,517136,Staff,82,0,100,18
1713345559546,BIMM 110,A01,517182,Staff,52,0,100,48
1713345560572,BIMM 120,A01,517228,Pickett; Brooke Elizabeth,28,0,63,35
1713345560572,BIMM 120,A02,517240,Pickett; Brooke Elizabeth,44,0,63,19
1713345561602,BIMM 132GS,A01,491498,Pirino; Giorgia,21,0,28,7
1713345562629,BIMM 143,A01,491589,Bozinovic; Goran,12,0,40,28
1713345563658,BIPN 100,A01,491594,Armour; Jon Christopher,83,0,100,17
1713345564690,BIPN 140,A01,491602,Marino; Marc J,23,0,50,27
1713345566742,CAT 125,A00,515973,Staff,18,0,20,2
1713345567767,CAT 125GS,A00,515974,Rahimi; Babak,16,0,20,4
1713345568797,CAT 125R,A00,515980,Staff,12,0,20,8
1713345568797,CAT 125R,B00,515981,Tosun; Adriana,19,0,20,1
1713345568797,CAT 125R,C00,515987,Hyland; Tina Mae,0,5,20,20
1713345568797,CAT 125R,D00,515988,Bronstein; Phoebe Malan,16,0,20,4
1713345569829,CENG 15,A01,488699,Drews; Aaron,25,0,25,0
1713345570855,CENG 100,A00,505196,Opatkiewicz; Justin Paul,25,0,25,0
1713345571882,CGS 2A,A01,489598,Staff,32,0,35,3
1713345572909,CGS 112,A00,489599,Staff,15,0,15,0
1713345573935,CGS 119,A00,489603,Staff,10,0,10,0
1713345574961,CGS 120,A00,489604,Staff,13,0,15,2
1713345575986,CGS 150,A00,489607,Staff,15,0,15,0
1713345577012,CHEM 6A,A01,488715,Staff,97,0,100,3
1713345578044,CHEM 6B,A01,488719,Piercy; Marc Anthony,99,0,100,1
1713345579076,CHEM 6C,A01,488723,Albizati; Kim F.,93,0,100,7
1713345580116,CHEM 7L,A01,488728,Schurmeier; Kimberly,18,0,24,6
1713345580116,CHEM 7L,A02,488730,Schurmeier; Kimberly,23,0,24,1
1713345580116,CHEM 7L,A03,488734,Schurmeier; Kimberly,20,0,24,4
1713345580116,CHEM 7L,A04,488763,Schurmeier; Kimberly,23,0,24,1
1713345580116,CHEM 7L,B01,488798,Schurmeier; Kimberly,16,0,24,8
1713345580116,CHEM 7L,B02,488801,Schurmeier; Kimberly,22,0,24,2
1713345580116,CHEM 7L,B03,488808,Schurmeier; Kimberly,22,0,24,2
1713345580116,CHEM 7L,B04,488811,Schurmeier; Kimberly,24,0,24,0
1713345581143,CHEM 11,A01,488897,Stallings; Dontarie M,94,0,100,6
1713345582167,CHEM 40A,A01,488913,Albizati; Kim F.,83,0,100,17
1713345583198,CHEM 40B,A01,488920,Weizman; Haim,42,0,50,8
1713345583198,CHEM 40B,A02,488938,Weizman; Haim,43,0,50,7
1713345584226,CHEM 41A,A01,489029,Klosterman; Jeremy K,57,0,60,3
1713345585254,CHEM 41C,A01,500436,Tor; Yitzhak,54,0,60,6
1713345586284,CHEM 43A,A01,500426,Weizman; Haim,0,1,24,24
1713345586284,CHEM 43A,A02,500430,Weizman; Haim,6,0,24,18
1713345586284,CHEM 43A,B01,514041,Klosterman; Jeremy K,14,0,24,10
1713345586284,CHEM 43A,B02,514047,Klosterman; Jeremy K,23,0,24,1
1713345587311,CHEM 108,A01,489140,Jennings; Patricia A.,6,0,24,18
1713345587311,CHEM 108,A02,489142,Jennings; Patricia A.,14,0,24,10
1713345588338,CHEM 114A,A01,489147,Stallings; Dontarie M,65,0,100,35
1713345589364,CHIN 169A,A00,489171,Wang; Xiao,19,0,20,1
1713345591414,COGS 3,A01,518827,Boyle; Mary E. T.,25,0,40,15
1713345592439,COGS 11,A01,489175,Staff,27,0,30,3
1713345593466,COGS 14A,A01,518829,Staff,50,0,60,10
1713345594491,COGS 14B,A01,489177,Hoffman; Drew Ellen,62,0,75,13
1713345595517,COGS 100,A01,489181,Allen; Michael Gordon,62,0,75,13
1713345596549,COGS 101A,A01,489183,Staff,45,0,60,15
1713345597577,COGS 101B,A01,489185,Allen; Michael Gordon,6,0,30,24
1713345598608,COGS 101C,A01,526786,Staff,23,0,30,7
1713345600666,COGS 107A,A01,489189,Boyle; Mary E. T.,16,0,35,19
1713345601697,COGS 107B,A01,627144,Mooshagian; Eric Frederick,59,0,60,1
1713345602731,COGS 118A,A01,489191,Staff,0,46,40,40
1713345604787,COGS 171GS,A01,489194,Pineda; Jaime A,19,0,28,9
1713345605815,COGS 172,A01,489196,Staff,1,0,30,29
1713345606841,COGS 174GS,A01,489264,Pineda; Jaime A,19,0,28,9
1713345607867,COGS 180,A01,627150,Staff,28,0,30,2
1713345608893,COGS 186,A01,489274,Staff,0,3,30,30
1713345609976,COMM 10,A01,489276,Staff,23,0,25,2
1713345609976,COMM 10,A02,489303,Staff,23,0,25,2
1713345611003,COMM 100A,A01,489312,Staff,14,0,25,11
1713345611003,COMM 100A,A02,489313,Staff,24,0,25,1
1713345612029,COMM 106T,A00,512540,Staff,33,0,35,2
1713345613055,COMM 107,A00,489347,Staff,27,0,35,8
1713345614081,COMM 109P,A00,489358,Staff,31,0,35,4
1713345615108,COMM 132,A00,489361,McKenna; Denise,27,0,30,3
1713345616133,COMM 146,A00,489362,Halm; Gavin Patrick,26,0,30,4
1713345617159,COMM 190,A00,489363,Abuelhiga; Soraya Jill,17,0,23,6
1713345618187,CSE 8A,A50,489366,Staff,21,0,25,4
1713345618187,CSE 8A,A51,489367,Staff,24,0,25,1
1713345619213,CSE 11,A01,489398,Cao; Yingjun,72,0,100,28
1713345620240,CSE 12,A01,489487,Staff,43,0,50,7
1713345621266,CSE 20,A01,489497,Staff,47,0,50,3
1713345622298,CSE 21,A01,489517,Braun; Oliver,42,0,50,8
1713345623322,CSE 101,A01,489524,Braun; Oliver,0,34,50,50
1713345624350,CSE 105,A01,512594,Jones; Miles E,72,0,100,28
1713345624350,CSE 105,B01,512598,Jones; Miles E,51,0,100,49
1713345625381,CSE 140,A01,489538,Staff,39,0,50,11
1713345626410,CSE 141,A01,489550,Eldon; John,67,0,100,33
1713345627441,CSE 141L,A01,489571,Eldon; John,65,0,100,35
1713345628475,CSE 151A,A01,489583,Solares; Edwin A,139,0,200,61
1713345629504,CSE 175,A01,510886,Kumar; Rakesh,30,0,30,0
1713345630530,CSE 190,A00,516828,Dubnov; Shlomo,37,0,49,12
1713345631558,DOC 100D,A00,489667,Pass; Natalye Joann,19,0,25,6
1713345632583,DSC 10,A01,624268,Staff,72,0,75,3
1713345633613,DSC 20,A01,624476,Staff,50,0,50,0
1713345634638,DSC 40A,A01,624608,Staff,39,0,40,1
1713345635670,DSGN 1,A01,489179,Rill; Bryan,32,0,50,18
1713345636701,ECE 17,A01,490489,Sahay; Rajeev,18,0,30,12
1713345637732,ECE 65,A50,490492,Staff,11,0,20,9
1713345637732,ECE 65,A51,490493,Staff,18,0,20,2
1713345638759,ECON 1,A01,489715,Famulari; Melissa,67,0,70,3
1713345639789,ECON 2,A01,489717,Levkoff; Steven B.,67,0,70,3
1713345640816,ECON 3,A01,489948,Staff,70,0,70,0
1713345642871,ECON 5,A01,490103,Staff,27,0,30,3
1713345642871,ECON 5,B01,626281,Dai; Yinlin,45,0,45,0
1713345643899,ECON 100A,A01,490127,Famulari; Melissa,62,0,70,8
1713345644927,ECON 100B,A01,490129,Staff,64,0,70,6
1713345645953,ECON 109,A01,490187,Shishkin; Denis,27,0,35,8
1713345646979,ECON 110A,A01,490190,Levkoff; Steven B.,59,0,70,11
1713345648004,ECON 120A,A01,490245,Dai; Yinlin,59,0,70,11
1713345649028,ECON 120B,A01,490247,Nieto-Barthaburu; Augusto,40,0,70,30
1713345650070,ECON 120C,A01,490253,Sun; Yixiao,30,0,35,5
1713345650070,ECON 120C,B01,490255,Sun; Yixiao,34,0,35,1
1713345651100,ECON 129,A00,490256,Eckert; Fabian Paul,22,0,35,13
1713345652131,ECON 131,A00,490257,Nieto-Barthaburu; Augusto,0,6,35,35
1713345653165,ECON 138,A00,490258,Bharadwaj; Prashant,13,0,35,22
1713345653165,ECON 138,B00,490259,Bharadwaj; Prashant,15,0,35,20
1713345654196,ECON 159,A00,490260,Hendrickson; Gerald M.,0,9,0,0
1713345655231,ECON 178,A01,553995,Zhu; Ying,24,0,35,11
1713345656259,EDS 40,A01,512576,Black; Alison Michelle,20,0,20,0
1713345657285,EDS 107,A01,515848,Staff,30,0,30,0
1713345658310,EDS 110R,A01,490262,Staff,26,0,30,4
1713345659338,EDS 112,A01,490264,Chapman; Thandeka K,40,0,50,10
1713345660364,EDS 113,A00,490266,Staff,25,0,30,5
1713345661391,EDS 118,A00,490267,Warstadt; Melissa Fawn,18,0,30,12
1713345662422,EDS 124BR,A00,490268,Eguchi; Emi,4,0,25,21
1713345662422,EDS 124BR,B00,490269,Eguchi; Emi,23,0,25,2
1713345663450,EDS 126,A01,490271,Jones; Makeba,43,0,50,7
1713345664477,EDS 135,A01,490316,Staff,19,0,20,1
1713345665508,ENVR 142GS,A00,519514,Chang; Edmond Yi-Teh,26,0,28,2
1713345666537,ETHN 103,A00,490504,Staff,24,0,36,12
1713345667563,ETHN 103A,A00,490505,Man; Simeon S,3,0,9,6
1713345668589,ETHN 109,A00,490506,Staff,28,0,30,2
1713345669616,ETHN 118,A00,490507,Staff,35,0,36,1
1713345670644,ETHN 119,A00,490508,Staff,32,0,36,4
1713345671676,ETHN 121R,A00,490518,Choi; Esther Min,21,0,36,15
1713345672708,ETHN 127,A00,490528,Staff,14,0,15,1
1713345673737,ETHN 139,A00,490573,Staff,10,0,10,0
1713345674762,ETHN 150,A00,490575,Staff,15,0,15,0
1713345675792,GLBH 20,A00,491705,Elwardani; Nile Regina,38,0,40,2
1713345676820,GLBH 101,A00,491706,Staff,20,0,20,0
1713345677846,GLBH 111,A01,491708,Burgos; Jose L.,15,0,15,0
1713345678872,GLBH 146,A00,491709,Staff,8,0,20,12
1713345679900,GLBH 148,A00,491710,Olivas Hernandez; Olga Lid,10,0,20,10
1713345680927,GLBH 150,A00,491711,Sloane; Julia Kathryn,19,0,20,1
1713345681958,HIEA 131,A00,491760,Staff,28,0,32,4
1713345682982,HIEA 153,A00,491762,Staff,28,0,30,2
1713345684008,HIEU 124,A00,491811,Staff,26,0,32,6
1713345685034,HIEU 124GS,A00,491812,Markman; Kristina,27,0,28,1
1713345686062,HIEU 147,A00,491813,Staff,30,0,32,2
1713345687091,HIEU 149GS,A00,491816,Caldwell; Michael Alan,28,0,28,0
1713345688120,HILD 2C,A01,491713,Hendrickson; Gerald M.,26,0,30,4
1713345689147,HILD 7B,A01,491715,Kwak; Nancy,0,2,30,30
1713345690170,HILD 10,A01,491717,Staff,9,0,20,11
1713345691198,HILD 30GS,A00,491719,Edington; Claire Ellen,23,0,28,5
1713345692228,HINE 109,A00,491818,Shafir; Nir,26,0,32,6
1713345693258,HINE 128,A00,491821,Shafir; Nir,30,0,32,2
1713345694289,HISC 117,A00,491830,Staff,27,0,32,5
1713345695316,HIUS 103,A00,491834,Man; Simeon S,14,0,23,9
1713345696343,HIUS 108B,A00,491835,Staff,27,0,30,3
1713345697368,HIUS 141,A00,491836,Hendrickson; Gerald M.,28,0,32,4
1713345698393,HIUS 149,A00,491839,Staff,24,0,32,8
1713345699426,HUM 3,A01,512617,Crum; Matthew Stephen,42,0,50,8
1713345699426,HUM 3,A02,512618,Crum; Matthew Stephen,48,0,50,2
1713345700452,HUM 3GS,A00,512663,Markman; Kristina,0,0,0,1
1713345700452,HUM 3GS,B00,512664,Staff,0,0,0,0
1713345701484,HUM 4,A01,512620,West; Geoffrey Scott,23,0,50,27
1713345702513,HUM 4GS,A00,512666,Lyon; Antony J.,0,0,0,5
1713345703540,HUM 4R,A01,512625,Watkins; Eric,49,0,50,1
1713345704573,HUM 5,A01,512649,Zavodny; Tatiana Sophia,20,0,50,30
1713345704573,HUM 5,B01,512661,Zroka; Ryan Edward,48,0,50,2
1713345705608,INTL 190,A00,490577,Segui; Alan S,0,0,0,5
1713345706640,JAPN 20AR,A01,491267,Ross; Kayoko F,7,0,20,13
1713345707665,JAPN 180,A00,491285,Berman; Michael David,33,0,40,7
1713345708691,LATI 50,A01,502536,Kokinis; Troy Andreas,16,0,22,6
1713345708691,LATI 50,A02,502551,Kokinis; Troy Andreas,22,0,22,0
1713345708691,LATI 50,A03,502650,Kokinis; Troy Andreas,22,0,22,0
1713345708691,LATI 50,A04,502909,Kokinis; Troy Andreas,21,0,22,1
1713345709717,LATI 160,A01,502920,Kokinis; Troy Andreas,30,0,30,0
1713345710743,LIFR 1A,A00,490494,Van Moer; Vinciane G,17,0,20,3
1713345711772,LIFR 1AX,A00,490495,Van Moer; Vinciane G,17,0,20,3
1713345712802,LIFR 1B,A00,490496,Van Moer; Vinciane G,17,0,20,3
1713345713883,LIFR 1BX,A00,490497,Van Moer; Vinciane G,17,0,20,3
1713345714916,LIGN 8,A00,505198,McIntosh; Justin Daniel,134,0,150,16
1713345715942,LIGN 9GS,A00,491239,Lott; Margaret S.,18,0,20,2
1713345716968,LIGN 101,A01,505200,McIntosh; Justin Daniel,22,0,30,8
1713345718013,LIGN 120,A01,491244,Staff,22,0,30,8
1713345719042,LIGN 149GS,A00,491245,Lott; Margaret S.,18,0,20,2
1713345720070,LIGN 170,A00,491247,Staff,22,0,30,8
1713345721101,LISP 1D,A00,490498,Munoz Sanchez; Alicia,8,0,14,6
1713345721101,LISP 1D,B00,490499,Munoz Sanchez; Alicia,4,0,14,10
1713345721101,LISP 1D,C00,490500,Munoz Sanchez; Alicia,7,0,14,7
1713345721101,LISP 1D,D00,490501,Munoz Sanchez; Alicia,10,0,14,4
1713345722131,LISP 1DX,A00,490502,Munoz Sanchez; Alicia,11,0,28,17
1713345722131,LISP 1DX,B00,490503,Munoz Sanchez; Alicia,16,0,28,12
1713345724192,LTAM 110,A00,491847,Staff,22,0,25,3
1713345725220,LTCS 119,A00,491848,Staff,11,0,15,4
1713345726249,LTCS 130,A00,491849,Staff,24,0,25,1
1713345728303,LTEA 120C,A00,491852,Staff,32,0,40,8
1713345729328,LTEN 130GS,A00,491853,Lyon; Antony J.,23,0,28,5
1713345730352,LTEN 148,A00,491855,Staff,23,0,25,2
1713345731376,LTEN 159,A00,491856,Staff,20,0,25,5
1713345732404,LTEN 180,A00,491857,Staff,8,0,15,7
1713345734456,LTSP 123GS,A00,505928,Bessett; Ryan Matthew,24,0,28,4
1713345735481,LTSP 174GS,A00,506037,Bessett; Ryan Matthew,24,0,28,4
1713345737532,LTWR 102,A00,491861,Staff,9,0,15,6
1713345738557,LTWR 106,A00,491862,Staff,8,0,15,7
1713345739589,MAE 11,A00,490930,Bahadori; Mohammad Yousef,94,0,100,6
1713345740621,MAE 30A,A00,490931,Qi; Huihui,37,0,40,3
1713345741650,MAE 101A,A00,491036,Sadeghizadeh; Zahra,91,0,100,9
1713345742685,MAE 101C,A00,491037,Seshadri; Kalyanasundaram,63,0,100,37
1713345743712,MAE 113,A00,491040,Seshadri; Kalyanasundaram,64,0,80,16
1713345744739,MAE 131A,A00,491041,Ghazinejad; Maziar,37,0,40,3
1713345745769,MAE 142,A00,491053,Staff,39,0,40,1
1713345746795,MAE 143A,A00,491054,Staff,29,0,50,21
1713345747822,MAE 150,A00,491092,Truong; Phuong Thi Ngoc,23,0,35,12
1713345748855,MATH 3C,A01,494031,Pardo Guerra; Sebastian,30,0,30,0
1713345748855,MATH 3C,A02,494032,Pardo Guerra; Sebastian,29,0,30,1
1713345749881,MATH 10A,A01,494034,Staff,27,0,30,3
1713345749881,MATH 10A,A02,494035,Staff,28,0,30,2
1713345749881,MATH 10A,B01,494037,Staff,27,0,30,3
1713345749881,MATH 10A,B02,494038,Staff,29,0,30,1
1713345750912,MATH 10B,A01,494040,Habib; Yousaf,22,0,30,8
1713345750912,MATH 10B,A02,494041,Habib; Yousaf,28,0,30,2
1713345750912,MATH 10B,A03,494042,Habib; Yousaf,29,0,30,1
1713345750912,MATH 10B,A04,494043,Habib; Yousaf,30,0,30,0
1713345750912,MATH 10B,B01,494045,Habib; Yousaf,25,0,30,5
1713345750912,MATH 10B,B02,494046,Habib; Yousaf,30,0,30,0
1713345750912,MATH 10B,B03,494047,Habib; Yousaf,30,0,30,0
1713345750912,MATH 10B,B04,494048,Habib; Yousaf,30,0,30,0
1713345751946,MATH 18,A01,494050,Kemp; Todd Aahron,25,0,30,5
1713345751946,MATH 18,A02,494051,Kemp; Todd Aahron,29,0,30,1
1713345751946,MATH 18,B01,494054,Kemp; Todd Aahron,25,0,30,5
1713345751946,MATH 18,B02,494055,Kemp; Todd Aahron,29,0,30,1
1713345752973,MATH 20A,A01,494059,Suk; Andrew Hoon,30,0,30,0
1713345754001,MATH 20B,A01,494061,Briones; Jor-el Thomas Caparas,33,0,35,2
1713345754001,MATH 20B,B01,494063,Bach; Quang Tran,34,0,35,1
1713345755038,MATH 20C,A01,494065,Staff,28,0,30,2
1713345755038,MATH 20C,A02,494066,Staff,30,0,30,0
1713345755038,MATH 20C,A03,494067,Staff,30,0,30,0
1713345755038,MATH 20C,A04,494068,Staff,30,0,30,0
1713345755038,MATH 20C,B01,494070,Zhang; Ming,23,0,30,7
1713345755038,MATH 20C,B02,494071,Zhang; Ming,27,0,30,3
1713345755038,MATH 20C,B03,494072,Zhang; Ming,29,0,30,1
1713345755038,MATH 20C,B04,494073,Zhang; Ming,29,0,30,1
1713345756068,MATH 20D,A01,494075,Staff,22,0,30,8
1713345756068,MATH 20D,A02,494076,Staff,29,0,30,1
1713345757099,MATH 20E,A01,494079,Staff,24,0,30,6
1713345757099,MATH 20E,A02,494080,Staff,26,0,30,4
1713345757099,MATH 20E,B01,494082,Staff,25,0,30,5
1713345757099,MATH 20E,B02,494083,Staff,25,0,30,5
1713345758132,MATH 103A,A01,494085,Aliabadi Sr.; Mohsen,12,0,30,18
1713345758132,MATH 103A,A02,494086,Aliabadi Sr.; Mohsen,28,0,30,2
1713345758132,MATH 103A,B01,494088,Aliabadi Sr.; Mohsen,20,0,30,10
1713345758132,MATH 103A,B02,494089,Aliabadi Sr.; Mohsen,27,0,30,3
1713345759165,MATH 109,A01,494091,Staff,30,0,30,0
1713345759165,MATH 109,A02,494092,Staff,29,0,30,1
1713345759165,MATH 109,B01,494094,Staff,27,0,30,3
1713345759165,MATH 109,B02,494095,Staff,29,0,30,1
1713345760202,MATH 142A,A01,494097,Chow; Bennett,13,0,30,17
1713345760202,MATH 142A,A02,494098,Chow; Bennett,23,0,30,7
1713345760202,MATH 142A,B01,494100,Chow; Bennett,19,0,30,11
1713345760202,MATH 142A,B02,494101,Chow; Bennett,29,0,30,1
1713345762262,MATH 168A,A01,516677,Dumitriu; Ioana,16,0,35,19
1713345763289,MATH 170A,A01,516679,Dumitriu; Ioana,18,0,30,12
1713345763289,MATH 170A,A02,516680,Dumitriu; Ioana,28,0,30,2
1713345764320,MATH 193A,A01,494107,Staff,12,0,30,18
1713345764320,MATH 193A,A02,494108,Staff,18,0,30,12
1713345764320,MATH 193A,A03,494109,Staff,29,0,30,1
1713345764320,MATH 193A,A04,494110,Staff,22,0,30,8
1713345767411,MGT 16,A00,491930,McKay; Michael J,92,0,98,6
1713345768439,MGT 18,A00,491992,McKay; Michael J,96,0,98,2
1713345769468,MGT 71,A00,492003,Staff,63,0,98,35
1713345770500,MGT 103,A00,505209,Eberhard; Craig A,80,0,98,18
1713345771529,MGT 131A,A00,505210,Anderson; John Charles,89,0,98,9
1713345773581,MGT 153,A00,492077,Perols; Johan Lars,15,0,90,75
1713345776658,MGT 164,A00,492222,McKay; Mary A,91,0,98,7
1713345777691,MGT 172,A00,492245,Staff,59,0,60,1
1713345777691,MGT 172,B00,505526,Hedges; Kathleen,65,0,98,33
1713345778724,MGT 181,A00,505669,Dunn; Louis Jean,78,0,98,20
1713345779753,MMW 14,A01,494399,Staff,15,0,28,13
1713345779753,MMW 14,A02,494400,Staff,25,0,28,3
1713345779753,MMW 14,A03,494401,Staff,28,0,28,0
1713345779753,MMW 14,A04,494402,Staff,28,0,28,0
1713345779753,MMW 14,B01,494404,Carreras; Maria Victoria,8,0,28,20
1713345779753,MMW 14,B02,494405,Carreras; Maria Victoria,25,0,28,3
1713345779753,MMW 14,B03,494406,Carreras; Maria Victoria,27,0,28,1
1713345779753,MMW 14,B04,494407,Carreras; Maria Victoria,28,0,28,0
1713345780779,MMW 14GS,A00,506250,Chang; Edmond Yi-Teh,0,0,0,0
1713345781810,MMW 121R,A01,494415,Adamiak; Patrick John,10,0,28,18
1713345781810,MMW 121R,A02,494416,Adamiak; Patrick John,24,0,28,4
1713345782839,MUS 1A,A01,494113,Staff,12,0,25,13
1713345782839,MUS 1A,A02,494114,Staff,24,0,25,1
1713345783872,MUS 4,A01,494116,Staff,23,0,25,2
1713345783872,MUS 4,A02,494117,Staff,22,0,25,3
1713345784904,MUS 5R,A01,494236,Dubnov; Shlomo,4,0,25,21
1713345784904,MUS 5R,A02,494237,Dubnov; Shlomo,25,0,25,0
1713345785929,MUS 6,A01,494122,Staff,9,0,25,16
1713345785929,MUS 6,A02,494123,Staff,23,0,25,2
1713345786957,MUS 7,A01,494125,Staff,16,0,25,9
1713345786957,MUS 7,A02,494126,Staff,24,0,25,1
1713345787986,MUS 11,A01,494128,Staff,23,0,25,2
1713345787986,MUS 11,A02,494129,Staff,24,0,25,1
1713345789012,MUS 13,A01,494131,Staff,25,0,25,0
1713345789012,MUS 13,A02,494132,Staff,25,0,25,0
1713345790044,MUS 15,A01,494134,Staff,16,0,25,9
1713345790044,MUS 15,A02,494135,Staff,25,0,25,0
1713345790044,MUS 15,B01,494137,Staff,24,0,25,1
1713345791073,MUS 80,A00,494232,Staff,24,0,25,1
1713345791073,MUS 80,B00,494233,Staff,25,0,25,0
1713345791073,MUS 80,C00,494234,Staff,23,0,25,2
1713345792102,MUS 95C,A00,494141,Staff,69,0,75,6
1713345793128,MUS 114,A00,494142,Staff,39,0,50,11
1713345794156,NANO 15,A01,490636,Drews; Aaron,7,0,7,0
1713345795185,PHIL 1,A00,490578,Grush; Rick Scott,49,0,50,1
1713345796211,PHIL 10,A01,490580,Grush; Rick Scott,33,0,35,2
1713345796211,PHIL 10,A02,490586,Grush; Rick Scott,32,0,35,3
1713345797235,PHIL 27,A01,490591,Staff,22,0,25,3
1713345797235,PHIL 27,A02,490592,Staff,25,0,25,0
1713345797235,PHIL 27,A03,490593,Staff,25,0,25,0
1713345797235,PHIL 27,A04,490598,Staff,25,0,25,0
1713345798261,PHIL 32,A01,490611,Staff,20,0,20,0
1713345798261,PHIL 32,A02,490618,Staff,20,0,20,0
1713345799288,PHIL 90,A00,490624,Staff,40,0,40,0
1713345800319,PHIL 136,A00,490627,Cohen; Jonathan David,37,0,40,3
1713345801344,PHIL 155,A00,490634,Staff,61,0,70,9
1713345802375,PHYS 1A,A00,491610,Staff,245,0,250,5
1713345803407,PHYS 1AL,001,491616,Tsai; Philbert S,27,0,30,3
1713345803407,PHYS 1AL,002,491618,Tsai; Philbert S,30,0,30,0
1713345804433,PHYS 1B,A00,491623,Staff,235,0,250,15
1713345805459,PHYS 1BL,001,491626,Tsai; Philbert S,18,0,30,12
1713345805459,PHYS 1BL,002,491628,Tsai; Philbert S,26,0,30,4
1713345806488,PHYS 1C,A00,491632,Staff,211,0,245,34
1713345807514,PHYS 1CL,001,491635,Tsai; Philbert S,2,0,30,28
1713345807514,PHYS 1CL,002,491643,Tsai; Philbert S,22,0,30,8
1713345808547,PHYS 2AR,A01,491651,Meyertholen; Andrew D.,44,0,50,6
1713345809577,PHYS 2B,A01,491659,Staff,105,0,115,10
1713345810603,PHYS 2BL,A01,491685,Staff,21,0,24,3
1713345810603,PHYS 2BL,A02,491700,Staff,21,0,24,3
1713345811629,PHYS 2C,A01,505161,Staff,101,0,115,14
1713345812661,PHYS 4A,A01,491704,Grinstein; Benjamin,99,0,100,1
1713345813688,POLI 5D,A01,494144,Staff,3,0,5,2
1713345813688,POLI 5D,B01,626283,Dai; Yinlin,5,0,5,0
1713345814719,POLI 12,A00,494145,Staff,43,0,45,2
1713345815746,POLI 13R,A00,494146,Forman; Fonna,45,0,50,5
1713345816776,POLI 27,A01,494148,Staff,54,0,60,6
1713345817856,POLI 30,A00,494149,Staff,49,0,50,1
1713345818886,POLI 100DA,A00,494150,Staff,20,0,25,5
1713345820938,POLI 100I,A00,494152,Staff,27,0,30,3
1713345821988,POLI 104B,A00,494153,Smith; Glenn Chatmas,53,0,55,2
1713345823016,POLI 104F,A00,494154,Staff,28,0,30,2
1713345824042,POLI 104I,A00,494155,Smith; Glenn Chatmas,29,0,30,1
1713345825072,POLI 110C,A00,494156,Ingham; Sean,23,0,25,2
1713345826103,POLI 117R,A00,494157,Forman; Fonna,5,0,20,15
1713345827134,POLI 118,A00,494158,Ingham; Sean,21,0,25,4
1713345828160,POLI 120H,A00,494159,Fisk; David Lee,39,0,45,6
1713345829189,POLI 131CR,A00,494160,Hoston; Germaine,35,0,45,10
1713345830214,POLI 133J,A00,494161,Staff,31,0,35,4
1713345831241,POLI 135,A00,494162,Fisk; David Lee,33,0,35,2
1713345832267,POLI 140A,A00,494164,Staff,18,0,30,12
1713345833297,POLI 142I,A00,494165,Staff,30,0,30,0
1713345834326,POLI 144D,A00,494166,Staff,22,0,25,3
1713345835356,POLI 151,A00,494167,Staff,30,0,30,0
1713345836384,POLI 153,A00,494168,Staff,33,0,35,2
1713345837410,POLI 160AA,A00,494169,Staff,33,0,40,7
1713345838437,POLI 162,A00,494170,Mignozzetti; Umberto,17,0,25,8
1713345839465,POLI 171,A00,494171,Mignozzetti; Umberto,18,0,25,7
1713345840493,PSYC 1,A00,494172,Staff,95,0,100,5
1713345841520,PSYC 2,A00,494173,Moranton; Nirelia Melbina-,33,0,50,17
1713345842551,PSYC 3,A00,494174,Staff,29,0,30,1
1713345843578,PSYC 6,A00,494175,Staff,17,0,20,3
1713345844607,PSYC 60,A01,494177,Staff,37,0,45,8
1713345845634,PSYC 70,A01,505724,Geller; Emma Harlan,42,0,45,3
1713345846665,PSYC 101,A00,494180,Heyman; Gail D.,83,0,100,17
1713345847691,PSYC 105,A00,494181,Geller; Emma Harlan,51,0,90,39
1713345848718,PSYC 106,A00,494182,Dobkins; Karen R.,26,0,45,19
1713345849742,PSYC 108,A00,494183,Adrian; Julia Anna,89,0,100,11
1713345850769,PSYC 114,A01,494185,Winkielman; Piotr,0,4,30,30
1713345851794,PSYC 122,A00,494186,Moranton; Nirelia Melbina-,27,0,50,23
1713345852826,PSYC 124,A00,494187,Chapman; Eddie Nathaniel,69,0,80,11
1713345853853,PSYC 131,A00,494188,Anagnostaras; Stephan,39,0,80,41
1713345854878,PSYC 144,A00,494189,Staff,1,1,50,49
1713345855906,PSYC 154,A00,494190,Lacefield; Katharine I,105,0,180,75
1713345856936,PSYC 162,A00,494191,Wixted; John T,70,0,100,30
1713345857967,PSYC 172,A00,494192,Gorman; Michael R.,36,0,45,9
1713345858993,PSYC 178,A00,494193,Glaser; Dale,32,0,45,13
1713345860026,PSYC 193,A00,505725,Chapman; Eddie Nathaniel,20,0,20,0
1713345861052,RELI 145GS,A00,519817,Rahimi; Babak,17,0,20,3
1713345862085,SE 101A,A01,490862,Chadha; Mayank,23,0,25,2
1713345863112,SE 101C,A01,490924,Krysl; Petr,15,0,20,5
1713345864138,SE 110A,A01,490928,Staff,19,0,20,1
1713345865165,SE 130A,A00,490929,Morrison; Machel Leigh,54,0,70,16
1713345866190,SIO 1,A01,519325,Staff,39,0,40,1
1713345867218,SIO 30,A01,519327,Staff,38,0,40,2
1713345868244,SIO 40,A00,519328,Staff,39,0,40,1
1713345869270,SIO 46GS,A00,519819,Cook; Geoffrey W,15,0,25,10
1713345870301,SIO 109R,A00,494197,Forman; Fonna,0,3,20,20
1713345871325,SIO 121GS,A00,519827,Cook; Geoffrey W,15,0,25,10
1713345872351,SIO 132,A01,519330,Staff,38,0,40,2
1713345873375,SIO 133,A01,519397,Staff,37,0,40,3
1713345874405,SIO 139,A00,519396,Kacev; David,29,0,40,11
1713345875433,SOCI 1,A01,494199,Thorpe; Charles Robert,21,0,30,9
1713345875433,SOCI 1,A02,494200,Thorpe; Charles Robert,30,0,30,0
1713345875433,SOCI 1,A03,494201,Thorpe; Charles Robert,29,0,30,1
1713345875433,SOCI 1,A04,494202,Thorpe; Charles Robert,29,0,30,1
1713345875433,SOCI 1,A05,494203,Thorpe; Charles Robert,29,0,30,1
1713345875433,SOCI 1,A06,494204,Thorpe; Charles Robert,30,0,30,0
1713345875433,SOCI 1,A07,494205,Thorpe; Charles Robert,28,0,30,2
1713345876459,SOCI 60,A01,494207,Staff,33,0,40,7
1713345876459,SOCI 60,A02,494208,Staff,39,0,40,1
1713345877486,SOCI 100,A01,494210,Payne; Christine Anna,25,0,30,5
1713345877486,SOCI 100,A02,494211,Payne; Christine Anna,26,0,30,4
1713345878515,SOCI 109M,A00,494212,Staff,20,0,20,0
1713345879544,SOCI 110,A00,494213,Staff,34,0,40,6
1713345881600,SOCI 118E,A00,494215,Ng; Kwai,37,0,40,3
1713345882629,SOCI 125,A00,494216,Calderon-Zaks; Michael Aar,39,0,45,6
1713345883655,SOCI 126,A01,494218,Jones; Makeba,3,0,5,2
1713345884684,SOCI 131,A00,494219,Thorpe; Charles Robert,26,0,30,4
1713345886736,SOCI 135,A00,494221,Payne; Christine Anna,28,0,50,22
1713345887769,SOCI 136E,A00,626690,Ruiz; Jonathan Joseph,24,0,25,1
1713345888794,SOCI 138GS,A00,494222,Navon; Daniel,23,0,28,5
1713345890843,SOCI 145,A00,494224,Staff,40,0,45,5
1713345891869,SOCI 153,A00,494225,Staff,28,0,30,2
1713345892899,SOCI 160E,A00,494226,Ng; Kwai,27,0,40,13
1713345893929,SOCI 180,A00,494227,Staff,29,0,30,1
1713345894958,SOCI 189GS,A00,494228,Ribas Norris; Janet Vanesa,11,0,11,0
1713345895987,SOCI 190GS,A00,553232,Ribas Norris; Janet Vanesa,11,0,11,0
1713345897013,SOMI 220,A00,627178,Schneid; Stephen David,30,0,30,0
1713345898040,SYN 2,001,490768,Staff,13,0,15,2
1713345898040,SYN 2,002,490769,Staff,14,0,15,1
1713345898040,SYN 2,004,490775,Staff,0,0,0,0
1713345898040,SYN 2,003,490774,Staff,0,0,0,0
1713345898040,SYN 2,005,490776,Staff,0,0,0,0
1713345899072,SYN 2R,001,490779,Staff,10,0,15,5
1713345899072,SYN 2R,002,514635,Staff,14,0,15,1
1713345900102,SYN 100,A01,490783,Staff,8,0,20,12
1713345900102,SYN 100,B01,490787,Staff,10,0,20,10
1713345900102,SYN 100,C01,490789,Staff,10,0,20,10
1713345901127,SYN 150,A00,490817,Staff,14,0,15,1
1713345901127,SYN 150,B00,514610,Staff,15,0,15,0
1713345902156,TDAC 1,A00,492753,Walsh; Kim C.,19,0,20,1
1713345902156,TDAC 1,B00,492754,Harting; Carla Kelso,18,0,20,2
1713345902156,TDAC 1,C00,513995,Salovey; Todd,15,0,20,5
1713345903184,TDAC 101,A00,492766,Harting; Carla Kelso,17,0,20,3
1713345904217,TDAC 102,A00,492768,Basso; Beatrice,19,0,20,1
1713345905242,TDDE 111,A00,492769,Staff,25,0,25,0
1713345906269,TDDE 131,A00,492770,Staff,15,0,15,0
1713345906269,TDDE 131,B00,492771,Staff,15,0,15,0
1713345907295,TDDE 131GS,A00,523716,Guirguis; Mark C,23,0,28,5
1713345908328,TDGE 1,A01,492756,Salovey; Todd,56,0,60,4
1713345909352,TDGE 5,A01,492758,Staff,23,0,25,2
1713345910379,TDGE 10,A00,492759,Fulton; Julia,203,0,220,17
1713345911410,TDGE 11,A00,492760,Castro; Robert Jess,198,0,200,2
1713345913461,TDGE 124,A00,492772,Fulton; Julia,180,0,220,40
1713345914494,TDGE 125,A00,492773,Meyer; Ursula,38,0,50,12
1713345914494,TDGE 125,B00,492774,Staff,49,0,50,1
1713345914494,TDGE 125,C00,523565,Staff,48,0,50,2
1713345915517,TDGE 125GS,A00,523580,Guirguis; Mark C,23,0,28,5
1713345916553,TDGE 127,A00,492775,Havis; Allan,33,0,50,17
1713345917578,TDHT 101,A00,492776,Staff,34,0,35,1
1713345918605,TDMV 1,A00,492762,Caligagan; Maria T.,29,0,30,1
1713345918605,TDMV 1,B00,492763,Arcidiacono; Kristin,26,0,30,4
1713345919633,TDMV 2,A00,492764,Weinberg; Sadie,27,0,30,3
1713345920659,TDMV 3,A00,492765,Mack; Kara Shanai',37,0,40,3
1713345921742,TDMV 138,A00,492777,Mack; Kara Shanai',32,0,40,8
1713345922773,TDMV 140,A00,492778,Lima; Paulo Henrique,40,0,40,0
1713345923806,TDMV 142,A00,492779,Caligagan; Maria T.,33,0,40,7
1713345923806,TDMV 142,B00,492780,Caligagan; Tony,37,0,40,3
1713345924835,TDMV 143,A00,492781,Fyall; Daunte Edward,39,0,40,1
1713345925864,USP 1,A01,492401,Kwak; Nancy,27,0,35,8
1713345926890,USP 2,A01,492453,Hinds; Juli Beth,35,0,35,0
1713345927916,USP 3,A01,492516,Staff,28,0,35,7
1713345928942,USP 4,A00,492522,McTague; Sarah,16,0,25,9
1713345929970,USP 100,A00,492523,Staff,32,0,35,3
1713345930996,USP 101,A00,492524,Staff,13,0,15,2
1713345932022,USP 105,A00,492525,Staff,21,0,25,4
1713345933053,USP 151,A00,492526,Shenkman; Michael Thomas,32,0,35,3
1713345934078,USP 170,A00,492545,Hinds; Juli Beth,32,0,35,3
1713345935102,USP 171GS,A00,492608,Bussell; Mirle Rabinowitz,24,0,28,4
1713345936128,USP 183GS,A00,492613,Peerson; Susan,24,0,28,4
1713345937173,VIS 30,A01,490693,Yoldas; Pinar,19,0,22,3
1713345937173,VIS 30,A02,490694,Yoldas; Pinar,18,0,22,4
1713345938197,VIS 83,A00,490695,Kester; Grant,63,0,75,12
1713345939224,VIS 105D,A00,490696,Staff,22,0,25,3
1713345940249,VIS 124CN,A00,490699,Rose; Jordan M,64,0,75,11
1713345941278,VIS 125GS,A00,511221,Williams; Alena J,21,0,22,1
1713345942307,VIS 128D,A00,490700,Staff,73,0,75,2
1713345943336,VIS 151,A01,490717,Staff,33,0,34,1
1713345943336,VIS 151,A02,490766,Staff,32,0,34,2
1713345944362,VIS 154GS,A00,511972,Williams; Alena J,21,0,22,1
1713345945394,VIS 160A,A00,490767,Stone; Patricia,7,0,10,3
1713345946420,WCWP 10A,A00,490638,Staff,14,0,15,1
1713345946420,WCWP 10A,B00,490640,Staff,15,0,15,0
1713345947446,WCWP 10B,A00,490641,Staff,0,0,0,0
1713345947446,WCWP 10B,B00,490642,Staff,14,0,15,1
1713345947446,WCWP 10B,C00,490644,Staff,13,0,15,2
1713345947446,WCWP 10B,D00,490647,Staff,0,0,0,0
1713345948475,WCWP 100,A00,490655,Staff,0,0,0,0
1713345948475,WCWP 100,B00,490687,Staff,10,0,15,5
1713345950596,ANAR 153,A00,487222,Braswell; Geoffrey E.,53,0,60,7
1713345951621,ANBI 134,A00,487223,Staff,5,0,20,15
1713345952647,ANBI 143GS,A00,487224,Noel; Geoffroy Pierre Jean,18,0,24,6
1713345953673,ANBI 144GS,A00,519548,Noel; Geoffroy Pierre Jean,18,0,24,6
1713345954705,ANSC 101,A00,487225,Staff,17,0,20,3
1713345955734,ANSC 125,A00,487227,Brenner; Suzanne A,38,0,40,2
1713345957788,ANSC 146,A00,487229,Staff,35,0,40,5
1713345958821,ANSC 148,A00,487230,Olivas Hernandez; Olga Lid,39,0,40,1
1713345959910,ANSC 150,A00,504165,Sloane; Julia Kathryn,18,0,20,2
1713345960935,ANSC 180,A00,487232,Staff,14,0,15,1
1713345961962,ANSC 188,A00,627155,Staff,37,0,40,3
1713345962993,ANTH 5,A00,519529,Semendeferi; Ekaterini,15,0,15,0
1713345964023,ANTH 10,A00,487219,Staff,58,0,60,2
1713345965050,ANTH 23,A01,487221,Staff,17,0,20,3
1713345966082,ANTH 102,A00,487233,Wilder; Linnea Lorene,50,0,60,10
1713345967109,ANTH 103,A00,487234,Varma; Saiba,54,0,60,6
1713345968138,ANTH 105,A00,487235,Stewart; Alexander B,54,0,60,6
1713345969171,BENG 100,A01,516685,Taylor Amos; Alyssa C,25,0,30,5
1713345970205,BIBC 102,A01,491316,Flagg; Matthew Paul,5,0,88,83
1713345970205,BIBC 102,A02,491366,Flagg; Matthew Paul,78,0,88,10
1713345971231,BIBC 103,A01,491486,Boumechache; Miyyada,16,0,24,8
1713345971231,BIBC 103,A02,491487,Boumechache; Miyyada,24,0,24,0
1713345972266,BICD 100,A01,516882,Staff,73,0,75,2
1713345972266,BICD 100,A02,516890,Staff,69,0,75,6
1713345973298,BICD 102GS,A00,491488,Lo; Stanley M.,26,0,28,2
1713345974325,BIEB 136GS,A00,516940,Holway; David A. & Shurin; Jonathan,18,0,24,6
1713345975351,BIEB 137GS,A01,517034,Holway; David A. & Shurin; Jonathan,18,0,24,6
1713345976377,BIEB 138GS,A01,491492,Pirino; Giorgia,21,0,28,7
1713345977402,BILD 1,A01,491296,Staff,60,0,63,3
1713345977402,BILD 1,A02,491297,Staff,63,0,63,0
1713345978434,BILD 4,A01,517099,Gonzalez Gamboa; Ivonne,22,0,24,2
1713345978434,BILD 4,A02,517100,Gonzalez Gamboa; Ivonne,24,0,24,0
1713345979462,BILD 60GS,A00,491309,Lo; Stanley M.,26,0,28,2
1713345980493,BIMM 100,A01,517136,Staff,82,0,100,18
1713345981522,BIMM 110,A01,517182,Staff,52,0,100,48
1713345982550,BIMM 120,A01,517228,Pickett; Brooke Elizabeth,28,0,63,35
1713345982550,BIMM 120,A02,517240,Pickett; Brooke Elizabeth,44,0,63,19
1713345983575,BIMM 132GS,A01,491498,Pirino; Giorgia,21,0,28,7
1713345984607,BIMM 143,A01,491589,Bozinovic; Goran,12,0,40,28
1713345985641,BIPN 100,A01,491594,Armour; Jon Christopher,83,0,100,17
1713345986668,BIPN 140,A01,491602,Marino; Marc J,23,0,50,27
1713345988719,CAT 125,A00,515973,Staff,18,0,20,2
1713345989745,CAT 125GS,A00,515974,Rahimi; Babak,16,0,20,4
1713345990771,CAT 125R,A00,515980,Staff,12,0,20,8
1713345990771,CAT 125R,B00,515981,Tosun; Adriana,19,0,20,1
1713345990771,CAT 125R,C00,515987,Hyland; Tina Mae,0,5,20,20
1713345990771,CAT 125R,D00,515988,Bronstein; Phoebe Malan,16,0,20,4
1713345991799,CENG 15,A01,488699,Drews; Aaron,25,0,25,0
1713345992831,CENG 100,A00,505196,Opatkiewicz; Justin Paul,25,0,25,0
1713345993859,CGS 2A,A01,489598,Staff,32,0,35,3
1713345994885,CGS 112,A00,489599,Staff,15,0,15,0
1713345995913,CGS 119,A00,489603,Staff,10,0,10,0
1713345996938,CGS 120,A00,489604,Staff,13,0,15,2
1713345997963,CGS 150,A00,489607,Staff,15,0,15,0
1713345998992,CHEM 6A,A01,488715,Staff,97,0,100,3
1713346000024,CHEM 6B,A01,488719,Piercy; Marc Anthony,99,0,100,1
1713346001055,CHEM 6C,A01,488723,Albizati; Kim F.,93,0,100,7
1713346002091,CHEM 7L,A01,488728,Schurmeier; Kimberly,18,0,24,6
1713346002091,CHEM 7L,A02,488730,Schurmeier; Kimberly,23,0,24,1
1713346002091,CHEM 7L,A03,488734,Schurmeier; Kimberly,20,0,24,4
1713346002091,CHEM 7L,A04,488763,Schurmeier; Kimberly,23,0,24,1
1713346002091,CHEM 7L,B01,488798,Schurmeier; Kimberly,16,0,24,8
1713346002091,CHEM 7L,B02,488801,Schurmeier; Kimberly,22,0,24,2
1713346002091,CHEM 7L,B03,488808,Schurmeier; Kimberly,22,0,24,2
1713346002091,CHEM 7L,B04,488811,Schurmeier; Kimberly,24,0,24,0
1713346003126,CHEM 11,A01,488897,Stallings; Dontarie M,94,0,100,6
1713346004152,CHEM 40A,A01,488913,Albizati; Kim F.,83,0,100,17
1713346005183,CHEM 40B,A01,488920,Weizman; Haim,42,0,50,8
1713346005183,CHEM 40B,A02,488938,Weizman; Haim,43,0,50,7
1713346006209,CHEM 41A,A01,489029,Klosterman; Jeremy K,57,0,60,3
1713346007236,CHEM 41C,A01,500436,Tor; Yitzhak,54,0,60,6
1713346008265,CHEM 43A,A01,500426,Weizman; Haim,0,1,24,24
1713346008265,CHEM 43A,A02,500430,Weizman; Haim,6,0,24,18
1713346008265,CHEM 43A,B01,514041,Klosterman; Jeremy K,14,0,24,10
1713346008265,CHEM 43A,B02,514047,Klosterman; Jeremy K,23,0,24,1
1713346009297,CHEM 108,A01,489140,Jennings; Patricia A.,6,0,24,18
1713346009297,CHEM 108,A02,489142,Jennings; Patricia A.,14,0,24,10
1713346010323,CHEM 114A,A01,489147,Stallings; Dontarie M,65,0,100,35
1713346011348,CHIN 169A,A00,489171,Wang; Xiao,19,0,20,1
1713346013401,COGS 3,A01,518827,Boyle; Mary E. T.,25,0,40,15
1713346014426,COGS 11,A01,489175,Staff,27,0,30,3
1713346015453,COGS 14A,A01,518829,Staff,50,0,60,10
1713346016485,COGS 14B,A01,489177,Hoffman; Drew Ellen,62,0,75,13
1713346017518,COGS 100,A01,489181,Allen; Michael Gordon,62,0,75,13
1713346018544,COGS 101A,A01,489183,Staff,45,0,60,15
1713346019569,COGS 101B,A01,489185,Allen; Michael Gordon,6,0,30,24
1713346020600,COGS 101C,A01,526786,Staff,23,0,30,7
1713346022651,COGS 107A,A01,489189,Boyle; Mary E. T.,16,0,35,19
1713346023682,COGS 107B,A01,627144,Mooshagian; Eric Frederick,59,0,60,1
1713346024709,COGS 118A,A01,489191,Staff,0,46,40,40
1713346026820,COGS 171GS,A01,489194,Pineda; Jaime A,19,0,28,9
1713346027847,COGS 172,A01,489196,Staff,1,0,30,29
1713346028873,COGS 174GS,A01,489264,Pineda; Jaime A,19,0,28,9
1713346029898,COGS 180,A01,627150,Staff,28,0,30,2
1713346030929,COGS 186,A01,489274,Staff,0,3,30,30
1713346031960,COMM 10,A01,489276,Staff,23,0,25,2
1713346031960,COMM 10,A02,489303,Staff,23,0,25,2
1713346032986,COMM 100A,A01,489312,Staff,14,0,25,11
1713346032986,COMM 100A,A02,489313,Staff,24,0,25,1
1713346034017,COMM 106T,A00,512540,Staff,33,0,35,2
1713346035044,COMM 107,A00,489347,Staff,27,0,35,8
1713346036073,COMM 109P,A00,489358,Staff,31,0,35,4
1713346037103,COMM 132,A00,489361,McKenna; Denise,27,0,30,3
1713346038129,COMM 146,A00,489362,Halm; Gavin Patrick,26,0,30,4
1713346039159,COMM 190,A00,489363,Abuelhiga; Soraya Jill,17,0,23,6
1713346040187,CSE 8A,A50,489366,Staff,21,0,25,4
1713346040187,CSE 8A,A51,489367,Staff,24,0,25,1
1713346041215,CSE 11,A01,489398,Cao; Yingjun,72,0,100,28
1713346042242,CSE 12,A01,489487,Staff,43,0,50,7
1713346043273,CSE 20,A01,489497,Staff,47,0,50,3
1713346044306,CSE 21,A01,489517,Braun; Oliver,42,0,50,8
1713346045336,CSE 101,A01,489524,Braun; Oliver,0,35,50,50
1713346046365,CSE 105,A01,512594,Jones; Miles E,72,0,100,28
1713346046365,CSE 105,B01,512598,Jones; Miles E,51,0,100,49
1713346047391,CSE 140,A01,489538,Staff,39,0,50,11
1713346048420,CSE 141,A01,489550,Eldon; John,67,0,100,33
1713346049449,CSE 141L,A01,489571,Eldon; John,65,0,100,35
1713346050476,CSE 151A,A01,489583,Solares; Edwin A,139,0,200,61
1713346051503,CSE 175,A01,510886,Kumar; Rakesh,30,0,30,0
1713346052535,CSE 190,A00,516828,Dubnov; Shlomo,37,0,49,12
1713346053560,DOC 100D,A00,489667,Pass; Natalye Joann,19,0,25,6
1713346054587,DSC 10,A01,624268,Staff,72,0,75,3
1713346055616,DSC 20,A01,624476,Staff,50,0,50,0
1713346056642,DSC 40A,A01,624608,Staff,39,0,40,1
1713346057668,DSGN 1,A01,489179,Rill; Bryan,32,0,50,18
1713346058695,ECE 17,A01,490489,Sahay; Rajeev,18,0,30,12
1713346059720,ECE 65,A50,490492,Staff,11,0,20,9
1713346059720,ECE 65,A51,490493,Staff,18,0,20,2
1713346060748,ECON 1,A01,489715,Famulari; Melissa,67,0,70,3
1713346061777,ECON 2,A01,489717,Levkoff; Steven B.,67,0,70,3
1713346062818,ECON 3,A01,489948,Staff,70,0,70,0
1713346064882,ECON 5,A01,490103,Staff,27,0,30,3
1713346064882,ECON 5,B01,626281,Dai; Yinlin,45,0,45,0
1713346065908,ECON 100A,A01,490127,Famulari; Melissa,62,0,70,8
1713346066938,ECON 100B,A01,490129,Staff,64,0,70,6
1713346067964,ECON 109,A01,490187,Shishkin; Denis,27,0,35,8
1713346068989,ECON 110A,A01,490190,Levkoff; Steven B.,59,0,70,11
1713346070014,ECON 120A,A01,490245,Dai; Yinlin,59,0,70,11
1713346071040,ECON 120B,A01,490247,Nieto-Barthaburu; Augusto,40,0,70,30
1713346072074,ECON 120C,A01,490253,Sun; Yixiao,30,0,35,5
1713346072074,ECON 120C,B01,490255,Sun; Yixiao,34,0,35,1
1713346073108,ECON 129,A00,490256,Eckert; Fabian Paul,22,0,35,13
1713346074134,ECON 131,A00,490257,Nieto-Barthaburu; Augusto,0,6,35,35
1713346075167,ECON 138,A00,490258,Bharadwaj; Prashant,13,0,35,22
1713346075167,ECON 138,B00,490259,Bharadwaj; Prashant,15,0,35,20
1713346076198,ECON 159,A00,490260,Hendrickson; Gerald M.,0,9,0,0
1713346077224,ECON 178,A01,553995,Zhu; Ying,24,0,35,11
1713346078252,EDS 40,A01,512576,Black; Alison Michelle,20,0,20,0
1713346079284,EDS 107,A01,515848,Staff,30,0,30,0
1713346080309,EDS 110R,A01,490262,Staff,26,0,30,4
1713346081335,EDS 112,A01,490264,Chapman; Thandeka K,40,0,50,10
1713346082361,EDS 113,A00,490266,Staff,25,0,30,5
1713346083385,EDS 118,A00,490267,Warstadt; Melissa Fawn,18,0,30,12
1713346084410,EDS 124BR,A00,490268,Eguchi; Emi,4,0,25,21
1713346084410,EDS 124BR,B00,490269,Eguchi; Emi,23,0,25,2
1713346085436,EDS 126,A01,490271,Jones; Makeba,43,0,50,7
1713346086466,EDS 135,A01,490316,Staff,19,0,20,1
1713346087492,ENVR 142GS,A00,519514,Chang; Edmond Yi-Teh,26,0,28,2
1713346088521,ETHN 103,A00,490504,Staff,24,0,36,12
1713346089547,ETHN 103A,A00,490505,Man; Simeon S,3,0,9,6
1713346090573,ETHN 109,A00,490506,Staff,28,0,30,2
1713346091599,ETHN 118,A00,490507,Staff,35,0,36,1
1713346092623,ETHN 119,A00,490508,Staff,32,0,36,4
1713346093658,ETHN 121R,A00,490518,Choi; Esther Min,21,0,36,15
1713346094682,ETHN 127,A00,490528,Staff,14,0,15,1
1713346095712,ETHN 139,A00,490573,Staff,10,0,10,0
1713346096742,ETHN 150,A00,490575,Staff,15,0,15,0
1713346097768,GLBH 20,A00,491705,Elwardani; Nile Regina,38,0,40,2
1713346098794,GLBH 101,A00,491706,Staff,20,0,20,0
1713346099824,GLBH 111,A01,491708,Burgos; Jose L.,15,0,15,0
1713346100852,GLBH 146,A00,491709,Staff,8,0,20,12
1713346101884,GLBH 148,A00,491710,Olivas Hernandez; Olga Lid,10,0,20,10
1713346102915,GLBH 150,A00,491711,Sloane; Julia Kathryn,19,0,20,1
1713346103943,HIEA 131,A00,491760,Staff,28,0,32,4
1713346104968,HIEA 153,A00,491762,Staff,28,0,30,2
1713346106010,HIEU 124,A00,491811,Staff,26,0,32,6
1713346107039,HIEU 124GS,A00,491812,Markman; Kristina,27,0,28,1
1713346108063,HIEU 147,A00,491813,Staff,30,0,32,2
1713346109089,HIEU 149GS,A00,491816,Caldwell; Michael Alan,28,0,28,0
1713346110114,HILD 2C,A01,491713,Hendrickson; Gerald M.,26,0,30,4
1713346111139,HILD 7B,A01,491715,Kwak; Nancy,0,3,30,30
1713346112165,HILD 10,A01,491717,Staff,9,0,20,11
1713346113190,HILD 30GS,A00,491719,Edington; Claire Ellen,23,0,28,5
1713346114220,HINE 109,A00,491818,Shafir; Nir,26,0,32,6
1713346115248,HINE 128,A00,491821,Shafir; Nir,30,0,32,2
1713346116273,HISC 117,A00,491830,Staff,27,0,32,5
1713346117298,HIUS 103,A00,491834,Man; Simeon S,14,0,23,9
1713346118323,HIUS 108B,A00,491835,Staff,27,0,30,3
1713346119351,HIUS 141,A00,491836,Hendrickson; Gerald M.,28,0,32,4
1713346120376,HIUS 149,A00,491839,Staff,24,0,32,8
1713346121404,HUM 3,A01,512617,Crum; Matthew Stephen,42,0,50,8
1713346121404,HUM 3,A02,512618,Crum; Matthew Stephen,48,0,50,2
1713346122428,HUM 3GS,A00,512663,Markman; Kristina,0,0,0,1
1713346122428,HUM 3GS,B00,512664,Staff,0,0,0,0
1713346123459,HUM 4,A01,512620,West; Geoffrey Scott,23,0,50,27
1713346124486,HUM 4GS,A00,512666,Lyon; Antony J.,0,0,0,5
1713346125510,HUM 4R,A01,512625,Watkins; Eric,49,0,50,1
1713346126540,HUM 5,A01,512649,Zavodny; Tatiana Sophia,20,0,50,30
1713346126540,HUM 5,B01,512661,Zroka; Ryan Edward,48,0,50,2
1713346127571,INTL 190,A00,490577,Segui; Alan S,0,0,0,5
1713346128600,JAPN 20AR,A01,491267,Ross; Kayoko F,7,0,20,13
1713346129682,JAPN 180,A00,491285,Berman; Michael David,33,0,40,7
1713346130711,LATI 50,A01,502536,Kokinis; Troy Andreas,16,0,22,6
1713346130711,LATI 50,A02,502551,Kokinis; Troy Andreas,22,0,22,0
1713346130711,LATI 50,A03,502650,Kokinis; Troy Andreas,22,0,22,0
1713346130711,LATI 50,A04,502909,Kokinis; Troy Andreas,21,0,22,1
1713346131740,LATI 160,A01,502920,Kokinis; Troy Andreas,30,0,30,0
1713346132767,LIFR 1A,A00,490494,Van Moer; Vinciane G,17,0,20,3
1713346133793,LIFR 1AX,A00,490495,Van Moer; Vinciane G,17,0,20,3
1713346134819,LIFR 1B,A00,490496,Van Moer; Vinciane G,17,0,20,3
1713346135845,LIFR 1BX,A00,490497,Van Moer; Vinciane G,17,0,20,3
1713346136871,LIGN 8,A00,505198,McIntosh; Justin Daniel,134,0,150,16
1713346137897,LIGN 9GS,A00,491239,Lott; Margaret S.,18,0,20,2
1713346138923,LIGN 101,A01,505200,McIntosh; Justin Daniel,22,0,30,8
1713346139954,LIGN 120,A01,491244,Staff,22,0,30,8
1713346140982,LIGN 149GS,A00,491245,Lott; Margaret S.,18,0,20,2
1713346142010,LIGN 170,A00,491247,Staff,22,0,30,8
1713346143039,LISP 1D,A00,490498,Munoz Sanchez; Alicia,8,0,14,6
1713346143039,LISP 1D,B00,490499,Munoz Sanchez; Alicia,4,0,14,10
1713346143039,LISP 1D,C00,490500,Munoz Sanchez; Alicia,7,0,14,7
1713346143039,LISP 1D,D00,490501,Munoz Sanchez; Alicia,10,0,14,4
1713346144067,LISP 1DX,A00,490502,Munoz Sanchez; Alicia,11,0,28,17
1713346144067,LISP 1DX,B00,490503,Munoz Sanchez; Alicia,16,0,28,12
1713346146121,LTAM 110,A00,491847,Staff,22,0,25,3
1713346147150,LTCS 119,A00,491848,Staff,11,0,15,4
1713346148176,LTCS 130,A00,491849,Staff,24,0,25,1
1713346150230,LTEA 120C,A00,491852,Staff,32,0,40,8
1713346151259,LTEN 130GS,A00,491853,Lyon; Antony J.,23,0,28,5
1713346152288,LTEN 148,A00,491855,Staff,23,0,25,2
1713346153314,LTEN 159,A00,491856,Staff,20,0,25,5
1713346154344,LTEN 180,A00,491857,Staff,8,0,15,7
1713346156401,LTSP 123GS,A00,505928,Bessett; Ryan Matthew,24,0,28,4
1713346157425,LTSP 174GS,A00,506037,Bessett; Ryan Matthew,24,0,28,4
1713346159478,LTWR 102,A00,491861,Staff,9,0,15,6
1713346160503,LTWR 106,A00,491862,Staff,8,0,15,7
1713346161528,MAE 11,A00,490930,Bahadori; Mohammad Yousef,94,0,100,6
1713346162561,MAE 30A,A00,490931,Qi; Huihui,37,0,40,3
1713346163594,MAE 101A,A00,491036,Sadeghizadeh; Zahra,91,0,100,9
1713346164623,MAE 101C,A00,491037,Seshadri; Kalyanasundaram,63,0,100,37
1713346165649,MAE 113,A00,491040,Seshadri; Kalyanasundaram,64,0,80,16
1713346166675,MAE 131A,A00,491041,Ghazinejad; Maziar,37,0,40,3
1713346167701,MAE 142,A00,491053,Staff,39,0,40,1
1713346168730,MAE 143A,A00,491054,Staff,29,0,50,21
1713346169771,MAE 150,A00,491092,Truong; Phuong Thi Ngoc,23,0,35,12
1713346170799,MATH 3C,A01,494031,Pardo Guerra; Sebastian,30,0,30,0
1713346170799,MATH 3C,A02,494032,Pardo Guerra; Sebastian,29,0,30,1
1713346171826,MATH 10A,A01,494034,Staff,27,0,30,3
1713346171826,MATH 10A,A02,494035,Staff,28,0,30,2
1713346171826,MATH 10A,B01,494037,Staff,27,0,30,3
1713346171826,MATH 10A,B02,494038,Staff,29,0,30,1
1713346172862,MATH 10B,A01,494040,Habib; Yousaf,22,0,30,8
1713346172862,MATH 10B,A02,494041,Habib; Yousaf,28,0,30,2
1713346172862,MATH 10B,A03,494042,Habib; Yousaf,29,0,30,1
1713346172862,MATH 10B,A04,494043,Habib; Yousaf,30,0,30,0
1713346172862,MATH 10B,B01,494045,Habib; Yousaf,25,0,30,5
1713346172862,MATH 10B,B02,494046,Habib; Yousaf,30,0,30,0
1713346172862,MATH 10B,B03,494047,Habib; Yousaf,30,0,30,0
1713346172862,MATH 10B,B04,494048,Habib; Yousaf,30,0,30,0
1713346173912,MATH 18,A01,494050,Kemp; Todd Aahron,25,0,30,5
1713346173912,MATH 18,A02,494051,Kemp; Todd Aahron,29,0,30,1
1713346173912,MATH 18,B01,494054,Kemp; Todd Aahron,25,0,30,5
1713346173912,MATH 18,B02,494055,Kemp; Todd Aahron,29,0,30,1
1713346174939,MATH 20A,A01,494059,Suk; Andrew Hoon,30,0,30,0
1713346175966,MATH 20B,A01,494061,Briones; Jor-el Thomas Caparas,33,0,35,2
1713346175966,MATH 20B,B01,494063,Bach; Quang Tran,34,0,35,1
1713346177002,MATH 20C,A01,494065,Staff,28,0,30,2
1713346177002,MATH 20C,A02,494066,Staff,30,0,30,0
1713346177002,MATH 20C,A03,494067,Staff,30,0,30,0
1713346177002,MATH 20C,A04,494068,Staff,30,0,30,0
1713346177002,MATH 20C,B01,494070,Zhang; Ming,23,0,30,7
1713346177002,MATH 20C,B02,494071,Zhang; Ming,27,0,30,3
1713346177002,MATH 20C,B03,494072,Zhang; Ming,29,0,30,1
1713346177002,MATH 20C,B04,494073,Zhang; Ming,29,0,30,1
1713346178028,MATH 20D,A01,494075,Staff,22,0,30,8
1713346178028,MATH 20D,A02,494076,Staff,29,0,30,1
1713346179060,MATH 20E,A01,494079,Staff,24,0,30,6
1713346179060,MATH 20E,A02,494080,Staff,26,0,30,4
1713346179060,MATH 20E,B01,494082,Staff,25,0,30,5
1713346179060,MATH 20E,B02,494083,Staff,25,0,30,5
1713346180089,MATH 103A,A01,494085,Aliabadi Sr.; Mohsen,12,0,30,18
1713346180089,MATH 103A,A02,494086,Aliabadi Sr.; Mohsen,28,0,30,2
1713346180089,MATH 103A,B01,494088,Aliabadi Sr.; Mohsen,20,0,30,10
1713346180089,MATH 103A,B02,494089,Aliabadi Sr.; Mohsen,27,0,30,3
1713346181122,MATH 109,A01,494091,Staff,30,0,30,0
1713346181122,MATH 109,A02,494092,Staff,29,0,30,1
1713346181122,MATH 109,B01,494094,Staff,27,0,30,3
1713346181122,MATH 109,B02,494095,Staff,29,0,30,1
1713346182150,MATH 142A,A01,494097,Chow; Bennett,13,0,30,17
1713346182150,MATH 142A,A02,494098,Chow; Bennett,23,0,30,7
1713346182150,MATH 142A,B01,494100,Chow; Bennett,19,0,30,11
1713346182150,MATH 142A,B02,494101,Chow; Bennett,29,0,30,1
1713346184203,MATH 168A,A01,516677,Dumitriu; Ioana,16,0,35,19
1713346185228,MATH 170A,A01,516679,Dumitriu; Ioana,18,0,30,12
1713346185228,MATH 170A,A02,516680,Dumitriu; Ioana,28,0,30,2
1713346186253,MATH 193A,A01,494107,Staff,12,0,30,18
1713346186253,MATH 193A,A02,494108,Staff,18,0,30,12
1713346186253,MATH 193A,A03,494109,Staff,29,0,30,1
1713346186253,MATH 193A,A04,494110,Staff,22,0,30,8
1713346189335,MGT 16,A00,491930,McKay; Michael J,92,0,98,6
1713346190366,MGT 18,A00,491992,McKay; Michael J,96,0,98,2
1713346191390,MGT 71,A00,492003,Staff,63,0,98,35
1713346192421,MGT 103,A00,505209,Eberhard; Craig A,80,0,98,18
1713346193447,MGT 131A,A00,505210,Anderson; John Charles,89,0,98,9
1713346195500,MGT 153,A00,492077,Perols; Johan Lars,15,0,90,75
1713346198574,MGT 164,A00,492222,McKay; Mary A,91,0,98,7
1713346199606,MGT 172,A00,492245,Staff,59,0,60,1
1713346199606,MGT 172,B00,505526,Hedges; Kathleen,65,0,98,33
1713346200637,MGT 181,A00,505669,Dunn; Louis Jean,78,0,98,20
1713346201680,MMW 14,A01,494399,Staff,15,0,28,13
1713346201680,MMW 14,A02,494400,Staff,25,0,28,3
1713346201680,MMW 14,A03,494401,Staff,28,0,28,0
1713346201680,MMW 14,A04,494402,Staff,28,0,28,0
1713346201680,MMW 14,B01,494404,Carreras; Maria Victoria,8,0,28,20
1713346201680,MMW 14,B02,494405,Carreras; Maria Victoria,25,0,28,3
1713346201680,MMW 14,B03,494406,Carreras; Maria Victoria,27,0,28,1
1713346201680,MMW 14,B04,494407,Carreras; Maria Victoria,28,0,28,0
1713346202705,MMW 14GS,A00,506250,Chang; Edmond Yi-Teh,0,0,0,0
1713346203732,MMW 121R,A01,494415,Adamiak; Patrick John,10,0,28,18
1713346203732,MMW 121R,A02,494416,Adamiak; Patrick John,24,0,28,4
1713346204757,MUS 1A,A01,494113,Staff,12,0,25,13
1713346204757,MUS 1A,A02,494114,Staff,24,0,25,1
1713346205783,MUS 4,A01,494116,Staff,23,0,25,2
1713346205783,MUS 4,A02,494117,Staff,22,0,25,3
1713346206810,MUS 5R,A01,494236,Dubnov; Shlomo,4,0,25,21
1713346206810,MUS 5R,A02,494237,Dubnov; Shlomo,25,0,25,0
1713346207834,MUS 6,A01,494122,Staff,9,0,25,16
1713346207834,MUS 6,A02,494123,Staff,23,0,25,2
1713346208864,MUS 7,A01,494125,Staff,16,0,25,9
1713346208864,MUS 7,A02,494126,Staff,24,0,25,1
1713346209889,MUS 11,A01,494128,Staff,23,0,25,2
1713346209889,MUS 11,A02,494129,Staff,24,0,25,1
1713346210917,MUS 13,A01,494131,Staff,25,0,25,0
1713346210917,MUS 13,A02,494132,Staff,25,0,25,0
1713346211947,MUS 15,A01,494134,Staff,16,0,25,9
1713346211947,MUS 15,A02,494135,Staff,25,0,25,0
1713346211947,MUS 15,B01,494137,Staff,24,0,25,1
1713346212976,MUS 80,A00,494232,Staff,24,0,25,1
1713346212976,MUS 80,B00,494233,Staff,25,0,25,0
1713346212976,MUS 80,C00,494234,Staff,23,0,25,2
1713346214002,MUS 95C,A00,494141,Staff,69,0,75,6
1713346215031,MUS 114,A00,494142,Staff,39,0,50,11
1713346216059,NANO 15,A01,490636,Drews; Aaron,7,0,7,0
1713346217091,PHIL 1,A00,490578,Grush; Rick Scott,49,0,50,1
1713346218118,PHIL 10,A01,490580,Grush; Rick Scott,33,0,35,2
1713346218118,PHIL 10,A02,490586,Grush; Rick Scott,32,0,35,3
1713346219144,PHIL 27,A01,490591,Staff,22,0,25,3
1713346219144,PHIL 27,A02,490592,Staff,25,0,25,0
1713346219144,PHIL 27,A03,490593,Staff,25,0,25,0
1713346219144,PHIL 27,A04,490598,Staff,25,0,25,0
1713346220173,PHIL 32,A01,490611,Staff,20,0,20,0
1713346220173,PHIL 32,A02,490618,Staff,20,0,20,0
1713346221200,PHIL 90,A00,490624,Staff,40,0,40,0
1713346222235,PHIL 136,A00,490627,Cohen; Jonathan David,37,0,40,3
1713346223262,PHIL 155,A00,490634,Staff,61,0,70,9
1713346224288,PHYS 1A,A00,491610,Staff,245,0,250,5
1713346225314,PHYS 1AL,001,491616,Tsai; Philbert S,27,0,30,3
1713346225314,PHYS 1AL,002,491618,Tsai; Philbert S,30,0,30,0
1713346226344,PHYS 1B,A00,491623,Staff,235,0,250,15
1713346227373,PHYS 1BL,001,491626,Tsai; Philbert S,18,0,30,12
1713346227373,PHYS 1BL,002,491628,Tsai; Philbert S,26,0,30,4
1713346228401,PHYS 1C,A00,491632,Staff,211,0,245,34
1713346229431,PHYS 1CL,001,491635,Tsai; Philbert S,2,0,30,28
1713346229431,PHYS 1CL,002,491643,Tsai; Philbert S,22,0,30,8
1713346230462,PHYS 2AR,A01,491651,Meyertholen; Andrew D.,44,0,50,6
1713346231487,PHYS 2B,A01,491659,Staff,105,0,115,10
1713346232514,PHYS 2BL,A01,491685,Staff,21,0,24,3
1713346232514,PHYS 2BL,A02,491700,Staff,21,0,24,3
1713346233594,PHYS 2C,A01,505161,Staff,101,0,115,14
1713346234621,PHYS 4A,A01,491704,Grinstein; Benjamin,99,0,100,1
1713346235649,POLI 5D,A01,494144,Staff,3,0,5,2
1713346235649,POLI 5D,B01,626283,Dai; Yinlin,5,0,5,0
1713346236673,POLI 12,A00,494145,Staff,43,0,45,2
1713346237701,POLI 13R,A00,494146,Forman; Fonna,45,0,50,5
1713346238727,POLI 27,A01,494148,Staff,54,0,60,6
1713346239752,POLI 30,A00,494149,Staff,49,0,50,1
1713346240783,POLI 100DA,A00,494150,Staff,20,0,25,5
1713346242847,POLI 100I,A00,494152,Staff,27,0,30,3
1713346243876,POLI 104B,A00,494153,Smith; Glenn Chatmas,53,0,55,2
1713346244904,POLI 104F,A00,494154,Staff,28,0,30,2
1713346245933,POLI 104I,A00,494155,Smith; Glenn Chatmas,29,0,30,1
1713346246960,POLI 110C,A00,494156,Ingham; Sean,23,0,25,2
1713346247984,POLI 117R,A00,494157,Forman; Fonna,5,0,20,15
1713346249012,POLI 118,A00,494158,Ingham; Sean,21,0,25,4
1713346250038,POLI 120H,A00,494159,Fisk; David Lee,39,0,45,6
1713346251064,POLI 131CR,A00,494160,Hoston; Germaine,35,0,45,10
1713346252090,POLI 133J,A00,494161,Staff,31,0,35,4
1713346253116,POLI 135,A00,494162,Fisk; David Lee,33,0,35,2
1713346254142,POLI 140A,A00,494164,Staff,18,0,30,12
1713346255168,POLI 142I,A00,494165,Staff,30,0,30,0
1713346256197,POLI 144D,A00,494166,Staff,22,0,25,3
1713346257222,POLI 151,A00,494167,Staff,30,0,30,0
1713346258248,POLI 153,A00,494168,Staff,33,0,35,2
1713346259279,POLI 160AA,A00,494169,Staff,33,0,40,7
1713346260306,POLI 162,A00,494170,Mignozzetti; Umberto,17,0,25,8
1713346261335,POLI 171,A00,494171,Mignozzetti; Umberto,18,0,25,7
1713346262360,PSYC 1,A00,494172,Staff,95,0,100,5
1713346263390,PSYC 2,A00,494173,Moranton; Nirelia Melbina-,33,0,50,17
1713346264414,PSYC 3,A00,494174,Staff,29,0,30,1
1713346265443,PSYC 6,A00,494175,Staff,17,0,20,3
1713346266469,PSYC 60,A01,494177,Staff,37,0,45,8
1713346267503,PSYC 70,A01,505724,Geller; Emma Harlan,42,0,45,3
1713346268533,PSYC 101,A00,494180,Heyman; Gail D.,83,0,100,17
1713346269560,PSYC 105,A00,494181,Geller; Emma Harlan,51,0,90,39
1713346270589,PSYC 106,A00,494182,Dobkins; Karen R.,26,0,45,19
1713346271616,PSYC 108,A00,494183,Adrian; Julia Anna,89,0,100,11
1713346272647,PSYC 114,A01,494185,Winkielman; Piotr,0,4,30,30
1713346273673,PSYC 122,A00,494186,Moranton; Nirelia Melbina-,27,0,50,23
1713346274702,PSYC 124,A00,494187,Chapman; Eddie Nathaniel,69,0,80,11
1713346275732,PSYC 131,A00,494188,Anagnostaras; Stephan,39,0,80,41
1713346276757,PSYC 144,A00,494189,Staff,1,1,50,49
1713346277783,PSYC 154,A00,494190,Lacefield; Katharine I,105,0,180,75
1713346278813,PSYC 162,A00,494191,Wixted; John T,70,0,100,30
1713346279843,PSYC 172,A00,494192,Gorman; Michael R.,36,0,45,9
1713346280868,PSYC 178,A00,494193,Glaser; Dale,32,0,45,13
1713346281895,PSYC 193,A00,505725,Chapman; Eddie Nathaniel,20,0,20,0
1713346282922,RELI 145GS,A00,519817,Rahimi; Babak,17,0,20,3
1713346283949,SE 101A,A01,490862,Chadha; Mayank,23,0,25,2
1713346284974,SE 101C,A01,490924,Krysl; Petr,15,0,20,5
1713346285999,SE 110A,A01,490928,Staff,19,0,20,1
1713346287034,SE 130A,A00,490929,Morrison; Machel Leigh,54,0,70,16
1713346288090,SIO 1,A01,519325,Staff,39,0,40,1
1713346289116,SIO 30,A01,519327,Staff,38,0,40,2
1713346290141,SIO 40,A00,519328,Staff,39,0,40,1
1713346291172,SIO 46GS,A00,519819,Cook; Geoffrey W,15,0,25,10
1713346292197,SIO 109R,A00,494197,Forman; Fonna,0,3,20,20
1713346293227,SIO 121GS,A00,519827,Cook; Geoffrey W,15,0,25,10
1713346294255,SIO 132,A01,519330,Staff,38,0,40,2
1713346295281,SIO 133,A01,519397,Staff,37,0,40,3
1713346296312,SIO 139,A00,519396,Kacev; David,29,0,40,11
1713346297345,SOCI 1,A01,494199,Thorpe; Charles Robert,21,0,30,9
1713346297345,SOCI 1,A02,494200,Thorpe; Charles Robert,30,0,30,0
1713346297345,SOCI 1,A03,494201,Thorpe; Charles Robert,29,0,30,1
1713346297345,SOCI 1,A04,494202,Thorpe; Charles Robert,29,0,30,1
1713346297345,SOCI 1,A05,494203,Thorpe; Charles Robert,29,0,30,1
1713346297345,SOCI 1,A06,494204,Thorpe; Charles Robert,30,0,30,0
1713346297345,SOCI 1,A07,494205,Thorpe; Charles Robert,28,0,30,2
1713346298371,SOCI 60,A01,494207,Staff,33,0,40,7
1713346298371,SOCI 60,A02,494208,Staff,39,0,40,1
1713346299396,SOCI 100,A01,494210,Payne; Christine Anna,25,0,30,5
1713346299396,SOCI 100,A02,494211,Payne; Christine Anna,26,0,30,4
1713346300427,SOCI 109M,A00,494212,Staff,20,0,20,0
1713346301454,SOCI 110,A00,494213,Staff,34,0,40,6
1713346303504,SOCI 118E,A00,494215,Ng; Kwai,37,0,40,3
1713346304530,SOCI 125,A00,494216,Calderon-Zaks; Michael Aar,39,0,45,6
1713346305560,SOCI 126,A01,494218,Jones; Makeba,3,0,5,2
1713346306584,SOCI 131,A00,494219,Thorpe; Charles Robert,26,0,30,4
1713346308641,SOCI 135,A00,494221,Payne; Christine Anna,28,0,50,22
1713346309666,SOCI 136E,A00,626690,Ruiz; Jonathan Joseph,24,0,25,1
1713346310692,SOCI 138GS,A00,494222,Navon; Daniel,23,0,28,5
1713346312744,SOCI 145,A00,494224,Staff,40,0,45,5
1713346313770,SOCI 153,A00,494225,Staff,28,0,30,2
1713346314801,SOCI 160E,A00,494226,Ng; Kwai,27,0,40,13
1713346315827,SOCI 180,A00,494227,Staff,29,0,30,1
1713346316858,SOCI 189GS,A00,494228,Ribas Norris; Janet Vanesa,11,0,11,0
1713346317883,SOCI 190GS,A00,553232,Ribas Norris; Janet Vanesa,11,0,11,0
1713346318910,SOMI 220,A00,627178,Schneid; Stephen David,30,0,30,0
1713346319938,SYN 2,001,490768,Staff,13,0,15,2
1713346319938,SYN 2,002,490769,Staff,14,0,15,1
1713346319938,SYN 2,004,490775,Staff,0,0,0,0
1713346319938,SYN 2,003,490774,Staff,0,0,0,0
1713346319938,SYN 2,005,490776,Staff,0,0,0,0
1713346320965,SYN 2R,001,490779,Staff,10,0,15,5
1713346320965,SYN 2R,002,514635,Staff,14,0,15,1
1713346321997,SYN 100,A01,490783,Staff,8,0,20,12
1713346321997,SYN 100,B01,490787,Staff,10,0,20,10
1713346321997,SYN 100,C01,490789,Staff,10,0,20,10
1713346323027,SYN 150,A00,490817,Staff,14,0,15,1
1713346323027,SYN 150,B00,514610,Staff,15,0,15,0
1713346324058,TDAC 1,A00,492753,Walsh; Kim C.,19,0,20,1
1713346324058,TDAC 1,B00,492754,Harting; Carla Kelso,18,0,20,2
1713346324058,TDAC 1,C00,513995,Salovey; Todd,15,0,20,5
1713346325085,TDAC 101,A00,492766,Harting; Carla Kelso,17,0,20,3
1713346326113,TDAC 102,A00,492768,Basso; Beatrice,19,0,20,1
1713346327138,TDDE 111,A00,492769,Staff,25,0,25,0
1713346328165,TDDE 131,A00,492770,Staff,15,0,15,0
1713346328165,TDDE 131,B00,492771,Staff,15,0,15,0
1713346329191,TDDE 131GS,A00,523716,Guirguis; Mark C,23,0,28,5
1713346330221,TDGE 1,A01,492756,Salovey; Todd,56,0,60,4
1713346331249,TDGE 5,A01,492758,Staff,23,0,25,2
1713346332280,TDGE 10,A00,492759,Fulton; Julia,203,0,220,17
1713346333308,TDGE 11,A00,492760,Castro; Robert Jess,198,0,200,2
1713346335365,TDGE 124,A00,492772,Fulton; Julia,180,0,220,40
1713346336393,TDGE 125,A00,492773,Meyer; Ursula,38,0,50,12
1713346336393,TDGE 125,B00,492774,Staff,49,0,50,1
1713346336393,TDGE 125,C00,523565,Staff,48,0,50,2
1713346337473,TDGE 125GS,A00,523580,Guirguis; Mark C,23,0,28,5
1713346338501,TDGE 127,A00,492775,Havis; Allan,33,0,50,17
1713346339527,TDHT 101,A00,492776,Staff,34,0,35,1
1713346340559,TDMV 1,A00,492762,Caligagan; Maria T.,29,0,30,1
1713346340559,TDMV 1,B00,492763,Arcidiacono; Kristin,26,0,30,4
1713346341591,TDMV 2,A00,492764,Weinberg; Sadie,27,0,30,3
1713346342616,TDMV 3,A00,492765,Mack; Kara Shanai',37,0,40,3
1713346343642,TDMV 138,A00,492777,Mack; Kara Shanai',32,0,40,8
1713346344676,TDMV 140,A00,492778,Lima; Paulo Henrique,40,0,40,0
1713346345702,TDMV 142,A00,492779,Caligagan; Maria T.,33,0,40,7
1713346345702,TDMV 142,B00,492780,Caligagan; Tony,37,0,40,3
1713346346727,TDMV 143,A00,492781,Fyall; Daunte Edward,39,0,40,1
1713346347759,USP 1,A01,492401,Kwak; Nancy,27,0,35,8
1713346348791,USP 2,A01,492453,Hinds; Juli Beth,35,0,35,0
1713346349819,USP 3,A01,492516,Staff,28,0,35,7
1713346350851,USP 4,A00,492522,McTague; Sarah,16,0,25,9
1713346351880,USP 100,A00,492523,Staff,32,0,35,3
1713346352905,USP 101,A00,492524,Staff,13,0,15,2
1713346353930,USP 105,A00,492525,Staff,21,0,25,4
1713346354955,USP 151,A00,492526,Shenkman; Michael Thomas,32,0,35,3
1713346355986,USP 170,A00,492545,Hinds; Juli Beth,32,0,35,3
1713346357016,USP 171GS,A00,492608,Bussell; Mirle Rabinowitz,24,0,28,4
1713346358047,USP 183GS,A00,492613,Peerson; Susan,24,0,28,4
1713346359073,VIS 30,A01,490693,Yoldas; Pinar,19,0,22,3
1713346359073,VIS 30,A02,490694,Yoldas; Pinar,18,0,22,4
1713346360099,VIS 83,A00,490695,Kester; Grant,63,0,75,12
1713346361126,VIS 105D,A00,490696,Staff,22,0,25,3
1713346362152,VIS 124CN,A00,490699,Rose; Jordan M,64,0,75,11
1713346363182,VIS 125GS,A00,511221,Williams; Alena J,21,0,22,1
1713346364211,VIS 128D,A00,490700,Staff,73,0,75,2
1713346365237,VIS 151,A01,490717,Staff,33,0,34,1
1713346365237,VIS 151,A02,490766,Staff,32,0,34,2
1713346366267,VIS 154GS,A00,511972,Williams; Alena J,21,0,22,1
1713346367297,VIS 160A,A00,490767,Stone; Patricia,7,0,10,3
1713346368325,WCWP 10A,A00,490638,Staff,14,0,15,1
1713346368325,WCWP 10A,B00,490640,Staff,15,0,15,0
1713346369352,WCWP 10B,A00,490641,Staff,0,0,0,0
1713346369352,WCWP 10B,B00,490642,Staff,14,0,15,1
1713346369352,WCWP 10B,C00,490644,Staff,13,0,15,2
1713346369352,WCWP 10B,D00,490647,Staff,0,0,0,0
1713346370380,WCWP 100,A00,490655,Staff,0,0,0,0
1713346370380,WCWP 100,B00,490687,Staff,10,0,15,5
1713346372529,ANAR 153,A00,487222,Braswell; Geoffrey E.,53,0,60,7
1713346373557,ANBI 134,A00,487223,Staff,5,0,20,15
1713346374583,ANBI 143GS,A00,487224,Noel; Geoffroy Pierre Jean,18,0,24,6
1713346375613,ANBI 144GS,A00,519548,Noel; Geoffroy Pierre Jean,18,0,24,6
1713346376644,ANSC 101,A00,487225,Staff,17,0,20,3
1713346377672,ANSC 125,A00,487227,Brenner; Suzanne A,38,0,40,2
1713346379722,ANSC 146,A00,487229,Staff,35,0,40,5
1713346380752,ANSC 148,A00,487230,Olivas Hernandez; Olga Lid,39,0,40,1
1713346381785,ANSC 150,A00,504165,Sloane; Julia Kathryn,18,0,20,2
1713346382810,ANSC 180,A00,487232,Staff,14,0,15,1
1713346383838,ANSC 188,A00,627155,Staff,37,0,40,3
1713346384866,ANTH 5,A00,519529,Semendeferi; Ekaterini,15,0,15,0
1713346385891,ANTH 10,A00,487219,Staff,58,0,60,2
1713346386920,ANTH 23,A01,487221,Staff,17,0,20,3
1713346387948,ANTH 102,A00,487233,Wilder; Linnea Lorene,50,0,60,10
1713346388978,ANTH 103,A00,487234,Varma; Saiba,54,0,60,6
1713346390004,ANTH 105,A00,487235,Stewart; Alexander B,54,0,60,6
1713346391033,BENG 100,A01,516685,Taylor Amos; Alyssa C,25,0,30,5
1713346392066,BIBC 102,A01,491316,Flagg; Matthew Paul,5,0,88,83
1713346392066,BIBC 102,A02,491366,Flagg; Matthew Paul,78,0,88,10
1713346393102,BIBC 103,A01,491486,Boumechache; Miyyada,16,0,24,8
1713346393102,BIBC 103,A02,491487,Boumechache; Miyyada,24,0,24,0
1713346394129,BICD 100,A01,516882,Staff,72,0,75,3
1713346394129,BICD 100,A02,516890,Staff,69,0,75,6
1713346395153,BICD 102GS,A00,491488,Lo; Stanley M.,26,0,28,2
1713346396182,BIEB 136GS,A00,516940,Holway; David A. & Shurin; Jonathan,18,0,24,6
1713346397206,BIEB 137GS,A01,517034,Holway; David A. & Shurin; Jonathan,18,0,24,6
1713346398235,BIEB 138GS,A01,491492,Pirino; Giorgia,21,0,28,7
1713346399262,BILD 1,A01,491296,Staff,60,0,63,3
1713346399262,BILD 1,A02,491297,Staff,63,0,63,0
1713346400291,BILD 4,A01,517099,Gonzalez Gamboa; Ivonne,22,0,24,2
1713346400291,BILD 4,A02,517100,Gonzalez Gamboa; Ivonne,24,0,24,0
1713346401319,BILD 60GS,A00,491309,Lo; Stanley M.,26,0,28,2
1713346402352,BIMM 100,A01,517136,Staff,82,0,100,18
1713346403379,BIMM 110,A01,517182,Staff,52,0,100,48
1713346404407,BIMM 120,A01,517228,Pickett; Brooke Elizabeth,28,0,63,35
1713346404407,BIMM 120,A02,517240,Pickett; Brooke Elizabeth,44,0,63,19
1713346405432,BIMM 132GS,A01,491498,Pirino; Giorgia,21,0,28,7
1713346406465,BIMM 143,A01,491589,Bozinovic; Goran,12,0,40,28
1713346407497,BIPN 100,A01,491594,Armour; Jon Christopher,83,0,100,17
1713346408528,BIPN 140,A01,491602,Marino; Marc J,23,0,50,27
1713346410584,CAT 125,A00,515973,Staff,18,0,20,2
1713346411610,CAT 125GS,A00,515974,Rahimi; Babak,16,0,20,4
1713346412644,CAT 125R,A00,515980,Staff,12,0,20,8
1713346412644,CAT 125R,B00,515981,Tosun; Adriana,19,0,20,1
1713346412644,CAT 125R,C00,515987,Hyland; Tina Mae,0,5,20,20
1713346412644,CAT 125R,D00,515988,Bronstein; Phoebe Malan,16,0,20,4
1713346413682,CENG 15,A01,488699,Drews; Aaron,25,0,25,0
1713346414709,CENG 100,A00,505196,Opatkiewicz; Justin Paul,25,0,25,0
1713346415733,CGS 2A,A01,489598,Staff,32,0,35,3
1713346416758,CGS 112,A00,489599,Staff,15,0,15,0
1713346417786,CGS 119,A00,489603,Staff,10,0,10,0
1713346418821,CGS 120,A00,489604,Staff,13,0,15,2
1713346419867,CGS 150,A00,489607,Staff,15,0,15,0
1713346420896,CHEM 6A,A01,488715,Staff,97,0,100,3
1713346421927,CHEM 6B,A01,488719,Piercy; Marc Anthony,99,0,100,1
1713346422958,CHEM 6C,A01,488723,Albizati; Kim F.,93,0,100,7
1713346423994,CHEM 7L,A01,488728,Schurmeier; Kimberly,18,0,24,6
1713346423994,CHEM 7L,A02,488730,Schurmeier; Kimberly,23,0,24,1
1713346423994,CHEM 7L,A03,488734,Schurmeier; Kimberly,20,0,24,4
1713346423994,CHEM 7L,A04,488763,Schurmeier; Kimberly,23,0,24,1
1713346423994,CHEM 7L,B01,488798,Schurmeier; Kimberly,16,0,24,8
1713346423994,CHEM 7L,B02,488801,Schurmeier; Kimberly,22,0,24,2
1713346423994,CHEM 7L,B03,488808,Schurmeier; Kimberly,22,0,24,2
1713346423994,CHEM 7L,B04,488811,Schurmeier; Kimberly,24,0,24,0
1713346425019,CHEM 11,A01,488897,Stallings; Dontarie M,94,0,100,6
1713346426046,CHEM 40A,A01,488913,Albizati; Kim F.,83,0,100,17
1713346427072,CHEM 40B,A01,488920,Weizman; Haim,42,0,50,8
1713346427072,CHEM 40B,A02,488938,Weizman; Haim,43,0,50,7
1713346428106,CHEM 41A,A01,489029,Klosterman; Jeremy K,57,0,60,3
1713346429133,CHEM 41C,A01,500436,Tor; Yitzhak,54,0,60,6
1713346430161,CHEM 43A,A01,500426,Weizman; Haim,0,1,24,24
1713346430161,CHEM 43A,A02,500430,Weizman; Haim,6,0,24,18
1713346430161,CHEM 43A,B01,514041,Klosterman; Jeremy K,14,0,24,10
1713346430161,CHEM 43A,B02,514047,Klosterman; Jeremy K,23,0,24,1
1713346431187,CHEM 108,A01,489140,Jennings; Patricia A.,6,0,24,18
1713346431187,CHEM 108,A02,489142,Jennings; Patricia A.,14,0,24,10
1713346432213,CHEM 114A,A01,489147,Stallings; Dontarie M,65,0,100,35
1713346433241,CHIN 169A,A00,489171,Wang; Xiao,19,0,20,1
1713346435302,COGS 3,A01,518827,Boyle; Mary E. T.,25,0,40,15
1713346436333,COGS 11,A01,489175,Staff,27,0,30,3
1713346437359,COGS 14A,A01,518829,Staff,50,0,60,10
1713346438391,COGS 14B,A01,489177,Hoffman; Drew Ellen,62,0,75,13
1713346439418,COGS 100,A01,489181,Allen; Michael Gordon,62,0,75,13
1713346440443,COGS 101A,A01,489183,Staff,45,0,60,15
1713346441526,COGS 101B,A01,489185,Allen; Michael Gordon,6,0,30,24
1713346442556,COGS 101C,A01,526786,Staff,23,0,30,7
1713346444615,COGS 107A,A01,489189,Boyle; Mary E. T.,16,0,35,19
1713346445649,COGS 107B,A01,627144,Mooshagian; Eric Frederick,59,0,60,1
1713346446675,COGS 118A,A01,489191,Staff,0,46,40,40
1713346448731,COGS 171GS,A01,489194,Pineda; Jaime A,19,0,28,9
1713346449758,COGS 172,A01,489196,Staff,1,0,30,29
1713346450788,COGS 174GS,A01,489264,Pineda; Jaime A,19,0,28,9
1713346451814,COGS 180,A01,627150,Staff,28,0,30,2
1713346452842,COGS 186,A01,489274,Staff,0,3,30,30
1713346453869,COMM 10,A01,489276,Staff,23,0,25,2
1713346453869,COMM 10,A02,489303,Staff,23,0,25,2
1713346454896,COMM 100A,A01,489312,Staff,14,0,25,11
1713346454896,COMM 100A,A02,489313,Staff,24,0,25,1
1713346455921,COMM 106T,A00,512540,Staff,33,0,35,2
1713346456946,COMM 107,A00,489347,Staff,27,0,35,8
1713346457972,COMM 109P,A00,489358,Staff,31,0,35,4
1713346458999,COMM 132,A00,489361,McKenna; Denise,27,0,30,3
1713346460033,COMM 146,A00,489362,Halm; Gavin Patrick,26,0,30,4
1713346461063,COMM 190,A00,489363,Abuelhiga; Soraya Jill,17,0,23,6
1713346462100,CSE 8A,A50,489366,Staff,21,0,25,4
1713346462100,CSE 8A,A51,489367,Staff,24,0,25,1
1713346463126,CSE 11,A01,489398,Cao; Yingjun,72,0,100,28
1713346464152,CSE 12,A01,489487,Staff,43,0,50,7
1713346465177,CSE 20,A01,489497,Staff,47,0,50,3
1713346466203,CSE 21,A01,489517,Braun; Oliver,42,0,50,8
1713346467229,CSE 101,A01,489524,Braun; Oliver,0,35,50,50
1713346468269,CSE 105,A01,512594,Jones; Miles E,72,0,100,28
1713346468269,CSE 105,B01,512598,Jones; Miles E,51,0,100,49
1713346469299,CSE 140,A01,489538,Staff,39,0,50,11
1713346470324,CSE 141,A01,489550,Eldon; John,67,0,100,33
1713346471350,CSE 141L,A01,489571,Eldon; John,65,0,100,35
1713346472376,CSE 151A,A01,489583,Solares; Edwin A,139,0,200,61
1713346473413,CSE 175,A01,510886,Kumar; Rakesh,30,0,30,0
1713346474438,CSE 190,A00,516828,Dubnov; Shlomo,37,0,49,12
1713346475471,DOC 100D,A00,489667,Pass; Natalye Joann,19,0,25,6
1713346476496,DSC 10,A01,624268,Staff,72,0,75,3
1713346477520,DSC 20,A01,624476,Staff,50,0,50,0
1713346478544,DSC 40A,A01,624608,Staff,39,0,40,1
1713346479571,DSGN 1,A01,489179,Rill; Bryan,32,0,50,18
1713346480606,ECE 17,A01,490489,Sahay; Rajeev,18,0,30,12
1713346481632,ECE 65,A50,490492,Staff,11,0,20,9
1713346481632,ECE 65,A51,490493,Staff,18,0,20,2
1713346482664,ECON 1,A01,489715,Famulari; Melissa,67,0,70,3
1713346483692,ECON 2,A01,489717,Levkoff; Steven B.,67,0,70,3
1713346484720,ECON 3,A01,489948,Staff,70,0,70,0
1713346486777,ECON 5,A01,490103,Staff,27,0,30,3
1713346486777,ECON 5,B01,626281,Dai; Yinlin,45,0,45,0
1713346487801,ECON 100A,A01,490127,Famulari; Melissa,62,0,70,8
1713346488829,ECON 100B,A01,490129,Staff,64,0,70,6
1713346489856,ECON 109,A01,490187,Shishkin; Denis,27,0,35,8
1713346490881,ECON 110A,A01,490190,Levkoff; Steven B.,59,0,70,11
1713346491908,ECON 120A,A01,490245,Dai; Yinlin,59,0,70,11
1713346492937,ECON 120B,A01,490247,Nieto-Barthaburu; Augusto,40,0,70,30
1713346493964,ECON 120C,A01,490253,Sun; Yixiao,30,0,35,5
1713346493964,ECON 120C,B01,490255,Sun; Yixiao,34,0,35,1
1713346494991,ECON 129,A00,490256,Eckert; Fabian Paul,22,0,35,13
1713346496023,ECON 131,A00,490257,Nieto-Barthaburu; Augusto,0,6,35,35
1713346497051,ECON 138,A00,490258,Bharadwaj; Prashant,13,0,35,22
1713346497051,ECON 138,B00,490259,Bharadwaj; Prashant,15,0,35,20
1713346498076,ECON 159,A00,490260,Hendrickson; Gerald M.,0,9,0,0
1713346499104,ECON 178,A01,553995,Zhu; Ying,24,0,35,11
1713346500131,EDS 40,A01,512576,Black; Alison Michelle,20,0,20,0
1713346501156,EDS 107,A01,515848,Staff,30,0,30,0
1713346502186,EDS 110R,A01,490262,Staff,26,0,30,4
1713346503213,EDS 112,A01,490264,Chapman; Thandeka K,40,0,50,10
1713346504239,EDS 113,A00,490266,Staff,25,0,30,5
1713346505267,EDS 118,A00,490267,Warstadt; Melissa Fawn,18,0,30,12
1713346506296,EDS 124BR,A00,490268,Eguchi; Emi,4,0,25,21
1713346506296,EDS 124BR,B00,490269,Eguchi; Emi,23,0,25,2
1713346507329,EDS 126,A01,490271,Jones; Makeba,43,0,50,7
1713346508360,EDS 135,A01,490316,Staff,19,0,20,1
1713346509384,ENVR 142GS,A00,519514,Chang; Edmond Yi-Teh,26,0,28,2
1713346510420,ETHN 103,A00,490504,Staff,24,0,36,12
1713346511451,ETHN 103A,A00,490505,Man; Simeon S,3,0,9,6
1713346512479,ETHN 109,A00,490506,Staff,28,0,30,2
1713346513503,ETHN 118,A00,490507,Staff,35,0,36,1
1713346514533,ETHN 119,A00,490508,Staff,32,0,36,4
1713346515558,ETHN 121R,A00,490518,Choi; Esther Min,21,0,36,15
1713346516583,ETHN 127,A00,490528,Staff,14,0,15,1
1713346517608,ETHN 139,A00,490573,Staff,10,0,10,0
1713346518637,ETHN 150,A00,490575,Staff,15,0,15,0
1713346519668,GLBH 20,A00,491705,Elwardani; Nile Regina,38,0,40,2
1713346520696,GLBH 101,A00,491706,Staff,20,0,20,0
1713346521722,GLBH 111,A01,491708,Burgos; Jose L.,15,0,15,0
1713346522747,GLBH 146,A00,491709,Staff,8,0,20,12
1713346523778,GLBH 148,A00,491710,Olivas Hernandez; Olga Lid,10,0,20,10
1713346524807,GLBH 150,A00,491711,Sloane; Julia Kathryn,19,0,20,1
1713346525831,HIEA 131,A00,491760,Staff,28,0,32,4
1713346526857,HIEA 153,A00,491762,Staff,28,0,30,2
1713346527885,HIEU 124,A00,491811,Staff,26,0,32,6
1713346528910,HIEU 124GS,A00,491812,Markman; Kristina,27,0,28,1
1713346529934,HIEU 147,A00,491813,Staff,30,0,32,2
1713346530960,HIEU 149GS,A00,491816,Caldwell; Michael Alan,28,0,28,0
1713346531991,HILD 2C,A01,491713,Hendrickson; Gerald M.,26,0,30,4
1713346533020,HILD 7B,A01,491715,Kwak; Nancy,0,3,30,30
1713346534048,HILD 10,A01,491717,Staff,9,0,20,11
1713346535074,HILD 30GS,A00,491719,Edington; Claire Ellen,23,0,28,5
1713346536103,HINE 109,A00,491818,Shafir; Nir,26,0,32,6
1713346537131,HINE 128,A00,491821,Shafir; Nir,30,0,32,2
1713346538162,HISC 117,A00,491830,Staff,27,0,32,5
1713346539186,HIUS 103,A00,491834,Man; Simeon S,14,0,23,9
1713346540215,HIUS 108B,A00,491835,Staff,27,0,30,3
1713346541248,HIUS 141,A00,491836,Hendrickson; Gerald M.,28,0,32,4
1713346542281,HIUS 149,A00,491839,Staff,24,0,32,8
1713346543316,HUM 3,A01,512617,Crum; Matthew Stephen,42,0,50,8
1713346543316,HUM 3,A02,512618,Crum; Matthew Stephen,48,0,50,2
1713346544345,HUM 3GS,A00,512663,Markman; Kristina,0,0,0,1
1713346544345,HUM 3GS,B00,512664,Staff,0,0,0,0
1713346545431,HUM 4,A01,512620,West; Geoffrey Scott,23,0,50,27
1713346546459,HUM 4GS,A00,512666,Lyon; Antony J.,0,0,0,5
1713346547490,HUM 4R,A01,512625,Watkins; Eric,49,0,50,1
1713346548515,HUM 5,A01,512649,Zavodny; Tatiana Sophia,20,0,50,30
1713346548515,HUM 5,B01,512661,Zroka; Ryan Edward,48,0,50,2
1713346549547,INTL 190,A00,490577,Segui; Alan S,0,0,0,5
1713346550581,JAPN 20AR,A01,491267,Ross; Kayoko F,7,0,20,13
1713346551609,JAPN 180,A00,491285,Berman; Michael David,33,0,40,7
1713346552638,LATI 50,A01,502536,Kokinis; Troy Andreas,16,0,22,6
1713346552638,LATI 50,A02,502551,Kokinis; Troy Andreas,22,0,22,0
1713346552638,LATI 50,A03,502650,Kokinis; Troy Andreas,22,0,22,0
1713346552638,LATI 50,A04,502909,Kokinis; Troy Andreas,21,0,22,1
1713346553665,LATI 160,A01,502920,Kokinis; Troy Andreas,30,0,30,0
1713346554696,LIFR 1A,A00,490494,Van Moer; Vinciane G,17,0,20,3
1713346555722,LIFR 1AX,A00,490495,Van Moer; Vinciane G,17,0,20,3
1713346556749,LIFR 1B,A00,490496,Van Moer; Vinciane G,17,0,20,3
1713346557779,LIFR 1BX,A00,490497,Van Moer; Vinciane G,17,0,20,3
1713346558809,LIGN 8,A00,505198,McIntosh; Justin Daniel,134,0,150,16
1713346559834,LIGN 9GS,A00,491239,Lott; Margaret S.,18,0,20,2
1713346560860,LIGN 101,A01,505200,McIntosh; Justin Daniel,22,0,30,8
1713346561888,LIGN 120,A01,491244,Staff,22,0,30,8
1713346562914,LIGN 149GS,A00,491245,Lott; Margaret S.,18,0,20,2
1713346563940,LIGN 170,A00,491247,Staff,22,0,30,8
1713346564966,LISP 1D,A00,490498,Munoz Sanchez; Alicia,8,0,14,6
1713346564966,LISP 1D,B00,490499,Munoz Sanchez; Alicia,4,0,14,10
1713346564966,LISP 1D,C00,490500,Munoz Sanchez; Alicia,7,0,14,7
1713346564966,LISP 1D,D00,490501,Munoz Sanchez; Alicia,10,0,14,4
1713346565998,LISP 1DX,A00,490502,Munoz Sanchez; Alicia,11,0,28,17
1713346565998,LISP 1DX,B00,490503,Munoz Sanchez; Alicia,16,0,28,12
1713346568050,LTAM 110,A00,491847,Staff,22,0,25,3
1713346569079,LTCS 119,A00,491848,Staff,11,0,15,4
1713346570105,LTCS 130,A00,491849,Staff,24,0,25,1
1713346572159,LTEA 120C,A00,491852,Staff,32,0,40,8
1713346573186,LTEN 130GS,A00,491853,Lyon; Antony J.,23,0,28,5
1713346574211,LTEN 148,A00,491855,Staff,23,0,25,2
1713346575237,LTEN 159,A00,491856,Staff,20,0,25,5
1713346576267,LTEN 180,A00,491857,Staff,8,0,15,7
1713346578319,LTSP 123GS,A00,505928,Bessett; Ryan Matthew,24,0,28,4
1713346579345,LTSP 174GS,A00,506037,Bessett; Ryan Matthew,24,0,28,4
1713346581400,LTWR 102,A00,491861,Staff,9,0,15,6
1713346582426,LTWR 106,A00,491862,Staff,8,0,15,7
1713346583459,MAE 11,A00,490930,Bahadori; Mohammad Yousef,94,0,100,6
1713346584487,MAE 30A,A00,490931,Qi; Huihui,37,0,40,3
1713346585514,MAE 101A,A00,491036,Sadeghizadeh; Zahra,91,0,100,9
1713346586544,MAE 101C,A00,491037,Seshadri; Kalyanasundaram,63,0,100,37
1713346587570,MAE 113,A00,491040,Seshadri; Kalyanasundaram,64,0,80,16
1713346588596,MAE 131A,A00,491041,Ghazinejad; Maziar,37,0,40,3
1713346589622,MAE 142,A00,491053,Staff,39,0,40,1
1713346590652,MAE 143A,A00,491054,Staff,29,0,50,21
1713346591680,MAE 150,A00,491092,Truong; Phuong Thi Ngoc,23,0,35,12
1713346592709,MATH 3C,A01,494031,Pardo Guerra; Sebastian,30,0,30,0
1713346592709,MATH 3C,A02,494032,Pardo Guerra; Sebastian,29,0,30,1
1713346593743,MATH 10A,A01,494034,Staff,27,0,30,3
1713346593743,MATH 10A,A02,494035,Staff,28,0,30,2
1713346593743,MATH 10A,B01,494037,Staff,27,0,30,3
1713346593743,MATH 10A,B02,494038,Staff,29,0,30,1
1713346594783,MATH 10B,A01,494040,Habib; Yousaf,22,0,30,8
1713346594783,MATH 10B,A02,494041,Habib; Yousaf,28,0,30,2
1713346594783,MATH 10B,A03,494042,Habib; Yousaf,29,0,30,1
1713346594783,MATH 10B,A04,494043,Habib; Yousaf,30,0,30,0
1713346594783,MATH 10B,B01,494045,Habib; Yousaf,25,0,30,5
1713346594783,MATH 10B,B02,494046,Habib; Yousaf,30,0,30,0
1713346594783,MATH 10B,B03,494047,Habib; Yousaf,30,0,30,0
1713346594783,MATH 10B,B04,494048,Habib; Yousaf,30,0,30,0
1713346595816,MATH 18,A01,494050,Kemp; Todd Aahron,25,0,30,5
1713346595816,MATH 18,A02,494051,Kemp; Todd Aahron,29,0,30,1
1713346595816,MATH 18,B01,494054,Kemp; Todd Aahron,25,0,30,5
1713346595816,MATH 18,B02,494055,Kemp; Todd Aahron,29,0,30,1
1713346596843,MATH 20A,A01,494059,Suk; Andrew Hoon,30,0,30,0
1713346597874,MATH 20B,A01,494061,Briones; Jor-el Thomas Caparas,33,0,35,2
1713346597874,MATH 20B,B01,494063,Bach; Quang Tran,34,0,35,1
1713346598901,MATH 20C,A01,494065,Staff,28,0,30,2
1713346598901,MATH 20C,A02,494066,Staff,30,0,30,0
1713346598901,MATH 20C,A03,494067,Staff,30,0,30,0
1713346598901,MATH 20C,A04,494068,Staff,30,0,30,0
1713346598901,MATH 20C,B01,494070,Zhang; Ming,23,0,30,7
1713346598901,MATH 20C,B02,494071,Zhang; Ming,27,0,30,3
1713346598901,MATH 20C,B03,494072,Zhang; Ming,29,0,30,1
1713346598901,MATH 20C,B04,494073,Zhang; Ming,29,0,30,1
1713346599932,MATH 20D,A01,494075,Staff,22,0,30,8
1713346599932,MATH 20D,A02,494076,Staff,29,0,30,1
1713346600960,MATH 20E,A01,494079,Staff,24,0,30,6
1713346600960,MATH 20E,A02,494080,Staff,26,0,30,4
1713346600960,MATH 20E,B01,494082,Staff,25,0,30,5
1713346600960,MATH 20E,B02,494083,Staff,25,0,30,5
1713346601991,MATH 103A,A01,494085,Aliabadi Sr.; Mohsen,12,0,30,18
1713346601991,MATH 103A,A02,494086,Aliabadi Sr.; Mohsen,28,0,30,2
1713346601991,MATH 103A,B01,494088,Aliabadi Sr.; Mohsen,20,0,30,10
1713346601991,MATH 103A,B02,494089,Aliabadi Sr.; Mohsen,27,0,30,3
1713346603019,MATH 109,A01,494091,Staff,30,0,30,0
1713346603019,MATH 109,A02,494092,Staff,29,0,30,1
1713346603019,MATH 109,B01,494094,Staff,27,0,30,3
1713346603019,MATH 109,B02,494095,Staff,29,0,30,1
1713346604048,MATH 142A,A01,494097,Chow; Bennett,13,0,30,17
1713346604048,MATH 142A,A02,494098,Chow; Bennett,23,0,30,7
1713346604048,MATH 142A,B01,494100,Chow; Bennett,19,0,30,11
1713346604048,MATH 142A,B02,494101,Chow; Bennett,29,0,30,1
1713346606102,MATH 168A,A01,516677,Dumitriu; Ioana,16,0,35,19
1713346607126,MATH 170A,A01,516679,Dumitriu; Ioana,18,0,30,12
1713346607126,MATH 170A,A02,516680,Dumitriu; Ioana,28,0,30,2
1713346608154,MATH 193A,A01,494107,Staff,12,0,30,18
1713346608154,MATH 193A,A02,494108,Staff,18,0,30,12
1713346608154,MATH 193A,A03,494109,Staff,29,0,30,1
1713346608154,MATH 193A,A04,494110,Staff,22,0,30,8
1713346611236,MGT 16,A00,491930,McKay; Michael J,92,0,98,6
1713346612261,MGT 18,A00,491992,McKay; Michael J,96,0,98,2
1713346613286,MGT 71,A00,492003,Staff,63,0,98,35
1713346614320,MGT 103,A00,505209,Eberhard; Craig A,80,0,98,18
1713346615347,MGT 131A,A00,505210,Anderson; John Charles,89,0,98,9
1713346617401,MGT 153,A00,492077,Perols; Johan Lars,15,0,90,75
1713346620483,MGT 164,A00,492222,McKay; Mary A,91,0,98,7
1713346621513,MGT 172,A00,492245,Staff,59,0,60,1
1713346621513,MGT 172,B00,505526,Hedges; Kathleen,65,0,98,33
1713346622543,MGT 181,A00,505669,Dunn; Louis Jean,78,0,98,20
1713346623572,MMW 14,A01,494399,Staff,15,0,28,13
1713346623572,MMW 14,A02,494400,Staff,25,0,28,3
1713346623572,MMW 14,A03,494401,Staff,28,0,28,0
1713346623572,MMW 14,A04,494402,Staff,28,0,28,0
1713346623572,MMW 14,B01,494404,Carreras; Maria Victoria,8,0,28,20
1713346623572,MMW 14,B02,494405,Carreras; Maria Victoria,25,0,28,3
1713346623572,MMW 14,B03,494406,Carreras; Maria Victoria,27,0,28,1
1713346623572,MMW 14,B04,494407,Carreras; Maria Victoria,28,0,28,0
1713346624604,MMW 14GS,A00,506250,Chang; Edmond Yi-Teh,0,0,0,0
1713346625633,MMW 121R,A01,494415,Adamiak; Patrick John,10,0,28,18
1713346625633,MMW 121R,A02,494416,Adamiak; Patrick John,24,0,28,4
1713346626661,MUS 1A,A01,494113,Staff,12,0,25,13
1713346626661,MUS 1A,A02,494114,Staff,24,0,25,1
1713346627686,MUS 4,A01,494116,Staff,23,0,25,2
1713346627686,MUS 4,A02,494117,Staff,22,0,25,3
1713346628712,MUS 5R,A01,494236,Dubnov; Shlomo,4,0,25,21
1713346628712,MUS 5R,A02,494237,Dubnov; Shlomo,25,0,25,0
1713346629742,MUS 6,A01,494122,Staff,9,0,25,16
1713346629742,MUS 6,A02,494123,Staff,23,0,25,2
1713346630768,MUS 7,A01,494125,Staff,16,0,25,9
1713346630768,MUS 7,A02,494126,Staff,24,0,25,1
1713346631797,MUS 11,A01,494128,Staff,23,0,25,2
1713346631797,MUS 11,A02,494129,Staff,24,0,25,1
1713346632824,MUS 13,A01,494131,Staff,25,0,25,0
1713346632824,MUS 13,A02,494132,Staff,25,0,25,0
1713346633849,MUS 15,A01,494134,Staff,16,0,25,9
1713346633849,MUS 15,A02,494135,Staff,25,0,25,0
1713346633849,MUS 15,B01,494137,Staff,24,0,25,1
1713346634884,MUS 80,A00,494232,Staff,24,0,25,1
1713346634884,MUS 80,B00,494233,Staff,25,0,25,0
1713346634884,MUS 80,C00,494234,Staff,23,0,25,2
1713346635914,MUS 95C,A00,494141,Staff,69,0,75,6
1713346636938,MUS 114,A00,494142,Staff,39,0,50,11
1713346637971,NANO 15,A01,490636,Drews; Aaron,7,0,7,0
1713346639005,PHIL 1,A00,490578,Grush; Rick Scott,49,0,50,1
1713346640031,PHIL 10,A01,490580,Grush; Rick Scott,33,0,35,2
1713346640031,PHIL 10,A02,490586,Grush; Rick Scott,32,0,35,3
1713346641061,PHIL 27,A01,490591,Staff,22,0,25,3
1713346641061,PHIL 27,A02,490592,Staff,25,0,25,0
1713346641061,PHIL 27,A03,490593,Staff,25,0,25,0
1713346641061,PHIL 27,A04,490598,Staff,25,0,25,0
1713346642089,PHIL 32,A01,490611,Staff,20,0,20,0
1713346642089,PHIL 32,A02,490618,Staff,20,0,20,0
1713346643118,PHIL 90,A00,490624,Staff,40,0,40,0
1713346644144,PHIL 136,A00,490627,Cohen; Jonathan David,37,0,40,3
1713346645170,PHIL 155,A00,490634,Staff,61,0,70,9
1713346646197,PHYS 1A,A00,491610,Staff,245,0,250,5
1713346647228,PHYS 1AL,001,491616,Tsai; Philbert S,27,0,30,3
1713346647228,PHYS 1AL,002,491618,Tsai; Philbert S,30,0,30,0
1713346648258,PHYS 1B,A00,491623,Staff,235,0,250,15
1713346649344,PHYS 1BL,001,491626,Tsai; Philbert S,18,0,30,12
1713346649344,PHYS 1BL,002,491628,Tsai; Philbert S,26,0,30,4
1713346650368,PHYS 1C,A00,491632,Staff,211,0,245,34
1713346651394,PHYS 1CL,001,491635,Tsai; Philbert S,2,0,30,28
1713346651394,PHYS 1CL,002,491643,Tsai; Philbert S,22,0,30,8
1713346652421,PHYS 2AR,A01,491651,Meyertholen; Andrew D.,44,0,50,6
1713346653449,PHYS 2B,A01,491659,Staff,105,0,115,10
1713346654476,PHYS 2BL,A01,491685,Staff,21,0,24,3
1713346654476,PHYS 2BL,A02,491700,Staff,21,0,24,3
1713346655503,PHYS 2C,A01,505161,Staff,101,0,115,14
1713346656533,PHYS 4A,A01,491704,Grinstein; Benjamin,99,0,100,1
1713346657562,POLI 5D,A01,494144,Staff,3,0,5,2
1713346657562,POLI 5D,B01,626283,Dai; Yinlin,5,0,5,0
1713346658587,POLI 12,A00,494145,Staff,43,0,45,2
1713346659613,POLI 13R,A00,494146,Forman; Fonna,45,0,50,5
1713346660639,POLI 27,A01,494148,Staff,54,0,60,6
1713346661671,POLI 30,A00,494149,Staff,49,0,50,1
1713346662698,POLI 100DA,A00,494150,Staff,20,0,25,5
1713346664750,POLI 100I,A00,494152,Staff,27,0,30,3
1713346665781,POLI 104B,A00,494153,Smith; Glenn Chatmas,53,0,55,2
1713346666810,POLI 104F,A00,494154,Staff,28,0,30,2
1713346667835,POLI 104I,A00,494155,Smith; Glenn Chatmas,29,0,30,1
1713346668866,POLI 110C,A00,494156,Ingham; Sean,23,0,25,2
1713346669891,POLI 117R,A00,494157,Forman; Fonna,5,0,20,15
1713346670917,POLI 118,A00,494158,Ingham; Sean,21,0,25,4
1713346671946,POLI 120H,A00,494159,Fisk; David Lee,39,0,45,6
1713346672971,POLI 131CR,A00,494160,Hoston; Germaine,35,0,45,10
1713346674001,POLI 133J,A00,494161,Staff,31,0,35,4
1713346675028,POLI 135,A00,494162,Fisk; David Lee,33,0,35,2
1713346676058,POLI 140A,A00,494164,Staff,18,0,30,12
1713346677086,POLI 142I,A00,494165,Staff,30,0,30,0
1713346678111,POLI 144D,A00,494166,Staff,22,0,25,3
1713346679137,POLI 151,A00,494167,Staff,30,0,30,0
1713346680162,POLI 153,A00,494168,Staff,33,0,35,2
1713346681191,POLI 160AA,A00,494169,Staff,33,0,40,7
1713346682217,POLI 162,A00,494170,Mignozzetti; Umberto,17,0,25,8
1713346683243,POLI 171,A00,494171,Mignozzetti; Umberto,18,0,25,7
1713346684270,PSYC 1,A00,494172,Staff,95,0,100,5
1713346685298,PSYC 2,A00,494173,Moranton; Nirelia Melbina-,33,0,50,17
1713346686325,PSYC 3,A00,494174,Staff,29,0,30,1
1713346687350,PSYC 6,A00,494175,Staff,17,0,20,3
1713346688391,PSYC 60,A01,494177,Staff,37,0,45,8
1713346689421,PSYC 70,A01,505724,Geller; Emma Harlan,42,0,45,3
1713346690448,PSYC 101,A00,494180,Heyman; Gail D.,83,0,100,17
1713346691472,PSYC 105,A00,494181,Geller; Emma Harlan,51,0,90,39
1713346692500,PSYC 106,A00,494182,Dobkins; Karen R.,26,0,45,19
1713346693525,PSYC 108,A00,494183,Adrian; Julia Anna,89,0,100,11
1713346694555,PSYC 114,A01,494185,Winkielman; Piotr,0,4,30,30
1713346695585,PSYC 122,A00,494186,Moranton; Nirelia Melbina-,27,0,50,23
1713346696616,PSYC 124,A00,494187,Chapman; Eddie Nathaniel,69,0,80,11
1713346697643,PSYC 131,A00,494188,Anagnostaras; Stephan,39,0,80,41
1713346698668,PSYC 144,A00,494189,Staff,1,1,50,49
1713346699695,PSYC 154,A00,494190,Lacefield; Katharine I,105,0,180,75
1713346700725,PSYC 162,A00,494191,Wixted; John T,70,0,100,30
1713346701755,PSYC 172,A00,494192,Gorman; Michael R.,36,0,45,9
1713346702780,PSYC 178,A00,494193,Glaser; Dale,32,0,45,13
1713346703806,PSYC 193,A00,505725,Chapman; Eddie Nathaniel,20,0,20,0
1713346704836,RELI 145GS,A00,519817,Rahimi; Babak,17,0,20,3
1713346705866,SE 101A,A01,490862,Chadha; Mayank,23,0,25,2
1713346706897,SE 101C,A01,490924,Krysl; Petr,15,0,20,5
1713346707923,SE 110A,A01,490928,Staff,19,0,20,1
1713346708957,SE 130A,A00,490929,Morrison; Machel Leigh,54,0,70,16
1713346709995,SIO 1,A01,519325,Staff,39,0,40,1
1713346711019,SIO 30,A01,519327,Staff,38,0,40,2
1713346712044,SIO 40,A00,519328,Staff,39,0,40,1
1713346713073,SIO 46GS,A00,519819,Cook; Geoffrey W,15,0,25,10
1713346714099,SIO 109R,A00,494197,Forman; Fonna,0,3,20,20
1713346715127,SIO 121GS,A00,519827,Cook; Geoffrey W,15,0,25,10
1713346716156,SIO 132,A01,519330,Staff,38,0,40,2
1713346717187,SIO 133,A01,519397,Staff,37,0,40,3
1713346718214,SIO 139,A00,519396,Kacev; David,29,0,40,11
1713346719239,SOCI 1,A01,494199,Thorpe; Charles Robert,21,0,30,9
1713346719239,SOCI 1,A02,494200,Thorpe; Charles Robert,30,0,30,0
1713346719239,SOCI 1,A03,494201,Thorpe; Charles Robert,29,0,30,1
1713346719239,SOCI 1,A04,494202,Thorpe; Charles Robert,29,0,30,1
1713346719239,SOCI 1,A05,494203,Thorpe; Charles Robert,29,0,30,1
1713346719239,SOCI 1,A06,494204,Thorpe; Charles Robert,30,0,30,0
1713346719239,SOCI 1,A07,494205,Thorpe; Charles Robert,28,0,30,2
1713346720264,SOCI 60,A01,494207,Staff,33,0,40,7
1713346720264,SOCI 60,A02,494208,Staff,39,0,40,1
1713346721288,SOCI 100,A01,494210,Payne; Christine Anna,25,0,30,5
1713346721288,SOCI 100,A02,494211,Payne; Christine Anna,26,0,30,4
1713346722317,SOCI 109M,A00,494212,Staff,20,0,20,0
1713346723342,SOCI 110,A00,494213,Staff,34,0,40,6
1713346725393,SOCI 118E,A00,494215,Ng; Kwai,37,0,40,3
1713346726423,SOCI 125,A00,494216,Calderon-Zaks; Michael Aar,39,0,45,6
1713346727451,SOCI 126,A01,494218,Jones; Makeba,3,0,5,2
1713346728476,SOCI 131,A00,494219,Thorpe; Charles Robert,26,0,30,4
1713346730532,SOCI 135,A00,494221,Payne; Christine Anna,28,0,50,22
1713346731560,SOCI 136E,A00,626690,Ruiz; Jonathan Joseph,24,0,25,1
1713346732590,SOCI 138GS,A00,494222,Navon; Daniel,23,0,28,5
1713346734641,SOCI 145,A00,494224,Staff,40,0,45,5
1713346735667,SOCI 153,A00,494225,Staff,28,0,30,2
1713346736694,SOCI 160E,A00,494226,Ng; Kwai,27,0,40,13
1713346737725,SOCI 180,A00,494227,Staff,29,0,30,1
1713346738750,SOCI 189GS,A00,494228,Ribas Norris; Janet Vanesa,11,0,11,0
1713346739776,SOCI 190GS,A00,553232,Ribas Norris; Janet Vanesa,11,0,11,0
1713346740809,SOMI 220,A00,627178,Schneid; Stephen David,30,0,30,0
1713346741841,SYN 2,001,490768,Staff,13,0,15,2
1713346741841,SYN 2,002,490769,Staff,14,0,15,1
1713346741841,SYN 2,004,490775,Staff,0,0,0,0
1713346741841,SYN 2,003,490774,Staff,0,0,0,0
1713346741841,SYN 2,005,490776,Staff,0,0,0,0
1713346742867,SYN 2R,001,490779,Staff,10,0,15,5
1713346742867,SYN 2R,002,514635,Staff,14,0,15,1
1713346743897,SYN 100,A01,490783,Staff,8,0,20,12
1713346743897,SYN 100,B01,490787,Staff,10,0,20,10
1713346743897,SYN 100,C01,490789,Staff,10,0,20,10
1713346744923,SYN 150,A00,490817,Staff,14,0,15,1
1713346744923,SYN 150,B00,514610,Staff,15,0,15,0
1713346745959,TDAC 1,A00,492753,Walsh; Kim C.,19,0,20,1
1713346745959,TDAC 1,B00,492754,Harting; Carla Kelso,18,0,20,2
1713346745959,TDAC 1,C00,513995,Salovey; Todd,15,0,20,5
1713346746989,TDAC 101,A00,492766,Harting; Carla Kelso,17,0,20,3
1713346748022,TDAC 102,A00,492768,Basso; Beatrice,19,0,20,1
1713346749046,TDDE 111,A00,492769,Staff,25,0,25,0
1713346750074,TDDE 131,A00,492770,Staff,15,0,15,0
1713346750074,TDDE 131,B00,492771,Staff,15,0,15,0
1713346751103,TDDE 131GS,A00,523716,Guirguis; Mark C,23,0,28,5
1713346752132,TDGE 1,A01,492756,Salovey; Todd,56,0,60,4
1713346753222,TDGE 5,A01,492758,Staff,23,0,25,2
1713346754248,TDGE 10,A00,492759,Fulton; Julia,203,0,220,17
1713346755274,TDGE 11,A00,492760,Castro; Robert Jess,198,0,200,2
1713346757323,TDGE 124,A00,492772,Fulton; Julia,180,0,220,40
1713346758357,TDGE 125,A00,492773,Meyer; Ursula,38,0,50,12
1713346758357,TDGE 125,B00,492774,Staff,49,0,50,1
1713346758357,TDGE 125,C00,523565,Staff,48,0,50,2
1713346759379,TDGE 125GS,A00,523580,Guirguis; Mark C,23,0,28,5
1713346760409,TDGE 127,A00,492775,Havis; Allan,33,0,50,17
1713346761441,TDHT 101,A00,492776,Staff,34,0,35,1
1713346762474,TDMV 1,A00,492762,Caligagan; Maria T.,29,0,30,1
1713346762474,TDMV 1,B00,492763,Arcidiacono; Kristin,26,0,30,4
1713346763503,TDMV 2,A00,492764,Weinberg; Sadie,27,0,30,3
1713346764533,TDMV 3,A00,492765,Mack; Kara Shanai',37,0,40,3
1713346765559,TDMV 138,A00,492777,Mack; Kara Shanai',32,0,40,8
1713346766591,TDMV 140,A00,492778,Lima; Paulo Henrique,40,0,40,0
1713346767619,TDMV 142,A00,492779,Caligagan; Maria T.,33,0,40,7
1713346767619,TDMV 142,B00,492780,Caligagan; Tony,37,0,40,3
1713346768650,TDMV 143,A00,492781,Fyall; Daunte Edward,39,0,40,1
1713346769739,USP 1,A01,492401,Kwak; Nancy,27,0,35,8
1713346770770,USP 2,A01,492453,Hinds; Juli Beth,35,0,35,0
1713346771796,USP 3,A01,492516,Staff,28,0,35,7
1713346772826,USP 4,A00,492522,McTague; Sarah,16,0,25,9
1713346773850,USP 100,A00,492523,Staff,32,0,35,3
1713346774874,USP 101,A00,492524,Staff,13,0,15,2
1713346775902,USP 105,A00,492525,Staff,21,0,25,4
1713346776927,USP 151,A00,492526,Shenkman; Michael Thomas,32,0,35,3
1713346777955,USP 170,A00,492545,Hinds; Juli Beth,32,0,35,3
1713346778987,USP 171GS,A00,492608,Bussell; Mirle Rabinowitz,24,0,28,4
1713346780018,USP 183GS,A00,492613,Peerson; Susan,24,0,28,4
1713346781054,VIS 30,A01,490693,Yoldas; Pinar,19,0,22,3
1713346781054,VIS 30,A02,490694,Yoldas; Pinar,18,0,22,4
1713346782079,VIS 83,A00,490695,Kester; Grant,63,0,75,12
1713346783104,VIS 105D,A00,490696,Staff,22,0,25,3
1713346784134,VIS 124CN,A00,490699,Rose; Jordan M,64,0,75,11
1713346785166,VIS 125GS,A00,511221,Williams; Alena J,21,0,22,1
1713346786192,VIS 128D,A00,490700,Staff,73,0,75,2
1713346787219,VIS 151,A01,490717,Staff,33,0,34,1
1713346787219,VIS 151,A02,490766,Staff,32,0,34,2
1713346788249,VIS 154GS,A00,511972,Williams; Alena J,21,0,22,1
1713346789280,VIS 160A,A00,490767,Stone; Patricia,7,0,10,3
1713346790311,WCWP 10A,A00,490638,Staff,14,0,15,1
1713346790311,WCWP 10A,B00,490640,Staff,15,0,15,0
1713346791341,WCWP 10B,A00,490641,Staff,0,0,0,0
1713346791341,WCWP 10B,B00,490642,Staff,14,0,15,1
1713346791341,WCWP 10B,C00,490644,Staff,13,0,15,2
1713346791341,WCWP 10B,D00,490647,Staff,0,0,0,0
1713346792371,WCWP 100,A00,490655,Staff,0,0,0,0
1713346792371,WCWP 100,B00,490687,Staff,10,0,15,5
1713346794531,ANAR 153,A00,487222,Braswell; Geoffrey E.,53,0,60,7
1713346795556,ANBI 134,A00,487223,Staff,5,0,20,15
1713346796583,ANBI 143GS,A00,487224,Noel; Geoffroy Pierre Jean,18,0,24,6
1713346797611,ANBI 144GS,A00,519548,Noel; Geoffroy Pierre Jean,18,0,24,6
1713346798643,ANSC 101,A00,487225,Staff,17,0,20,3
1713346799674,ANSC 125,A00,487227,Brenner; Suzanne A,38,0,40,2
1713346801729,ANSC 146,A00,487229,Staff,35,0,40,5
1713346802758,ANSC 148,A00,487230,Olivas Hernandez; Olga Lid,39,0,40,1
1713346803796,ANSC 150,A00,504165,Sloane; Julia Kathryn,18,0,20,2
1713346804821,ANSC 180,A00,487232,Staff,14,0,15,1
1713346805848,ANSC 188,A00,627155,Staff,37,0,40,3
1713346806875,ANTH 5,A00,519529,Semendeferi; Ekaterini,15,0,15,0
1713346807902,ANTH 10,A00,487219,Staff,58,0,60,2
1713346808928,ANTH 23,A01,487221,Staff,17,0,20,3
1713346809962,ANTH 102,A00,487233,Wilder; Linnea Lorene,49,0,60,11
1713346810989,ANTH 103,A00,487234,Varma; Saiba,54,0,60,6
1713346812014,ANTH 105,A00,487235,Stewart; Alexander B,54,0,60,6
1713346813041,BENG 100,A01,516685,Taylor Amos; Alyssa C,25,0,30,5
1713346814082,BIBC 102,A01,491316,Flagg; Matthew Paul,5,0,88,83
1713346814082,BIBC 102,A02,491366,Flagg; Matthew Paul,78,0,88,10
1713346815112,BIBC 103,A01,491486,Boumechache; Miyyada,16,0,24,8
1713346815112,BIBC 103,A02,491487,Boumechache; Miyyada,24,0,24,0
1713346816140,BICD 100,A01,516882,Staff,72,0,75,3
1713346816140,BICD 100,A02,516890,Staff,69,0,75,6
1713346817167,BICD 102GS,A00,491488,Lo; Stanley M.,26,0,28,2
1713346818193,BIEB 136GS,A00,516940,Holway; David A. & Shurin; Jonathan,18,0,24,6
1713346819219,BIEB 137GS,A01,517034,Holway; David A. & Shurin; Jonathan,18,0,24,6
1713346820245,BIEB 138GS,A01,491492,Pirino; Giorgia,21,0,28,7
1713346821275,BILD 1,A01,491296,Staff,60,0,63,3
1713346821275,BILD 1,A02,491297,Staff,63,0,63,0
1713346822302,BILD 4,A01,517099,Gonzalez Gamboa; Ivonne,22,0,24,2
1713346822302,BILD 4,A02,517100,Gonzalez Gamboa; Ivonne,24,0,24,0
1713346823332,BILD 60GS,A00,491309,Lo; Stanley M.,26,0,28,2
1713346824370,BIMM 100,A01,517136,Staff,82,0,100,18
1713346825400,BIMM 110,A01,517182,Staff,52,0,100,48
1713346826427,BIMM 120,A01,517228,Pickett; Brooke Elizabeth,28,0,63,35
1713346826427,BIMM 120,A02,517240,Pickett; Brooke Elizabeth,44,0,63,19
1713346827453,BIMM 132GS,A01,491498,Pirino; Giorgia,21,0,28,7
1713346828484,BIMM 143,A01,491589,Bozinovic; Goran,12,0,40,28
1713346829515,BIPN 100,A01,491594,Armour; Jon Christopher,83,0,100,17
1713346830541,BIPN 140,A01,491602,Marino; Marc J,23,0,50,27
1713346832593,CAT 125,A00,515973,Staff,18,0,20,2
1713346833618,CAT 125GS,A00,515974,Rahimi; Babak,16,0,20,4
1713346834651,CAT 125R,A00,515980,Staff,12,0,20,8
1713346834651,CAT 125R,B00,515981,Tosun; Adriana,19,0,20,1
1713346834651,CAT 125R,C00,515987,Hyland; Tina Mae,0,5,20,20
1713346834651,CAT 125R,D00,515988,Bronstein; Phoebe Malan,16,0,20,4
1713346835678,CENG 15,A01,488699,Drews; Aaron,25,0,25,0
1713346836706,CENG 100,A00,505196,Opatkiewicz; Justin Paul,25,0,25,0
1713346837736,CGS 2A,A01,489598,Staff,32,0,35,3
1713346838765,CGS 112,A00,489599,Staff,15,0,15,0
1713346839796,CGS 119,A00,489603,Staff,10,0,10,0
1713346840824,CGS 120,A00,489604,Staff,13,0,15,2
1713346841850,CGS 150,A00,489607,Staff,15,0,15,0
1713346842882,CHEM 6A,A01,488715,Staff,97,0,100,3
1713346843908,CHEM 6B,A01,488719,Piercy; Marc Anthony,99,0,100,1
1713346844935,CHEM 6C,A01,488723,Albizati; Kim F.,93,0,100,7
1713346845967,CHEM 7L,A01,488728,Schurmeier; Kimberly,18,0,24,6
1713346845967,CHEM 7L,A02,488730,Schurmeier; Kimberly,23,0,24,1
1713346845967,CHEM 7L,A03,488734,Schurmeier; Kimberly,20,0,24,4
1713346845967,CHEM 7L,A04,488763,Schurmeier; Kimberly,23,0,24,1
1713346845967,CHEM 7L,B01,488798,Schurmeier; Kimberly,16,0,24,8
1713346845967,CHEM 7L,B02,488801,Schurmeier; Kimberly,22,0,24,2
1713346845967,CHEM 7L,B03,488808,Schurmeier; Kimberly,22,0,24,2
1713346845967,CHEM 7L,B04,488811,Schurmeier; Kimberly,24,0,24,0
1713346846993,CHEM 11,A01,488897,Stallings; Dontarie M,94,0,100,6
1713346848024,CHEM 40A,A01,488913,Albizati; Kim F.,83,0,100,17
1713346849055,CHEM 40B,A01,488920,Weizman; Haim,42,0,50,8
1713346849055,CHEM 40B,A02,488938,Weizman; Haim,43,0,50,7
1713346850084,CHEM 41A,A01,489029,Klosterman; Jeremy K,57,0,60,3
1713346851117,CHEM 41C,A01,500436,Tor; Yitzhak,54,0,60,6
1713346852156,CHEM 43A,A01,500426,Weizman; Haim,0,1,24,24
1713346852156,CHEM 43A,A02,500430,Weizman; Haim,6,0,24,18
1713346852156,CHEM 43A,B01,514041,Klosterman; Jeremy K,14,0,24,10
1713346852156,CHEM 43A,B02,514047,Klosterman; Jeremy K,23,0,24,1
1713346853184,CHEM 108,A01,489140,Jennings; Patricia A.,6,0,24,18
1713346853184,CHEM 108,A02,489142,Jennings; Patricia A.,14,0,24,10
1713346854209,CHEM 114A,A01,489147,Stallings; Dontarie M,65,0,100,35
1713346855236,CHIN 169A,A00,489171,Wang; Xiao,19,0,20,1
1713346857342,COGS 3,A01,518827,Boyle; Mary E. T.,25,0,40,15
1713346858370,COGS 11,A01,489175,Staff,27,0,30,3
1713346859396,COGS 14A,A01,518829,Staff,50,0,60,10
1713346860424,COGS 14B,A01,489177,Hoffman; Drew Ellen,62,0,75,13
1713346861452,COGS 100,A01,489181,Allen; Michael Gordon,62,0,75,13
1713346862481,COGS 101A,A01,489183,Staff,45,0,60,15
1713346863507,COGS 101B,A01,489185,Allen; Michael Gordon,6,0,30,24
1713346864543,COGS 101C,A01,526786,Staff,23,0,30,7
1713346866813,COGS 107A,A01,489189,Boyle; Mary E. T.,16,0,35,19
1713346867839,COGS 107B,A01,627144,Mooshagian; Eric Frederick,59,0,60,1
1713346868875,COGS 118A,A01,489191,Staff,0,46,40,40
1713346870927,COGS 171GS,A01,489194,Pineda; Jaime A,19,0,28,9
1713346871953,COGS 172,A01,489196,Staff,1,0,30,29
1713346872978,COGS 174GS,A01,489264,Pineda; Jaime A,19,0,28,9
1713346874004,COGS 180,A01,627150,Staff,28,0,30,2
1713346875035,COGS 186,A01,489274,Staff,0,3,30,30
1713346876067,COMM 10,A01,489276,Staff,23,0,25,2
1713346876067,COMM 10,A02,489303,Staff,23,0,25,2
1713346877095,COMM 100A,A01,489312,Staff,14,0,25,11
1713346877095,COMM 100A,A02,489313,Staff,24,0,25,1
1713346878120,COMM 106T,A00,512540,Staff,33,0,35,2
1713346879150,COMM 107,A00,489347,Staff,27,0,35,8
1713346880176,COMM 109P,A00,489358,Staff,31,0,35,4
1713346881205,COMM 132,A00,489361,McKenna; Denise,27,0,30,3
1713346882234,COMM 146,A00,489362,Halm; Gavin Patrick,26,0,30,4
1713346883259,COMM 190,A00,489363,Abuelhiga; Soraya Jill,17,0,23,6
1713346884286,CSE 8A,A50,489366,Staff,21,0,25,4
1713346884286,CSE 8A,A51,489367,Staff,24,0,25,1
1713346885317,CSE 11,A01,489398,Cao; Yingjun,72,0,100,28
1713346886354,CSE 12,A01,489487,Staff,43,0,50,7
1713346887388,CSE 20,A01,489497,Staff,47,0,50,3
1713346888418,CSE 21,A01,489517,Braun; Oliver,42,0,50,8
1713346889449,CSE 101,A01,489524,Braun; Oliver,0,35,50,50
1713346890482,CSE 105,A01,512594,Jones; Miles E,72,0,100,28
1713346890482,CSE 105,B01,512598,Jones; Miles E,51,0,100,49
1713346891507,CSE 140,A01,489538,Staff,39,0,50,11
1713346892539,CSE 141,A01,489550,Eldon; John,67,0,100,33
1713346893568,CSE 141L,A01,489571,Eldon; John,65,0,100,35
1713346894598,CSE 151A,A01,489583,Solares; Edwin A,139,0,200,61
1713346895629,CSE 175,A01,510886,Kumar; Rakesh,30,0,30,0
1713346896656,CSE 190,A00,516828,Dubnov; Shlomo,37,0,49,12
1713346897686,DOC 100D,A00,489667,Pass; Natalye Joann,19,0,25,6
1713346898713,DSC 10,A01,624268,Staff,72,0,75,3
1713346899742,DSC 20,A01,624476,Staff,50,0,50,0
1713346900771,DSC 40A,A01,624608,Staff,39,0,40,1
1713346901798,DSGN 1,A01,489179,Rill; Bryan,32,0,50,18
1713346902824,ECE 17,A01,490489,Sahay; Rajeev,18,0,30,12
1713346903862,ECE 65,A50,490492,Staff,11,0,20,9
1713346903862,ECE 65,A51,490493,Staff,18,0,20,2
1713346904892,ECON 1,A01,489715,Famulari; Melissa,67,0,70,3
1713346905919,ECON 2,A01,489717,Levkoff; Steven B.,67,0,70,3
1713346906946,ECON 3,A01,489948,Staff,70,0,70,0
1713346909011,ECON 5,A01,490103,Staff,27,0,30,3
1713346909011,ECON 5,B01,626281,Dai; Yinlin,45,0,45,0
1713346910044,ECON 100A,A01,490127,Famulari; Melissa,62,0,70,8
1713346911071,ECON 100B,A01,490129,Staff,64,0,70,6
1713346912103,ECON 109,A01,490187,Shishkin; Denis,27,0,35,8
1713346913128,ECON 110A,A01,490190,Levkoff; Steven B.,59,0,70,11
1713346914159,ECON 120A,A01,490245,Dai; Yinlin,59,0,70,11
1713346915188,ECON 120B,A01,490247,Nieto-Barthaburu; Augusto,40,0,70,30
1713346916223,ECON 120C,A01,490253,Sun; Yixiao,30,0,35,5
1713346916223,ECON 120C,B01,490255,Sun; Yixiao,34,0,35,1
1713346917249,ECON 129,A00,490256,Eckert; Fabian Paul,22,0,35,13
1713346918322,ECON 131,A00,490257,Nieto-Barthaburu; Augusto,0,6,35,35
1713346919355,ECON 138,A00,490258,Bharadwaj; Prashant,13,0,35,22
1713346919355,ECON 138,B00,490259,Bharadwaj; Prashant,15,0,35,20
1713346920384,ECON 159,A00,490260,Hendrickson; Gerald M.,0,9,0,0
1713346921413,ECON 178,A01,553995,Zhu; Ying,24,0,35,11
1713346922441,EDS 40,A01,512576,Black; Alison Michelle,20,0,20,0
1713346923466,EDS 107,A01,515848,Staff,30,0,30,0
1713346924501,EDS 110R,A01,490262,Staff,26,0,30,4
1713346925531,EDS 112,A01,490264,Chapman; Thandeka K,40,0,50,10
1713346926557,EDS 113,A00,490266,Staff,25,0,30,5
1713346927583,EDS 118,A00,490267,Warstadt; Melissa Fawn,18,0,30,12
1713346928607,EDS 124BR,A00,490268,Eguchi; Emi,4,0,25,21
1713346928607,EDS 124BR,B00,490269,Eguchi; Emi,23,0,25,2
1713346929634,EDS 126,A01,490271,Jones; Makeba,43,0,50,7
1713346930660,EDS 135,A01,490316,Staff,19,0,20,1
1713346931691,ENVR 142GS,A00,519514,Chang; Edmond Yi-Teh,26,0,28,2
1713346932728,ETHN 103,A00,490504,Staff,24,0,36,12
1713346933757,ETHN 103A,A00,490505,Man; Simeon S,3,0,9,6
1713346934784,ETHN 109,A00,490506,Staff,28,0,30,2
1713346935814,ETHN 118,A00,490507,Staff,35,0,36,1
1713346936842,ETHN 119,A00,490508,Staff,32,0,36,4
1713346937868,ETHN 121R,A00,490518,Choi; Esther Min,21,0,36,15
1713346938892,ETHN 127,A00,490528,Staff,14,0,15,1
1713346939918,ETHN 139,A00,490573,Staff,10,0,10,0
1713346940943,ETHN 150,A00,490575,Staff,15,0,15,0
1713346941972,GLBH 20,A00,491705,Elwardani; Nile Regina,38,0,40,2
1713346942999,GLBH 101,A00,491706,Staff,20,0,20,0
1713346944023,GLBH 111,A01,491708,Burgos; Jose L.,15,0,15,0
1713346945048,GLBH 146,A00,491709,Staff,8,0,20,12
1713346946079,GLBH 148,A00,491710,Olivas Hernandez; Olga Lid,10,0,20,10
1713346947111,GLBH 150,A00,491711,Sloane; Julia Kathryn,19,0,20,1
1713346948144,HIEA 131,A00,491760,Staff,28,0,32,4
1713346949172,HIEA 153,A00,491762,Staff,28,0,30,2
1713346950199,HIEU 124,A00,491811,Staff,26,0,32,6
1713346951224,HIEU 124GS,A00,491812,Markman; Kristina,27,0,28,1
1713346952250,HIEU 147,A00,491813,Staff,30,0,32,2
1713346953275,HIEU 149GS,A00,491816,Caldwell; Michael Alan,28,0,28,0
1713346954301,HILD 2C,A01,491713,Hendrickson; Gerald M.,26,0,30,4
1713346955327,HILD 7B,A01,491715,Kwak; Nancy,0,3,30,30
1713346956352,HILD 10,A01,491717,Staff,9,0,20,11
1713346957378,HILD 30GS,A00,491719,Edington; Claire Ellen,23,0,28,5
1713346958403,HINE 109,A00,491818,Shafir; Nir,26,0,32,6
1713346959427,HINE 128,A00,491821,Shafir; Nir,30,0,32,2
1713346960456,HISC 117,A00,491830,Staff,27,0,32,5
1713346961541,HIUS 103,A00,491834,Man; Simeon S,14,0,23,9
1713346962571,HIUS 108B,A00,491835,Staff,27,0,30,3
1713346963595,HIUS 141,A00,491836,Hendrickson; Gerald M.,28,0,32,4
1713346964624,HIUS 149,A00,491839,Staff,24,0,32,8
1713346965652,HUM 3,A01,512617,Crum; Matthew Stephen,42,0,50,8
1713346965652,HUM 3,A02,512618,Crum; Matthew Stephen,48,0,50,2
1713346966678,HUM 3GS,A00,512663,Markman; Kristina,0,0,0,1
1713346966678,HUM 3GS,B00,512664,Staff,0,0,0,0
1713346967710,HUM 4,A01,512620,West; Geoffrey Scott,23,0,50,27
1713346968737,HUM 4GS,A00,512666,Lyon; Antony J.,0,0,0,5
1713346969764,HUM 4R,A01,512625,Watkins; Eric,49,0,50,1
1713346970795,HUM 5,A01,512649,Zavodny; Tatiana Sophia,20,0,50,30
1713346970795,HUM 5,B01,512661,Zroka; Ryan Edward,48,0,50,2
1713346971820,INTL 190,A00,490577,Segui; Alan S,0,0,0,5
1713346972851,JAPN 20AR,A01,491267,Ross; Kayoko F,7,0,20,13
1713346973883,JAPN 180,A00,491285,Berman; Michael David,33,0,40,7
1713346974914,LATI 50,A01,502536,Kokinis; Troy Andreas,16,0,22,6
1713346974914,LATI 50,A02,502551,Kokinis; Troy Andreas,22,0,22,0
1713346974914,LATI 50,A03,502650,Kokinis; Troy Andreas,22,0,22,0
1713346974914,LATI 50,A04,502909,Kokinis; Troy Andreas,21,0,22,1
1713346975942,LATI 160,A01,502920,Kokinis; Troy Andreas,30,0,30,0
1713346976971,LIFR 1A,A00,490494,Van Moer; Vinciane G,17,0,20,3
1713346977996,LIFR 1AX,A00,490495,Van Moer; Vinciane G,17,0,20,3
1713346979023,LIFR 1B,A00,490496,Van Moer; Vinciane G,17,0,20,3
1713346980048,LIFR 1BX,A00,490497,Van Moer; Vinciane G,17,0,20,3
1713346981075,LIGN 8,A00,505198,McIntosh; Justin Daniel,134,0,150,16
1713346982105,LIGN 9GS,A00,491239,Lott; Margaret S.,18,0,20,2
1713346983132,LIGN 101,A01,505200,McIntosh; Justin Daniel,22,0,30,8
1713346984159,LIGN 120,A01,491244,Staff,22,0,30,8
1713346985187,LIGN 149GS,A00,491245,Lott; Margaret S.,18,0,20,2
1713346986211,LIGN 170,A00,491247,Staff,22,0,30,8
1713346987241,LISP 1D,A00,490498,Munoz Sanchez; Alicia,8,0,14,6
1713346987241,LISP 1D,B00,490499,Munoz Sanchez; Alicia,4,0,14,10
1713346987241,LISP 1D,C00,490500,Munoz Sanchez; Alicia,7,0,14,7
1713346987241,LISP 1D,D00,490501,Munoz Sanchez; Alicia,10,0,14,4
1713346988271,LISP 1DX,A00,490502,Munoz Sanchez; Alicia,11,0,28,17
1713346988271,LISP 1DX,B00,490503,Munoz Sanchez; Alicia,16,0,28,12
1713346990324,LTAM 110,A00,491847,Staff,22,0,25,3
1713346991349,LTCS 119,A00,491848,Staff,11,0,15,4
1713346992375,LTCS 130,A00,491849,Staff,24,0,25,1
1713346994427,LTEA 120C,A00,491852,Staff,32,0,40,8
1713346995454,LTEN 130GS,A00,491853,Lyon; Antony J.,23,0,28,5
1713346996480,LTEN 148,A00,491855,Staff,23,0,25,2
1713346997511,LTEN 159,A00,491856,Staff,20,0,25,5
1713346998535,LTEN 180,A00,491857,Staff,8,0,15,7
1713347000586,LTSP 123GS,A00,505928,Bessett; Ryan Matthew,24,0,28,4
1713347001612,LTSP 174GS,A00,506037,Bessett; Ryan Matthew,24,0,28,4
1713347003667,LTWR 102,A00,491861,Staff,9,0,15,6
1713347004696,LTWR 106,A00,491862,Staff,8,0,15,7
1713347005731,MAE 11,A00,490930,Bahadori; Mohammad Yousef,94,0,100,6
1713347006757,MAE 30A,A00,490931,Qi; Huihui,37,0,40,3
1713347007790,MAE 101A,A00,491036,Sadeghizadeh; Zahra,91,0,100,9
1713347008821,MAE 101C,A00,491037,Seshadri; Kalyanasundaram,63,0,100,37
1713347009846,MAE 113,A00,491040,Seshadri; Kalyanasundaram,64,0,80,16
1713347010871,MAE 131A,A00,491041,Ghazinejad; Maziar,37,0,40,3
1713347011900,MAE 142,A00,491053,Staff,39,0,40,1
1713347012927,MAE 143A,A00,491054,Staff,29,0,50,21
1713347013955,MAE 150,A00,491092,Truong; Phuong Thi Ngoc,23,0,35,12
1713347014982,MATH 3C,A01,494031,Pardo Guerra; Sebastian,30,0,30,0
1713347014982,MATH 3C,A02,494032,Pardo Guerra; Sebastian,29,0,30,1
1713347016008,MATH 10A,A01,494034,Staff,27,0,30,3
1713347016008,MATH 10A,A02,494035,Staff,28,0,30,2
1713347016008,MATH 10A,B01,494037,Staff,27,0,30,3
1713347016008,MATH 10A,B02,494038,Staff,29,0,30,1
1713347017040,MATH 10B,A01,494040,Habib; Yousaf,22,0,30,8
1713347017040,MATH 10B,A02,494041,Habib; Yousaf,28,0,30,2
1713347017040,MATH 10B,A03,494042,Habib; Yousaf,29,0,30,1
1713347017040,MATH 10B,A04,494043,Habib; Yousaf,30,0,30,0
1713347017040,MATH 10B,B01,494045,Habib; Yousaf,25,0,30,5
1713347017040,MATH 10B,B02,494046,Habib; Yousaf,30,0,30,0
1713347017040,MATH 10B,B03,494047,Habib; Yousaf,30,0,30,0
1713347017040,MATH 10B,B04,494048,Habib; Yousaf,30,0,30,0
1713347018077,MATH 18,A01,494050,Kemp; Todd Aahron,25,0,30,5
1713347018077,MATH 18,A02,494051,Kemp; Todd Aahron,29,0,30,1
1713347018077,MATH 18,B01,494054,Kemp; Todd Aahron,25,0,30,5
1713347018077,MATH 18,B02,494055,Kemp; Todd Aahron,29,0,30,1
1713347019107,MATH 20A,A01,494059,Suk; Andrew Hoon,30,0,30,0
1713347020134,MATH 20B,A01,494061,Briones; Jor-el Thomas Caparas,33,0,35,2
1713347020134,MATH 20B,B01,494063,Bach; Quang Tran,34,0,35,1
1713347021162,MATH 20C,A01,494065,Staff,28,0,30,2
1713347021162,MATH 20C,A02,494066,Staff,30,0,30,0
1713347021162,MATH 20C,A03,494067,Staff,30,0,30,0
1713347021162,MATH 20C,A04,494068,Staff,30,0,30,0
1713347021162,MATH 20C,B01,494070,Zhang; Ming,23,0,30,7
1713347021162,MATH 20C,B02,494071,Zhang; Ming,27,0,30,3
1713347021162,MATH 20C,B03,494072,Zhang; Ming,29,0,30,1
1713347021162,MATH 20C,B04,494073,Zhang; Ming,29,0,30,1
1713347022187,MATH 20D,A01,494075,Staff,22,0,30,8
1713347022187,MATH 20D,A02,494076,Staff,29,0,30,1
1713347023214,MATH 20E,A01,494079,Staff,24,0,30,6
1713347023214,MATH 20E,A02,494080,Staff,26,0,30,4
1713347023214,MATH 20E,B01,494082,Staff,25,0,30,5
1713347023214,MATH 20E,B02,494083,Staff,25,0,30,5
1713347024251,MATH 103A,A01,494085,Aliabadi Sr.; Mohsen,12,0,30,18
1713347024251,MATH 103A,A02,494086,Aliabadi Sr.; Mohsen,28,0,30,2
1713347024251,MATH 103A,B01,494088,Aliabadi Sr.; Mohsen,20,0,30,10
1713347024251,MATH 103A,B02,494089,Aliabadi Sr.; Mohsen,27,0,30,3
1713347025278,MATH 109,A01,494091,Staff,30,0,30,0
1713347025278,MATH 109,A02,494092,Staff,29,0,30,1
1713347025278,MATH 109,B01,494094,Staff,27,0,30,3
1713347025278,MATH 109,B02,494095,Staff,29,0,30,1
1713347026304,MATH 142A,A01,494097,Chow; Bennett,13,0,30,17
1713347026304,MATH 142A,A02,494098,Chow; Bennett,23,0,30,7
1713347026304,MATH 142A,B01,494100,Chow; Bennett,19,0,30,11
1713347026304,MATH 142A,B02,494101,Chow; Bennett,29,0,30,1
1713347028357,MATH 168A,A01,516677,Dumitriu; Ioana,16,0,35,19
1713347029387,MATH 170A,A01,516679,Dumitriu; Ioana,18,0,30,12
1713347029387,MATH 170A,A02,516680,Dumitriu; Ioana,28,0,30,2
1713347030418,MATH 193A,A01,494107,Staff,12,0,30,18
1713347030418,MATH 193A,A02,494108,Staff,18,0,30,12
1713347030418,MATH 193A,A03,494109,Staff,29,0,30,1
1713347030418,MATH 193A,A04,494110,Staff,22,0,30,8
1713347033499,MGT 16,A00,491930,McKay; Michael J,92,0,98,6
1713347034524,MGT 18,A00,491992,McKay; Michael J,96,0,98,2
1713347035552,MGT 71,A00,492003,Staff,63,0,98,35
1713347036578,MGT 103,A00,505209,Eberhard; Craig A,80,0,98,18
1713347037603,MGT 131A,A00,505210,Anderson; John Charles,89,0,98,9
1713347039659,MGT 153,A00,492077,Perols; Johan Lars,15,0,90,75
1713347042736,MGT 164,A00,492222,McKay; Mary A,91,0,98,7
1713347043773,MGT 172,A00,492245,Staff,59,0,60,1
1713347043773,MGT 172,B00,505526,Hedges; Kathleen,65,0,98,33
1713347044804,MGT 181,A00,505669,Dunn; Louis Jean,78,0,98,20
1713347045832,MMW 14,A01,494399,Staff,15,0,28,13
1713347045832,MMW 14,A02,494400,Staff,25,0,28,3
1713347045832,MMW 14,A03,494401,Staff,28,0,28,0
1713347045832,MMW 14,A04,494402,Staff,28,0,28,0
1713347045832,MMW 14,B01,494404,Carreras; Maria Victoria,8,0,28,20
1713347045832,MMW 14,B02,494405,Carreras; Maria Victoria,25,0,28,3
1713347045832,MMW 14,B03,494406,Carreras; Maria Victoria,27,0,28,1
1713347045832,MMW 14,B04,494407,Carreras; Maria Victoria,28,0,28,0
1713347046861,MMW 14GS,A00,506250,Chang; Edmond Yi-Teh,0,0,0,0
1713347047890,MMW 121R,A01,494415,Adamiak; Patrick John,9,0,28,19
1713347047890,MMW 121R,A02,494416,Adamiak; Patrick John,24,0,28,4
1713347048922,MUS 1A,A01,494113,Staff,12,0,25,13
1713347048922,MUS 1A,A02,494114,Staff,24,0,25,1
1713347049953,MUS 4,A01,494116,Staff,23,0,25,2
1713347049953,MUS 4,A02,494117,Staff,22,0,25,3
1713347051053,MUS 5R,A01,494236,Dubnov; Shlomo,4,0,25,21
1713347051053,MUS 5R,A02,494237,Dubnov; Shlomo,25,0,25,0
1713347052083,MUS 6,A01,494122,Staff,9,0,25,16
1713347052083,MUS 6,A02,494123,Staff,23,0,25,2
1713347053112,MUS 7,A01,494125,Staff,16,0,25,9
1713347053112,MUS 7,A02,494126,Staff,24,0,25,1
1713347054139,MUS 11,A01,494128,Staff,23,0,25,2
1713347054139,MUS 11,A02,494129,Staff,24,0,25,1
1713347055166,MUS 13,A01,494131,Staff,25,0,25,0
1713347055166,MUS 13,A02,494132,Staff,25,0,25,0
1713347056195,MUS 15,A01,494134,Staff,16,0,25,9
1713347056195,MUS 15,A02,494135,Staff,25,0,25,0
1713347056195,MUS 15,B01,494137,Staff,24,0,25,1
1713347057225,MUS 80,A00,494232,Staff,24,0,25,1
1713347057225,MUS 80,B00,494233,Staff,25,0,25,0
1713347057225,MUS 80,C00,494234,Staff,23,0,25,2
1713347058250,MUS 95C,A00,494141,Staff,69,0,75,6
1713347059275,MUS 114,A00,494142,Staff,39,0,50,11
1713347060305,NANO 15,A01,490636,Drews; Aaron,7,0,7,0
1713347061339,PHIL 1,A00,490578,Grush; Rick Scott,49,0,50,1
1713347062366,PHIL 10,A01,490580,Grush; Rick Scott,33,0,35,2
1713347062366,PHIL 10,A02,490586,Grush; Rick Scott,32,0,35,3
1713347063392,PHIL 27,A01,490591,Staff,22,0,25,3
1713347063392,PHIL 27,A02,490592,Staff,25,0,25,0
1713347063392,PHIL 27,A03,490593,Staff,25,0,25,0
1713347063392,PHIL 27,A04,490598,Staff,25,0,25,0
1713347064417,PHIL 32,A01,490611,Staff,20,0,20,0
1713347064417,PHIL 32,A02,490618,Staff,20,0,20,0
1713347065497,PHIL 90,A00,490624,Staff,40,0,40,0
1713347066523,PHIL 136,A00,490627,Cohen; Jonathan David,37,0,40,3
1713347067547,PHIL 155,A00,490634,Staff,61,0,70,9
1713347068579,PHYS 1A,A00,491610,Staff,245,0,250,5
1713347069605,PHYS 1AL,001,491616,Tsai; Philbert S,27,0,30,3
1713347069605,PHYS 1AL,002,491618,Tsai; Philbert S,30,0,30,0
1713347070629,PHYS 1B,A00,491623,Staff,235,0,250,15
1713347071655,PHYS 1BL,001,491626,Tsai; Philbert S,18,0,30,12
1713347071655,PHYS 1BL,002,491628,Tsai; Philbert S,26,0,30,4
1713347072681,PHYS 1C,A00,491632,Staff,211,0,245,34
1713347073706,PHYS 1CL,001,491635,Tsai; Philbert S,2,0,30,28
1713347073706,PHYS 1CL,002,491643,Tsai; Philbert S,22,0,30,8
1713347074737,PHYS 2AR,A01,491651,Meyertholen; Andrew D.,44,0,50,6
1713347075763,PHYS 2B,A01,491659,Staff,105,0,115,10
1713347076791,PHYS 2BL,A01,491685,Staff,21,0,24,3
1713347076791,PHYS 2BL,A02,491700,Staff,21,0,24,3
1713347077819,PHYS 2C,A01,505161,Staff,101,0,115,14
1713347078850,PHYS 4A,A01,491704,Grinstein; Benjamin,99,0,100,1
1713347079882,POLI 5D,A01,494144,Staff,3,0,5,2
1713347079882,POLI 5D,B01,626283,Dai; Yinlin,5,0,5,0
1713347080907,POLI 12,A00,494145,Staff,43,0,45,2
1713347081935,POLI 13R,A00,494146,Forman; Fonna,45,0,50,5
1713347082963,POLI 27,A01,494148,Staff,54,0,60,6
1713347083992,POLI 30,A00,494149,Staff,49,0,50,1
1713347085026,POLI 100DA,A00,494150,Staff,20,0,25,5
1713347087079,POLI 100I,A00,494152,Staff,27,0,30,3
1713347088112,POLI 104B,A00,494153,Smith; Glenn Chatmas,53,0,55,2
1713347089136,POLI 104F,A00,494154,Staff,28,0,30,2
1713347090163,POLI 104I,A00,494155,Smith; Glenn Chatmas,29,0,30,1
1713347091197,POLI 110C,A00,494156,Ingham; Sean,23,0,25,2
1713347092231,POLI 117R,A00,494157,Forman; Fonna,5,0,20,15
1713347093260,POLI 118,A00,494158,Ingham; Sean,21,0,25,4
1713347094287,POLI 120H,A00,494159,Fisk; David Lee,39,0,45,6
1713347095318,POLI 131CR,A00,494160,Hoston; Germaine,35,0,45,10
1713347096345,POLI 133J,A00,494161,Staff,31,0,35,4
1713347097370,POLI 135,A00,494162,Fisk; David Lee,33,0,35,2
1713347098405,POLI 140A,A00,494164,Staff,18,0,30,12
1713347099431,POLI 142I,A00,494165,Staff,30,0,30,0
1713347100459,POLI 144D,A00,494166,Staff,22,0,25,3
1713347101491,POLI 151,A00,494167,Staff,30,0,30,0
1713347102518,POLI 153,A00,494168,Staff,33,0,35,2
1713347103548,POLI 160AA,A00,494169,Staff,33,0,40,7
1713347104577,POLI 162,A00,494170,Mignozzetti; Umberto,17,0,25,8
1713347105606,POLI 171,A00,494171,Mignozzetti; Umberto,18,0,25,7
1713347106637,PSYC 1,A00,494172,Staff,95,0,100,5
1713347107662,PSYC 2,A00,494173,Moranton; Nirelia Melbina-,33,0,50,17
1713347108689,PSYC 3,A00,494174,Staff,29,0,30,1
1713347109715,PSYC 6,A00,494175,Staff,17,0,20,3
1713347110744,PSYC 60,A01,494177,Staff,37,0,45,8
1713347111775,PSYC 70,A01,505724,Geller; Emma Harlan,42,0,45,3
1713347112802,PSYC 101,A00,494180,Heyman; Gail D.,83,0,100,17
1713347113828,PSYC 105,A00,494181,Geller; Emma Harlan,51,0,90,39
1713347114859,PSYC 106,A00,494182,Dobkins; Karen R.,26,0,45,19
1713347115889,PSYC 108,A00,494183,Adrian; Julia Anna,89,0,100,11
1713347116915,PSYC 114,A01,494185,Winkielman; Piotr,0,4,30,30
1713347117947,PSYC 122,A00,494186,Moranton; Nirelia Melbina-,27,0,50,23
1713347118975,PSYC 124,A00,494187,Chapman; Eddie Nathaniel,69,0,80,11
1713347120006,PSYC 131,A00,494188,Anagnostaras; Stephan,39,0,80,41
1713347121032,PSYC 144,A00,494189,Staff,1,1,50,49
1713347122062,PSYC 154,A00,494190,Lacefield; Katharine I,105,0,180,75
1713347123093,PSYC 162,A00,494191,Wixted; John T,70,0,100,30
1713347124118,PSYC 172,A00,494192,Gorman; Michael R.,36,0,45,9
1713347125148,PSYC 178,A00,494193,Glaser; Dale,32,0,45,13
1713347126174,PSYC 193,A00,505725,Chapman; Eddie Nathaniel,20,0,20,0
1713347127201,RELI 145GS,A00,519817,Rahimi; Babak,17,0,20,3
1713347128233,SE 101A,A01,490862,Chadha; Mayank,23,0,25,2
1713347129263,SE 101C,A01,490924,Krysl; Petr,15,0,20,5
1713347130291,SE 110A,A01,490928,Staff,19,0,20,1
1713347131321,SE 130A,A00,490929,Morrison; Machel Leigh,54,0,70,16
1713347132348,SIO 1,A01,519325,Staff,39,0,40,1
1713347133374,SIO 30,A01,519327,Staff,38,0,40,2
1713347134400,SIO 40,A00,519328,Staff,39,0,40,1
1713347135427,SIO 46GS,A00,519819,Cook; Geoffrey W,15,0,25,10
1713347136452,SIO 109R,A00,494197,Forman; Fonna,0,3,20,20
1713347137481,SIO 121GS,A00,519827,Cook; Geoffrey W,15,0,25,10
1713347138510,SIO 132,A01,519330,Staff,38,0,40,2
1713347139537,SIO 133,A01,519397,Staff,37,0,40,3
1713347140564,SIO 139,A00,519396,Kacev; David,29,0,40,11
1713347141594,SOCI 1,A01,494199,Thorpe; Charles Robert,21,0,30,9
1713347141594,SOCI 1,A02,494200,Thorpe; Charles Robert,30,0,30,0
1713347141594,SOCI 1,A03,494201,Thorpe; Charles Robert,29,0,30,1
1713347141594,SOCI 1,A04,494202,Thorpe; Charles Robert,29,0,30,1
1713347141594,SOCI 1,A05,494203,Thorpe; Charles Robert,29,0,30,1
1713347141594,SOCI 1,A06,494204,Thorpe; Charles Robert,30,0,30,0
1713347141594,SOCI 1,A07,494205,Thorpe; Charles Robert,28,0,30,2
1713347142621,SOCI 60,A01,494207,Staff,33,0,40,7
1713347142621,SOCI 60,A02,494208,Staff,39,0,40,1
1713347143648,SOCI 100,A01,494210,Payne; Christine Anna,25,0,30,5
1713347143648,SOCI 100,A02,494211,Payne; Christine Anna,26,0,30,4
1713347144680,SOCI 109M,A00,494212,Staff,20,0,20,0
1713347145708,SOCI 110,A00,494213,Staff,34,0,40,6
1713347147764,SOCI 118E,A00,494215,Ng; Kwai,37,0,40,3
1713347148791,SOCI 125,A00,494216,Calderon-Zaks; Michael Aar,39,0,45,6
1713347149818,SOCI 126,A01,494218,Jones; Makeba,3,0,5,2
1713347150843,SOCI 131,A00,494219,Thorpe; Charles Robert,25,0,30,5
1713347152894,SOCI 135,A00,494221,Payne; Christine Anna,28,0,50,22
1713347153926,SOCI 136E,A00,626690,Ruiz; Jonathan Joseph,24,0,25,1
1713347154952,SOCI 138GS,A00,494222,Navon; Daniel,23,0,28,5
1713347157005,SOCI 145,A00,494224,Staff,40,0,45,5
1713347158031,SOCI 153,A00,494225,Staff,28,0,30,2
1713347159057,SOCI 160E,A00,494226,Ng; Kwai,27,0,40,13
1713347160141,SOCI 180,A00,494227,Staff,29,0,30,1
1713347161169,SOCI 189GS,A00,494228,Ribas Norris; Janet Vanesa,11,0,11,0
1713347162195,SOCI 190GS,A00,553232,Ribas Norris; Janet Vanesa,11,0,11,0
1713347163238,SOMI 220,A00,627178,Schneid; Stephen David,30,0,30,0
1713347164265,SYN 2,001,490768,Staff,13,0,15,2
1713347164265,SYN 2,002,490769,Staff,14,0,15,1
1713347164265,SYN 2,004,490775,Staff,0,0,0,0
1713347164265,SYN 2,003,490774,Staff,0,0,0,0
1713347164265,SYN 2,005,490776,Staff,0,0,0,0
1713347165300,SYN 2R,001,490779,Staff,10,0,15,5
1713347165300,SYN 2R,002,514635,Staff,14,0,15,1
1713347166326,SYN 100,A01,490783,Staff,8,0,20,12
1713347166326,SYN 100,B01,490787,Staff,10,0,20,10
1713347166326,SYN 100,C01,490789,Staff,10,0,20,10
1713347167350,SYN 150,A00,490817,Staff,14,0,15,1
1713347167350,SYN 150,B00,514610,Staff,15,0,15,0
1713347168385,TDAC 1,A00,492753,Walsh; Kim C.,19,0,20,1
1713347168385,TDAC 1,B00,492754,Harting; Carla Kelso,18,0,20,2
1713347168385,TDAC 1,C00,513995,Salovey; Todd,15,0,20,5
1713347169471,TDAC 101,A00,492766,Harting; Carla Kelso,17,0,20,3
1713347170498,TDAC 102,A00,492768,Basso; Beatrice,19,0,20,1
1713347171526,TDDE 111,A00,492769,Staff,25,0,25,0
1713347172551,TDDE 131,A00,492770,Staff,15,0,15,0
1713347172551,TDDE 131,B00,492771,Staff,15,0,15,0
1713347173585,TDDE 131GS,A00,523716,Guirguis; Mark C,23,0,28,5
1713347174611,TDGE 1,A01,492756,Salovey; Todd,56,0,60,4
1713347175635,TDGE 5,A01,492758,Staff,23,0,25,2
1713347176667,TDGE 10,A00,492759,Fulton; Julia,203,0,220,17
1713347177693,TDGE 11,A00,492760,Castro; Robert Jess,198,0,200,2
1713347179755,TDGE 124,A00,492772,Fulton; Julia,180,0,220,40
1713347180780,TDGE 125,A00,492773,Meyer; Ursula,38,0,50,12
1713347180780,TDGE 125,B00,492774,Staff,49,0,50,1
1713347180780,TDGE 125,C00,523565,Staff,48,0,50,2
1713347181809,TDGE 125GS,A00,523580,Guirguis; Mark C,23,0,28,5
1713347182837,TDGE 127,A00,492775,Havis; Allan,33,0,50,17
1713347183873,TDHT 101,A00,492776,Staff,34,0,35,1
1713347184905,TDMV 1,A00,492762,Caligagan; Maria T.,29,0,30,1
1713347184905,TDMV 1,B00,492763,Arcidiacono; Kristin,26,0,30,4
1713347185932,TDMV 2,A00,492764,Weinberg; Sadie,27,0,30,3
1713347186958,TDMV 3,A00,492765,Mack; Kara Shanai',37,0,40,3
1713347187985,TDMV 138,A00,492777,Mack; Kara Shanai',32,0,40,8
1713347189015,TDMV 140,A00,492778,Lima; Paulo Henrique,40,0,40,0
1713347190047,TDMV 142,A00,492779,Caligagan; Maria T.,33,0,40,7
1713347190047,TDMV 142,B00,492780,Caligagan; Tony,37,0,40,3
1713347191073,TDMV 143,A00,492781,Fyall; Daunte Edward,39,0,40,1
1713347192100,USP 1,A01,492401,Kwak; Nancy,27,0,35,8
1713347193126,USP 2,A01,492453,Hinds; Juli Beth,35,0,35,0
1713347194152,USP 3,A01,492516,Staff,28,0,35,7
1713347195179,USP 4,A00,492522,McTague; Sarah,16,0,25,9
1713347196211,USP 100,A00,492523,Staff,32,0,35,3
1713347197236,USP 101,A00,492524,Staff,13,0,15,2
1713347198263,USP 105,A00,492525,Staff,21,0,25,4
1713347199287,USP 151,A00,492526,Shenkman; Michael Thomas,32,0,35,3
1713347200312,USP 170,A00,492545,Hinds; Juli Beth,32,0,35,3
1713347201340,USP 171GS,A00,492608,Bussell; Mirle Rabinowitz,24,0,28,4
1713347202365,USP 183GS,A00,492613,Peerson; Susan,24,0,28,4
1713347203392,VIS 30,A01,490693,Yoldas; Pinar,19,0,22,3
1713347203392,VIS 30,A02,490694,Yoldas; Pinar,18,0,22,4
1713347204423,VIS 83,A00,490695,Kester; Grant,63,0,75,12
1713347205446,VIS 105D,A00,490696,Staff,22,0,25,3
1713347206471,VIS 124CN,A00,490699,Rose; Jordan M,64,0,75,11
1713347207499,VIS 125GS,A00,511221,Williams; Alena J,21,0,22,1
1713347208529,VIS 128D,A00,490700,Staff,73,0,75,2
1713347209554,VIS 151,A01,490717,Staff,33,0,34,1
1713347209554,VIS 151,A02,490766,Staff,32,0,34,2
1713347210581,VIS 154GS,A00,511972,Williams; Alena J,21,0,22,1
1713347211607,VIS 160A,A00,490767,Stone; Patricia,7,0,10,3
1713347212639,WCWP 10A,A00,490638,Staff,14,0,15,1
1713347212639,WCWP 10A,B00,490640,Staff,15,0,15,0
1713347213665,WCWP 10B,A00,490641,Staff,0,0,0,0
1713347213665,WCWP 10B,B00,490642,Staff,14,0,15,1
1713347213665,WCWP 10B,C00,490644,Staff,13,0,15,2
1713347213665,WCWP 10B,D00,490647,Staff,0,0,0,0
1713347214691,WCWP 100,A00,490655,Staff,0,0,0,0
1713347214691,WCWP 100,B00,490687,Staff,10,0,15,5
1713347216859,ANAR 153,A00,487222,Braswell; Geoffrey E.,53,0,60,7
1713347217884,ANBI 134,A00,487223,Staff,5,0,20,15
1713347218911,ANBI 143GS,A00,487224,Noel; Geoffroy Pierre Jean,18,0,24,6
1713347219937,ANBI 144GS,A00,519548,Noel; Geoffroy Pierre Jean,18,0,24,6
1713347220963,ANSC 101,A00,487225,Staff,17,0,20,3
1713347221990,ANSC 125,A00,487227,Brenner; Suzanne A,38,0,40,2
1713347224065,ANSC 146,A00,487229,Staff,35,0,40,5
1713347225090,ANSC 148,A00,487230,Olivas Hernandez; Olga Lid,39,0,40,1
1713347226118,ANSC 150,A00,504165,Sloane; Julia Kathryn,18,0,20,2
1713347227147,ANSC 180,A00,487232,Staff,14,0,15,1
1713347228173,ANSC 188,A00,627155,Staff,37,0,40,3
1713347229207,ANTH 5,A00,519529,Semendeferi; Ekaterini,15,0,15,0
1713347230233,ANTH 10,A00,487219,Staff,58,0,60,2
1713347231258,ANTH 23,A01,487221,Staff,17,0,20,3
1713347232286,ANTH 102,A00,487233,Wilder; Linnea Lorene,49,0,60,11
1713347233316,ANTH 103,A00,487234,Varma; Saiba,54,0,60,6
1713347234343,ANTH 105,A00,487235,Stewart; Alexander B,54,0,60,6
1713347235369,BENG 100,A01,516685,Taylor Amos; Alyssa C,25,0,30,5
1713347236403,BIBC 102,A01,491316,Flagg; Matthew Paul,5,0,88,83
1713347236403,BIBC 102,A02,491366,Flagg; Matthew Paul,78,0,88,10
1713347237436,BIBC 103,A01,491486,Boumechache; Miyyada,16,0,24,8
1713347237436,BIBC 103,A02,491487,Boumechache; Miyyada,24,0,24,0
1713347238465,BICD 100,A01,516882,Staff,72,0,75,3
1713347238465,BICD 100,A02,516890,Staff,69,0,75,6
1713347239491,BICD 102GS,A00,491488,Lo; Stanley M.,26,0,28,2
1713347240518,BIEB 136GS,A00,516940,Holway; David A. & Shurin; Jonathan,18,0,24,6
1713347241543,BIEB 137GS,A01,517034,Holway; David A. & Shurin; Jonathan,18,0,24,6
1713347242573,BIEB 138GS,A01,491492,Pirino; Giorgia,21,0,28,7
1713347243601,BILD 1,A01,491296,Staff,60,0,63,3
1713347243601,BILD 1,A02,491297,Staff,63,0,63,0
1713347244629,BILD 4,A01,517099,Gonzalez Gamboa; Ivonne,22,0,24,2
1713347244629,BILD 4,A02,517100,Gonzalez Gamboa; Ivonne,24,0,24,0
1713347245656,BILD 60GS,A00,491309,Lo; Stanley M.,26,0,28,2
1713347246687,BIMM 100,A01,517136,Staff,82,0,100,18
1713347247715,BIMM 110,A01,517182,Staff,52,0,100,48
1713347248742,BIMM 120,A01,517228,Pickett; Brooke Elizabeth,28,0,63,35
1713347248742,BIMM 120,A02,517240,Pickett; Brooke Elizabeth,44,0,63,19
1713347249771,BIMM 132GS,A01,491498,Pirino; Giorgia,21,0,28,7
1713347250802,BIMM 143,A01,491589,Bozinovic; Goran,12,0,40,28
1713347251829,BIPN 100,A01,491594,Armour; Jon Christopher,83,0,100,17
1713347252860,BIPN 140,A01,491602,Marino; Marc J,23,0,50,27
1713347254920,CAT 125,A00,515973,Staff,18,0,20,2
1713347255946,CAT 125GS,A00,515974,Rahimi; Babak,16,0,20,4
1713347256975,CAT 125R,A00,515980,Staff,12,0,20,8
1713347256975,CAT 125R,B00,515981,Tosun; Adriana,19,0,20,1
1713347256975,CAT 125R,C00,515987,Hyland; Tina Mae,0,5,20,20
1713347256975,CAT 125R,D00,515988,Bronstein; Phoebe Malan,16,0,20,4
1713347258005,CENG 15,A01,488699,Drews; Aaron,25,0,25,0
1713347259030,CENG 100,A00,505196,Opatkiewicz; Justin Paul,25,0,25,0
1713347260060,CGS 2A,A01,489598,Staff,32,0,35,3
1713347261091,CGS 112,A00,489599,Staff,15,0,15,0
1713347262119,CGS 119,A00,489603,Staff,10,0,10,0
1713347263144,CGS 120,A00,489604,Staff,13,0,15,2
1713347264170,CGS 150,A00,489607,Staff,15,0,15,0
1713347265196,CHEM 6A,A01,488715,Staff,97,0,100,3
1713347266222,CHEM 6B,A01,488719,Piercy; Marc Anthony,99,0,100,1
1713347267249,CHEM 6C,A01,488723,Albizati; Kim F.,93,0,100,7
1713347268279,CHEM 7L,A01,488728,Schurmeier; Kimberly,18,0,24,6
1713347268279,CHEM 7L,A02,488730,Schurmeier; Kimberly,23,0,24,1
1713347268279,CHEM 7L,A03,488734,Schurmeier; Kimberly,20,0,24,4
1713347268279,CHEM 7L,A04,488763,Schurmeier; Kimberly,23,0,24,1
1713347268279,CHEM 7L,B01,488798,Schurmeier; Kimberly,16,0,24,8
1713347268279,CHEM 7L,B02,488801,Schurmeier; Kimberly,22,0,24,2
1713347268279,CHEM 7L,B03,488808,Schurmeier; Kimberly,22,0,24,2
1713347268279,CHEM 7L,B04,488811,Schurmeier; Kimberly,24,0,24,0
1713347269309,CHEM 11,A01,488897,Stallings; Dontarie M,94,0,100,6
1713347270339,CHEM 40A,A01,488913,Albizati; Kim F.,83,0,100,17
1713347271368,CHEM 40B,A01,488920,Weizman; Haim,42,0,50,8
1713347271368,CHEM 40B,A02,488938,Weizman; Haim,43,0,50,7
1713347272395,CHEM 41A,A01,489029,Klosterman; Jeremy K,57,0,60,3
1713347273482,CHEM 41C,A01,500436,Tor; Yitzhak,54,0,60,6
1713347274508,CHEM 43A,A01,500426,Weizman; Haim,0,1,24,24
1713347274508,CHEM 43A,A02,500430,Weizman; Haim,6,0,24,18
1713347274508,CHEM 43A,B01,514041,Klosterman; Jeremy K,14,0,24,10
1713347274508,CHEM 43A,B02,514047,Klosterman; Jeremy K,23,0,24,1
1713347275536,CHEM 108,A01,489140,Jennings; Patricia A.,6,0,24,18
1713347275536,CHEM 108,A02,489142,Jennings; Patricia A.,14,0,24,10
1713347276567,CHEM 114A,A01,489147,Stallings; Dontarie M,65,0,100,35
1713347277599,CHIN 169A,A00,489171,Wang; Xiao,19,0,20,1
1713347279654,COGS 3,A01,518827,Boyle; Mary E. T.,25,0,40,15
1713347280682,COGS 11,A01,489175,Staff,27,0,30,3
1713347281715,COGS 14A,A01,518829,Staff,50,0,60,10
1713347282748,COGS 14B,A01,489177,Hoffman; Drew Ellen,62,0,75,13
1713347283774,COGS 100,A01,489181,Allen; Michael Gordon,62,0,75,13
1713347284800,COGS 101A,A01,489183,Staff,45,0,60,15
1713347285827,COGS 101B,A01,489185,Allen; Michael Gordon,6,0,30,24
1713347286857,COGS 101C,A01,526786,Staff,23,0,30,7
1713347288909,COGS 107A,A01,489189,Boyle; Mary E. T.,16,0,35,19
1713347289935,COGS 107B,A01,627144,Mooshagian; Eric Frederick,59,0,60,1
1713347290961,COGS 118A,A01,489191,Staff,0,46,40,40
1713347293013,COGS 171GS,A01,489194,Pineda; Jaime A,19,0,28,9
1713347294043,COGS 172,A01,489196,Staff,1,0,30,29
1713347295068,COGS 174GS,A01,489264,Pineda; Jaime A,19,0,28,9
1713347296097,COGS 180,A01,627150,Staff,28,0,30,2
1713347297127,COGS 186,A01,489274,Staff,0,3,30,30
1713347298155,COMM 10,A01,489276,Staff,23,0,25,2
1713347298155,COMM 10,A02,489303,Staff,23,0,25,2
1713347299179,COMM 100A,A01,489312,Staff,14,0,25,11
1713347299179,COMM 100A,A02,489313,Staff,24,0,25,1
1713347300210,COMM 106T,A00,512540,Staff,33,0,35,2
1713347301234,COMM 107,A00,489347,Staff,27,0,35,8
1713347302263,COMM 109P,A00,489358,Staff,31,0,35,4
1713347303293,COMM 132,A00,489361,McKenna; Denise,27,0,30,3
1713347304318,COMM 146,A00,489362,Halm; Gavin Patrick,26,0,30,4
1713347305343,COMM 190,A00,489363,Abuelhiga; Soraya Jill,17,0,23,6
1713347306372,CSE 8A,A50,489366,Staff,21,0,25,4
1713347306372,CSE 8A,A51,489367,Staff,24,0,25,1
1713347307399,CSE 11,A01,489398,Cao; Yingjun,72,0,100,28
1713347308432,CSE 12,A01,489487,Staff,43,0,50,7
1713347309458,CSE 20,A01,489497,Staff,47,0,50,3
1713347310488,CSE 21,A01,489517,Braun; Oliver,42,0,50,8
1713347311515,CSE 101,A01,489524,Braun; Oliver,0,35,50,50
1713347312547,CSE 105,A01,512594,Jones; Miles E,72,0,100,28
1713347312547,CSE 105,B01,512598,Jones; Miles E,51,0,100,49
1713347313574,CSE 140,A01,489538,Staff,39,0,50,11
1713347314602,CSE 141,A01,489550,Eldon; John,67,0,100,33
1713347315627,CSE 141L,A01,489571,Eldon; John,65,0,100,35
1713347316659,CSE 151A,A01,489583,Solares; Edwin A,139,0,200,61
1713347317692,CSE 175,A01,510886,Kumar; Rakesh,30,0,30,0
1713347318726,CSE 190,A00,516828,Dubnov; Shlomo,37,0,49,12
1713347319756,DOC 100D,A00,489667,Pass; Natalye Joann,19,0,25,6
1713347320784,DSC 10,A01,624268,Staff,72,0,75,3
1713347321811,DSC 20,A01,624476,Staff,50,0,50,0
1713347322841,DSC 40A,A01,624608,Staff,39,0,40,1
1713347323868,DSGN 1,A01,489179,Rill; Bryan,32,0,50,18
1713347324901,ECE 17,A01,490489,Sahay; Rajeev,18,0,30,12
1713347325931,ECE 65,A50,490492,Staff,11,0,20,9
1713347325931,ECE 65,A51,490493,Staff,18,0,20,2
1713347326957,ECON 1,A01,489715,Famulari; Melissa,67,0,70,3
1713347328048,ECON 2,A01,489717,Levkoff; Steven B.,67,0,70,3
1713347329079,ECON 3,A01,489948,Staff,70,0,70,0
1713347331139,ECON 5,A01,490103,Staff,27,0,30,3
1713347331139,ECON 5,B01,626281,Dai; Yinlin,45,0,45,0
1713347332171,ECON 100A,A01,490127,Famulari; Melissa,62,0,70,8
1713347333198,ECON 100B,A01,490129,Staff,64,0,70,6
1713347334232,ECON 109,A01,490187,Shishkin; Denis,27,0,35,8
1713347335260,ECON 110A,A01,490190,Levkoff; Steven B.,59,0,70,11
1713347336290,ECON 120A,A01,490245,Dai; Yinlin,59,0,70,11
1713347337317,ECON 120B,A01,490247,Nieto-Barthaburu; Augusto,40,0,70,30
1713347338408,ECON 120C,A01,490253,Sun; Yixiao,30,0,35,5
1713347338408,ECON 120C,B01,490255,Sun; Yixiao,34,0,35,1
1713347339434,ECON 129,A00,490256,Eckert; Fabian Paul,22,0,35,13
1713347340462,ECON 131,A00,490257,Nieto-Barthaburu; Augusto,0,6,35,35
1713347341510,ECON 138,A00,490258,Bharadwaj; Prashant,13,0,35,22
1713347341510,ECON 138,B00,490259,Bharadwaj; Prashant,15,0,35,20
1713347342538,ECON 159,A00,490260,Hendrickson; Gerald M.,0,9,0,0
1713347343572,ECON 178,A01,553995,Zhu; Ying,24,0,35,11
1713347344600,EDS 40,A01,512576,Black; Alison Michelle,20,0,20,0
1713347345628,EDS 107,A01,515848,Staff,30,0,30,0
1713347346658,EDS 110R,A01,490262,Staff,26,0,30,4
1713347347687,EDS 112,A01,490264,Chapman; Thandeka K,40,0,50,10
1713347348712,EDS 113,A00,490266,Staff,25,0,30,5
1713347349740,EDS 118,A00,490267,Warstadt; Melissa Fawn,18,0,30,12
1713347350765,EDS 124BR,A00,490268,Eguchi; Emi,4,0,25,21
1713347350765,EDS 124BR,B00,490269,Eguchi; Emi,23,0,25,2
1713347351797,EDS 126,A01,490271,Jones; Makeba,43,0,50,7
1713347352827,EDS 135,A01,490316,Staff,19,0,20,1
1713347353852,ENVR 142GS,A00,519514,Chang; Edmond Yi-Teh,26,0,28,2
1713347354879,ETHN 103,A00,490504,Staff,24,0,36,12
1713347355908,ETHN 103A,A00,490505,Man; Simeon S,3,0,9,6
1713347356939,ETHN 109,A00,490506,Staff,28,0,30,2
1713347357967,ETHN 118,A00,490507,Staff,35,0,36,1
1713347358995,ETHN 119,A00,490508,Staff,32,0,36,4
1713347360024,ETHN 121R,A00,490518,Choi; Esther Min,21,0,36,15
1713347361051,ETHN 127,A00,490528,Staff,14,0,15,1
1713347362081,ETHN 139,A00,490573,Staff,10,0,10,0
1713347363105,ETHN 150,A00,490575,Staff,15,0,15,0
1713347364132,GLBH 20,A00,491705,Elwardani; Nile Regina,38,0,40,2
1713347365156,GLBH 101,A00,491706,Staff,20,0,20,0
1713347366187,GLBH 111,A01,491708,Burgos; Jose L.,15,0,15,0
1713347367216,GLBH 146,A00,491709,Staff,8,0,20,12
1713347368246,GLBH 148,A00,491710,Olivas Hernandez; Olga Lid,10,0,20,10
1713347369278,GLBH 150,A00,491711,Sloane; Julia Kathryn,19,0,20,1
1713347370305,HIEA 131,A00,491760,Staff,28,0,32,4
1713347371332,HIEA 153,A00,491762,Staff,28,0,30,2
1713347372361,HIEU 124,A00,491811,Staff,26,0,32,6
1713347373385,HIEU 124GS,A00,491812,Markman; Kristina,27,0,28,1
1713347374412,HIEU 147,A00,491813,Staff,30,0,32,2
1713347375437,HIEU 149GS,A00,491816,Caldwell; Michael Alan,28,0,28,0
1713347376466,HILD 2C,A01,491713,Hendrickson; Gerald M.,26,0,30,4
1713347377547,HILD 7B,A01,491715,Kwak; Nancy,0,3,30,30
1713347378571,HILD 10,A01,491717,Staff,9,0,20,11
1713347379597,HILD 30GS,A00,491719,Edington; Claire Ellen,23,0,28,5
1713347380626,HINE 109,A00,491818,Shafir; Nir,26,0,32,6
1713347381652,HINE 128,A00,491821,Shafir; Nir,30,0,32,2
1713347382678,HISC 117,A00,491830,Staff,27,0,32,5
1713347383704,HIUS 103,A00,491834,Man; Simeon S,14,0,23,9
1713347384730,HIUS 108B,A00,491835,Staff,27,0,30,3
1713347385757,HIUS 141,A00,491836,Hendrickson; Gerald M.,28,0,32,4
1713347386783,HIUS 149,A00,491839,Staff,24,0,32,8
1713347387818,HUM 3,A01,512617,Crum; Matthew Stephen,42,0,50,8
1713347387818,HUM 3,A02,512618,Crum; Matthew Stephen,48,0,50,2
1713347388849,HUM 3GS,A00,512663,Markman; Kristina,0,0,0,1
1713347388849,HUM 3GS,B00,512664,Staff,0,0,0,0
1713347389879,HUM 4,A01,512620,West; Geoffrey Scott,23,0,50,27
1713347390906,HUM 4GS,A00,512666,Lyon; Antony J.,0,0,0,5
1713347391931,HUM 4R,A01,512625,Watkins; Eric,49,0,50,1
1713347392959,HUM 5,A01,512649,Zavodny; Tatiana Sophia,20,0,50,30
1713347392959,HUM 5,B01,512661,Zroka; Ryan Edward,48,0,50,2
1713347393987,INTL 190,A00,490577,Segui; Alan S,0,0,0,5
1713347395014,JAPN 20AR,A01,491267,Ross; Kayoko F,7,0,20,13
1713347396039,JAPN 180,A00,491285,Berman; Michael David,33,0,40,7
1713347397066,LATI 50,A01,502536,Kokinis; Troy Andreas,16,0,22,6
1713347397066,LATI 50,A02,502551,Kokinis; Troy Andreas,22,0,22,0
1713347397066,LATI 50,A03,502650,Kokinis; Troy Andreas,22,0,22,0
1713347397066,LATI 50,A04,502909,Kokinis; Troy Andreas,21,0,22,1
1713347398096,LATI 160,A01,502920,Kokinis; Troy Andreas,30,0,30,0
1713347399123,LIFR 1A,A00,490494,Van Moer; Vinciane G,17,0,20,3
1713347400154,LIFR 1AX,A00,490495,Van Moer; Vinciane G,17,0,20,3
1713347401181,LIFR 1B,A00,490496,Van Moer; Vinciane G,17,0,20,3
1713347402206,LIFR 1BX,A00,490497,Van Moer; Vinciane G,17,0,20,3
1713347403233,LIGN 8,A00,505198,McIntosh; Justin Daniel,134,0,150,16
1713347404259,LIGN 9GS,A00,491239,Lott; Margaret S.,18,0,20,2
1713347405288,LIGN 101,A01,505200,McIntosh; Justin Daniel,22,0,30,8
1713347406313,LIGN 120,A01,491244,Staff,22,0,30,8
1713347407340,LIGN 149GS,A00,491245,Lott; Margaret S.,18,0,20,2
1713347408366,LIGN 170,A00,491247,Staff,22,0,30,8
1713347409392,LISP 1D,A00,490498,Munoz Sanchez; Alicia,8,0,14,6
1713347409392,LISP 1D,B00,490499,Munoz Sanchez; Alicia,4,0,14,10
1713347409392,LISP 1D,C00,490500,Munoz Sanchez; Alicia,7,0,14,7
1713347409392,LISP 1D,D00,490501,Munoz Sanchez; Alicia,10,0,14,4
1713347410418,LISP 1DX,A00,490502,Munoz Sanchez; Alicia,11,0,28,17
1713347410418,LISP 1DX,B00,490503,Munoz Sanchez; Alicia,16,0,28,12
1713347412472,LTAM 110,A00,491847,Staff,22,0,25,3
1713347413501,LTCS 119,A00,491848,Staff,11,0,15,4
1713347414532,LTCS 130,A00,491849,Staff,24,0,25,1
1713347416589,LTEA 120C,A00,491852,Staff,32,0,40,8
1713347417615,LTEN 130GS,A00,491853,Lyon; Antony J.,23,0,28,5
1713347418641,LTEN 148,A00,491855,Staff,23,0,25,2
1713347419666,LTEN 159,A00,491856,Staff,20,0,25,5
1713347420692,LTEN 180,A00,491857,Staff,8,0,15,7
1713347422748,LTSP 123GS,A00,505928,Bessett; Ryan Matthew,24,0,28,4
1713347423772,LTSP 174GS,A00,506037,Bessett; Ryan Matthew,24,0,28,4
1713347425830,LTWR 102,A00,491861,Staff,9,0,15,6
1713347426855,LTWR 106,A00,491862,Staff,8,0,15,7
1713347427887,MAE 11,A00,490930,Bahadori; Mohammad Yousef,94,0,100,6
1713347428917,MAE 30A,A00,490931,Qi; Huihui,37,0,40,3
1713347429945,MAE 101A,A00,491036,Sadeghizadeh; Zahra,91,0,100,9
1713347430975,MAE 101C,A00,491037,Seshadri; Kalyanasundaram,63,0,100,37
1713347432003,MAE 113,A00,491040,Seshadri; Kalyanasundaram,64,0,80,16
1713347433030,MAE 131A,A00,491041,Ghazinejad; Maziar,37,0,40,3
1713347434059,MAE 142,A00,491053,Staff,39,0,40,1
1713347435084,MAE 143A,A00,491054,Staff,29,0,50,21
1713347436113,MAE 150,A00,491092,Truong; Phuong Thi Ngoc,23,0,35,12
1713347437141,MATH 3C,A01,494031,Pardo Guerra; Sebastian,30,0,30,0
1713347437141,MATH 3C,A02,494032,Pardo Guerra; Sebastian,29,0,30,1
1713347438167,MATH 10A,A01,494034,Staff,27,0,30,3
1713347438167,MATH 10A,A02,494035,Staff,28,0,30,2
1713347438167,MATH 10A,B01,494037,Staff,27,0,30,3
1713347438167,MATH 10A,B02,494038,Staff,29,0,30,1
1713347439204,MATH 10B,A01,494040,Habib; Yousaf,22,0,30,8
1713347439204,MATH 10B,A02,494041,Habib; Yousaf,28,0,30,2
1713347439204,MATH 10B,A03,494042,Habib; Yousaf,29,0,30,1
1713347439204,MATH 10B,A04,494043,Habib; Yousaf,30,0,30,0
1713347439204,MATH 10B,B01,494045,Habib; Yousaf,25,0,30,5
1713347439204,MATH 10B,B02,494046,Habib; Yousaf,30,0,30,0
1713347439204,MATH 10B,B03,494047,Habib; Yousaf,30,0,30,0
1713347439204,MATH 10B,B04,494048,Habib; Yousaf,30,0,30,0
1713347440239,MATH 18,A01,494050,Kemp; Todd Aahron,25,0,30,5
1713347440239,MATH 18,A02,494051,Kemp; Todd Aahron,29,0,30,1
1713347440239,MATH 18,B01,494054,Kemp; Todd Aahron,25,0,30,5
1713347440239,MATH 18,B02,494055,Kemp; Todd Aahron,29,0,30,1
1713347441265,MATH 20A,A01,494059,Suk; Andrew Hoon,30,0,30,0
1713347442293,MATH 20B,A01,494061,Briones; Jor-el Thomas Caparas,33,0,35,2
1713347442293,MATH 20B,B01,494063,Bach; Quang Tran,34,0,35,1
1713347443321,MATH 20C,A01,494065,Staff,28,0,30,2
1713347443321,MATH 20C,A02,494066,Staff,30,0,30,0
1713347443321,MATH 20C,A03,494067,Staff,30,0,30,0
1713347443321,MATH 20C,A04,494068,Staff,30,0,30,0
1713347443321,MATH 20C,B01,494070,Zhang; Ming,23,0,30,7
1713347443321,MATH 20C,B02,494071,Zhang; Ming,27,0,30,3
1713347443321,MATH 20C,B03,494072,Zhang; Ming,29,0,30,1
1713347443321,MATH 20C,B04,494073,Zhang; Ming,29,0,30,1
1713347444353,MATH 20D,A01,494075,Staff,22,0,30,8
1713347444353,MATH 20D,A02,494076,Staff,29,0,30,1
1713347445383,MATH 20E,A01,494079,Staff,24,0,30,6
1713347445383,MATH 20E,A02,494080,Staff,26,0,30,4
1713347445383,MATH 20E,B01,494082,Staff,25,0,30,5
1713347445383,MATH 20E,B02,494083,Staff,25,0,30,5
1713347446411,MATH 103A,A01,494085,Aliabadi Sr.; Mohsen,12,0,30,18
1713347446411,MATH 103A,A02,494086,Aliabadi Sr.; Mohsen,28,0,30,2
1713347446411,MATH 103A,B01,494088,Aliabadi Sr.; Mohsen,20,0,30,10
1713347446411,MATH 103A,B02,494089,Aliabadi Sr.; Mohsen,27,0,30,3
1713347447439,MATH 109,A01,494091,Staff,30,0,30,0
1713347447439,MATH 109,A02,494092,Staff,29,0,30,1
1713347447439,MATH 109,B01,494094,Staff,27,0,30,3
1713347447439,MATH 109,B02,494095,Staff,29,0,30,1
1713347448473,MATH 142A,A01,494097,Chow; Bennett,13,0,30,17
1713347448473,MATH 142A,A02,494098,Chow; Bennett,23,0,30,7
1713347448473,MATH 142A,B01,494100,Chow; Bennett,19,0,30,11
1713347448473,MATH 142A,B02,494101,Chow; Bennett,29,0,30,1
1713347450526,MATH 168A,A01,516677,Dumitriu; Ioana,16,0,35,19
1713347451556,MATH 170A,A01,516679,Dumitriu; Ioana,18,0,30,12
1713347451556,MATH 170A,A02,516680,Dumitriu; Ioana,28,0,30,2
1713347452586,MATH 193A,A01,494107,Staff,12,0,30,18
1713347452586,MATH 193A,A02,494108,Staff,18,0,30,12
1713347452586,MATH 193A,A03,494109,Staff,29,0,30,1
1713347452586,MATH 193A,A04,494110,Staff,22,0,30,8
1713347455672,MGT 16,A00,491930,McKay; Michael J,92,0,98,6
1713347456701,MGT 18,A00,491992,McKay; Michael J,96,0,98,2
1713347457726,MGT 71,A00,492003,Staff,63,0,98,35
1713347458769,MGT 103,A00,505209,Eberhard; Craig A,80,0,98,18
1713347459802,MGT 131A,A00,505210,Anderson; John Charles,89,0,98,9
1713347461856,MGT 153,A00,492077,Perols; Johan Lars,15,0,90,75
1713347464939,MGT 164,A00,492222,McKay; Mary A,91,0,98,7
1713347465966,MGT 172,A00,492245,Staff,59,0,60,1
1713347465966,MGT 172,B00,505526,Hedges; Kathleen,65,0,98,33
1713347466994,MGT 181,A00,505669,Dunn; Louis Jean,78,0,98,20
1713347468021,MMW 14,A01,494399,Staff,15,0,28,13
1713347468021,MMW 14,A02,494400,Staff,25,0,28,3
1713347468021,MMW 14,A03,494401,Staff,28,0,28,0
1713347468021,MMW 14,A04,494402,Staff,28,0,28,0
1713347468021,MMW 14,B01,494404,Carreras; Maria Victoria,8,0,28,20
1713347468021,MMW 14,B02,494405,Carreras; Maria Victoria,25,0,28,3
1713347468021,MMW 14,B03,494406,Carreras; Maria Victoria,27,0,28,1
1713347468021,MMW 14,B04,494407,Carreras; Maria Victoria,28,0,28,0
1713347469051,MMW 14GS,A00,506250,Chang; Edmond Yi-Teh,0,0,0,0
1713347470080,MMW 121R,A01,494415,Adamiak; Patrick John,9,0,28,19
1713347470080,MMW 121R,A02,494416,Adamiak; Patrick John,24,0,28,4
1713347471106,MUS 1A,A01,494113,Staff,12,0,25,13
1713347471106,MUS 1A,A02,494114,Staff,24,0,25,1
1713347472134,MUS 4,A01,494116,Staff,23,0,25,2
1713347472134,MUS 4,A02,494117,Staff,22,0,25,3
1713347473167,MUS 5R,A01,494236,Dubnov; Shlomo,4,0,25,21
1713347473167,MUS 5R,A02,494237,Dubnov; Shlomo,25,0,25,0
1713347474193,MUS 6,A01,494122,Staff,9,0,25,16
1713347474193,MUS 6,A02,494123,Staff,23,0,25,2
1713347475219,MUS 7,A01,494125,Staff,16,0,25,9
1713347475219,MUS 7,A02,494126,Staff,24,0,25,1
1713347476249,MUS 11,A01,494128,Staff,23,0,25,2
1713347476249,MUS 11,A02,494129,Staff,24,0,25,1
1713347477281,MUS 13,A01,494131,Staff,25,0,25,0
1713347477281,MUS 13,A02,494132,Staff,25,0,25,0
1713347478311,MUS 15,A01,494134,Staff,16,0,25,9
1713347478311,MUS 15,A02,494135,Staff,25,0,25,0
1713347478311,MUS 15,B01,494137,Staff,24,0,25,1
1713347479338,MUS 80,A00,494232,Staff,24,0,25,1
1713347479338,MUS 80,B00,494233,Staff,25,0,25,0
1713347479338,MUS 80,C00,494234,Staff,23,0,25,2
1713347480365,MUS 95C,A00,494141,Staff,69,0,75,6
1713347481446,MUS 114,A00,494142,Staff,39,0,50,11
1713347482472,NANO 15,A01,490636,Drews; Aaron,7,0,7,0
1713347483497,PHIL 1,A00,490578,Grush; Rick Scott,49,0,50,1
1713347484523,PHIL 10,A01,490580,Grush; Rick Scott,33,0,35,2
1713347484523,PHIL 10,A02,490586,Grush; Rick Scott,32,0,35,3
1713347485548,PHIL 27,A01,490591,Staff,22,0,25,3
1713347485548,PHIL 27,A02,490592,Staff,25,0,25,0
1713347485548,PHIL 27,A03,490593,Staff,25,0,25,0
1713347485548,PHIL 27,A04,490598,Staff,25,0,25,0
1713347486574,PHIL 32,A01,490611,Staff,20,0,20,0
1713347486574,PHIL 32,A02,490618,Staff,20,0,20,0
1713347487599,PHIL 90,A00,490624,Staff,40,0,40,0
1713347488625,PHIL 136,A00,490627,Cohen; Jonathan David,37,0,40,3
1713347489653,PHIL 155,A00,490634,Staff,61,0,70,9
1713347490681,PHYS 1A,A00,491610,Staff,245,0,250,5
1713347491712,PHYS 1AL,001,491616,Tsai; Philbert S,27,0,30,3
1713347491712,PHYS 1AL,002,491618,Tsai; Philbert S,30,0,30,0
1713347492738,PHYS 1B,A00,491623,Staff,235,0,250,15
1713347493767,PHYS 1BL,001,491626,Tsai; Philbert S,18,0,30,12
1713347493767,PHYS 1BL,002,491628,Tsai; Philbert S,26,0,30,4
1713347494794,PHYS 1C,A00,491632,Staff,211,0,245,34
1713347495819,PHYS 1CL,001,491635,Tsai; Philbert S,2,0,30,28
1713347495819,PHYS 1CL,002,491643,Tsai; Philbert S,22,0,30,8
1713347496851,PHYS 2AR,A01,491651,Meyertholen; Andrew D.,44,0,50,6
1713347497878,PHYS 2B,A01,491659,Staff,105,0,115,10
1713347498908,PHYS 2BL,A01,491685,Staff,21,0,24,3
1713347498908,PHYS 2BL,A02,491700,Staff,21,0,24,3
1713347499932,PHYS 2C,A01,505161,Staff,101,0,115,14
1713347500962,PHYS 4A,A01,491704,Grinstein; Benjamin,99,0,100,1
1713347501989,POLI 5D,A01,494144,Staff,3,0,5,2
1713347501989,POLI 5D,B01,626283,Dai; Yinlin,5,0,5,0
1713347503019,POLI 12,A00,494145,Staff,43,0,45,2
1713347504049,POLI 13R,A00,494146,Forman; Fonna,45,0,50,5
1713347505075,POLI 27,A01,494148,Staff,54,0,60,6
1713347506108,POLI 30,A00,494149,Staff,49,0,50,1
1713347507136,POLI 100DA,A00,494150,Staff,20,0,25,5
1713347509185,POLI 100I,A00,494152,Staff,27,0,30,3
1713347510211,POLI 104B,A00,494153,Smith; Glenn Chatmas,53,0,55,2
1713347511236,POLI 104F,A00,494154,Staff,28,0,30,2
1713347512260,POLI 104I,A00,494155,Smith; Glenn Chatmas,29,0,30,1
1713347513291,POLI 110C,A00,494156,Ingham; Sean,23,0,25,2
1713347514323,POLI 117R,A00,494157,Forman; Fonna,5,0,20,15
1713347515348,POLI 118,A00,494158,Ingham; Sean,21,0,25,4
1713347516373,POLI 120H,A00,494159,Fisk; David Lee,39,0,45,6
1713347517399,POLI 131CR,A00,494160,Hoston; Germaine,35,0,45,10
1713347518429,POLI 133J,A00,494161,Staff,31,0,35,4
1713347519457,POLI 135,A00,494162,Fisk; David Lee,33,0,35,2
1713347520489,POLI 140A,A00,494164,Staff,18,0,30,12
1713347521515,POLI 142I,A00,494165,Staff,30,0,30,0
1713347522544,POLI 144D,A00,494166,Staff,22,0,25,3
1713347523573,POLI 151,A00,494167,Staff,30,0,30,0
1713347524602,POLI 153,A00,494168,Staff,33,0,35,2
1713347525626,POLI 160AA,A00,494169,Staff,33,0,40,7
1713347526652,POLI 162,A00,494170,Mignozzetti; Umberto,17,0,25,8
1713347527679,POLI 171,A00,494171,Mignozzetti; Umberto,18,0,25,7
1713347528705,PSYC 1,A00,494172,Staff,95,0,100,5
1713347529734,PSYC 2,A00,494173,Moranton; Nirelia Melbina-,33,0,50,17
1713347530762,PSYC 3,A00,494174,Staff,29,0,30,1
1713347531788,PSYC 6,A00,494175,Staff,17,0,20,3
1713347532814,PSYC 60,A01,494177,Staff,37,0,45,8
1713347533839,PSYC 70,A01,505724,Geller; Emma Harlan,42,0,45,3
1713347534863,PSYC 101,A00,494180,Heyman; Gail D.,83,0,100,17
1713347535889,PSYC 105,A00,494181,Geller; Emma Harlan,51,0,90,39
1713347536916,PSYC 106,A00,494182,Dobkins; Karen R.,26,0,45,19
1713347537945,PSYC 108,A00,494183,Adrian; Julia Anna,89,0,100,11
1713347538974,PSYC 114,A01,494185,Winkielman; Piotr,0,4,30,30
1713347539997,PSYC 122,A00,494186,Moranton; Nirelia Melbina-,27,0,50,23
1713347541024,PSYC 124,A00,494187,Chapman; Eddie Nathaniel,69,0,80,11
1713347542049,PSYC 131,A00,494188,Anagnostaras; Stephan,39,0,80,41
1713347543075,PSYC 144,A00,494189,Staff,1,1,50,49
1713347544104,PSYC 154,A00,494190,Lacefield; Katharine I,105,0,180,75
1713347545135,PSYC 162,A00,494191,Wixted; John T,70,0,100,30
1713347546165,PSYC 172,A00,494192,Gorman; Michael R.,36,0,45,9
1713347547195,PSYC 178,A00,494193,Glaser; Dale,32,0,45,13
1713347548222,PSYC 193,A00,505725,Chapman; Eddie Nathaniel,20,0,20,0
1713347549253,RELI 145GS,A00,519817,Rahimi; Babak,17,0,20,3
1713347550279,SE 101A,A01,490862,Chadha; Mayank,23,0,25,2
1713347551305,SE 101C,A01,490924,Krysl; Petr,15,0,20,5
1713347552331,SE 110A,A01,490928,Staff,19,0,20,1
1713347553358,SE 130A,A00,490929,Morrison; Machel Leigh,54,0,70,16
1713347554385,SIO 1,A01,519325,Staff,39,0,40,1
1713347555410,SIO 30,A01,519327,Staff,38,0,40,2
1713347556435,SIO 40,A00,519328,Staff,39,0,40,1
1713347557462,SIO 46GS,A00,519819,Cook; Geoffrey W,15,0,25,10
1713347558490,SIO 109R,A00,494197,Forman; Fonna,0,3,20,20
1713347559516,SIO 121GS,A00,519827,Cook; Geoffrey W,15,0,25,10
1713347560546,SIO 132,A01,519330,Staff,38,0,40,2
1713347561571,SIO 133,A01,519397,Staff,37,0,40,3
1713347562603,SIO 139,A00,519396,Kacev; David,29,0,40,11
1713347563635,SOCI 1,A01,494199,Thorpe; Charles Robert,21,0,30,9
1713347563635,SOCI 1,A02,494200,Thorpe; Charles Robert,30,0,30,0
1713347563635,SOCI 1,A03,494201,Thorpe; Charles Robert,29,0,30,1
1713347563635,SOCI 1,A04,494202,Thorpe; Charles Robert,29,0,30,1
1713347563635,SOCI 1,A05,494203,Thorpe; Charles Robert,29,0,30,1
1713347563635,SOCI 1,A06,494204,Thorpe; Charles Robert,30,0,30,0
1713347563635,SOCI 1,A07,494205,Thorpe; Charles Robert,28,0,30,2
1713347564662,SOCI 60,A01,494207,Staff,33,0,40,7
1713347564662,SOCI 60,A02,494208,Staff,39,0,40,1
1713347565688,SOCI 100,A01,494210,Payne; Christine Anna,25,0,30,5
1713347565688,SOCI 100,A02,494211,Payne; Christine Anna,26,0,30,4
1713347566719,SOCI 109M,A00,494212,Staff,20,0,20,0
1713347567744,SOCI 110,A00,494213,Staff,34,0,40,6
1713347569797,SOCI 118E,A00,494215,Ng; Kwai,37,0,40,3
1713347570822,SOCI 125,A00,494216,Calderon-Zaks; Michael Aar,39,0,45,6
1713347571849,SOCI 126,A01,494218,Jones; Makeba,3,0,5,2
1713347572876,SOCI 131,A00,494219,Thorpe; Charles Robert,25,0,30,5
1713347574929,SOCI 135,A00,494221,Payne; Christine Anna,28,0,50,22
1713347575955,SOCI 136E,A00,626690,Ruiz; Jonathan Joseph,24,0,25,1
1713347576979,SOCI 138GS,A00,494222,Navon; Daniel,23,0,28,5
1713347579032,SOCI 145,A00,494224,Staff,40,0,45,5
1713347580063,SOCI 153,A00,494225,Staff,28,0,30,2
1713347581093,SOCI 160E,A00,494226,Ng; Kwai,27,0,40,13
1713347582118,SOCI 180,A00,494227,Staff,29,0,30,1
1713347583145,SOCI 189GS,A00,494228,Ribas Norris; Janet Vanesa,11,0,11,0
1713347584170,SOCI 190GS,A00,553232,Ribas Norris; Janet Vanesa,11,0,11,0
1713347585251,SOMI 220,A00,627178,Schneid; Stephen David,30,0,30,0
1713347586278,SYN 2,001,490768,Staff,13,0,15,2
1713347586278,SYN 2,002,490769,Staff,14,0,15,1
1713347586278,SYN 2,004,490775,Staff,0,0,0,0
1713347586278,SYN 2,003,490774,Staff,0,0,0,0
1713347586278,SYN 2,005,490776,Staff,0,0,0,0
1713347587304,SYN 2R,001,490779,Staff,10,0,15,5
1713347587304,SYN 2R,002,514635,Staff,14,0,15,1
1713347588331,SYN 100,A01,490783,Staff,8,0,20,12
1713347588331,SYN 100,B01,490787,Staff,10,0,20,10
1713347588331,SYN 100,C01,490789,Staff,10,0,20,10
1713347589357,SYN 150,A00,490817,Staff,14,0,15,1
1713347589357,SYN 150,B00,514610,Staff,15,0,15,0
1713347590387,TDAC 1,A00,492753,Walsh; Kim C.,19,0,20,1
1713347590387,TDAC 1,B00,492754,Harting; Carla Kelso,18,0,20,2
1713347590387,TDAC 1,C00,513995,Salovey; Todd,15,0,20,5
1713347591418,TDAC 101,A00,492766,Harting; Carla Kelso,17,0,20,3
1713347592447,TDAC 102,A00,492768,Basso; Beatrice,19,0,20,1
1713347593477,TDDE 111,A00,492769,Staff,25,0,25,0
1713347594514,TDDE 131,A00,492770,Staff,15,0,15,0
1713347594514,TDDE 131,B00,492771,Staff,15,0,15,0
1713347595538,TDDE 131GS,A00,523716,Guirguis; Mark C,23,0,28,5
1713347596569,TDGE 1,A01,492756,Salovey; Todd,56,0,60,4
1713347597595,TDGE 5,A01,492758,Staff,23,0,25,2
1713347598626,TDGE 10,A00,492759,Fulton; Julia,203,0,220,17
1713347599653,TDGE 11,A00,492760,Castro; Robert Jess,198,0,200,2
1713347601711,TDGE 124,A00,492772,Fulton; Julia,180,0,220,40
1713347602738,TDGE 125,A00,492773,Meyer; Ursula,38,0,50,12
1713347602738,TDGE 125,B00,492774,Staff,49,0,50,1
1713347602738,TDGE 125,C00,523565,Staff,48,0,50,2
1713347603763,TDGE 125GS,A00,523580,Guirguis; Mark C,23,0,28,5
1713347604791,TDGE 127,A00,492775,Havis; Allan,33,0,50,17
1713347605820,TDHT 101,A00,492776,Staff,34,0,35,1
1713347606847,TDMV 1,A00,492762,Caligagan; Maria T.,29,0,30,1
1713347606847,TDMV 1,B00,492763,Arcidiacono; Kristin,26,0,30,4
1713347607878,TDMV 2,A00,492764,Weinberg; Sadie,27,0,30,3
1713347608904,TDMV 3,A00,492765,Mack; Kara Shanai',37,0,40,3
1713347609934,TDMV 138,A00,492777,Mack; Kara Shanai',32,0,40,8
1713347610959,TDMV 140,A00,492778,Lima; Paulo Henrique,40,0,40,0
1713347611986,TDMV 142,A00,492779,Caligagan; Maria T.,33,0,40,7
1713347611986,TDMV 142,B00,492780,Caligagan; Tony,37,0,40,3
1713347613015,TDMV 143,A00,492781,Fyall; Daunte Edward,39,0,40,1
1713347614043,USP 1,A01,492401,Kwak; Nancy,27,0,35,8
1713347615068,USP 2,A01,492453,Hinds; Juli Beth,35,0,35,0
1713347616098,USP 3,A01,492516,Staff,28,0,35,7
1713347617126,USP 4,A00,492522,McTague; Sarah,16,0,25,9
1713347618150,USP 100,A00,492523,Staff,32,0,35,3
1713347619175,USP 101,A00,492524,Staff,13,0,15,2
1713347620199,USP 105,A00,492525,Staff,21,0,25,4
1713347621227,USP 151,A00,492526,Shenkman; Michael Thomas,32,0,35,3
1713347622255,USP 170,A00,492545,Hinds; Juli Beth,32,0,35,3
1713347623280,USP 171GS,A00,492608,Bussell; Mirle Rabinowitz,24,0,28,4
1713347624310,USP 183GS,A00,492613,Peerson; Susan,24,0,28,4
1713347625337,VIS 30,A01,490693,Yoldas; Pinar,19,0,22,3
1713347625337,VIS 30,A02,490694,Yoldas; Pinar,18,0,22,4
1713347626369,VIS 83,A00,490695,Kester; Grant,63,0,75,12
1713347627399,VIS 105D,A00,490696,Staff,22,0,25,3
1713347628423,VIS 124CN,A00,490699,Rose; Jordan M,64,0,75,11
1713347629452,VIS 125GS,A00,511221,Williams; Alena J,21,0,22,1
1713347630496,VIS 128D,A00,490700,Staff,73,0,75,2
1713347631521,VIS 151,A01,490717,Staff,33,0,34,1
1713347631521,VIS 151,A02,490766,Staff,32,0,34,2
1713347632547,VIS 154GS,A00,511972,Williams; Alena J,21,0,22,1
1713347633578,VIS 160A,A00,490767,Stone; Patricia,7,0,10,3
1713347634604,WCWP 10A,A00,490638,Staff,14,0,15,1
1713347634604,WCWP 10A,B00,490640,Staff,15,0,15,0
1713347635636,WCWP 10B,A00,490641,Staff,0,0,0,0
1713347635636,WCWP 10B,B00,490642,Staff,14,0,15,1
1713347635636,WCWP 10B,C00,490644,Staff,13,0,15,2
1713347635636,WCWP 10B,D00,490647,Staff,0,0,0,0
1713347636666,WCWP 100,A00,490655,Staff,0,0,0,0
1713347636666,WCWP 100,B00,490687,Staff,10,0,15,5
1713347638777,ANAR 153,A00,487222,Braswell; Geoffrey E.,53,0,60,7
1713347639806,ANBI 134,A00,487223,Staff,5,0,20,15
1713347640831,ANBI 143GS,A00,487224,Noel; Geoffroy Pierre Jean,18,0,24,6
1713347641857,ANBI 144GS,A00,519548,Noel; Geoffroy Pierre Jean,18,0,24,6
1713347642883,ANSC 101,A00,487225,Staff,17,0,20,3
1713347643910,ANSC 125,A00,487227,Brenner; Suzanne A,38,0,40,2
1713347645969,ANSC 146,A00,487229,Staff,35,0,40,5
1713347647000,ANSC 148,A00,487230,Olivas Hernandez; Olga Lid,39,0,40,1
1713347648031,ANSC 150,A00,504165,Sloane; Julia Kathryn,18,0,20,2
1713347649057,ANSC 180,A00,487232,Staff,14,0,15,1
1713347650083,ANSC 188,A00,627155,Staff,37,0,40,3
1713347651109,ANTH 5,A00,519529,Semendeferi; Ekaterini,15,0,15,0
1713347652135,ANTH 10,A00,487219,Staff,58,0,60,2
1713347653162,ANTH 23,A01,487221,Staff,17,0,20,3
1713347654192,ANTH 102,A00,487233,Wilder; Linnea Lorene,49,0,60,11
1713347655219,ANTH 103,A00,487234,Varma; Saiba,54,0,60,6
1713347656245,ANTH 105,A00,487235,Stewart; Alexander B,54,0,60,6
1713347657277,BENG 100,A01,516685,Taylor Amos; Alyssa C,25,0,30,5
1713347658304,BIBC 102,A01,491316,Flagg; Matthew Paul,5,0,88,83
1713347658304,BIBC 102,A02,491366,Flagg; Matthew Paul,78,0,88,10
1713347659330,BIBC 103,A01,491486,Boumechache; Miyyada,16,0,24,8
1713347659330,BIBC 103,A02,491487,Boumechache; Miyyada,24,0,24,0
1713347660356,BICD 100,A01,516882,Staff,72,0,75,3
1713347660356,BICD 100,A02,516890,Staff,69,0,75,6
1713347661383,BICD 102GS,A00,491488,Lo; Stanley M.,26,0,28,2
1713347662412,BIEB 136GS,A00,516940,Holway; David A. & Shurin; Jonathan,18,0,24,6
1713347663436,BIEB 137GS,A01,517034,Holway; David A. & Shurin; Jonathan,18,0,24,6
1713347664462,BIEB 138GS,A01,491492,Pirino; Giorgia,21,0,28,7
1713347665493,BILD 1,A01,491296,Staff,60,0,63,3
1713347665493,BILD 1,A02,491297,Staff,63,0,63,0
1713347666520,BILD 4,A01,517099,Gonzalez Gamboa; Ivonne,22,0,24,2
1713347666520,BILD 4,A02,517100,Gonzalez Gamboa; Ivonne,24,0,24,0
1713347667545,BILD 60GS,A00,491309,Lo; Stanley M.,26,0,28,2
1713347668577,BIMM 100,A01,517136,Staff,82,0,100,18
1713347669670,BIMM 110,A01,517182,Staff,52,0,100,48
1713347670697,BIMM 120,A01,517228,Pickett; Brooke Elizabeth,28,0,63,35
1713347670697,BIMM 120,A02,517240,Pickett; Brooke Elizabeth,44,0,63,19
1713347671727,BIMM 132GS,A01,491498,Pirino; Giorgia,21,0,28,7
1713347672755,BIMM 143,A01,491589,Bozinovic; Goran,12,0,40,28
1713347673787,BIPN 100,A01,491594,Armour; Jon Christopher,83,0,100,17
1713347674815,BIPN 140,A01,491602,Marino; Marc J,23,0,50,27
1713347676873,CAT 125,A00,515973,Staff,18,0,20,2
1713347677903,CAT 125GS,A00,515974,Rahimi; Babak,16,0,20,4
1713347678930,CAT 125R,A00,515980,Staff,12,0,20,8
1713347678930,CAT 125R,B00,515981,Tosun; Adriana,19,0,20,1
1713347678930,CAT 125R,C00,515987,Hyland; Tina Mae,0,5,20,20
1713347678930,CAT 125R,D00,515988,Bronstein; Phoebe Malan,16,0,20,4
1713347679957,CENG 15,A01,488699,Drews; Aaron,25,0,25,0
1713347680988,CENG 100,A00,505196,Opatkiewicz; Justin Paul,25,0,25,0
1713347682017,CGS 2A,A01,489598,Staff,32,0,35,3
1713347683048,CGS 112,A00,489599,Staff,15,0,15,0
1713347684072,CGS 119,A00,489603,Staff,10,0,10,0
1713347685098,CGS 120,A00,489604,Staff,13,0,15,2
1713347686125,CGS 150,A00,489607,Staff,15,0,15,0
1713347687152,CHEM 6A,A01,488715,Staff,97,0,100,3
1713347688178,CHEM 6B,A01,488719,Piercy; Marc Anthony,99,0,100,1
1713347689260,CHEM 6C,A01,488723,Albizati; Kim F.,93,0,100,7
1713347690288,CHEM 7L,A01,488728,Schurmeier; Kimberly,18,0,24,6
1713347690288,CHEM 7L,A02,488730,Schurmeier; Kimberly,23,0,24,1
1713347690288,CHEM 7L,A03,488734,Schurmeier; Kimberly,20,0,24,4
1713347690288,CHEM 7L,A04,488763,Schurmeier; Kimberly,23,0,24,1
1713347690288,CHEM 7L,B01,488798,Schurmeier; Kimberly,16,0,24,8
1713347690288,CHEM 7L,B02,488801,Schurmeier; Kimberly,22,0,24,2
1713347690288,CHEM 7L,B03,488808,Schurmeier; Kimberly,22,0,24,2
1713347690288,CHEM 7L,B04,488811,Schurmeier; Kimberly,24,0,24,0
1713347691316,CHEM 11,A01,488897,Stallings; Dontarie M,94,0,100,6
1713347692343,CHEM 40A,A01,488913,Albizati; Kim F.,83,0,100,17
1713347693373,CHEM 40B,A01,488920,Weizman; Haim,42,0,50,8
1713347693373,CHEM 40B,A02,488938,Weizman; Haim,43,0,50,7
1713347694404,CHEM 41A,A01,489029,Klosterman; Jeremy K,57,0,60,3
1713347695431,CHEM 41C,A01,500436,Tor; Yitzhak,54,0,60,6
1713347696466,CHEM 43A,A01,500426,Weizman; Haim,0,1,24,24
1713347696466,CHEM 43A,A02,500430,Weizman; Haim,6,0,24,18
1713347696466,CHEM 43A,B01,514041,Klosterman; Jeremy K,14,0,24,10
1713347696466,CHEM 43A,B02,514047,Klosterman; Jeremy K,23,0,24,1
1713347697497,CHEM 108,A01,489140,Jennings; Patricia A.,6,0,24,18
1713347697497,CHEM 108,A02,489142,Jennings; Patricia A.,14,0,24,10
1713347698527,CHEM 114A,A01,489147,Stallings; Dontarie M,65,0,100,35
1713347699556,CHIN 169A,A00,489171,Wang; Xiao,19,0,20,1
1713347701611,COGS 3,A01,518827,Boyle; Mary E. T.,25,0,40,15
1713347702639,COGS 11,A01,489175,Staff,27,0,30,3
1713347703670,COGS 14A,A01,518829,Staff,50,0,60,10
1713347704696,COGS 14B,A01,489177,Hoffman; Drew Ellen,62,0,75,13
1713347705726,COGS 100,A01,489181,Allen; Michael Gordon,62,0,75,13
1713347706751,COGS 101A,A01,489183,Staff,45,0,60,15
1713347707778,COGS 101B,A01,489185,Allen; Michael Gordon,6,0,30,24
1713347708809,COGS 101C,A01,526786,Staff,23,0,30,7
1713347710867,COGS 107A,A01,489189,Boyle; Mary E. T.,16,0,35,19
1713347711892,COGS 107B,A01,627144,Mooshagian; Eric Frederick,59,0,60,1
1713347712917,COGS 118A,A01,489191,Staff,0,46,40,40
1713347714974,COGS 171GS,A01,489194,Pineda; Jaime A,19,0,28,9
1713347716005,COGS 172,A01,489196,Staff,1,0,30,29
1713347717035,COGS 174GS,A01,489264,Pineda; Jaime A,19,0,28,9
1713347718064,COGS 180,A01,627150,Staff,28,0,30,2
1713347719092,COGS 186,A01,489274,Staff,0,3,30,30
1713347720116,COMM 10,A01,489276,Staff,23,0,25,2
1713347720116,COMM 10,A02,489303,Staff,23,0,25,2
1713347721146,COMM 100A,A01,489312,Staff,14,0,25,11
1713347721146,COMM 100A,A02,489313,Staff,24,0,25,1
1713347722172,COMM 106T,A00,512540,Staff,33,0,35,2
1713347723195,COMM 107,A00,489347,Staff,27,0,35,8
1713347724220,COMM 109P,A00,489358,Staff,31,0,35,4
1713347725245,COMM 132,A00,489361,McKenna; Denise,27,0,30,3
1713347726271,COMM 146,A00,489362,Halm; Gavin Patrick,26,0,30,4
1713347727296,COMM 190,A00,489363,Abuelhiga; Soraya Jill,17,0,23,6
1713347728325,CSE 8A,A50,489366,Staff,21,0,25,4
1713347728325,CSE 8A,A51,489367,Staff,24,0,25,1
1713347729349,CSE 11,A01,489398,Cao; Yingjun,72,0,100,28
1713347730380,CSE 12,A01,489487,Staff,43,0,50,7
1713347731410,CSE 20,A01,489497,Staff,47,0,50,3
1713347732441,CSE 21,A01,489517,Braun; Oliver,42,0,50,8
1713347733470,CSE 101,A01,489524,Braun; Oliver,0,35,50,50
1713347734502,CSE 105,A01,512594,Jones; Miles E,72,0,100,28
1713347734502,CSE 105,B01,512598,Jones; Miles E,51,0,100,49
1713347735530,CSE 140,A01,489538,Staff,39,0,50,11
1713347736555,CSE 141,A01,489550,Eldon; John,67,0,100,33
1713347737585,CSE 141L,A01,489571,Eldon; John,65,0,100,35
1713347738611,CSE 151A,A01,489583,Solares; Edwin A,139,0,200,61
1713347739636,CSE 175,A01,510886,Kumar; Rakesh,30,0,30,0
1713347740663,CSE 190,A00,516828,Dubnov; Shlomo,37,0,49,12
1713347741689,DOC 100D,A00,489667,Pass; Natalye Joann,19,0,25,6
1713347742716,DSC 10,A01,624268,Staff,72,0,75,3
1713347743745,DSC 20,A01,624476,Staff,50,0,50,0
1713347744770,DSC 40A,A01,624608,Staff,39,0,40,1
1713347745797,DSGN 1,A01,489179,Rill; Bryan,32,0,50,18
1713347746824,ECE 17,A01,490489,Sahay; Rajeev,18,0,30,12
1713347747850,ECE 65,A50,490492,Staff,11,0,20,9
1713347747850,ECE 65,A51,490493,Staff,18,0,20,2
1713347748884,ECON 1,A01,489715,Famulari; Melissa,67,0,70,3
1713347749912,ECON 2,A01,489717,Levkoff; Steven B.,67,0,70,3
1713347750944,ECON 3,A01,489948,Staff,70,0,70,0
1713347752999,ECON 5,A01,490103,Staff,27,0,30,3
1713347752999,ECON 5,B01,626281,Dai; Yinlin,45,0,45,0
1713347754030,ECON 100A,A01,490127,Famulari; Melissa,62,0,70,8
1713347755059,ECON 100B,A01,490129,Staff,64,0,70,6
1713347756090,ECON 109,A01,490187,Shishkin; Denis,27,0,35,8
1713347757113,ECON 110A,A01,490190,Levkoff; Steven B.,59,0,70,11
1713347758137,ECON 120A,A01,490245,Dai; Yinlin,59,0,70,11
1713347759164,ECON 120B,A01,490247,Nieto-Barthaburu; Augusto,40,0,70,30
1713347760192,ECON 120C,A01,490253,Sun; Yixiao,30,0,35,5
1713347760192,ECON 120C,B01,490255,Sun; Yixiao,34,0,35,1
1713347761224,ECON 129,A00,490256,Eckert; Fabian Paul,22,0,35,13
1713347762248,ECON 131,A00,490257,Nieto-Barthaburu; Augusto,0,6,35,35
1713347763275,ECON 138,A00,490258,Bharadwaj; Prashant,13,0,35,22
1713347763275,ECON 138,B00,490259,Bharadwaj; Prashant,15,0,35,20
1713347764301,ECON 159,A00,490260,Hendrickson; Gerald M.,0,9,0,0
1713347765332,ECON 178,A01,553995,Zhu; Ying,24,0,35,11
1713347766360,EDS 40,A01,512576,Black; Alison Michelle,20,0,20,0
1713347767388,EDS 107,A01,515848,Staff,30,0,30,0
1713347768414,EDS 110R,A01,490262,Staff,26,0,30,4
1713347769440,EDS 112,A01,490264,Chapman; Thandeka K,40,0,50,10
1713347770465,EDS 113,A00,490266,Staff,25,0,30,5
1713347771491,EDS 118,A00,490267,Warstadt; Melissa Fawn,18,0,30,12
1713347772515,EDS 124BR,A00,490268,Eguchi; Emi,4,0,25,21
1713347772515,EDS 124BR,B00,490269,Eguchi; Emi,23,0,25,2
1713347773545,EDS 126,A01,490271,Jones; Makeba,43,0,50,7
1713347774573,EDS 135,A01,490316,Staff,19,0,20,1
1713347775604,ENVR 142GS,A00,519514,Chang; Edmond Yi-Teh,26,0,28,2
1713347776633,ETHN 103,A00,490504,Staff,24,0,36,12
1713347777661,ETHN 103A,A00,490505,Man; Simeon S,3,0,9,6
1713347778688,ETHN 109,A00,490506,Staff,28,0,30,2
1713347779716,ETHN 118,A00,490507,Staff,35,0,36,1
1713347780745,ETHN 119,A00,490508,Staff,32,0,36,4
1713347781778,ETHN 121R,A00,490518,Choi; Esther Min,21,0,36,15
1713347782806,ETHN 127,A00,490528,Staff,14,0,15,1
1713347783835,ETHN 139,A00,490573,Staff,10,0,10,0
1713347784862,ETHN 150,A00,490575,Staff,15,0,15,0
1713347785890,GLBH 20,A00,491705,Elwardani; Nile Regina,38,0,40,2
1713347786915,GLBH 101,A00,491706,Staff,20,0,20,0
1713347787947,GLBH 111,A01,491708,Burgos; Jose L.,15,0,15,0
1713347788976,GLBH 146,A00,491709,Staff,8,0,20,12
1713347790000,GLBH 148,A00,491710,Olivas Hernandez; Olga Lid,10,0,20,10
1713347791025,GLBH 150,A00,491711,Sloane; Julia Kathryn,19,0,20,1
1713347792052,HIEA 131,A00,491760,Staff,28,0,32,4
1713347793132,HIEA 153,A00,491762,Staff,28,0,30,2
1713347794157,HIEU 124,A00,491811,Staff,26,0,32,6
1713347795182,HIEU 124GS,A00,491812,Markman; Kristina,27,0,28,1
1713347796208,HIEU 147,A00,491813,Staff,30,0,32,2
1713347797233,HIEU 149GS,A00,491816,Caldwell; Michael Alan,28,0,28,0
1713347798265,HILD 2C,A01,491713,Hendrickson; Gerald M.,26,0,30,4
1713347799294,HILD 7B,A01,491715,Kwak; Nancy,0,3,30,30
1713347800322,HILD 10,A01,491717,Staff,9,0,20,11
1713347801346,HILD 30GS,A00,491719,Edington; Claire Ellen,23,0,28,5
1713347802375,HINE 109,A00,491818,Shafir; Nir,26,0,32,6
1713347803404,HINE 128,A00,491821,Shafir; Nir,30,0,32,2
1713347804431,HISC 117,A00,491830,Staff,27,0,32,5
1713347805459,HIUS 103,A00,491834,Man; Simeon S,14,0,23,9
1713347806484,HIUS 108B,A00,491835,Staff,27,0,30,3
1713347807512,HIUS 141,A00,491836,Hendrickson; Gerald M.,28,0,32,4
1713347808535,HIUS 149,A00,491839,Staff,24,0,32,8
1713347809562,HUM 3,A01,512617,Crum; Matthew Stephen,42,0,50,8
1713347809562,HUM 3,A02,512618,Crum; Matthew Stephen,48,0,50,2
1713347810589,HUM 3GS,A00,512663,Markman; Kristina,0,0,0,1
1713347810589,HUM 3GS,B00,512664,Staff,0,0,0,0
1713347811616,HUM 4,A01,512620,West; Geoffrey Scott,23,0,50,27
1713347812644,HUM 4GS,A00,512666,Lyon; Antony J.,0,0,0,5
1713347813690,HUM 4R,A01,512625,Watkins; Eric,49,0,50,1
1713347814717,HUM 5,A01,512649,Zavodny; Tatiana Sophia,20,0,50,30
1713347814717,HUM 5,B01,512661,Zroka; Ryan Edward,48,0,50,2
1713347815748,INTL 190,A00,490577,Segui; Alan S,0,0,0,5
1713347816774,JAPN 20AR,A01,491267,Ross; Kayoko F,7,0,20,13
1713347817805,JAPN 180,A00,491285,Berman; Michael David,33,0,40,7
1713347818837,LATI 50,A01,502536,Kokinis; Troy Andreas,16,0,22,6
1713347818837,LATI 50,A02,502551,Kokinis; Troy Andreas,22,0,22,0
1713347818837,LATI 50,A03,502650,Kokinis; Troy Andreas,22,0,22,0
1713347818837,LATI 50,A04,502909,Kokinis; Troy Andreas,21,0,22,1
1713347819863,LATI 160,A01,502920,Kokinis; Troy Andreas,30,0,30,0
1713347820893,LIFR 1A,A00,490494,Van Moer; Vinciane G,17,0,20,3
1713347821919,LIFR 1AX,A00,490495,Van Moer; Vinciane G,17,0,20,3
1713347822946,LIFR 1B,A00,490496,Van Moer; Vinciane G,17,0,20,3
1713347823973,LIFR 1BX,A00,490497,Van Moer; Vinciane G,17,0,20,3
1713347824998,LIGN 8,A00,505198,McIntosh; Justin Daniel,134,0,150,16
1713347826025,LIGN 9GS,A00,491239,Lott; Margaret S.,18,0,20,2
1713347827052,LIGN 101,A01,505200,McIntosh; Justin Daniel,22,0,30,8
1713347828078,LIGN 120,A01,491244,Staff,22,0,30,8
1713347829104,LIGN 149GS,A00,491245,Lott; Margaret S.,18,0,20,2
1713347830131,LIGN 170,A00,491247,Staff,22,0,30,8
1713347831158,LISP 1D,A00,490498,Munoz Sanchez; Alicia,8,0,14,6
1713347831158,LISP 1D,B00,490499,Munoz Sanchez; Alicia,4,0,14,10
1713347831158,LISP 1D,C00,490500,Munoz Sanchez; Alicia,7,0,14,7
1713347831158,LISP 1D,D00,490501,Munoz Sanchez; Alicia,10,0,14,4
1713347832186,LISP 1DX,A00,490502,Munoz Sanchez; Alicia,11,0,28,17
1713347832186,LISP 1DX,B00,490503,Munoz Sanchez; Alicia,16,0,28,12
1713347834236,LTAM 110,A00,491847,Staff,22,0,25,3
1713347835265,LTCS 119,A00,491848,Staff,11,0,15,4
1713347836290,LTCS 130,A00,491849,Staff,24,0,25,1
1713347838341,LTEA 120C,A00,491852,Staff,32,0,40,8
1713347839364,LTEN 130GS,A00,491853,Lyon; Antony J.,23,0,28,5
1713347840388,LTEN 148,A00,491855,Staff,23,0,25,2
1713347841415,LTEN 159,A00,491856,Staff,20,0,25,5
1713347842445,LTEN 180,A00,491857,Staff,8,0,15,7
1713347844500,LTSP 123GS,A00,505928,Bessett; Ryan Matthew,24,0,28,4
1713347845529,LTSP 174GS,A00,506037,Bessett; Ryan Matthew,24,0,28,4
1713347847582,LTWR 102,A00,491861,Staff,9,0,15,6
1713347848611,LTWR 106,A00,491862,Staff,8,0,15,7
1713347849639,MAE 11,A00,490930,Bahadori; Mohammad Yousef,94,0,100,6
1713347850667,MAE 30A,A00,490931,Qi; Huihui,37,0,40,3
1713347851693,MAE 101A,A00,491036,Sadeghizadeh; Zahra,91,0,100,9
1713347852724,MAE 101C,A00,491037,Seshadri; Kalyanasundaram,63,0,100,37
1713347853751,MAE 113,A00,491040,Seshadri; Kalyanasundaram,64,0,80,16
1713347854780,MAE 131A,A00,491041,Ghazinejad; Maziar,37,0,40,3
1713347855805,MAE 142,A00,491053,Staff,39,0,40,1
1713347856834,MAE 143A,A00,491054,Staff,29,0,50,21
1713347857862,MAE 150,A00,491092,Truong; Phuong Thi Ngoc,23,0,35,12
1713347858892,MATH 3C,A01,494031,Pardo Guerra; Sebastian,30,0,30,0
1713347858892,MATH 3C,A02,494032,Pardo Guerra; Sebastian,29,0,30,1
1713347859922,MATH 10A,A01,494034,Staff,27,0,30,3
1713347859922,MATH 10A,A02,494035,Staff,28,0,30,2
1713347859922,MATH 10A,B01,494037,Staff,27,0,30,3
1713347859922,MATH 10A,B02,494038,Staff,29,0,30,1
1713347860952,MATH 10B,A01,494040,Habib; Yousaf,22,0,30,8
1713347860952,MATH 10B,A02,494041,Habib; Yousaf,28,0,30,2
1713347860952,MATH 10B,A03,494042,Habib; Yousaf,29,0,30,1
1713347860952,MATH 10B,A04,494043,Habib; Yousaf,30,0,30,0
1713347860952,MATH 10B,B01,494045,Habib; Yousaf,25,0,30,5
1713347860952,MATH 10B,B02,494046,Habib; Yousaf,30,0,30,0
1713347860952,MATH 10B,B03,494047,Habib; Yousaf,30,0,30,0
1713347860952,MATH 10B,B04,494048,Habib; Yousaf,30,0,30,0
1713347861980,MATH 18,A01,494050,Kemp; Todd Aahron,25,0,30,5
1713347861980,MATH 18,A02,494051,Kemp; Todd Aahron,29,0,30,1
1713347861980,MATH 18,B01,494054,Kemp; Todd Aahron,25,0,30,5
1713347861980,MATH 18,B02,494055,Kemp; Todd Aahron,29,0,30,1
1713347863010,MATH 20A,A01,494059,Suk; Andrew Hoon,30,0,30,0
1713347864042,MATH 20B,A01,494061,Briones; Jor-el Thomas Caparas,33,0,35,2
1713347864042,MATH 20B,B01,494063,Bach; Quang Tran,34,0,35,1
1713347865072,MATH 20C,A01,494065,Staff,28,0,30,2
1713347865072,MATH 20C,A02,494066,Staff,30,0,30,0
1713347865072,MATH 20C,A03,494067,Staff,30,0,30,0
1713347865072,MATH 20C,A04,494068,Staff,30,0,30,0
1713347865072,MATH 20C,B01,494070,Zhang; Ming,23,0,30,7
1713347865072,MATH 20C,B02,494071,Zhang; Ming,27,0,30,3
1713347865072,MATH 20C,B03,494072,Zhang; Ming,29,0,30,1
1713347865072,MATH 20C,B04,494073,Zhang; Ming,29,0,30,1
1713347866099,MATH 20D,A01,494075,Staff,22,0,30,8
1713347866099,MATH 20D,A02,494076,Staff,29,0,30,1
1713347867127,MATH 20E,A01,494079,Staff,24,0,30,6
1713347867127,MATH 20E,A02,494080,Staff,26,0,30,4
1713347867127,MATH 20E,B01,494082,Staff,25,0,30,5
1713347867127,MATH 20E,B02,494083,Staff,25,0,30,5
1713347868159,MATH 103A,A01,494085,Aliabadi Sr.; Mohsen,12,0,30,18
1713347868159,MATH 103A,A02,494086,Aliabadi Sr.; Mohsen,28,0,30,2
1713347868159,MATH 103A,B01,494088,Aliabadi Sr.; Mohsen,20,0,30,10
1713347868159,MATH 103A,B02,494089,Aliabadi Sr.; Mohsen,27,0,30,3
1713347869185,MATH 109,A01,494091,Staff,30,0,30,0
1713347869185,MATH 109,A02,494092,Staff,29,0,30,1
1713347869185,MATH 109,B01,494094,Staff,27,0,30,3
1713347869185,MATH 109,B02,494095,Staff,29,0,30,1
1713347870213,MATH 142A,A01,494097,Chow; Bennett,13,0,30,17
1713347870213,MATH 142A,A02,494098,Chow; Bennett,23,0,30,7
1713347870213,MATH 142A,B01,494100,Chow; Bennett,19,0,30,11
1713347870213,MATH 142A,B02,494101,Chow; Bennett,29,0,30,1
1713347872277,MATH 168A,A01,516677,Dumitriu; Ioana,16,0,35,19
1713347873303,MATH 170A,A01,516679,Dumitriu; Ioana,18,0,30,12
1713347873303,MATH 170A,A02,516680,Dumitriu; Ioana,28,0,30,2
1713347874330,MATH 193A,A01,494107,Staff,12,0,30,18
1713347874330,MATH 193A,A02,494108,Staff,18,0,30,12
1713347874330,MATH 193A,A03,494109,Staff,29,0,30,1
1713347874330,MATH 193A,A04,494110,Staff,22,0,30,8
1713347877410,MGT 16,A00,491930,McKay; Michael J,92,0,98,6
1713347878439,MGT 18,A00,491992,McKay; Michael J,96,0,98,2
1713347879463,MGT 71,A00,492003,Staff,63,0,98,35
1713347880489,MGT 103,A00,505209,Eberhard; Craig A,80,0,98,18
1713347881520,MGT 131A,A00,505210,Anderson; John Charles,89,0,98,9
1713347883573,MGT 153,A00,492077,Perols; Johan Lars,15,0,90,75
1713347886655,MGT 164,A00,492222,McKay; Mary A,91,0,98,7
1713347887685,MGT 172,A00,492245,Staff,59,0,60,1
1713347887685,MGT 172,B00,505526,Hedges; Kathleen,65,0,98,33
1713347888716,MGT 181,A00,505669,Dunn; Louis Jean,78,0,98,20
1713347889743,MMW 14,A01,494399,Staff,15,0,28,13
1713347889743,MMW 14,A02,494400,Staff,25,0,28,3
1713347889743,MMW 14,A03,494401,Staff,28,0,28,0
1713347889743,MMW 14,A04,494402,Staff,28,0,28,0
1713347889743,MMW 14,B01,494404,Carreras; Maria Victoria,8,0,28,20
1713347889743,MMW 14,B02,494405,Carreras; Maria Victoria,25,0,28,3
1713347889743,MMW 14,B03,494406,Carreras; Maria Victoria,27,0,28,1
1713347889743,MMW 14,B04,494407,Carreras; Maria Victoria,28,0,28,0
1713347890770,MMW 14GS,A00,506250,Chang; Edmond Yi-Teh,0,0,0,0
1713347891796,MMW 121R,A01,494415,Adamiak; Patrick John,9,0,28,19
1713347891796,MMW 121R,A02,494416,Adamiak; Patrick John,24,0,28,4
1713347892828,MUS 1A,A01,494113,Staff,12,0,25,13
1713347892828,MUS 1A,A02,494114,Staff,24,0,25,1
1713347893873,MUS 4,A01,494116,Staff,23,0,25,2
1713347893873,MUS 4,A02,494117,Staff,22,0,25,3
1713347894904,MUS 5R,A01,494236,Dubnov; Shlomo,4,0,25,21
1713347894904,MUS 5R,A02,494237,Dubnov; Shlomo,25,0,25,0
1713347895934,MUS 6,A01,494122,Staff,9,0,25,16
1713347895934,MUS 6,A02,494123,Staff,23,0,25,2
1713347897018,MUS 7,A01,494125,Staff,16,0,25,9
1713347897018,MUS 7,A02,494126,Staff,24,0,25,1
1713347898043,MUS 11,A01,494128,Staff,23,0,25,2
1713347898043,MUS 11,A02,494129,Staff,24,0,25,1
1713347899075,MUS 13,A01,494131,Staff,25,0,25,0
1713347899075,MUS 13,A02,494132,Staff,25,0,25,0
1713347900102,MUS 15,A01,494134,Staff,16,0,25,9
1713347900102,MUS 15,A02,494135,Staff,25,0,25,0
1713347900102,MUS 15,B01,494137,Staff,24,0,25,1
1713347901128,MUS 80,A00,494232,Staff,24,0,25,1
1713347901128,MUS 80,B00,494233,Staff,25,0,25,0
1713347901128,MUS 80,C00,494234,Staff,23,0,25,2
1713347902154,MUS 95C,A00,494141,Staff,69,0,75,6
1713347903180,MUS 114,A00,494142,Staff,39,0,50,11
1713347904208,NANO 15,A01,490636,Drews; Aaron,7,0,7,0
1713347905242,PHIL 1,A00,490578,Grush; Rick Scott,49,0,50,1
1713347906269,PHIL 10,A01,490580,Grush; Rick Scott,33,0,35,2
1713347906269,PHIL 10,A02,490586,Grush; Rick Scott,32,0,35,3
1713347907298,PHIL 27,A01,490591,Staff,22,0,25,3
1713347907298,PHIL 27,A02,490592,Staff,25,0,25,0
1713347907298,PHIL 27,A03,490593,Staff,25,0,25,0
1713347907298,PHIL 27,A04,490598,Staff,25,0,25,0
1713347908325,PHIL 32,A01,490611,Staff,20,0,20,0
1713347908325,PHIL 32,A02,490618,Staff,20,0,20,0
1713347909351,PHIL 90,A00,490624,Staff,40,0,40,0
1713347910382,PHIL 136,A00,490627,Cohen; Jonathan David,37,0,40,3
1713347911407,PHIL 155,A00,490634,Staff,61,0,70,9
1713347912439,PHYS 1A,A00,491610,Staff,245,0,250,5
1713347913464,PHYS 1AL,001,491616,Tsai; Philbert S,27,0,30,3
1713347913464,PHYS 1AL,002,491618,Tsai; Philbert S,30,0,30,0
1713347914490,PHYS 1B,A00,491623,Staff,235,0,250,15
1713347915519,PHYS 1BL,001,491626,Tsai; Philbert S,18,0,30,12
1713347915519,PHYS 1BL,002,491628,Tsai; Philbert S,26,0,30,4
1713347916543,PHYS 1C,A00,491632,Staff,211,0,245,34
1713347917572,PHYS 1CL,001,491635,Tsai; Philbert S,2,0,30,28
1713347917572,PHYS 1CL,002,491643,Tsai; Philbert S,22,0,30,8
1713347918599,PHYS 2AR,A01,491651,Meyertholen; Andrew D.,44,0,50,6
1713347919625,PHYS 2B,A01,491659,Staff,105,0,115,10
1713347920651,PHYS 2BL,A01,491685,Staff,21,0,24,3
1713347920651,PHYS 2BL,A02,491700,Staff,21,0,24,3
1713347921678,PHYS 2C,A01,505161,Staff,101,0,115,14
1713347922709,PHYS 4A,A01,491704,Grinstein; Benjamin,99,0,100,1
1713347923737,POLI 5D,A01,494144,Staff,3,0,5,2
1713347923737,POLI 5D,B01,626283,Dai; Yinlin,5,0,5,0
1713347924765,POLI 12,A00,494145,Staff,43,0,45,2
1713347925791,POLI 13R,A00,494146,Forman; Fonna,45,0,50,5
1713347926819,POLI 27,A01,494148,Staff,54,0,60,6
1713347927845,POLI 30,A00,494149,Staff,49,0,50,1
1713347928872,POLI 100DA,A00,494150,Staff,20,0,25,5
1713347930926,POLI 100I,A00,494152,Staff,27,0,30,3
1713347931954,POLI 104B,A00,494153,Smith; Glenn Chatmas,53,0,55,2
1713347932980,POLI 104F,A00,494154,Staff,28,0,30,2
1713347934006,POLI 104I,A00,494155,Smith; Glenn Chatmas,29,0,30,1
1713347935032,POLI 110C,A00,494156,Ingham; Sean,23,0,25,2
1713347936057,POLI 117R,A00,494157,Forman; Fonna,5,0,20,15
1713347937082,POLI 118,A00,494158,Ingham; Sean,21,0,25,4
1713347938109,POLI 120H,A00,494159,Fisk; David Lee,39,0,45,6
1713347939133,POLI 131CR,A00,494160,Hoston; Germaine,35,0,45,10
1713347940164,POLI 133J,A00,494161,Staff,31,0,35,4
1713347941195,POLI 135,A00,494162,Fisk; David Lee,33,0,35,2
1713347942222,POLI 140A,A00,494164,Staff,18,0,30,12
1713347943248,POLI 142I,A00,494165,Staff,30,0,30,0
1713347944276,POLI 144D,A00,494166,Staff,22,0,25,3
1713347945302,POLI 151,A00,494167,Staff,30,0,30,0
1713347946332,POLI 153,A00,494168,Staff,33,0,35,2
1713347947359,POLI 160AA,A00,494169,Staff,33,0,40,7
1713347948385,POLI 162,A00,494170,Mignozzetti; Umberto,17,0,25,8
1713347949414,POLI 171,A00,494171,Mignozzetti; Umberto,18,0,25,7
1713347950439,PSYC 1,A00,494172,Staff,95,0,100,5
1713347951465,PSYC 2,A00,494173,Moranton; Nirelia Melbina-,33,0,50,17
1713347952490,PSYC 3,A00,494174,Staff,29,0,30,1
1713347953515,PSYC 6,A00,494175,Staff,17,0,20,3
1713347954544,PSYC 60,A01,494177,Staff,37,0,45,8
1713347955572,PSYC 70,A01,505724,Geller; Emma Harlan,42,0,45,3
1713347956599,PSYC 101,A00,494180,Heyman; Gail D.,83,0,100,17
1713347957625,PSYC 105,A00,494181,Geller; Emma Harlan,51,0,90,39
1713347958651,PSYC 106,A00,494182,Dobkins; Karen R.,26,0,45,19
1713347959681,PSYC 108,A00,494183,Adrian; Julia Anna,89,0,100,11
1713347960711,PSYC 114,A01,494185,Winkielman; Piotr,0,4,30,30
1713347961742,PSYC 122,A00,494186,Moranton; Nirelia Melbina-,27,0,50,23
1713347962772,PSYC 124,A00,494187,Chapman; Eddie Nathaniel,69,0,80,11
1713347963801,PSYC 131,A00,494188,Anagnostaras; Stephan,39,0,80,41
1713347964827,PSYC 144,A00,494189,Staff,1,1,50,49
1713347965854,PSYC 154,A00,494190,Lacefield; Katharine I,105,0,180,75
1713347966883,PSYC 162,A00,494191,Wixted; John T,70,0,100,30
1713347967910,PSYC 172,A00,494192,Gorman; Michael R.,36,0,45,9
1713347968936,PSYC 178,A00,494193,Glaser; Dale,32,0,45,13
1713347969962,PSYC 193,A00,505725,Chapman; Eddie Nathaniel,20,0,20,0
1713347970987,RELI 145GS,A00,519817,Rahimi; Babak,17,0,20,3
1713347972018,SE 101A,A01,490862,Chadha; Mayank,23,0,25,2
1713347973050,SE 101C,A01,490924,Krysl; Petr,15,0,20,5
1713347974076,SE 110A,A01,490928,Staff,19,0,20,1
1713347975103,SE 130A,A00,490929,Morrison; Machel Leigh,54,0,70,16
1713347976129,SIO 1,A01,519325,Staff,39,0,40,1
1713347977159,SIO 30,A01,519327,Staff,38,0,40,2
1713347978184,SIO 40,A00,519328,Staff,39,0,40,1
1713347979215,SIO 46GS,A00,519819,Cook; Geoffrey W,15,0,25,10
1713347980245,SIO 109R,A00,494197,Forman; Fonna,0,3,20,20
1713347981270,SIO 121GS,A00,519827,Cook; Geoffrey W,15,0,25,10
1713347982294,SIO 132,A01,519330,Staff,38,0,40,2
1713347983319,SIO 133,A01,519397,Staff,37,0,40,3
1713347984351,SIO 139,A00,519396,Kacev; David,29,0,40,11
1713347985379,SOCI 1,A01,494199,Thorpe; Charles Robert,21,0,30,9
1713347985379,SOCI 1,A02,494200,Thorpe; Charles Robert,30,0,30,0
1713347985379,SOCI 1,A03,494201,Thorpe; Charles Robert,29,0,30,1
1713347985379,SOCI 1,A04,494202,Thorpe; Charles Robert,29,0,30,1
1713347985379,SOCI 1,A05,494203,Thorpe; Charles Robert,29,0,30,1
1713347985379,SOCI 1,A06,494204,Thorpe; Charles Robert,30,0,30,0
1713347985379,SOCI 1,A07,494205,Thorpe; Charles Robert,28,0,30,2
1713347986408,SOCI 60,A01,494207,Staff,33,0,40,7
1713347986408,SOCI 60,A02,494208,Staff,39,0,40,1
1713347987439,SOCI 100,A01,494210,Payne; Christine Anna,25,0,30,5
1713347987439,SOCI 100,A02,494211,Payne; Christine Anna,26,0,30,4
1713347988470,SOCI 109M,A00,494212,Staff,20,0,20,0
1713347989495,SOCI 110,A00,494213,Staff,34,0,40,6
1713347991553,SOCI 118E,A00,494215,Ng; Kwai,37,0,40,3
1713347992583,SOCI 125,A00,494216,Calderon-Zaks; Michael Aar,39,0,45,6
1713347993614,SOCI 126,A01,494218,Jones; Makeba,3,0,5,2
1713347994643,SOCI 131,A00,494219,Thorpe; Charles Robert,25,0,30,5
1713347996696,SOCI 135,A00,494221,Payne; Christine Anna,28,0,50,22
1713347997726,SOCI 136E,A00,626690,Ruiz; Jonathan Joseph,24,0,25,1
1713347998756,SOCI 138GS,A00,494222,Navon; Daniel,23,0,28,5
1713348000867,SOCI 145,A00,494224,Staff,40,0,45,5
1713348001896,SOCI 153,A00,494225,Staff,28,0,30,2
1713348002921,SOCI 160E,A00,494226,Ng; Kwai,27,0,40,13
1713348003949,SOCI 180,A00,494227,Staff,29,0,30,1
1713348004977,SOCI 189GS,A00,494228,Ribas Norris; Janet Vanesa,11,0,11,0
1713348006005,SOCI 190GS,A00,553232,Ribas Norris; Janet Vanesa,11,0,11,0
1713348007036,SOMI 220,A00,627178,Schneid; Stephen David,30,0,30,0
1713348008065,SYN 2,001,490768,Staff,13,0,15,2
1713348008065,SYN 2,002,490769,Staff,14,0,15,1
1713348008065,SYN 2,004,490775,Staff,0,0,0,0
1713348008065,SYN 2,003,490774,Staff,0,0,0,0
1713348008065,SYN 2,005,490776,Staff,0,0,0,0
1713348009090,SYN 2R,001,490779,Staff,10,0,15,5
1713348009090,SYN 2R,002,514635,Staff,14,0,15,1
1713348010116,SYN 100,A01,490783,Staff,8,0,20,12
1713348010116,SYN 100,B01,490787,Staff,10,0,20,10
1713348010116,SYN 100,C01,490789,Staff,10,0,20,10
1713348011140,SYN 150,A00,490817,Staff,14,0,15,1
1713348011140,SYN 150,B00,514610,Staff,15,0,15,0
1713348012182,TDAC 1,A00,492753,Walsh; Kim C.,19,0,20,1
1713348012182,TDAC 1,B00,492754,Harting; Carla Kelso,18,0,20,2
1713348012182,TDAC 1,C00,513995,Salovey; Todd,15,0,20,5
1713348013211,TDAC 101,A00,492766,Harting; Carla Kelso,17,0,20,3
1713348014237,TDAC 102,A00,492768,Basso; Beatrice,19,0,20,1
1713348015260,TDDE 111,A00,492769,Staff,25,0,25,0
1713348016287,TDDE 131,A00,492770,Staff,15,0,15,0
1713348016287,TDDE 131,B00,492771,Staff,15,0,15,0
1713348017315,TDDE 131GS,A00,523716,Guirguis; Mark C,23,0,28,5
1713348018342,TDGE 1,A01,492756,Salovey; Todd,56,0,60,4
1713348019367,TDGE 5,A01,492758,Staff,23,0,25,2
1713348020394,TDGE 10,A00,492759,Fulton; Julia,203,0,220,17
1713348021419,TDGE 11,A00,492760,Castro; Robert Jess,198,0,200,2
1713348023469,TDGE 124,A00,492772,Fulton; Julia,180,0,220,40
1713348024497,TDGE 125,A00,492773,Meyer; Ursula,38,0,50,12
1713348024497,TDGE 125,B00,492774,Staff,49,0,50,1
1713348024497,TDGE 125,C00,523565,Staff,48,0,50,2
1713348025525,TDGE 125GS,A00,523580,Guirguis; Mark C,23,0,28,5
1713348026551,TDGE 127,A00,492775,Havis; Allan,33,0,50,17
1713348027579,TDHT 101,A00,492776,Staff,34,0,35,1
1713348028604,TDMV 1,A00,492762,Caligagan; Maria T.,29,0,30,1
1713348028604,TDMV 1,B00,492763,Arcidiacono; Kristin,26,0,30,4
1713348029631,TDMV 2,A00,492764,Weinberg; Sadie,27,0,30,3
1713348030662,TDMV 3,A00,492765,Mack; Kara Shanai',37,0,40,3
1713348031692,TDMV 138,A00,492777,Mack; Kara Shanai',32,0,40,8
1713348032716,TDMV 140,A00,492778,Lima; Paulo Henrique,40,0,40,0
1713348033742,TDMV 142,A00,492779,Caligagan; Maria T.,33,0,40,7
1713348033742,TDMV 142,B00,492780,Caligagan; Tony,37,0,40,3
1713348034768,TDMV 143,A00,492781,Fyall; Daunte Edward,39,0,40,1
1713348035797,USP 1,A01,492401,Kwak; Nancy,27,0,35,8
1713348036823,USP 2,A01,492453,Hinds; Juli Beth,35,0,35,0
1713348037850,USP 3,A01,492516,Staff,28,0,35,7
1713348038876,USP 4,A00,492522,McTague; Sarah,16,0,25,9
1713348039901,USP 100,A00,492523,Staff,32,0,35,3
1713348040927,USP 101,A00,492524,Staff,13,0,15,2
1713348041952,USP 105,A00,492525,Staff,21,0,25,4
1713348042981,USP 151,A00,492526,Shenkman; Michael Thomas,32,0,35,3
1713348044006,USP 170,A00,492545,Hinds; Juli Beth,32,0,35,3
1713348045031,USP 171GS,A00,492608,Bussell; Mirle Rabinowitz,24,0,28,4
1713348046056,USP 183GS,A00,492613,Peerson; Susan,24,0,28,4
1713348047085,VIS 30,A01,490693,Yoldas; Pinar,19,0,22,3
1713348047085,VIS 30,A02,490694,Yoldas; Pinar,18,0,22,4
1713348048110,VIS 83,A00,490695,Kester; Grant,63,0,75,12
1713348049136,VIS 105D,A00,490696,Staff,22,0,25,3
1713348050165,VIS 124CN,A00,490699,Rose; Jordan M,64,0,75,11
1713348051191,VIS 125GS,A00,511221,Williams; Alena J,21,0,22,1
1713348052220,VIS 128D,A00,490700,Staff,73,0,75,2
1713348053250,VIS 151,A01,490717,Staff,33,0,34,1
1713348053250,VIS 151,A02,490766,Staff,32,0,34,2
1713348054278,VIS 154GS,A00,511972,Williams; Alena J,21,0,22,1
1713348055302,VIS 160A,A00,490767,Stone; Patricia,7,0,10,3
1713348056328,WCWP 10A,A00,490638,Staff,14,0,15,1
1713348056328,WCWP 10A,B00,490640,Staff,15,0,15,0
1713348057357,WCWP 10B,A00,490641,Staff,0,0,0,0
1713348057357,WCWP 10B,B00,490642,Staff,14,0,15,1
1713348057357,WCWP 10B,C00,490644,Staff,13,0,15,2
1713348057357,WCWP 10B,D00,490647,Staff,0,0,0,0
1713348058389,WCWP 100,A00,490655,Staff,0,0,0,0
1713348058389,WCWP 100,B00,490687,Staff,10,0,15,5
1713348060520,ANAR 153,A00,487222,Braswell; Geoffrey E.,53,0,60,7
1713348061553,ANBI 134,A00,487223,Staff,5,0,20,15
1713348062580,ANBI 143GS,A00,487224,Noel; Geoffroy Pierre Jean,18,0,24,6
1713348063609,ANBI 144GS,A00,519548,Noel; Geoffroy Pierre Jean,18,0,24,6
1713348064635,ANSC 101,A00,487225,Staff,17,0,20,3
1713348065661,ANSC 125,A00,487227,Brenner; Suzanne A,38,0,40,2
1713348067715,ANSC 146,A00,487229,Staff,35,0,40,5
1713348068805,ANSC 148,A00,487230,Olivas Hernandez; Olga Lid,39,0,40,1
1713348069833,ANSC 150,A00,504165,Sloane; Julia Kathryn,18,0,20,2
1713348070862,ANSC 180,A00,487232,Staff,14,0,15,1
1713348071888,ANSC 188,A00,627155,Staff,37,0,40,3
1713348072913,ANTH 5,A00,519529,Semendeferi; Ekaterini,15,0,15,0
1713348073941,ANTH 10,A00,487219,Staff,58,0,60,2
1713348074972,ANTH 23,A01,487221,Staff,17,0,20,3
1713348076004,ANTH 102,A00,487233,Wilder; Linnea Lorene,49,0,60,11
1713348077035,ANTH 103,A00,487234,Varma; Saiba,54,0,60,6
1713348078069,ANTH 105,A00,487235,Stewart; Alexander B,54,0,60,6
1713348079095,BENG 100,A01,516685,Taylor Amos; Alyssa C,25,0,30,5
1713348080124,BIBC 102,A01,491316,Flagg; Matthew Paul,5,0,88,83
1713348080124,BIBC 102,A02,491366,Flagg; Matthew Paul,78,0,88,10
1713348081149,BIBC 103,A01,491486,Boumechache; Miyyada,16,0,24,8
1713348081149,BIBC 103,A02,491487,Boumechache; Miyyada,24,0,24,0
1713348082176,BICD 100,A01,516882,Staff,72,0,75,3
1713348082176,BICD 100,A02,516890,Staff,69,0,75,6
1713348083201,BICD 102GS,A00,491488,Lo; Stanley M.,26,0,28,2
1713348084226,BIEB 136GS,A00,516940,Holway; David A. & Shurin; Jonathan,18,0,24,6
1713348085255,BIEB 137GS,A01,517034,Holway; David A. & Shurin; Jonathan,18,0,24,6
1713348086288,BIEB 138GS,A01,491492,Pirino; Giorgia,21,0,28,7
1713348087323,BILD 1,A01,491296,Staff,60,0,63,3
1713348087323,BILD 1,A02,491297,Staff,63,0,63,0
1713348088351,BILD 4,A01,517099,Gonzalez Gamboa; Ivonne,22,0,24,2
1713348088351,BILD 4,A02,517100,Gonzalez Gamboa; Ivonne,24,0,24,0
1713348089376,BILD 60GS,A00,491309,Lo; Stanley M.,26,0,28,2
1713348090402,BIMM 100,A01,517136,Staff,82,0,100,18
1713348091429,BIMM 110,A01,517182,Staff,52,0,100,48
1713348092463,BIMM 120,A01,517228,Pickett; Brooke Elizabeth,28,0,63,35
1713348092463,BIMM 120,A02,517240,Pickett; Brooke Elizabeth,44,0,63,19
1713348093488,BIMM 132GS,A01,491498,Pirino; Giorgia,21,0,28,7
1713348094514,BIMM 143,A01,491589,Bozinovic; Goran,12,0,40,28
1713348095542,BIPN 100,A01,491594,Armour; Jon Christopher,83,0,100,17
1713348096574,BIPN 140,A01,491602,Marino; Marc J,23,0,50,27
1713348098626,CAT 125,A00,515973,Staff,18,0,20,2
1713348099651,CAT 125GS,A00,515974,Rahimi; Babak,16,0,20,4
1713348100680,CAT 125R,A00,515980,Staff,12,0,20,8
1713348100680,CAT 125R,B00,515981,Tosun; Adriana,19,0,20,1
1713348100680,CAT 125R,C00,515987,Hyland; Tina Mae,0,5,20,20
1713348100680,CAT 125R,D00,515988,Bronstein; Phoebe Malan,16,0,20,4
1713348101707,CENG 15,A01,488699,Drews; Aaron,25,0,25,0
1713348102739,CENG 100,A00,505196,Opatkiewicz; Justin Paul,25,0,25,0
1713348103768,CGS 2A,A01,489598,Staff,32,0,35,3
1713348104851,CGS 112,A00,489599,Staff,15,0,15,0
1713348105882,CGS 119,A00,489603,Staff,10,0,10,0
1713348106907,CGS 120,A00,489604,Staff,13,0,15,2
1713348107935,CGS 150,A00,489607,Staff,15,0,15,0
1713348108960,CHEM 6A,A01,488715,Staff,97,0,100,3
1713348109986,CHEM 6B,A01,488719,Piercy; Marc Anthony,99,0,100,1
1713348111012,CHEM 6C,A01,488723,Albizati; Kim F.,93,0,100,7
1713348112042,CHEM 7L,A01,488728,Schurmeier; Kimberly,18,0,24,6
1713348112042,CHEM 7L,A02,488730,Schurmeier; Kimberly,23,0,24,1
1713348112042,CHEM 7L,A03,488734,Schurmeier; Kimberly,20,0,24,4
1713348112042,CHEM 7L,A04,488763,Schurmeier; Kimberly,23,0,24,1
1713348112042,CHEM 7L,B01,488798,Schurmeier; Kimberly,16,0,24,8
1713348112042,CHEM 7L,B02,488801,Schurmeier; Kimberly,22,0,24,2
1713348112042,CHEM 7L,B03,488808,Schurmeier; Kimberly,22,0,24,2
1713348112042,CHEM 7L,B04,488811,Schurmeier; Kimberly,24,0,24,0
1713348113066,CHEM 11,A01,488897,Stallings; Dontarie M,94,0,100,6
1713348114097,CHEM 40A,A01,488913,Albizati; Kim F.,83,0,100,17
1713348115124,CHEM 40B,A01,488920,Weizman; Haim,42,0,50,8
1713348115124,CHEM 40B,A02,488938,Weizman; Haim,43,0,50,7
1713348116152,CHEM 41A,A01,489029,Klosterman; Jeremy K,57,0,60,3
1713348117180,CHEM 41C,A01,500436,Tor; Yitzhak,54,0,60,6
1713348118207,CHEM 43A,A01,500426,Weizman; Haim,0,1,24,24
1713348118207,CHEM 43A,A02,500430,Weizman; Haim,6,0,24,18
1713348118207,CHEM 43A,B01,514041,Klosterman; Jeremy K,14,0,24,10
1713348118207,CHEM 43A,B02,514047,Klosterman; Jeremy K,23,0,24,1
1713348119239,CHEM 108,A01,489140,Jennings; Patricia A.,6,0,24,18
1713348119239,CHEM 108,A02,489142,Jennings; Patricia A.,14,0,24,10
1713348120264,CHEM 114A,A01,489147,Stallings; Dontarie M,65,0,100,35
1713348121289,CHIN 169A,A00,489171,Wang; Xiao,19,0,20,1
1713348123342,COGS 3,A01,518827,Boyle; Mary E. T.,25,0,40,15
1713348124368,COGS 11,A01,489175,Staff,27,0,30,3
1713348125398,COGS 14A,A01,518829,Staff,50,0,60,10
1713348126426,COGS 14B,A01,489177,Hoffman; Drew Ellen,62,0,75,13
1713348127455,COGS 100,A01,489181,Allen; Michael Gordon,62,0,75,13
1713348128483,COGS 101A,A01,489183,Staff,45,0,60,15
1713348129511,COGS 101B,A01,489185,Allen; Michael Gordon,6,0,30,24
1713348130536,COGS 101C,A01,526786,Staff,23,0,30,7
1713348132598,COGS 107A,A01,489189,Boyle; Mary E. T.,16,0,35,19
1713348133623,COGS 107B,A01,627144,Mooshagian; Eric Frederick,59,0,60,1
1713348134652,COGS 118A,A01,489191,Staff,0,46,40,40
1713348136705,COGS 171GS,A01,489194,Pineda; Jaime A,19,0,28,9
1713348137729,COGS 172,A01,489196,Staff,1,0,30,29
1713348138759,COGS 174GS,A01,489264,Pineda; Jaime A,19,0,28,9
1713348139786,COGS 180,A01,627150,Staff,28,0,30,2
1713348140812,COGS 186,A01,489274,Staff,0,3,30,30
1713348141842,COMM 10,A01,489276,Staff,23,0,25,2
1713348141842,COMM 10,A02,489303,Staff,23,0,25,2
1713348142872,COMM 100A,A01,489312,Staff,14,0,25,11
1713348142872,COMM 100A,A02,489313,Staff,24,0,25,1
1713348143906,COMM 106T,A00,512540,Staff,33,0,35,2
1713348144933,COMM 107,A00,489347,Staff,27,0,35,8
1713348145963,COMM 109P,A00,489358,Staff,31,0,35,4
1713348146990,COMM 132,A00,489361,McKenna; Denise,27,0,30,3
1713348148016,COMM 146,A00,489362,Halm; Gavin Patrick,26,0,30,4
1713348149046,COMM 190,A00,489363,Abuelhiga; Soraya Jill,17,0,23,6
1713348150079,CSE 8A,A50,489366,Staff,21,0,25,4
1713348150079,CSE 8A,A51,489367,Staff,24,0,25,1
1713348151108,CSE 11,A01,489398,Cao; Yingjun,72,0,100,28
1713348152135,CSE 12,A01,489487,Staff,43,0,50,7
1713348153164,CSE 20,A01,489497,Staff,47,0,50,3
1713348154190,CSE 21,A01,489517,Braun; Oliver,42,0,50,8
1713348155216,CSE 101,A01,489524,Braun; Oliver,0,35,50,50
1713348156254,CSE 105,A01,512594,Jones; Miles E,72,0,100,28
1713348156254,CSE 105,B01,512598,Jones; Miles E,51,0,100,49
1713348157281,CSE 140,A01,489538,Staff,39,0,50,11
1713348158309,CSE 141,A01,489550,Eldon; John,67,0,100,33
1713348159332,CSE 141L,A01,489571,Eldon; John,65,0,100,35
1713348160365,CSE 151A,A01,489583,Solares; Edwin A,139,0,200,61
1713348161399,CSE 175,A01,510886,Kumar; Rakesh,30,0,30,0
1713348162425,CSE 190,A00,516828,Dubnov; Shlomo,37,0,49,12
1713348163452,DOC 100D,A00,489667,Pass; Natalye Joann,19,0,25,6
1713348164479,DSC 10,A01,624268,Staff,72,0,75,3
1713348165502,DSC 20,A01,624476,Staff,50,0,50,0
1713348166532,DSC 40A,A01,624608,Staff,39,0,40,1
1713348167564,DSGN 1,A01,489179,Rill; Bryan,32,0,50,18
1713348168589,ECE 17,A01,490489,Sahay; Rajeev,18,0,30,12
1713348169615,ECE 65,A50,490492,Staff,11,0,20,9
1713348169615,ECE 65,A51,490493,Staff,18,0,20,2
1713348170646,ECON 1,A01,489715,Famulari; Melissa,67,0,70,3
1713348171678,ECON 2,A01,489717,Levkoff; Steven B.,67,0,70,3
1713348172704,ECON 3,A01,489948,Staff,70,0,70,0
1713348174763,ECON 5,A01,490103,Staff,27,0,30,3
1713348174763,ECON 5,B01,626281,Dai; Yinlin,45,0,45,0
1713348175805,ECON 100A,A01,490127,Famulari; Melissa,62,0,70,8
1713348176834,ECON 100B,A01,490129,Staff,64,0,70,6
1713348177860,ECON 109,A01,490187,Shishkin; Denis,27,0,35,8
1713348178886,ECON 110A,A01,490190,Levkoff; Steven B.,59,0,70,11
1713348179913,ECON 120A,A01,490245,Dai; Yinlin,59,0,70,11
1713348180939,ECON 120B,A01,490247,Nieto-Barthaburu; Augusto,40,0,70,30
1713348181967,ECON 120C,A01,490253,Sun; Yixiao,30,0,35,5
1713348181967,ECON 120C,B01,490255,Sun; Yixiao,34,0,35,1
1713348182997,ECON 129,A00,490256,Eckert; Fabian Paul,22,0,35,13
1713348184027,ECON 131,A00,490257,Nieto-Barthaburu; Augusto,0,6,35,35
1713348185054,ECON 138,A00,490258,Bharadwaj; Prashant,13,0,35,22
1713348185054,ECON 138,B00,490259,Bharadwaj; Prashant,15,0,35,20
1713348186080,ECON 159,A00,490260,Hendrickson; Gerald M.,0,9,0,0
1713348187109,ECON 178,A01,553995,Zhu; Ying,24,0,35,11
1713348188135,EDS 40,A01,512576,Black; Alison Michelle,20,0,20,0
1713348189159,EDS 107,A01,515848,Staff,30,0,30,0
1713348190188,EDS 110R,A01,490262,Staff,26,0,30,4
1713348191216,EDS 112,A01,490264,Chapman; Thandeka K,40,0,50,10
1713348192243,EDS 113,A00,490266,Staff,25,0,30,5
1713348193272,EDS 118,A00,490267,Warstadt; Melissa Fawn,18,0,30,12
1713348194301,EDS 124BR,A00,490268,Eguchi; Emi,4,0,25,21
1713348194301,EDS 124BR,B00,490269,Eguchi; Emi,23,0,25,2
1713348195326,EDS 126,A01,490271,Jones; Makeba,43,0,50,7
1713348196351,EDS 135,A01,490316,Staff,19,0,20,1
1713348197378,ENVR 142GS,A00,519514,Chang; Edmond Yi-Teh,26,0,28,2
1713348198404,ETHN 103,A00,490504,Staff,24,0,36,12
1713348199430,ETHN 103A,A00,490505,Man; Simeon S,3,0,9,6
1713348200455,ETHN 109,A00,490506,Staff,28,0,30,2
1713348201484,ETHN 118,A00,490507,Staff,35,0,36,1
1713348202511,ETHN 119,A00,490508,Staff,32,0,36,4
1713348203541,ETHN 121R,A00,490518,Choi; Esther Min,21,0,36,15
1713348204566,ETHN 127,A00,490528,Staff,14,0,15,1
1713348205595,ETHN 139,A00,490573,Staff,10,0,10,0
1713348206625,ETHN 150,A00,490575,Staff,15,0,15,0
1713348207656,GLBH 20,A00,491705,Elwardani; Nile Regina,38,0,40,2
1713348208738,GLBH 101,A00,491706,Staff,20,0,20,0
1713348209763,GLBH 111,A01,491708,Burgos; Jose L.,15,0,15,0
1713348210787,GLBH 146,A00,491709,Staff,8,0,20,12
1713348211826,GLBH 148,A00,491710,Olivas Hernandez; Olga Lid,10,0,20,10
1713348212852,GLBH 150,A00,491711,Sloane; Julia Kathryn,19,0,20,1
1713348213878,HIEA 131,A00,491760,Staff,28,0,32,4
1713348214903,HIEA 153,A00,491762,Staff,28,0,30,2
1713348215934,HIEU 124,A00,491811,Staff,26,0,32,6
1713348216960,HIEU 124GS,A00,491812,Markman; Kristina,27,0,28,1
1713348217987,HIEU 147,A00,491813,Staff,30,0,32,2
1713348219012,HIEU 149GS,A00,491816,Caldwell; Michael Alan,28,0,28,0
1713348220037,HILD 2C,A01,491713,Hendrickson; Gerald M.,26,0,30,4
1713348221062,HILD 7B,A01,491715,Kwak; Nancy,0,3,30,30
1713348222087,HILD 10,A01,491717,Staff,9,0,20,11
1713348223113,HILD 30GS,A00,491719,Edington; Claire Ellen,23,0,28,5
1713348224144,HINE 109,A00,491818,Shafir; Nir,26,0,32,6
1713348225170,HINE 128,A00,491821,Shafir; Nir,30,0,32,2
1713348226199,HISC 117,A00,491830,Staff,27,0,32,5
1713348227228,HIUS 103,A00,491834,Man; Simeon S,14,0,23,9
1713348228258,HIUS 108B,A00,491835,Staff,27,0,30,3
1713348229287,HIUS 141,A00,491836,Hendrickson; Gerald M.,28,0,32,4
1713348230311,HIUS 149,A00,491839,Staff,24,0,32,8
1713348231342,HUM 3,A01,512617,Crum; Matthew Stephen,42,0,50,8
1713348231342,HUM 3,A02,512618,Crum; Matthew Stephen,48,0,50,2
1713348232369,HUM 3GS,A00,512663,Markman; Kristina,0,0,0,1
1713348232369,HUM 3GS,B00,512664,Staff,0,0,0,0
1713348233399,HUM 4,A01,512620,West; Geoffrey Scott,23,0,50,27
1713348234428,HUM 4GS,A00,512666,Lyon; Antony J.,0,0,0,5
1713348235454,HUM 4R,A01,512625,Watkins; Eric,49,0,50,1
1713348236482,HUM 5,A01,512649,Zavodny; Tatiana Sophia,20,0,50,30
1713348236482,HUM 5,B01,512661,Zroka; Ryan Edward,48,0,50,2
1713348237513,INTL 190,A00,490577,Segui; Alan S,0,0,0,5
1713348238571,JAPN 20AR,A01,491267,Ross; Kayoko F,7,0,20,13
1713348239599,JAPN 180,A00,491285,Berman; Michael David,33,0,40,7
1713348240627,LATI 50,A01,502536,Kokinis; Troy Andreas,16,0,22,6
1713348240627,LATI 50,A02,502551,Kokinis; Troy Andreas,22,0,22,0
1713348240627,LATI 50,A03,502650,Kokinis; Troy Andreas,22,0,22,0
1713348240627,LATI 50,A04,502909,Kokinis; Troy Andreas,21,0,22,1
1713348241657,LATI 160,A01,502920,Kokinis; Troy Andreas,30,0,30,0
1713348242684,LIFR 1A,A00,490494,Van Moer; Vinciane G,17,0,20,3
1713348243710,LIFR 1AX,A00,490495,Van Moer; Vinciane G,17,0,20,3
1713348244738,LIFR 1B,A00,490496,Van Moer; Vinciane G,17,0,20,3
1713348245764,LIFR 1BX,A00,490497,Van Moer; Vinciane G,17,0,20,3
1713348246795,LIGN 8,A00,505198,McIntosh; Justin Daniel,134,0,150,16
1713348247826,LIGN 9GS,A00,491239,Lott; Margaret S.,18,0,20,2
1713348248852,LIGN 101,A01,505200,McIntosh; Justin Daniel,22,0,30,8
1713348249880,LIGN 120,A01,491244,Staff,22,0,30,8
1713348250906,LIGN 149GS,A00,491245,Lott; Margaret S.,18,0,20,2
1713348251939,LIGN 170,A00,491247,Staff,22,0,30,8
1713348252971,LISP 1D,A00,490498,Munoz Sanchez; Alicia,8,0,14,6
1713348252971,LISP 1D,B00,490499,Munoz Sanchez; Alicia,4,0,14,10
1713348252971,LISP 1D,C00,490500,Munoz Sanchez; Alicia,7,0,14,7
1713348252971,LISP 1D,D00,490501,Munoz Sanchez; Alicia,10,0,14,4
1713348253997,LISP 1DX,A00,490502,Munoz Sanchez; Alicia,11,0,28,17
1713348253997,LISP 1DX,B00,490503,Munoz Sanchez; Alicia,16,0,28,12
1713348256053,LTAM 110,A00,491847,Staff,22,0,25,3
1713348257082,LTCS 119,A00,491848,Staff,11,0,15,4
1713348258113,LTCS 130,A00,491849,Staff,24,0,25,1
1713348260161,LTEA 120C,A00,491852,Staff,32,0,40,8
1713348261187,LTEN 130GS,A00,491853,Lyon; Antony J.,23,0,28,5
1713348262212,LTEN 148,A00,491855,Staff,23,0,25,2
1713348263238,LTEN 159,A00,491856,Staff,20,0,25,5
1713348264263,LTEN 180,A00,491857,Staff,8,0,15,7
1713348266323,LTSP 123GS,A00,505928,Bessett; Ryan Matthew,24,0,28,4
1713348267347,LTSP 174GS,A00,506037,Bessett; Ryan Matthew,24,0,28,4
1713348269399,LTWR 102,A00,491861,Staff,9,0,15,6
1713348270423,LTWR 106,A00,491862,Staff,8,0,15,7
1713348271449,MAE 11,A00,490930,Bahadori; Mohammad Yousef,94,0,100,6
1713348272476,MAE 30A,A00,490931,Qi; Huihui,37,0,40,3
1713348273539,MAE 101A,A00,491036,Sadeghizadeh; Zahra,91,0,100,9
1713348274563,MAE 101C,A00,491037,Seshadri; Kalyanasundaram,63,0,100,37
1713348275592,MAE 113,A00,491040,Seshadri; Kalyanasundaram,64,0,80,16
1713348276618,MAE 131A,A00,491041,Ghazinejad; Maziar,37,0,40,3
1713348277643,MAE 142,A00,491053,Staff,39,0,40,1
1713348278669,MAE 143A,A00,491054,Staff,29,0,50,21
1713348279694,MAE 150,A00,491092,Truong; Phuong Thi Ngoc,23,0,35,12
1713348280720,MATH 3C,A01,494031,Pardo Guerra; Sebastian,30,0,30,0
1713348280720,MATH 3C,A02,494032,Pardo Guerra; Sebastian,29,0,30,1
1713348281747,MATH 10A,A01,494034,Staff,27,0,30,3
1713348281747,MATH 10A,A02,494035,Staff,28,0,30,2
1713348281747,MATH 10A,B01,494037,Staff,27,0,30,3
1713348281747,MATH 10A,B02,494038,Staff,29,0,30,1
1713348282778,MATH 10B,A01,494040,Habib; Yousaf,22,0,30,8
1713348282778,MATH 10B,A02,494041,Habib; Yousaf,28,0,30,2
1713348282778,MATH 10B,A03,494042,Habib; Yousaf,29,0,30,1
1713348282778,MATH 10B,A04,494043,Habib; Yousaf,30,0,30,0
1713348282778,MATH 10B,B01,494045,Habib; Yousaf,25,0,30,5
1713348282778,MATH 10B,B02,494046,Habib; Yousaf,30,0,30,0
1713348282778,MATH 10B,B03,494047,Habib; Yousaf,30,0,30,0
1713348282778,MATH 10B,B04,494048,Habib; Yousaf,30,0,30,0
1713348283811,MATH 18,A01,494050,Kemp; Todd Aahron,25,0,30,5
1713348283811,MATH 18,A02,494051,Kemp; Todd Aahron,29,0,30,1
1713348283811,MATH 18,B01,494054,Kemp; Todd Aahron,25,0,30,5
1713348283811,MATH 18,B02,494055,Kemp; Todd Aahron,29,0,30,1
1713348284843,MATH 20A,A01,494059,Suk; Andrew Hoon,30,0,30,0
1713348285875,MATH 20B,A01,494061,Briones; Jor-el Thomas Caparas,33,0,35,2
1713348285875,MATH 20B,B01,494063,Bach; Quang Tran,34,0,35,1
1713348286911,MATH 20C,A01,494065,Staff,28,0,30,2
1713348286911,MATH 20C,A02,494066,Staff,30,0,30,0
1713348286911,MATH 20C,A03,494067,Staff,30,0,30,0
1713348286911,MATH 20C,A04,494068,Staff,30,0,30,0
1713348286911,MATH 20C,B01,494070,Zhang; Ming,23,0,30,7
1713348286911,MATH 20C,B02,494071,Zhang; Ming,27,0,30,3
1713348286911,MATH 20C,B03,494072,Zhang; Ming,29,0,30,1
1713348286911,MATH 20C,B04,494073,Zhang; Ming,29,0,30,1
1713348287936,MATH 20D,A01,494075,Staff,22,0,30,8
1713348287936,MATH 20D,A02,494076,Staff,29,0,30,1
1713348288964,MATH 20E,A01,494079,Staff,24,0,30,6
1713348288964,MATH 20E,A02,494080,Staff,26,0,30,4
1713348288964,MATH 20E,B01,494082,Staff,25,0,30,5
1713348288964,MATH 20E,B02,494083,Staff,25,0,30,5
1713348289998,MATH 103A,A01,494085,Aliabadi Sr.; Mohsen,12,0,30,18
1713348289998,MATH 103A,A02,494086,Aliabadi Sr.; Mohsen,28,0,30,2
1713348289998,MATH 103A,B01,494088,Aliabadi Sr.; Mohsen,20,0,30,10
1713348289998,MATH 103A,B02,494089,Aliabadi Sr.; Mohsen,27,0,30,3
1713348291023,MATH 109,A01,494091,Staff,30,0,30,0
1713348291023,MATH 109,A02,494092,Staff,29,0,30,1
1713348291023,MATH 109,B01,494094,Staff,27,0,30,3
1713348291023,MATH 109,B02,494095,Staff,29,0,30,1
1713348292058,MATH 142A,A01,494097,Chow; Bennett,13,0,30,17
1713348292058,MATH 142A,A02,494098,Chow; Bennett,23,0,30,7
1713348292058,MATH 142A,B01,494100,Chow; Bennett,19,0,30,11
1713348292058,MATH 142A,B02,494101,Chow; Bennett,29,0,30,1
1713348294117,MATH 168A,A01,516677,Dumitriu; Ioana,16,0,35,19
1713348295348,MATH 170A,A01,516679,Dumitriu; Ioana,18,0,30,12
1713348295348,MATH 170A,A02,516680,Dumitriu; Ioana,28,0,30,2
1713348296374,MATH 193A,A01,494107,Staff,12,0,30,18
1713348296374,MATH 193A,A02,494108,Staff,18,0,30,12
1713348296374,MATH 193A,A03,494109,Staff,29,0,30,1
1713348296374,MATH 193A,A04,494110,Staff,22,0,30,8
1713348299453,MGT 16,A00,491930,McKay; Michael J,92,0,98,6
1713348300482,MGT 18,A00,491992,McKay; Michael J,96,0,98,2
1713348301505,MGT 71,A00,492003,Staff,63,0,98,35
1713348302532,MGT 103,A00,505209,Eberhard; Craig A,80,0,98,18
1713348303556,MGT 131A,A00,505210,Anderson; John Charles,89,0,98,9
1713348305610,MGT 153,A00,492077,Perols; Johan Lars,15,0,90,75
1713348308687,MGT 164,A00,492222,McKay; Mary A,91,0,98,7
1713348309715,MGT 172,A00,492245,Staff,59,0,60,1
1713348309715,MGT 172,B00,505526,Hedges; Kathleen,65,0,98,33
1713348310742,MGT 181,A00,505669,Dunn; Louis Jean,78,0,98,20
1713348311774,MMW 14,A01,494399,Staff,15,0,28,13
1713348311774,MMW 14,A02,494400,Staff,25,0,28,3
1713348311774,MMW 14,A03,494401,Staff,28,0,28,0
1713348311774,MMW 14,A04,494402,Staff,28,0,28,0
1713348311774,MMW 14,B01,494404,Carreras; Maria Victoria,8,0,28,20
1713348311774,MMW 14,B02,494405,Carreras; Maria Victoria,25,0,28,3
1713348311774,MMW 14,B03,494406,Carreras; Maria Victoria,27,0,28,1
1713348311774,MMW 14,B04,494407,Carreras; Maria Victoria,28,0,28,0
1713348312854,MMW 14GS,A00,506250,Chang; Edmond Yi-Teh,0,0,0,0
1713348313884,MMW 121R,A01,494415,Adamiak; Patrick John,9,0,28,19
1713348313884,MMW 121R,A02,494416,Adamiak; Patrick John,24,0,28,4
1713348314913,MUS 1A,A01,494113,Staff,12,0,25,13
1713348314913,MUS 1A,A02,494114,Staff,24,0,25,1
1713348315939,MUS 4,A01,494116,Staff,23,0,25,2
1713348315939,MUS 4,A02,494117,Staff,22,0,25,3
1713348316966,MUS 5R,A01,494236,Dubnov; Shlomo,4,0,25,21
1713348316966,MUS 5R,A02,494237,Dubnov; Shlomo,25,0,25,0
1713348317995,MUS 6,A01,494122,Staff,9,0,25,16
1713348317995,MUS 6,A02,494123,Staff,23,0,25,2
1713348319025,MUS 7,A01,494125,Staff,16,0,25,9
1713348319025,MUS 7,A02,494126,Staff,24,0,25,1
1713348320051,MUS 11,A01,494128,Staff,23,0,25,2
1713348320051,MUS 11,A02,494129,Staff,24,0,25,1
1713348321103,MUS 13,A01,494131,Staff,25,0,25,0
1713348321103,MUS 13,A02,494132,Staff,25,0,25,0
1713348322133,MUS 15,A01,494134,Staff,16,0,25,9
1713348322133,MUS 15,A02,494135,Staff,25,0,25,0
1713348322133,MUS 15,B01,494137,Staff,24,0,25,1
1713348323162,MUS 80,A00,494232,Staff,24,0,25,1
1713348323162,MUS 80,B00,494233,Staff,25,0,25,0
1713348323162,MUS 80,C00,494234,Staff,23,0,25,2
1713348324187,MUS 95C,A00,494141,Staff,69,0,75,6
1713348325210,MUS 114,A00,494142,Staff,39,0,50,11
1713348326239,NANO 15,A01,490636,Drews; Aaron,7,0,7,0
1713348327347,PHIL 1,A00,490578,Grush; Rick Scott,49,0,50,1
1713348328375,PHIL 10,A01,490580,Grush; Rick Scott,33,0,35,2
1713348328375,PHIL 10,A02,490586,Grush; Rick Scott,32,0,35,3
1713348329400,PHIL 27,A01,490591,Staff,22,0,25,3
1713348329400,PHIL 27,A02,490592,Staff,25,0,25,0
1713348329400,PHIL 27,A03,490593,Staff,25,0,25,0
1713348329400,PHIL 27,A04,490598,Staff,25,0,25,0
1713348330465,PHIL 32,A01,490611,Staff,20,0,20,0
1713348330465,PHIL 32,A02,490618,Staff,20,0,20,0
1713348331495,PHIL 90,A00,490624,Staff,40,0,40,0
1713348332526,PHIL 136,A00,490627,Cohen; Jonathan David,37,0,40,3
1713348333551,PHIL 155,A00,490634,Staff,61,0,70,9
1713348334586,PHYS 1A,A00,491610,Staff,245,0,250,5
1713348335612,PHYS 1AL,001,491616,Tsai; Philbert S,27,0,30,3
1713348335612,PHYS 1AL,002,491618,Tsai; Philbert S,30,0,30,0
1713348336639,PHYS 1B,A00,491623,Staff,235,0,250,15
1713348337664,PHYS 1BL,001,491626,Tsai; Philbert S,18,0,30,12
1713348337664,PHYS 1BL,002,491628,Tsai; Philbert S,26,0,30,4
1713348338693,PHYS 1C,A00,491632,Staff,211,0,245,34
1713348339719,PHYS 1CL,001,491635,Tsai; Philbert S,2,0,30,28
1713348339719,PHYS 1CL,002,491643,Tsai; Philbert S,22,0,30,8
1713348340745,PHYS 2AR,A01,491651,Meyertholen; Andrew D.,44,0,50,6
1713348341774,PHYS 2B,A01,491659,Staff,105,0,115,10
1713348342803,PHYS 2BL,A01,491685,Staff,21,0,24,3
1713348342803,PHYS 2BL,A02,491700,Staff,21,0,24,3
1713348343830,PHYS 2C,A01,505161,Staff,101,0,115,14
1713348344855,PHYS 4A,A01,491704,Grinstein; Benjamin,99,0,100,1
1713348345883,POLI 5D,A01,494144,Staff,3,0,5,2
1713348345883,POLI 5D,B01,626283,Dai; Yinlin,5,0,5,0
1713348346911,POLI 12,A00,494145,Staff,43,0,45,2
1713348347947,POLI 13R,A00,494146,Forman; Fonna,45,0,50,5
1713348348976,POLI 27,A01,494148,Staff,54,0,60,6
1713348350001,POLI 30,A00,494149,Staff,49,0,50,1
1713348351027,POLI 100DA,A00,494150,Staff,20,0,25,5
1713348353084,POLI 100I,A00,494152,Staff,27,0,30,3
1713348354143,POLI 104B,A00,494153,Smith; Glenn Chatmas,53,0,55,2
1713348355173,POLI 104F,A00,494154,Staff,28,0,30,2
1713348356196,POLI 104I,A00,494155,Smith; Glenn Chatmas,29,0,30,1
1713348357227,POLI 110C,A00,494156,Ingham; Sean,23,0,25,2
1713348358258,POLI 117R,A00,494157,Forman; Fonna,5,0,20,15
1713348359289,POLI 118,A00,494158,Ingham; Sean,21,0,25,4
1713348360313,POLI 120H,A00,494159,Fisk; David Lee,39,0,45,6
1713348361344,POLI 131CR,A00,494160,Hoston; Germaine,35,0,45,10
1713348362376,POLI 133J,A00,494161,Staff,31,0,35,4
1713348363401,POLI 135,A00,494162,Fisk; David Lee,33,0,35,2
1713348364431,POLI 140A,A00,494164,Staff,18,0,30,12
1713348365463,POLI 142I,A00,494165,Staff,30,0,30,0
1713348366493,POLI 144D,A00,494166,Staff,22,0,25,3
1713348367524,POLI 151,A00,494167,Staff,30,0,30,0
1713348368548,POLI 153,A00,494168,Staff,33,0,35,2
1713348369577,POLI 160AA,A00,494169,Staff,33,0,40,7
1713348370611,POLI 162,A00,494170,Mignozzetti; Umberto,17,0,25,8
1713348371640,POLI 171,A00,494171,Mignozzetti; Umberto,18,0,25,7
1713348372697,PSYC 1,A00,494172,Staff,95,0,100,5
1713348373728,PSYC 2,A00,494173,Moranton; Nirelia Melbina-,33,0,50,17
1713348374756,PSYC 3,A00,494174,Staff,29,0,30,1
1713348375840,PSYC 6,A00,494175,Staff,17,0,20,3
1713348376863,PSYC 60,A01,494177,Staff,37,0,45,8
1713348377893,PSYC 70,A01,505724,Geller; Emma Harlan,42,0,45,3
1713348378919,PSYC 101,A00,494180,Heyman; Gail D.,83,0,100,17
1713348379944,PSYC 105,A00,494181,Geller; Emma Harlan,51,0,90,39
1713348380971,PSYC 106,A00,494182,Dobkins; Karen R.,26,0,45,19
1713348381997,PSYC 108,A00,494183,Adrian; Julia Anna,89,0,100,11
1713348383024,PSYC 114,A01,494185,Winkielman; Piotr,0,4,30,30
1713348384049,PSYC 122,A00,494186,Moranton; Nirelia Melbina-,27,0,50,23
1713348385074,PSYC 124,A00,494187,Chapman; Eddie Nathaniel,69,0,80,11
1713348386099,PSYC 131,A00,494188,Anagnostaras; Stephan,39,0,80,41
1713348387125,PSYC 144,A00,494189,Staff,1,1,50,49
1713348388151,PSYC 154,A00,494190,Lacefield; Katharine I,105,0,180,75
1713348389182,PSYC 162,A00,494191,Wixted; John T,70,0,100,30
1713348390206,PSYC 172,A00,494192,Gorman; Michael R.,36,0,45,9
1713348391232,PSYC 178,A00,494193,Glaser; Dale,32,0,45,13
1713348392258,PSYC 193,A00,505725,Chapman; Eddie Nathaniel,20,0,20,0
1713348393287,RELI 145GS,A00,519817,Rahimi; Babak,17,0,20,3
1713348394321,SE 101A,A01,490862,Chadha; Mayank,23,0,25,2
1713348395351,SE 101C,A01,490924,Krysl; Petr,15,0,20,5
1713348396379,SE 110A,A01,490928,Staff,19,0,20,1
1713348397404,SE 130A,A00,490929,Morrison; Machel Leigh,54,0,70,16
1713348398436,SIO 1,A01,519325,Staff,39,0,40,1
1713348399462,SIO 30,A01,519327,Staff,38,0,40,2
1713348400490,SIO 40,A00,519328,Staff,39,0,40,1
1713348401516,SIO 46GS,A00,519819,Cook; Geoffrey W,15,0,25,10
1713348402543,SIO 109R,A00,494197,Forman; Fonna,0,3,20,20
1713348403574,SIO 121GS,A00,519827,Cook; Geoffrey W,15,0,25,10
1713348404600,SIO 132,A01,519330,Staff,38,0,40,2
1713348405627,SIO 133,A01,519397,Staff,37,0,40,3
1713348406657,SIO 139,A00,519396,Kacev; David,29,0,40,11
1713348407692,SOCI 1,A01,494199,Thorpe; Charles Robert,21,0,30,9
1713348407692,SOCI 1,A02,494200,Thorpe; Charles Robert,30,0,30,0
1713348407692,SOCI 1,A03,494201,Thorpe; Charles Robert,29,0,30,1
1713348407692,SOCI 1,A04,494202,Thorpe; Charles Robert,29,0,30,1
1713348407692,SOCI 1,A05,494203,Thorpe; Charles Robert,29,0,30,1
1713348407692,SOCI 1,A06,494204,Thorpe; Charles Robert,30,0,30,0
1713348407692,SOCI 1,A07,494205,Thorpe; Charles Robert,28,0,30,2
1713348408721,SOCI 60,A01,494207,Staff,33,0,40,7
1713348408721,SOCI 60,A02,494208,Staff,39,0,40,1
1713348409755,SOCI 100,A01,494210,Payne; Christine Anna,25,0,30,5
1713348409755,SOCI 100,A02,494211,Payne; Christine Anna,26,0,30,4
1713348410780,SOCI 109M,A00,494212,Staff,20,0,20,0
1713348411805,SOCI 110,A00,494213,Staff,34,0,40,6
1713348413869,SOCI 118E,A00,494215,Ng; Kwai,37,0,40,3
1713348414902,SOCI 125,A00,494216,Calderon-Zaks; Michael Aar,39,0,45,6
1713348415931,SOCI 126,A01,494218,Jones; Makeba,3,0,5,2
1713348417016,SOCI 131,A00,494219,Thorpe; Charles Robert,25,0,30,5
1713348419085,SOCI 135,A00,494221,Payne; Christine Anna,28,0,50,22
1713348420172,SOCI 136E,A00,626690,Ruiz; Jonathan Joseph,24,0,25,1
1713348421199,SOCI 138GS,A00,494222,Navon; Daniel,23,0,28,5
1713348423249,SOCI 145,A00,494224,Staff,40,0,45,5
1713348424287,SOCI 153,A00,494225,Staff,28,0,30,2
1713348425339,SOCI 160E,A00,494226,Ng; Kwai,27,0,40,13
1713348426368,SOCI 180,A00,494227,Staff,29,0,30,1
1713348427395,SOCI 189GS,A00,494228,Ribas Norris; Janet Vanesa,11,0,11,0
1713348428420,SOCI 190GS,A00,553232,Ribas Norris; Janet Vanesa,11,0,11,0
1713348429445,SOMI 220,A00,627178,Schneid; Stephen David,30,0,30,0
1713348430477,SYN 2,001,490768,Staff,13,0,15,2
1713348430477,SYN 2,002,490769,Staff,14,0,15,1
1713348430477,SYN 2,004,490775,Staff,0,0,0,0
1713348430477,SYN 2,003,490774,Staff,0,0,0,0
1713348430477,SYN 2,005,490776,Staff,0,0,0,0
1713348431512,SYN 2R,001,490779,Staff,10,0,15,5
1713348431512,SYN 2R,002,514635,Staff,14,0,15,1
1713348432536,SYN 100,A01,490783,Staff,8,0,20,12
1713348432536,SYN 100,B01,490787,Staff,10,0,20,10
1713348432536,SYN 100,C01,490789,Staff,10,0,20,10
1713348433562,SYN 150,A00,490817,Staff,14,0,15,1
1713348433562,SYN 150,B00,514610,Staff,15,0,15,0
1713348434597,TDAC 1,A00,492753,Walsh; Kim C.,19,0,20,1
1713348434597,TDAC 1,B00,492754,Harting; Carla Kelso,18,0,20,2
1713348434597,TDAC 1,C00,513995,Salovey; Todd,15,0,20,5
1713348435622,TDAC 101,A00,492766,Harting; Carla Kelso,17,0,20,3
1713348436731,TDAC 102,A00,492768,Basso; Beatrice,19,0,20,1
1713348437757,TDDE 111,A00,492769,Staff,25,0,25,0
1713348438783,TDDE 131,A00,492770,Staff,15,0,15,0
1713348438783,TDDE 131,B00,492771,Staff,15,0,15,0
1713348439809,TDDE 131GS,A00,523716,Guirguis; Mark C,23,0,28,5
1713348440836,TDGE 1,A01,492756,Salovey; Todd,56,0,60,4
1713348441919,TDGE 5,A01,492758,Staff,23,0,25,2
1713348442945,TDGE 10,A00,492759,Fulton; Julia,203,0,220,17
1713348443972,TDGE 11,A00,492760,Castro; Robert Jess,198,0,200,2
1713348446025,TDGE 124,A00,492772,Fulton; Julia,180,0,220,40
1713348447172,TDGE 125,A00,492773,Meyer; Ursula,38,0,50,12
1713348447172,TDGE 125,B00,492774,Staff,49,0,50,1
1713348447172,TDGE 125,C00,523565,Staff,48,0,50,2
1713348448197,TDGE 125GS,A00,523580,Guirguis; Mark C,23,0,28,5
1713348449223,TDGE 127,A00,492775,Havis; Allan,33,0,50,17
1713348450251,TDHT 101,A00,492776,Staff,34,0,35,1
1713348451282,TDMV 1,A00,492762,Caligagan; Maria T.,29,0,30,1
1713348451282,TDMV 1,B00,492763,Arcidiacono; Kristin,26,0,30,4
1713348452308,TDMV 2,A00,492764,Weinberg; Sadie,27,0,30,3
1713348453373,TDMV 3,A00,492765,Mack; Kara Shanai',37,0,40,3
1713348454407,TDMV 138,A00,492777,Mack; Kara Shanai',32,0,40,8
1713348455434,TDMV 140,A00,492778,Lima; Paulo Henrique,40,0,40,0
1713348456467,TDMV 142,A00,492779,Caligagan; Maria T.,33,0,40,7
1713348456467,TDMV 142,B00,492780,Caligagan; Tony,37,0,40,3
1713348457499,TDMV 143,A00,492781,Fyall; Daunte Edward,39,0,40,1
1713348458548,USP 1,A01,492401,Kwak; Nancy,27,0,35,8
1713348459574,USP 2,A01,492453,Hinds; Juli Beth,35,0,35,0
1713348460604,USP 3,A01,492516,Staff,28,0,35,7
1713348461635,USP 4,A00,492522,McTague; Sarah,16,0,25,9
1713348462664,USP 100,A00,492523,Staff,32,0,35,3
1713348463699,USP 101,A00,492524,Staff,13,0,15,2
1713348464728,USP 105,A00,492525,Staff,21,0,25,4
1713348465753,USP 151,A00,492526,Shenkman; Michael Thomas,32,0,35,3
1713348466782,USP 170,A00,492545,Hinds; Juli Beth,32,0,35,3
1713348467807,USP 171GS,A00,492608,Bussell; Mirle Rabinowitz,24,0,28,4
1713348468832,USP 183GS,A00,492613,Peerson; Susan,24,0,28,4
1713348469858,VIS 30,A01,490693,Yoldas; Pinar,19,0,22,3
1713348469858,VIS 30,A02,490694,Yoldas; Pinar,18,0,22,4
1713348470900,VIS 83,A00,490695,Kester; Grant,63,0,75,12
1713348471926,VIS 105D,A00,490696,Staff,22,0,25,3
1713348472952,VIS 124CN,A00,490699,Rose; Jordan M,64,0,75,11
1713348473982,VIS 125GS,A00,511221,Williams; Alena J,21,0,22,1
1713348475008,VIS 128D,A00,490700,Staff,73,0,75,2
1713348476032,VIS 151,A01,490717,Staff,33,0,34,1
1713348476032,VIS 151,A02,490766,Staff,32,0,34,2
1713348477061,VIS 154GS,A00,511972,Williams; Alena J,21,0,22,1
1713348478104,VIS 160A,A00,490767,Stone; Patricia,7,0,10,3
1713348479135,WCWP 10A,A00,490638,Staff,14,0,15,1
1713348479135,WCWP 10A,B00,490640,Staff,15,0,15,0
1713348480162,WCWP 10B,A00,490641,Staff,0,0,0,0
1713348480162,WCWP 10B,B00,490642,Staff,14,0,15,1
1713348480162,WCWP 10B,C00,490644,Staff,13,0,15,2
1713348480162,WCWP 10B,D00,490647,Staff,0,0,0,0
1713348481187,WCWP 100,A00,490655,Staff,0,0,0,0
1713348481187,WCWP 100,B00,490687,Staff,10,0,15,5
1713348483277,ANAR 153,A00,487222,Braswell; Geoffrey E.,53,0,60,7
1713348484302,ANBI 134,A00,487223,Staff,5,0,20,15
1713348485328,ANBI 143GS,A00,487224,Noel; Geoffroy Pierre Jean,18,0,24,6
1713348486356,ANBI 144GS,A00,519548,Noel; Geoffroy Pierre Jean,18,0,24,6
1713348487386,ANSC 101,A00,487225,Staff,17,0,20,3
1713348488415,ANSC 125,A00,487227,Brenner; Suzanne A,38,0,40,2
1713348490467,ANSC 146,A00,487229,Staff,35,0,40,5
1713348491493,ANSC 148,A00,487230,Olivas Hernandez; Olga Lid,39,0,40,1
1713348492520,ANSC 150,A00,504165,Sloane; Julia Kathryn,18,0,20,2
1713348493546,ANSC 180,A00,487232,Staff,14,0,15,1
1713348494572,ANSC 188,A00,627155,Staff,37,0,40,3
1713348495601,ANTH 5,A00,519529,Semendeferi; Ekaterini,15,0,15,0
1713348496625,ANTH 10,A00,487219,Staff,58,0,60,2
1713348497651,ANTH 23,A01,487221,Staff,17,0,20,3
1713348498677,ANTH 102,A00,487233,Wilder; Linnea Lorene,49,0,60,11
1713348499706,ANTH 103,A00,487234,Varma; Saiba,54,0,60,6
1713348500736,ANTH 105,A00,487235,Stewart; Alexander B,54,0,60,6
1713348501762,BENG 100,A01,516685,Taylor Amos; Alyssa C,25,0,30,5
1713348502817,BIBC 102,A01,491316,Flagg; Matthew Paul,4,0,88,84
1713348502817,BIBC 102,A02,491366,Flagg; Matthew Paul,78,0,88,10
1713348503851,BIBC 103,A01,491486,Boumechache; Miyyada,16,0,24,8
1713348503851,BIBC 103,A02,491487,Boumechache; Miyyada,24,0,24,0
1713348504883,BICD 100,A01,516882,Staff,72,0,75,3
1713348504883,BICD 100,A02,516890,Staff,69,0,75,6
1713348505909,BICD 102GS,A00,491488,Lo; Stanley M.,26,0,28,2
1713348506939,BIEB 136GS,A00,516940,Holway; David A. & Shurin; Jonathan,18,0,24,6
1713348507965,BIEB 137GS,A01,517034,Holway; David A. & Shurin; Jonathan,18,0,24,6
1713348508991,BIEB 138GS,A01,491492,Pirino; Giorgia,21,0,28,7
1713348510021,BILD 1,A01,491296,Staff,60,0,63,3
1713348510021,BILD 1,A02,491297,Staff,63,0,63,0
1713348511049,BILD 4,A01,517099,Gonzalez Gamboa; Ivonne,22,0,24,2
1713348511049,BILD 4,A02,517100,Gonzalez Gamboa; Ivonne,24,0,24,0
1713348512077,BILD 60GS,A00,491309,Lo; Stanley M.,26,0,28,2
1713348513104,BIMM 100,A01,517136,Staff,82,0,100,18
1713348514199,BIMM 110,A01,517182,Staff,52,0,100,48
1713348515227,BIMM 120,A01,517228,Pickett; Brooke Elizabeth,28,0,63,35
1713348515227,BIMM 120,A02,517240,Pickett; Brooke Elizabeth,44,0,63,19
1713348516251,BIMM 132GS,A01,491498,Pirino; Giorgia,21,0,28,7
1713348517283,BIMM 143,A01,491589,Bozinovic; Goran,12,0,40,28
1713348518313,BIPN 100,A01,491594,Armour; Jon Christopher,83,0,100,17
1713348519338,BIPN 140,A01,491602,Marino; Marc J,23,0,50,27
1713348521468,CAT 125,A00,515973,Staff,18,0,20,2
1713348522496,CAT 125GS,A00,515974,Rahimi; Babak,16,0,20,4
1713348523528,CAT 125R,A00,515980,Staff,12,0,20,8
1713348523528,CAT 125R,B00,515981,Tosun; Adriana,19,0,20,1
1713348523528,CAT 125R,C00,515987,Hyland; Tina Mae,0,5,20,20
1713348523528,CAT 125R,D00,515988,Bronstein; Phoebe Malan,16,0,20,4
1713348524558,CENG 15,A01,488699,Drews; Aaron,25,0,25,0
1713348525594,CENG 100,A00,505196,Opatkiewicz; Justin Paul,25,0,25,0
1713348526622,CGS 2A,A01,489598,Staff,32,0,35,3
1713348527651,CGS 112,A00,489599,Staff,15,0,15,0
1713348528677,CGS 119,A00,489603,Staff,10,0,10,0
1713348529705,CGS 120,A00,489604,Staff,13,0,15,2
1713348530729,CGS 150,A00,489607,Staff,15,0,15,0
1713348531755,CHEM 6A,A01,488715,Staff,97,0,100,3
1713348532779,CHEM 6B,A01,488719,Piercy; Marc Anthony,99,0,100,1
1713348533809,CHEM 6C,A01,488723,Albizati; Kim F.,93,0,100,7
1713348534838,CHEM 7L,A01,488728,Schurmeier; Kimberly,18,0,24,6
1713348534838,CHEM 7L,A02,488730,Schurmeier; Kimberly,23,0,24,1
1713348534838,CHEM 7L,A03,488734,Schurmeier; Kimberly,20,0,24,4
1713348534838,CHEM 7L,A04,488763,Schurmeier; Kimberly,23,0,24,1
1713348534838,CHEM 7L,B01,488798,Schurmeier; Kimberly,16,0,24,8
1713348534838,CHEM 7L,B02,488801,Schurmeier; Kimberly,22,0,24,2
1713348534838,CHEM 7L,B03,488808,Schurmeier; Kimberly,22,0,24,2
1713348534838,CHEM 7L,B04,488811,Schurmeier; Kimberly,24,0,24,0
1713348535864,CHEM 11,A01,488897,Stallings; Dontarie M,94,0,100,6
1713348536889,CHEM 40A,A01,488913,Albizati; Kim F.,83,0,100,17
1713348537914,CHEM 40B,A01,488920,Weizman; Haim,42,0,50,8
1713348537914,CHEM 40B,A02,488938,Weizman; Haim,43,0,50,7
1713348538943,CHEM 41A,A01,489029,Klosterman; Jeremy K,57,0,60,3
1713348540059,CHEM 41C,A01,500436,Tor; Yitzhak,54,0,60,6
1713348541088,CHEM 43A,A01,500426,Weizman; Haim,0,1,24,24
1713348541088,CHEM 43A,A02,500430,Weizman; Haim,6,0,24,18
1713348541088,CHEM 43A,B01,514041,Klosterman; Jeremy K,14,0,24,10
1713348541088,CHEM 43A,B02,514047,Klosterman; Jeremy K,23,0,24,1
1713348542120,CHEM 108,A01,489140,Jennings; Patricia A.,6,0,24,18
1713348542120,CHEM 108,A02,489142,Jennings; Patricia A.,14,0,24,10
1713348543160,CHEM 114A,A01,489147,Stallings; Dontarie M,65,0,100,35
1713348544187,CHIN 169A,A00,489171,Wang; Xiao,19,0,20,1
1713348546244,COGS 3,A01,518827,Boyle; Mary E. T.,25,0,40,15
1713348547271,COGS 11,A01,489175,Staff,27,0,30,3
1713348548302,COGS 14A,A01,518829,Staff,50,0,60,10
1713348549331,COGS 14B,A01,489177,Hoffman; Drew Ellen,62,0,75,13
1713348550362,COGS 100,A01,489181,Allen; Michael Gordon,62,0,75,13
1713348551388,COGS 101A,A01,489183,Staff,45,0,60,15
1713348552422,COGS 101B,A01,489185,Allen; Michael Gordon,6,0,30,24
1713348553449,COGS 101C,A01,526786,Staff,23,0,30,7
1713348555499,COGS 107A,A01,489189,Boyle; Mary E. T.,16,0,35,19
1713348556528,COGS 107B,A01,627144,Mooshagian; Eric Frederick,59,0,60,1
1713348557554,COGS 118A,A01,489191,Staff,0,46,40,40
1713348559605,COGS 171GS,A01,489194,Pineda; Jaime A,19,0,28,9
1713348560631,COGS 172,A01,489196,Staff,1,0,30,29
1713348561656,COGS 174GS,A01,489264,Pineda; Jaime A,19,0,28,9
1713348562686,COGS 180,A01,627150,Staff,28,0,30,2
1713348563715,COGS 186,A01,489274,Staff,0,3,30,30
1713348564744,COMM 10,A01,489276,Staff,23,0,25,2
1713348564744,COMM 10,A02,489303,Staff,23,0,25,2
1713348565772,COMM 100A,A01,489312,Staff,14,0,25,11
1713348565772,COMM 100A,A02,489313,Staff,24,0,25,1
1713348566810,COMM 106T,A00,512540,Staff,33,0,35,2
1713348567850,COMM 107,A00,489347,Staff,27,0,35,8
1713348568913,COMM 109P,A00,489358,Staff,31,0,35,4
1713348569943,COMM 132,A00,489361,McKenna; Denise,27,0,30,3
1713348570973,COMM 146,A00,489362,Halm; Gavin Patrick,26,0,30,4
1713348572002,COMM 190,A00,489363,Abuelhiga; Soraya Jill,17,0,23,6
1713348573037,CSE 8A,A50,489366,Staff,21,0,25,4
1713348573037,CSE 8A,A51,489367,Staff,24,0,25,1
1713348574064,CSE 11,A01,489398,Cao; Yingjun,72,0,100,28
1713348575092,CSE 12,A01,489487,Staff,43,0,50,7
1713348576117,CSE 20,A01,489497,Staff,47,0,50,3
1713348577144,CSE 21,A01,489517,Braun; Oliver,42,0,50,8
1713348578167,CSE 101,A01,489524,Braun; Oliver,0,35,50,50
1713348579200,CSE 105,A01,512594,Jones; Miles E,72,0,100,28
1713348579200,CSE 105,B01,512598,Jones; Miles E,51,0,100,49
1713348580226,CSE 140,A01,489538,Staff,39,0,50,11
1713348581257,CSE 141,A01,489550,Eldon; John,67,0,100,33
1713348582283,CSE 141L,A01,489571,Eldon; John,65,0,100,35
1713348583311,CSE 151A,A01,489583,Solares; Edwin A,139,0,200,61
1713348584339,CSE 175,A01,510886,Kumar; Rakesh,30,0,30,0
1713348585369,CSE 190,A00,516828,Dubnov; Shlomo,37,0,49,12
1713348586451,DOC 100D,A00,489667,Pass; Natalye Joann,19,0,25,6
1713348587483,DSC 10,A01,624268,Staff,72,0,75,3
1713348588511,DSC 20,A01,624476,Staff,50,0,50,0
1713348589539,DSC 40A,A01,624608,Staff,39,0,40,1
1713348590567,DSGN 1,A01,489179,Rill; Bryan,32,0,50,18
1713348591594,ECE 17,A01,490489,Sahay; Rajeev,18,0,30,12
1713348592620,ECE 65,A50,490492,Staff,11,0,20,9
1713348592620,ECE 65,A51,490493,Staff,18,0,20,2
1713348593646,ECON 1,A01,489715,Famulari; Melissa,67,0,70,3
1713348594672,ECON 2,A01,489717,Levkoff; Steven B.,67,0,70,3
1713348595697,ECON 3,A01,489948,Staff,70,0,70,0
1713348597792,ECON 5,A01,490103,Staff,27,0,30,3
1713348597792,ECON 5,B01,626281,Dai; Yinlin,45,0,45,0
1713348598818,ECON 100A,A01,490127,Famulari; Melissa,62,0,70,8
1713348599849,ECON 100B,A01,490129,Staff,64,0,70,6
1713348600880,ECON 109,A01,490187,Shishkin; Denis,27,0,35,8
1713348601909,ECON 110A,A01,490190,Levkoff; Steven B.,59,0,70,11
1713348602942,ECON 120A,A01,490245,Dai; Yinlin,59,0,70,11
1713348603993,ECON 120B,A01,490247,Nieto-Barthaburu; Augusto,40,0,70,30
1713348605022,ECON 120C,A01,490253,Sun; Yixiao,30,0,35,5
1713348605022,ECON 120C,B01,490255,Sun; Yixiao,34,0,35,1
1713348606063,ECON 129,A00,490256,Eckert; Fabian Paul,22,0,35,13
1713348607096,ECON 131,A00,490257,Nieto-Barthaburu; Augusto,0,6,35,35
1713348608141,ECON 138,A00,490258,Bharadwaj; Prashant,13,0,35,22
1713348608141,ECON 138,B00,490259,Bharadwaj; Prashant,15,0,35,20
1713348609167,ECON 159,A00,490260,Hendrickson; Gerald M.,0,9,0,0
1713348610198,ECON 178,A01,553995,Zhu; Ying,24,0,35,11
1713348611281,EDS 40,A01,512576,Black; Alison Michelle,20,0,20,0
1713348612311,EDS 107,A01,515848,Staff,30,0,30,0
1713348613336,EDS 110R,A01,490262,Staff,26,0,30,4
1713348614367,EDS 112,A01,490264,Chapman; Thandeka K,40,0,50,10
1713348615391,EDS 113,A00,490266,Staff,25,0,30,5
1713348616418,EDS 118,A00,490267,Warstadt; Melissa Fawn,18,0,30,12
1713348617445,EDS 124BR,A00,490268,Eguchi; Emi,4,0,25,21
1713348617445,EDS 124BR,B00,490269,Eguchi; Emi,23,0,25,2
1713348618471,EDS 126,A01,490271,Jones; Makeba,43,0,50,7
1713348619503,EDS 135,A01,490316,Staff,19,0,20,1
1713348620533,ENVR 142GS,A00,519514,Chang; Edmond Yi-Teh,26,0,28,2
1713348621571,ETHN 103,A00,490504,Staff,24,0,36,12
1713348622596,ETHN 103A,A00,490505,Man; Simeon S,3,0,9,6
1713348623623,ETHN 109,A00,490506,Staff,28,0,30,2
1713348624650,ETHN 118,A00,490507,Staff,35,0,36,1
1713348625731,ETHN 119,A00,490508,Staff,32,0,36,4
1713348626759,ETHN 121R,A00,490518,Choi; Esther Min,21,0,36,15
1713348627785,ETHN 127,A00,490528,Staff,14,0,15,1
1713348628811,ETHN 139,A00,490573,Staff,10,0,10,0
1713348629842,ETHN 150,A00,490575,Staff,15,0,15,0
1713348630871,GLBH 20,A00,491705,Elwardani; Nile Regina,38,0,40,2
1713348631897,GLBH 101,A00,491706,Staff,20,0,20,0
1713348632925,GLBH 111,A01,491708,Burgos; Jose L.,15,0,15,0
1713348633951,GLBH 146,A00,491709,Staff,8,0,20,12
1713348634976,GLBH 148,A00,491710,Olivas Hernandez; Olga Lid,10,0,20,10
1713348636002,GLBH 150,A00,491711,Sloane; Julia Kathryn,19,0,20,1
1713348637027,HIEA 131,A00,491760,Staff,28,0,32,4
1713348638052,HIEA 153,A00,491762,Staff,28,0,30,2
1713348639080,HIEU 124,A00,491811,Staff,26,0,32,6
1713348640110,HIEU 124GS,A00,491812,Markman; Kristina,27,0,28,1
1713348641141,HIEU 147,A00,491813,Staff,30,0,32,2
1713348642173,HIEU 149GS,A00,491816,Caldwell; Michael Alan,28,0,28,0
1713348643205,HILD 2C,A01,491713,Hendrickson; Gerald M.,26,0,30,4
1713348644231,HILD 7B,A01,491715,Kwak; Nancy,0,3,30,30
1713348645257,HILD 10,A01,491717,Staff,9,0,20,11
1713348646282,HILD 30GS,A00,491719,Edington; Claire Ellen,23,0,28,5
1713348647311,HINE 109,A00,491818,Shafir; Nir,26,0,32,6
1713348648336,HINE 128,A00,491821,Shafir; Nir,30,0,32,2
1713348649361,HISC 117,A00,491830,Staff,27,0,32,5
1713348650386,HIUS 103,A00,491834,Man; Simeon S,14,0,23,9
1713348651412,HIUS 108B,A00,491835,Staff,27,0,30,3
1713348652441,HIUS 141,A00,491836,Hendrickson; Gerald M.,28,0,32,4
1713348653471,HIUS 149,A00,491839,Staff,24,0,32,8
1713348654500,HUM 3,A01,512617,Crum; Matthew Stephen,42,0,50,8
1713348654500,HUM 3,A02,512618,Crum; Matthew Stephen,48,0,50,2
1713348655526,HUM 3GS,A00,512663,Markman; Kristina,0,0,0,1
1713348655526,HUM 3GS,B00,512664,Staff,0,0,0,0
1713348656552,HUM 4,A01,512620,West; Geoffrey Scott,23,0,50,27
1713348657582,HUM 4GS,A00,512666,Lyon; Antony J.,0,0,0,5
1713348658608,HUM 4R,A01,512625,Watkins; Eric,49,0,50,1
1713348659640,HUM 5,A01,512649,Zavodny; Tatiana Sophia,20,0,50,30
1713348659640,HUM 5,B01,512661,Zroka; Ryan Edward,48,0,50,2
1713348660695,INTL 190,A00,490577,Segui; Alan S,0,0,0,5
1713348661730,JAPN 20AR,A01,491267,Ross; Kayoko F,7,0,20,13
1713348662755,JAPN 180,A00,491285,Berman; Michael David,33,0,40,7
1713348663788,LATI 50,A01,502536,Kokinis; Troy Andreas,16,0,22,6
1713348663788,LATI 50,A02,502551,Kokinis; Troy Andreas,22,0,22,0
1713348663788,LATI 50,A03,502650,Kokinis; Troy Andreas,22,0,22,0
1713348663788,LATI 50,A04,502909,Kokinis; Troy Andreas,21,0,22,1
1713348664814,LATI 160,A01,502920,Kokinis; Troy Andreas,30,0,30,0
1713348665860,LIFR 1A,A00,490494,Van Moer; Vinciane G,17,0,20,3
1713348666886,LIFR 1AX,A00,490495,Van Moer; Vinciane G,17,0,20,3
1713348667913,LIFR 1B,A00,490496,Van Moer; Vinciane G,17,0,20,3
1713348668942,LIFR 1BX,A00,490497,Van Moer; Vinciane G,17,0,20,3
1713348669969,LIGN 8,A00,505198,McIntosh; Justin Daniel,134,0,150,16
1713348670996,LIGN 9GS,A00,491239,Lott; Margaret S.,18,0,20,2
1713348672027,LIGN 101,A01,505200,McIntosh; Justin Daniel,22,0,30,8
1713348673056,LIGN 120,A01,491244,Staff,22,0,30,8
1713348674083,LIGN 149GS,A00,491245,Lott; Margaret S.,18,0,20,2
1713348675112,LIGN 170,A00,491247,Staff,22,0,30,8
1713348676136,LISP 1D,A00,490498,Munoz Sanchez; Alicia,8,0,14,6
1713348676136,LISP 1D,B00,490499,Munoz Sanchez; Alicia,4,0,14,10
1713348676136,LISP 1D,C00,490500,Munoz Sanchez; Alicia,7,0,14,7
1713348676136,LISP 1D,D00,490501,Munoz Sanchez; Alicia,10,0,14,4
1713348677161,LISP 1DX,A00,490502,Munoz Sanchez; Alicia,11,0,28,17
1713348677161,LISP 1DX,B00,490503,Munoz Sanchez; Alicia,16,0,28,12
1713348679213,LTAM 110,A00,491847,Staff,22,0,25,3
1713348680239,LTCS 119,A00,491848,Staff,11,0,15,4
1713348681266,LTCS 130,A00,491849,Staff,24,0,25,1
1713348683323,LTEA 120C,A00,491852,Staff,32,0,40,8
1713348684351,LTEN 130GS,A00,491853,Lyon; Antony J.,23,0,28,5
1713348685381,LTEN 148,A00,491855,Staff,23,0,25,2
1713348686409,LTEN 159,A00,491856,Staff,20,0,25,5
1713348687434,LTEN 180,A00,491857,Staff,8,0,15,7
1713348689490,LTSP 123GS,A00,505928,Bessett; Ryan Matthew,24,0,28,4
1713348690516,LTSP 174GS,A00,506037,Bessett; Ryan Matthew,24,0,28,4
1713348692570,LTWR 102,A00,491861,Staff,9,0,15,6
1713348693603,LTWR 106,A00,491862,Staff,8,0,15,7
1713348694630,MAE 11,A00,490930,Bahadori; Mohammad Yousef,94,0,100,6
1713348695663,MAE 30A,A00,490931,Qi; Huihui,37,0,40,3
1713348696692,MAE 101A,A00,491036,Sadeghizadeh; Zahra,91,0,100,9
1713348697717,MAE 101C,A00,491037,Seshadri; Kalyanasundaram,63,0,100,37
1713348698742,MAE 113,A00,491040,Seshadri; Kalyanasundaram,64,0,80,16
1713348699768,MAE 131A,A00,491041,Ghazinejad; Maziar,37,0,40,3
1713348700793,MAE 142,A00,491053,Staff,39,0,40,1
1713348701819,MAE 143A,A00,491054,Staff,29,0,50,21
1713348702849,MAE 150,A00,491092,Truong; Phuong Thi Ngoc,23,0,35,12
1713348703874,MATH 3C,A01,494031,Pardo Guerra; Sebastian,30,0,30,0
1713348703874,MATH 3C,A02,494032,Pardo Guerra; Sebastian,29,0,30,1
1713348704905,MATH 10A,A01,494034,Staff,27,0,30,3
1713348704905,MATH 10A,A02,494035,Staff,28,0,30,2
1713348704905,MATH 10A,B01,494037,Staff,27,0,30,3
1713348704905,MATH 10A,B02,494038,Staff,29,0,30,1
1713348705946,MATH 10B,A01,494040,Habib; Yousaf,22,0,30,8
1713348705946,MATH 10B,A02,494041,Habib; Yousaf,28,0,30,2
1713348705946,MATH 10B,A03,494042,Habib; Yousaf,29,0,30,1
1713348705946,MATH 10B,A04,494043,Habib; Yousaf,30,0,30,0
1713348705946,MATH 10B,B01,494045,Habib; Yousaf,25,0,30,5
1713348705946,MATH 10B,B02,494046,Habib; Yousaf,30,0,30,0
1713348705946,MATH 10B,B03,494047,Habib; Yousaf,30,0,30,0
1713348705946,MATH 10B,B04,494048,Habib; Yousaf,30,0,30,0
1713348706974,MATH 18,A01,494050,Kemp; Todd Aahron,25,0,30,5
1713348706974,MATH 18,A02,494051,Kemp; Todd Aahron,29,0,30,1
1713348706974,MATH 18,B01,494054,Kemp; Todd Aahron,25,0,30,5
1713348706974,MATH 18,B02,494055,Kemp; Todd Aahron,29,0,30,1
1713348708001,MATH 20A,A01,494059,Suk; Andrew Hoon,30,0,30,0
1713348709028,MATH 20B,A01,494061,Briones; Jor-el Thomas Caparas,33,0,35,2
1713348709028,MATH 20B,B01,494063,Bach; Quang Tran,34,0,35,1
1713348710056,MATH 20C,A01,494065,Staff,28,0,30,2
1713348710056,MATH 20C,A02,494066,Staff,30,0,30,0
1713348710056,MATH 20C,A03,494067,Staff,30,0,30,0
1713348710056,MATH 20C,A04,494068,Staff,30,0,30,0
1713348710056,MATH 20C,B01,494070,Zhang; Ming,23,0,30,7
1713348710056,MATH 20C,B02,494071,Zhang; Ming,27,0,30,3
1713348710056,MATH 20C,B03,494072,Zhang; Ming,29,0,30,1
1713348710056,MATH 20C,B04,494073,Zhang; Ming,29,0,30,1
1713348711080,MATH 20D,A01,494075,Staff,22,0,30,8
1713348711080,MATH 20D,A02,494076,Staff,29,0,30,1
1713348712107,MATH 20E,A01,494079,Staff,24,0,30,6
1713348712107,MATH 20E,A02,494080,Staff,26,0,30,4
1713348712107,MATH 20E,B01,494082,Staff,25,0,30,5
1713348712107,MATH 20E,B02,494083,Staff,25,0,30,5
1713348713134,MATH 103A,A01,494085,Aliabadi Sr.; Mohsen,12,0,30,18
1713348713134,MATH 103A,A02,494086,Aliabadi Sr.; Mohsen,28,0,30,2
1713348713134,MATH 103A,B01,494088,Aliabadi Sr.; Mohsen,20,0,30,10
1713348713134,MATH 103A,B02,494089,Aliabadi Sr.; Mohsen,27,0,30,3
1713348714161,MATH 109,A01,494091,Staff,30,0,30,0
1713348714161,MATH 109,A02,494092,Staff,29,0,30,1
1713348714161,MATH 109,B01,494094,Staff,27,0,30,3
1713348714161,MATH 109,B02,494095,Staff,29,0,30,1
1713348715190,MATH 142A,A01,494097,Chow; Bennett,13,0,30,17
1713348715190,MATH 142A,A02,494098,Chow; Bennett,23,0,30,7
1713348715190,MATH 142A,B01,494100,Chow; Bennett,19,0,30,11
1713348715190,MATH 142A,B02,494101,Chow; Bennett,29,0,30,1
1713348717240,MATH 168A,A01,516677,Dumitriu; Ioana,16,0,35,19
1713348718267,MATH 170A,A01,516679,Dumitriu; Ioana,18,0,30,12
1713348718267,MATH 170A,A02,516680,Dumitriu; Ioana,28,0,30,2
1713348719295,MATH 193A,A01,494107,Staff,12,0,30,18
1713348719295,MATH 193A,A02,494108,Staff,18,0,30,12
1713348719295,MATH 193A,A03,494109,Staff,29,0,30,1
1713348719295,MATH 193A,A04,494110,Staff,22,0,30,8
1713348722381,MGT 16,A00,491930,McKay; Michael J,92,0,98,6
1713348723412,MGT 18,A00,491992,McKay; Michael J,96,0,98,2
1713348724436,MGT 71,A00,492003,Staff,63,0,98,35
1713348725460,MGT 103,A00,505209,Eberhard; Craig A,80,0,98,18
1713348726486,MGT 131A,A00,505210,Anderson; John Charles,89,0,98,9
1713348728548,MGT 153,A00,492077,Perols; Johan Lars,15,0,90,75
1713348731682,MGT 164,A00,492222,McKay; Mary A,91,0,98,7
1713348732750,MGT 172,A00,492245,Staff,59,0,60,1
1713348732750,MGT 172,B00,505526,Hedges; Kathleen,65,0,98,33
1713348733778,MGT 181,A00,505669,Dunn; Louis Jean,78,0,98,20
1713348734807,MMW 14,A01,494399,Staff,15,0,28,13
1713348734807,MMW 14,A02,494400,Staff,25,0,28,3
1713348734807,MMW 14,A03,494401,Staff,28,0,28,0
1713348734807,MMW 14,A04,494402,Staff,28,0,28,0
1713348734807,MMW 14,B01,494404,Carreras; Maria Victoria,8,0,28,20
1713348734807,MMW 14,B02,494405,Carreras; Maria Victoria,25,0,28,3
1713348734807,MMW 14,B03,494406,Carreras; Maria Victoria,27,0,28,1
1713348734807,MMW 14,B04,494407,Carreras; Maria Victoria,28,0,28,0
1713348735837,MMW 14GS,A00,506250,Chang; Edmond Yi-Teh,0,0,0,0
1713348736862,MMW 121R,A01,494415,Adamiak; Patrick John,9,0,28,19
1713348736862,MMW 121R,A02,494416,Adamiak; Patrick John,24,0,28,4
1713348737893,MUS 1A,A01,494113,Staff,12,0,25,13
1713348737893,MUS 1A,A02,494114,Staff,24,0,25,1
1713348738927,MUS 4,A01,494116,Staff,23,0,25,2
1713348738927,MUS 4,A02,494117,Staff,22,0,25,3
1713348739955,MUS 5R,A01,494236,Dubnov; Shlomo,4,0,25,21
1713348739955,MUS 5R,A02,494237,Dubnov; Shlomo,25,0,25,0
1713348740985,MUS 6,A01,494122,Staff,9,0,25,16
1713348740985,MUS 6,A02,494123,Staff,23,0,25,2
1713348742011,MUS 7,A01,494125,Staff,16,0,25,9
1713348742011,MUS 7,A02,494126,Staff,24,0,25,1
1713348743037,MUS 11,A01,494128,Staff,23,0,25,2
1713348743037,MUS 11,A02,494129,Staff,24,0,25,1
1713348744063,MUS 13,A01,494131,Staff,25,0,25,0
1713348744063,MUS 13,A02,494132,Staff,25,0,25,0
1713348745117,MUS 15,A01,494134,Staff,16,0,25,9
1713348745117,MUS 15,A02,494135,Staff,25,0,25,0
1713348745117,MUS 15,B01,494137,Staff,24,0,25,1
1713348746148,MUS 80,A00,494232,Staff,24,0,25,1
1713348746148,MUS 80,B00,494233,Staff,25,0,25,0
1713348746148,MUS 80,C00,494234,Staff,23,0,25,2
1713348747177,MUS 95C,A00,494141,Staff,69,0,75,6
1713348748203,MUS 114,A00,494142,Staff,39,0,50,11
1713348749229,NANO 15,A01,490636,Drews; Aaron,7,0,7,0
1713348750264,PHIL 1,A00,490578,Grush; Rick Scott,49,0,50,1
1713348751290,PHIL 10,A01,490580,Grush; Rick Scott,33,0,35,2
1713348751290,PHIL 10,A02,490586,Grush; Rick Scott,32,0,35,3
1713348752317,PHIL 27,A01,490591,Staff,22,0,25,3
1713348752317,PHIL 27,A02,490592,Staff,25,0,25,0
1713348752317,PHIL 27,A03,490593,Staff,25,0,25,0
1713348752317,PHIL 27,A04,490598,Staff,25,0,25,0
1713348753346,PHIL 32,A01,490611,Staff,20,0,20,0
1713348753346,PHIL 32,A02,490618,Staff,20,0,20,0
1713348754370,PHIL 90,A00,490624,Staff,40,0,40,0
1713348755400,PHIL 136,A00,490627,Cohen; Jonathan David,37,0,40,3
1713348756427,PHIL 155,A00,490634,Staff,61,0,70,9
1713348757476,PHYS 1A,A00,491610,Staff,245,0,250,5
1713348758504,PHYS 1AL,001,491616,Tsai; Philbert S,27,0,30,3
1713348758504,PHYS 1AL,002,491618,Tsai; Philbert S,30,0,30,0
1713348759533,PHYS 1B,A00,491623,Staff,235,0,250,15
1713348760559,PHYS 1BL,001,491626,Tsai; Philbert S,18,0,30,12
1713348760559,PHYS 1BL,002,491628,Tsai; Philbert S,26,0,30,4
1713348761588,PHYS 1C,A00,491632,Staff,211,0,245,34
1713348762613,PHYS 1CL,001,491635,Tsai; Philbert S,2,0,30,28
1713348762613,PHYS 1CL,002,491643,Tsai; Philbert S,22,0,30,8
1713348763641,PHYS 2AR,A01,491651,Meyertholen; Andrew D.,44,0,50,6
1713348764672,PHYS 2B,A01,491659,Staff,105,0,115,10
1713348765698,PHYS 2BL,A01,491685,Staff,21,0,24,3
1713348765698,PHYS 2BL,A02,491700,Staff,21,0,24,3
1713348766734,PHYS 2C,A01,505161,Staff,101,0,115,14
1713348768427,PHYS 4A,A01,491704,Grinstein; Benjamin,99,0,100,1
1713348769460,POLI 5D,A01,494144,Staff,3,0,5,2
1713348769460,POLI 5D,B01,626283,Dai; Yinlin,5,0,5,0
1713348770490,POLI 12,A00,494145,Staff,43,0,45,2
1713348771515,POLI 13R,A00,494146,Forman; Fonna,45,0,50,5
1713348772539,POLI 27,A01,494148,Staff,54,0,60,6
1713348773567,POLI 30,A00,494149,Staff,49,0,50,1
1713348774593,POLI 100DA,A00,494150,Staff,20,0,25,5
1713348776644,POLI 100I,A00,494152,Staff,27,0,30,3
1713348777671,POLI 104B,A00,494153,Smith; Glenn Chatmas,53,0,55,2
1713348778697,POLI 104F,A00,494154,Staff,28,0,30,2
1713348779727,POLI 104I,A00,494155,Smith; Glenn Chatmas,29,0,30,1
1713348780758,POLI 110C,A00,494156,Ingham; Sean,23,0,25,2
1713348781787,POLI 117R,A00,494157,Forman; Fonna,5,0,20,15
1713348782815,POLI 118,A00,494158,Ingham; Sean,21,0,25,4
1713348783841,POLI 120H,A00,494159,Fisk; David Lee,39,0,45,6
1713348784869,POLI 131CR,A00,494160,Hoston; Germaine,35,0,45,10
1713348785898,POLI 133J,A00,494161,Staff,31,0,35,4
1713348786929,POLI 135,A00,494162,Fisk; David Lee,33,0,35,2
1713348787958,POLI 140A,A00,494164,Staff,18,0,30,12
1713348788986,POLI 142I,A00,494165,Staff,30,0,30,0
1713348790010,POLI 144D,A00,494166,Staff,22,0,25,3
1713348791071,POLI 151,A00,494167,Staff,30,0,30,0
1713348792095,POLI 153,A00,494168,Staff,33,0,35,2
1713348793123,POLI 160AA,A00,494169,Staff,33,0,40,7
1713348794154,POLI 162,A00,494170,Mignozzetti; Umberto,17,0,25,8
1713348795178,POLI 171,A00,494171,Mignozzetti; Umberto,18,0,25,7
1713348796203,PSYC 1,A00,494172,Staff,95,0,100,5
1713348797230,PSYC 2,A00,494173,Moranton; Nirelia Melbina-,33,0,50,17
1713348798255,PSYC 3,A00,494174,Staff,29,0,30,1
1713348799285,PSYC 6,A00,494175,Staff,17,0,20,3
1713348800314,PSYC 60,A01,494177,Staff,37,0,45,8
1713348801348,PSYC 70,A01,505724,Geller; Emma Harlan,42,0,45,3
1713348802373,PSYC 101,A00,494180,Heyman; Gail D.,83,0,100,17
1713348803403,PSYC 105,A00,494181,Geller; Emma Harlan,51,0,90,39
1713348804430,PSYC 106,A00,494182,Dobkins; Karen R.,26,0,45,19
1713348805457,PSYC 108,A00,494183,Adrian; Julia Anna,89,0,100,11
1713348806489,PSYC 114,A01,494185,Winkielman; Piotr,0,4,30,30
1713348807515,PSYC 122,A00,494186,Moranton; Nirelia Melbina-,27,0,50,23
1713348808541,PSYC 124,A00,494187,Chapman; Eddie Nathaniel,69,0,80,11
1713348809567,PSYC 131,A00,494188,Anagnostaras; Stephan,39,0,80,41
1713348810593,PSYC 144,A00,494189,Staff,1,1,50,49
1713348811617,PSYC 154,A00,494190,Lacefield; Katharine I,105,0,180,75
1713348812649,PSYC 162,A00,494191,Wixted; John T,70,0,100,30
1713348813677,PSYC 172,A00,494192,Gorman; Michael R.,36,0,45,9
1713348814706,PSYC 178,A00,494193,Glaser; Dale,32,0,45,13
1713348815734,PSYC 193,A00,505725,Chapman; Eddie Nathaniel,20,0,20,0
1713348816765,RELI 145GS,A00,519817,Rahimi; Babak,17,0,20,3
1713348817797,SE 101A,A01,490862,Chadha; Mayank,23,0,25,2
1713348818827,SE 101C,A01,490924,Krysl; Petr,15,0,20,5
1713348819853,SE 110A,A01,490928,Staff,19,0,20,1
1713348820886,SE 130A,A00,490929,Morrison; Machel Leigh,54,0,70,16
1713348821917,SIO 1,A01,519325,Staff,39,0,40,1
1713348822943,SIO 30,A01,519327,Staff,38,0,40,2
1713348823968,SIO 40,A00,519328,Staff,39,0,40,1
1713348824995,SIO 46GS,A00,519819,Cook; Geoffrey W,15,0,25,10
1713348826028,SIO 109R,A00,494197,Forman; Fonna,0,3,20,20
1713348827056,SIO 121GS,A00,519827,Cook; Geoffrey W,15,0,25,10
1713348828086,SIO 132,A01,519330,Staff,38,0,40,2
1713348829113,SIO 133,A01,519397,Staff,37,0,40,3
1713348830143,SIO 139,A00,519396,Kacev; David,29,0,40,11
1713348831182,SOCI 1,A01,494199,Thorpe; Charles Robert,21,0,30,9
1713348831182,SOCI 1,A02,494200,Thorpe; Charles Robert,30,0,30,0
1713348831182,SOCI 1,A03,494201,Thorpe; Charles Robert,29,0,30,1
1713348831182,SOCI 1,A04,494202,Thorpe; Charles Robert,29,0,30,1
1713348831182,SOCI 1,A05,494203,Thorpe; Charles Robert,29,0,30,1
1713348831182,SOCI 1,A06,494204,Thorpe; Charles Robert,30,0,30,0
1713348831182,SOCI 1,A07,494205,Thorpe; Charles Robert,28,0,30,2
1713348832209,SOCI 60,A01,494207,Staff,33,0,40,7
1713348832209,SOCI 60,A02,494208,Staff,39,0,40,1
1713348833236,SOCI 100,A01,494210,Payne; Christine Anna,25,0,30,5
1713348833236,SOCI 100,A02,494211,Payne; Christine Anna,26,0,30,4
1713348834315,SOCI 109M,A00,494212,Staff,20,0,20,0
1713348835341,SOCI 110,A00,494213,Staff,34,0,40,6
1713348837410,SOCI 118E,A00,494215,Ng; Kwai,37,0,40,3
1713348838435,SOCI 125,A00,494216,Calderon-Zaks; Michael Aar,39,0,45,6
1713348839461,SOCI 126,A01,494218,Jones; Makeba,3,0,5,2
1713348840485,SOCI 131,A00,494219,Thorpe; Charles Robert,25,0,30,5
1713348842544,SOCI 135,A00,494221,Payne; Christine Anna,28,0,50,22
1713348843653,SOCI 136E,A00,626690,Ruiz; Jonathan Joseph,24,0,25,1
1713348844682,SOCI 138GS,A00,494222,Navon; Daniel,23,0,28,5
1713348846733,SOCI 145,A00,494224,Staff,40,0,45,5
1713348847758,SOCI 153,A00,494225,Staff,28,0,30,2
1713348848784,SOCI 160E,A00,494226,Ng; Kwai,27,0,40,13
1713348849809,SOCI 180,A00,494227,Staff,29,0,30,1
1713348850834,SOCI 189GS,A00,494228,Ribas Norris; Janet Vanesa,11,0,11,0
1713348851860,SOCI 190GS,A00,553232,Ribas Norris; Janet Vanesa,11,0,11,0
1713348852887,SOMI 220,A00,627178,Schneid; Stephen David,30,0,30,0
1713348853912,SYN 2,001,490768,Staff,13,0,15,2
1713348853912,SYN 2,002,490769,Staff,14,0,15,1
1713348853912,SYN 2,004,490775,Staff,0,0,0,0
1713348853912,SYN 2,003,490774,Staff,0,0,0,0
1713348853912,SYN 2,005,490776,Staff,0,0,0,0
1713348854945,SYN 2R,001,490779,Staff,10,0,15,5
1713348854945,SYN 2R,002,514635,Staff,14,0,15,1
1713348855976,SYN 100,A01,490783,Staff,8,0,20,12
1713348855976,SYN 100,B01,490787,Staff,10,0,20,10
1713348855976,SYN 100,C01,490789,Staff,10,0,20,10
1713348857003,SYN 150,A00,490817,Staff,14,0,15,1
1713348857003,SYN 150,B00,514610,Staff,15,0,15,0
1713348858075,TDAC 1,A00,492753,Walsh; Kim C.,19,0,20,1
1713348858075,TDAC 1,B00,492754,Harting; Carla Kelso,18,0,20,2
1713348858075,TDAC 1,C00,513995,Salovey; Todd,15,0,20,5
1713348859104,TDAC 101,A00,492766,Harting; Carla Kelso,17,0,20,3
1713348860143,TDAC 102,A00,492768,Basso; Beatrice,19,0,20,1
1713348861169,TDDE 111,A00,492769,Staff,25,0,25,0
1713348862217,TDDE 131,A00,492770,Staff,15,0,15,0
1713348862217,TDDE 131,B00,492771,Staff,15,0,15,0
1713348863244,TDDE 131GS,A00,523716,Guirguis; Mark C,23,0,28,5
1713348864284,TDGE 1,A01,492756,Salovey; Todd,56,0,60,4
1713348865310,TDGE 5,A01,492758,Staff,23,0,25,2
1713348866335,TDGE 10,A00,492759,Fulton; Julia,203,0,220,17
1713348867366,TDGE 11,A00,492760,Castro; Robert Jess,198,0,200,2
1713348869419,TDGE 124,A00,492772,Fulton; Julia,180,0,220,40
1713348870489,TDGE 125,A00,492773,Meyer; Ursula,38,0,50,12
1713348870489,TDGE 125,B00,492774,Staff,49,0,50,1
1713348870489,TDGE 125,C00,523565,Staff,48,0,50,2
1713348871514,TDGE 125GS,A00,523580,Guirguis; Mark C,23,0,28,5
1713348872541,TDGE 127,A00,492775,Havis; Allan,33,0,50,17
1713348873567,TDHT 101,A00,492776,Staff,34,0,35,1
1713348874593,TDMV 1,A00,492762,Caligagan; Maria T.,29,0,30,1
1713348874593,TDMV 1,B00,492763,Arcidiacono; Kristin,26,0,30,4
1713348875617,TDMV 2,A00,492764,Weinberg; Sadie,27,0,30,3
1713348876644,TDMV 3,A00,492765,Mack; Kara Shanai',37,0,40,3
1713348877670,TDMV 138,A00,492777,Mack; Kara Shanai',32,0,40,8
1713348878699,TDMV 140,A00,492778,Lima; Paulo Henrique,40,0,40,0
1713348879734,TDMV 142,A00,492779,Caligagan; Maria T.,33,0,40,7
1713348879734,TDMV 142,B00,492780,Caligagan; Tony,37,0,40,3
1713348880758,TDMV 143,A00,492781,Fyall; Daunte Edward,39,0,40,1
1713348881784,USP 1,A01,492401,Kwak; Nancy,27,0,35,8
1713348882810,USP 2,A01,492453,Hinds; Juli Beth,35,0,35,0
1713348883836,USP 3,A01,492516,Staff,28,0,35,7
1713348884867,USP 4,A00,492522,McTague; Sarah,16,0,25,9
1713348885891,USP 100,A00,492523,Staff,32,0,35,3
1713348886920,USP 101,A00,492524,Staff,13,0,15,2
1713348887974,USP 105,A00,492525,Staff,21,0,25,4
1713348888999,USP 151,A00,492526,Shenkman; Michael Thomas,32,0,35,3
1713348890024,USP 170,A00,492545,Hinds; Juli Beth,32,0,35,3
1713348891052,USP 171GS,A00,492608,Bussell; Mirle Rabinowitz,24,0,28,4
1713348892081,USP 183GS,A00,492613,Peerson; Susan,24,0,28,4
1713348893107,VIS 30,A01,490693,Yoldas; Pinar,19,0,22,3
1713348893107,VIS 30,A02,490694,Yoldas; Pinar,18,0,22,4
1713348894138,VIS 83,A00,490695,Kester; Grant,63,0,75,12
1713348895163,VIS 105D,A00,490696,Staff,22,0,25,3
1713348896189,VIS 124CN,A00,490699,Rose; Jordan M,64,0,75,11
1713348897219,VIS 125GS,A00,511221,Williams; Alena J,21,0,22,1
1713348898244,VIS 128D,A00,490700,Staff,73,0,75,2
1713348899270,VIS 151,A01,490717,Staff,33,0,34,1
1713348899270,VIS 151,A02,490766,Staff,32,0,34,2
1713348900297,VIS 154GS,A00,511972,Williams; Alena J,21,0,22,1
1713348901322,VIS 160A,A00,490767,Stone; Patricia,7,0,10,3
1713348902356,WCWP 10A,A00,490638,Staff,14,0,15,1
1713348902356,WCWP 10A,B00,490640,Staff,15,0,15,0
1713348903384,WCWP 10B,A00,490641,Staff,0,0,0,0
1713348903384,WCWP 10B,B00,490642,Staff,14,0,15,1
1713348903384,WCWP 10B,C00,490644,Staff,13,0,15,2
1713348903384,WCWP 10B,D00,490647,Staff,0,0,0,0
1713348904409,WCWP 100,A00,490655,Staff,0,0,0,0
1713348904409,WCWP 100,B00,490687,Staff,10,0,15,5
1713348906522,ANAR 153,A00,487222,Braswell; Geoffrey E.,53,0,60,7
1713348907549,ANBI 134,A00,487223,Staff,5,0,20,15
1713348908575,ANBI 143GS,A00,487224,Noel; Geoffroy Pierre Jean,18,0,24,6
1713348909601,ANBI 144GS,A00,519548,Noel; Geoffroy Pierre Jean,18,0,24,6
1713348910629,ANSC 101,A00,487225,Staff,17,0,20,3
1713348911656,ANSC 125,A00,487227,Brenner; Suzanne A,38,0,40,2
1713348913711,ANSC 146,A00,487229,Staff,35,0,40,5
1713348914740,ANSC 148,A00,487230,Olivas Hernandez; Olga Lid,39,0,40,1
1713348915775,ANSC 150,A00,504165,Sloane; Julia Kathryn,18,0,20,2
1713348916801,ANSC 180,A00,487232,Staff,14,0,15,1
1713348917831,ANSC 188,A00,627155,Staff,37,0,40,3
1713348918856,ANTH 5,A00,519529,Semendeferi; Ekaterini,15,0,15,0
1713348919887,ANTH 10,A00,487219,Staff,58,0,60,2
1713348920911,ANTH 23,A01,487221,Staff,17,0,20,3
1713348921937,ANTH 102,A00,487233,Wilder; Linnea Lorene,49,0,60,11
1713348922970,ANTH 103,A00,487234,Varma; Saiba,54,0,60,6
1713348923997,ANTH 105,A00,487235,Stewart; Alexander B,54,0,60,6
1713348925028,BENG 100,A01,516685,Taylor Amos; Alyssa C,25,0,30,5
1713348926071,BIBC 102,A01,491316,Flagg; Matthew Paul,4,0,88,84
1713348926071,BIBC 102,A02,491366,Flagg; Matthew Paul,78,0,88,10
1713348927101,BIBC 103,A01,491486,Boumechache; Miyyada,16,0,24,8
1713348927101,BIBC 103,A02,491487,Boumechache; Miyyada,24,0,24,0
1713348928128,BICD 100,A01,516882,Staff,72,0,75,3
1713348928128,BICD 100,A02,516890,Staff,69,0,75,6
1713348929153,BICD 102GS,A00,491488,Lo; Stanley M.,26,0,28,2
1713348930179,BIEB 136GS,A00,516940,Holway; David A. & Shurin; Jonathan,18,0,24,6
1713348931210,BIEB 137GS,A01,517034,Holway; David A. & Shurin; Jonathan,18,0,24,6
1713348932240,BIEB 138GS,A01,491492,Pirino; Giorgia,21,0,28,7
1713348933278,BILD 1,A01,491296,Staff,60,0,63,3
1713348933278,BILD 1,A02,491297,Staff,63,0,63,0
1713348934305,BILD 4,A01,517099,Gonzalez Gamboa; Ivonne,22,0,24,2
1713348934305,BILD 4,A02,517100,Gonzalez Gamboa; Ivonne,24,0,24,0
1713348935330,BILD 60GS,A00,491309,Lo; Stanley M.,26,0,28,2
1713348936355,BIMM 100,A01,517136,Staff,82,0,100,18
1713348937381,BIMM 110,A01,517182,Staff,52,0,100,48
1713348938468,BIMM 120,A01,517228,Pickett; Brooke Elizabeth,28,0,63,35
1713348938468,BIMM 120,A02,517240,Pickett; Brooke Elizabeth,44,0,63,19
1713348939498,BIMM 132GS,A01,491498,Pirino; Giorgia,21,0,28,7
1713348940525,BIMM 143,A01,491589,Bozinovic; Goran,12,0,40,28
1713348941553,BIPN 100,A01,491594,Armour; Jon Christopher,83,0,100,17
1713348942580,BIPN 140,A01,491602,Marino; Marc J,23,0,50,27
1713348944630,CAT 125,A00,515973,Staff,18,0,20,2
1713348945658,CAT 125GS,A00,515974,Rahimi; Babak,16,0,20,4
1713348946692,CAT 125R,A00,515980,Staff,12,0,20,8
1713348946692,CAT 125R,B00,515981,Tosun; Adriana,19,0,20,1
1713348946692,CAT 125R,C00,515987,Hyland; Tina Mae,0,5,20,20
1713348946692,CAT 125R,D00,515988,Bronstein; Phoebe Malan,16,0,20,4
1713348947719,CENG 15,A01,488699,Drews; Aaron,25,0,25,0
1713348948744,CENG 100,A00,505196,Opatkiewicz; Justin Paul,25,0,25,0
1713348949795,CGS 2A,A01,489598,Staff,32,0,35,3
1713348950826,CGS 112,A00,489599,Staff,15,0,15,0
1713348951851,CGS 119,A00,489603,Staff,10,0,10,0
1713348952878,CGS 120,A00,489604,Staff,13,0,15,2
1713348953903,CGS 150,A00,489607,Staff,15,0,15,0
1713348954933,CHEM 6A,A01,488715,Staff,97,0,100,3
1713348955962,CHEM 6B,A01,488719,Piercy; Marc Anthony,99,0,100,1
1713348956988,CHEM 6C,A01,488723,Albizati; Kim F.,93,0,100,7
1713348958026,CHEM 7L,A01,488728,Schurmeier; Kimberly,18,0,24,6
1713348958026,CHEM 7L,A02,488730,Schurmeier; Kimberly,23,0,24,1
1713348958026,CHEM 7L,A03,488734,Schurmeier; Kimberly,20,0,24,4
1713348958026,CHEM 7L,A04,488763,Schurmeier; Kimberly,23,0,24,1
1713348958026,CHEM 7L,B01,488798,Schurmeier; Kimberly,16,0,24,8
1713348958026,CHEM 7L,B02,488801,Schurmeier; Kimberly,22,0,24,2
1713348958026,CHEM 7L,B03,488808,Schurmeier; Kimberly,22,0,24,2
1713348958026,CHEM 7L,B04,488811,Schurmeier; Kimberly,24,0,24,0
1713348959056,CHEM 11,A01,488897,Stallings; Dontarie M,94,0,100,6
1713348960118,CHEM 40A,A01,488913,Albizati; Kim F.,83,0,100,17
1713348961143,CHEM 40B,A01,488920,Weizman; Haim,42,0,50,8
1713348961143,CHEM 40B,A02,488938,Weizman; Haim,43,0,50,7
1713348962169,CHEM 41A,A01,489029,Klosterman; Jeremy K,57,0,60,3
1713348963195,CHEM 41C,A01,500436,Tor; Yitzhak,54,0,60,6
1713348964221,CHEM 43A,A01,500426,Weizman; Haim,0,1,24,24
1713348964221,CHEM 43A,A02,500430,Weizman; Haim,6,0,24,18
1713348964221,CHEM 43A,B01,514041,Klosterman; Jeremy K,14,0,24,10
1713348964221,CHEM 43A,B02,514047,Klosterman; Jeremy K,23,0,24,1
1713348965251,CHEM 108,A01,489140,Jennings; Patricia A.,6,0,24,18
1713348965251,CHEM 108,A02,489142,Jennings; Patricia A.,14,0,24,10
1713348966278,CHEM 114A,A01,489147,Stallings; Dontarie M,65,0,100,35
1713348967310,CHIN 169A,A00,489171,Wang; Xiao,19,0,20,1
1713348969369,COGS 3,A01,518827,Boyle; Mary E. T.,25,0,40,15
1713348970395,COGS 11,A01,489175,Staff,27,0,30,3
1713348971425,COGS 14A,A01,518829,Staff,50,0,60,10
1713348972457,COGS 14B,A01,489177,Hoffman; Drew Ellen,62,0,75,13
1713348973483,COGS 100,A01,489181,Allen; Michael Gordon,62,0,75,13
1713348974514,COGS 101A,A01,489183,Staff,45,0,60,15
1713348975540,COGS 101B,A01,489185,Allen; Michael Gordon,6,0,30,24
1713348976571,COGS 101C,A01,526786,Staff,23,0,30,7
1713348978628,COGS 107A,A01,489189,Boyle; Mary E. T.,16,0,35,19
1713348979657,COGS 107B,A01,627144,Mooshagian; Eric Frederick,59,0,60,1
1713348980689,COGS 118A,A01,489191,Staff,0,46,40,40
1713348982746,COGS 171GS,A01,489194,Pineda; Jaime A,19,0,28,9
1713348983773,COGS 172,A01,489196,Staff,1,0,30,29
1713348984799,COGS 174GS,A01,489264,Pineda; Jaime A,19,0,28,9
1713348985829,COGS 180,A01,627150,Staff,28,0,30,2
1713348986859,COGS 186,A01,489274,Staff,0,3,30,30
1713348987886,COMM 10,A01,489276,Staff,23,0,25,2
1713348987886,COMM 10,A02,489303,Staff,23,0,25,2
1713348988911,COMM 100A,A01,489312,Staff,14,0,25,11
1713348988911,COMM 100A,A02,489313,Staff,24,0,25,1
1713348989942,COMM 106T,A00,512540,Staff,33,0,35,2
1713348990973,COMM 107,A00,489347,Staff,27,0,35,8
1713348992000,COMM 109P,A00,489358,Staff,31,0,35,4
1713348993026,COMM 132,A00,489361,McKenna; Denise,27,0,30,3
1713348994052,COMM 146,A00,489362,Halm; Gavin Patrick,26,0,30,4
1713348995078,COMM 190,A00,489363,Abuelhiga; Soraya Jill,17,0,23,6
1713348996112,CSE 8A,A50,489366,Staff,21,0,25,4
1713348996112,CSE 8A,A51,489367,Staff,24,0,25,1
1713348997138,CSE 11,A01,489398,Cao; Yingjun,72,0,100,28
1713348998166,CSE 12,A01,489487,Staff,43,0,50,7
1713348999195,CSE 20,A01,489497,Staff,47,0,50,3
1713349000231,CSE 21,A01,489517,Braun; Oliver,42,0,50,8
1713349001256,CSE 101,A01,489524,Braun; Oliver,0,35,50,50
1713349002289,CSE 105,A01,512594,Jones; Miles E,72,0,100,28
1713349002289,CSE 105,B01,512598,Jones; Miles E,50,0,100,50
1713349003330,CSE 140,A01,489538,Staff,39,0,50,11
1713349004358,CSE 141,A01,489550,Eldon; John,67,0,100,33
1713349005383,CSE 141L,A01,489571,Eldon; John,65,0,100,35
1713349006410,CSE 151A,A01,489583,Solares; Edwin A,139,0,200,61
1713349007439,CSE 175,A01,510886,Kumar; Rakesh,30,0,30,0
1713349008471,CSE 190,A00,516828,Dubnov; Shlomo,37,0,49,12
1713349009501,DOC 100D,A00,489667,Pass; Natalye Joann,19,0,25,6
1713349010532,DSC 10,A01,624268,Staff,72,0,75,3
1713349011562,DSC 20,A01,624476,Staff,50,0,50,0
1713349012590,DSC 40A,A01,624608,Staff,39,0,40,1
1713349013621,DSGN 1,A01,489179,Rill; Bryan,32,0,50,18
1713349014653,ECE 17,A01,490489,Sahay; Rajeev,18,0,30,12
1713349015684,ECE 65,A50,490492,Staff,11,0,20,9
1713349015684,ECE 65,A51,490493,Staff,18,0,20,2
1713349016732,ECON 1,A01,489715,Famulari; Melissa,67,0,70,3
1713349017758,ECON 2,A01,489717,Levkoff; Steven B.,67,0,70,3
1713349018785,ECON 3,A01,489948,Staff,70,0,70,0
1713349020840,ECON 5,A01,490103,Staff,27,0,30,3
1713349020840,ECON 5,B01,626281,Dai; Yinlin,45,0,45,0
1713349021873,ECON 100A,A01,490127,Famulari; Melissa,62,0,70,8
1713349022898,ECON 100B,A01,490129,Staff,64,0,70,6
1713349023933,ECON 109,A01,490187,Shishkin; Denis,27,0,35,8
1713349024959,ECON 110A,A01,490190,Levkoff; Steven B.,59,0,70,11
1713349025996,ECON 120A,A01,490245,Dai; Yinlin,59,0,70,11
1713349027023,ECON 120B,A01,490247,Nieto-Barthaburu; Augusto,40,0,70,30
1713349028060,ECON 120C,A01,490253,Sun; Yixiao,30,0,35,5
1713349028060,ECON 120C,B01,490255,Sun; Yixiao,34,0,35,1
1713349029085,ECON 129,A00,490256,Eckert; Fabian Paul,22,0,35,13
1713349030135,ECON 131,A00,490257,Nieto-Barthaburu; Augusto,0,6,35,35
1713349031166,ECON 138,A00,490258,Bharadwaj; Prashant,13,0,35,22
1713349031166,ECON 138,B00,490259,Bharadwaj; Prashant,15,0,35,20
1713349032197,ECON 159,A00,490260,Hendrickson; Gerald M.,0,9,0,0
1713349033225,ECON 178,A01,553995,Zhu; Ying,24,0,35,11
1713349034256,EDS 40,A01,512576,Black; Alison Michelle,20,0,20,0
1713349035282,EDS 107,A01,515848,Staff,30,0,30,0
1713349036309,EDS 110R,A01,490262,Staff,26,0,30,4
1713349037335,EDS 112,A01,490264,Chapman; Thandeka K,40,0,50,10
1713349038361,EDS 113,A00,490266,Staff,25,0,30,5
1713349039386,EDS 118,A00,490267,Warstadt; Melissa Fawn,18,0,30,12
1713349040415,EDS 124BR,A00,490268,Eguchi; Emi,4,0,25,21
1713349040415,EDS 124BR,B00,490269,Eguchi; Emi,23,0,25,2
1713349041441,EDS 126,A01,490271,Jones; Makeba,43,0,50,7
1713349042528,EDS 135,A01,490316,Staff,19,0,20,1
1713349043554,ENVR 142GS,A00,519514,Chang; Edmond Yi-Teh,26,0,28,2
1713349044592,ETHN 103,A00,490504,Staff,24,0,36,12
1713349045622,ETHN 103A,A00,490505,Man; Simeon S,3,0,9,6
1713349046647,ETHN 109,A00,490506,Staff,28,0,30,2
1713349047675,ETHN 118,A00,490507,Staff,35,0,36,1
1713349048701,ETHN 119,A00,490508,Staff,32,0,36,4
1713349049727,ETHN 121R,A00,490518,Choi; Esther Min,21,0,36,15
1713349050776,ETHN 127,A00,490528,Staff,14,0,15,1
1713349051803,ETHN 139,A00,490573,Staff,10,0,10,0
1713349052831,ETHN 150,A00,490575,Staff,15,0,15,0
1713349053868,GLBH 20,A00,491705,Elwardani; Nile Regina,38,0,40,2
1713349054899,GLBH 101,A00,491706,Staff,20,0,20,0
1713349055924,GLBH 111,A01,491708,Burgos; Jose L.,15,0,15,0
1713349056954,GLBH 146,A00,491709,Staff,8,0,20,12
1713349057994,GLBH 148,A00,491710,Olivas Hernandez; Olga Lid,10,0,20,10
1713349059021,GLBH 150,A00,491711,Sloane; Julia Kathryn,19,0,20,1
1713349060050,HIEA 131,A00,491760,Staff,28,0,32,4
1713349061079,HIEA 153,A00,491762,Staff,28,0,30,2
1713349062106,HIEU 124,A00,491811,Staff,26,0,32,6
1713349063133,HIEU 124GS,A00,491812,Markman; Kristina,27,0,28,1
1713349064159,HIEU 147,A00,491813,Staff,30,0,32,2
1713349065186,HIEU 149GS,A00,491816,Caldwell; Michael Alan,28,0,28,0
1713349066226,HILD 2C,A01,491713,Hendrickson; Gerald M.,26,0,30,4
1713349067256,HILD 7B,A01,491715,Kwak; Nancy,0,3,30,30
1713349068281,HILD 10,A01,491717,Staff,9,0,20,11
1713349069311,HILD 30GS,A00,491719,Edington; Claire Ellen,23,0,28,5
1713349070334,HINE 109,A00,491818,Shafir; Nir,26,0,32,6
1713349071363,HINE 128,A00,491821,Shafir; Nir,30,0,32,2
1713349072387,HISC 117,A00,491830,Staff,27,0,32,5
1713349073417,HIUS 103,A00,491834,Man; Simeon S,14,0,23,9
1713349074441,HIUS 108B,A00,491835,Staff,27,0,30,3
1713349075468,HIUS 141,A00,491836,Hendrickson; Gerald M.,28,0,32,4
1713349076493,HIUS 149,A00,491839,Staff,24,0,32,8
1713349077517,HUM 3,A01,512617,Crum; Matthew Stephen,42,0,50,8
1713349077517,HUM 3,A02,512618,Crum; Matthew Stephen,48,0,50,2
1713349078543,HUM 3GS,A00,512663,Markman; Kristina,0,0,0,1
1713349078543,HUM 3GS,B00,512664,Staff,0,0,0,0
1713349079573,HUM 4,A01,512620,West; Geoffrey Scott,23,0,50,27
1713349080604,HUM 4GS,A00,512666,Lyon; Antony J.,0,0,0,5
1713349081634,HUM 4R,A01,512625,Watkins; Eric,49,0,50,1
1713349082664,HUM 5,A01,512649,Zavodny; Tatiana Sophia,20,0,50,30
1713349082664,HUM 5,B01,512661,Zroka; Ryan Edward,48,0,50,2
1713349083696,INTL 190,A00,490577,Segui; Alan S,0,0,0,5
1713349084722,JAPN 20AR,A01,491267,Ross; Kayoko F,7,0,20,13
1713349085751,JAPN 180,A00,491285,Berman; Michael David,33,0,40,7
1713349086781,LATI 50,A01,502536,Kokinis; Troy Andreas,16,0,22,6
1713349086781,LATI 50,A02,502551,Kokinis; Troy Andreas,22,0,22,0
1713349086781,LATI 50,A03,502650,Kokinis; Troy Andreas,22,0,22,0
1713349086781,LATI 50,A04,502909,Kokinis; Troy Andreas,21,0,22,1
1713349087807,LATI 160,A01,502920,Kokinis; Troy Andreas,30,0,30,0
1713349088840,LIFR 1A,A00,490494,Van Moer; Vinciane G,17,0,20,3
1713349089865,LIFR 1AX,A00,490495,Van Moer; Vinciane G,17,0,20,3
1713349090889,LIFR 1B,A00,490496,Van Moer; Vinciane G,17,0,20,3
1713349091986,LIFR 1BX,A00,490497,Van Moer; Vinciane G,17,0,20,3
1713349093012,LIGN 8,A00,505198,McIntosh; Justin Daniel,134,0,150,16
1713349094043,LIGN 9GS,A00,491239,Lott; Margaret S.,18,0,20,2
1713349095069,LIGN 101,A01,505200,McIntosh; Justin Daniel,22,0,30,8
1713349096096,LIGN 120,A01,491244,Staff,22,0,30,8
1713349097121,LIGN 149GS,A00,491245,Lott; Margaret S.,18,0,20,2
1713349098147,LIGN 170,A00,491247,Staff,22,0,30,8
1713349099175,LISP 1D,A00,490498,Munoz Sanchez; Alicia,8,0,14,6
1713349099175,LISP 1D,B00,490499,Munoz Sanchez; Alicia,4,0,14,10
1713349099175,LISP 1D,C00,490500,Munoz Sanchez; Alicia,7,0,14,7
1713349099175,LISP 1D,D00,490501,Munoz Sanchez; Alicia,10,0,14,4
1713349100204,LISP 1DX,A00,490502,Munoz Sanchez; Alicia,11,0,28,17
1713349100204,LISP 1DX,B00,490503,Munoz Sanchez; Alicia,16,0,28,12
1713349102262,LTAM 110,A00,491847,Staff,22,0,25,3
1713349103287,LTCS 119,A00,491848,Staff,11,0,15,4
1713349104312,LTCS 130,A00,491849,Staff,24,0,25,1
1713349106362,LTEA 120C,A00,491852,Staff,32,0,40,8
1713349107389,LTEN 130GS,A00,491853,Lyon; Antony J.,23,0,28,5
1713349108416,LTEN 148,A00,491855,Staff,23,0,25,2
1713349109442,LTEN 159,A00,491856,Staff,20,0,25,5
1713349110467,LTEN 180,A00,491857,Staff,8,0,15,7
1713349112527,LTSP 123GS,A00,505928,Bessett; Ryan Matthew,24,0,28,4
1713349113550,LTSP 174GS,A00,506037,Bessett; Ryan Matthew,24,0,28,4
1713349115610,LTWR 102,A00,491861,Staff,9,0,15,6
1713349116636,LTWR 106,A00,491862,Staff,8,0,15,7
1713349117661,MAE 11,A00,490930,Bahadori; Mohammad Yousef,94,0,100,6
1713349118695,MAE 30A,A00,490931,Qi; Huihui,37,0,40,3
1713349119720,MAE 101A,A00,491036,Sadeghizadeh; Zahra,91,0,100,9
1713349120752,MAE 101C,A00,491037,Seshadri; Kalyanasundaram,63,0,100,37
1713349121777,MAE 113,A00,491040,Seshadri; Kalyanasundaram,64,0,80,16
1713349122806,MAE 131A,A00,491041,Ghazinejad; Maziar,37,0,40,3
1713349123832,MAE 142,A00,491053,Staff,39,0,40,1
1713349124857,MAE 143A,A00,491054,Staff,29,0,50,21
1713349125883,MAE 150,A00,491092,Truong; Phuong Thi Ngoc,23,0,35,12
1713349126911,MATH 3C,A01,494031,Pardo Guerra; Sebastian,30,0,30,0
1713349126911,MATH 3C,A02,494032,Pardo Guerra; Sebastian,29,0,30,1
1713349127942,MATH 10A,A01,494034,Staff,27,0,30,3
1713349127942,MATH 10A,A02,494035,Staff,28,0,30,2
1713349127942,MATH 10A,B01,494037,Staff,27,0,30,3
1713349127942,MATH 10A,B02,494038,Staff,29,0,30,1
1713349128979,MATH 10B,A01,494040,Habib; Yousaf,22,0,30,8
1713349128979,MATH 10B,A02,494041,Habib; Yousaf,28,0,30,2
1713349128979,MATH 10B,A03,494042,Habib; Yousaf,29,0,30,1
1713349128979,MATH 10B,A04,494043,Habib; Yousaf,30,0,30,0
1713349128979,MATH 10B,B01,494045,Habib; Yousaf,25,0,30,5
1713349128979,MATH 10B,B02,494046,Habib; Yousaf,30,0,30,0
1713349128979,MATH 10B,B03,494047,Habib; Yousaf,30,0,30,0
1713349128979,MATH 10B,B04,494048,Habib; Yousaf,30,0,30,0
1713349130009,MATH 18,A01,494050,Kemp; Todd Aahron,25,0,30,5
1713349130009,MATH 18,A02,494051,Kemp; Todd Aahron,29,0,30,1
1713349130009,MATH 18,B01,494054,Kemp; Todd Aahron,25,0,30,5
1713349130009,MATH 18,B02,494055,Kemp; Todd Aahron,29,0,30,1
1713349131041,MATH 20A,A01,494059,Suk; Andrew Hoon,30,0,30,0
1713349132068,MATH 20B,A01,494061,Briones; Jor-el Thomas Caparas,33,0,35,2
1713349132068,MATH 20B,B01,494063,Bach; Quang Tran,34,0,35,1
1713349133097,MATH 20C,A01,494065,Staff,28,0,30,2
1713349133097,MATH 20C,A02,494066,Staff,30,0,30,0
1713349133097,MATH 20C,A03,494067,Staff,30,0,30,0
1713349133097,MATH 20C,A04,494068,Staff,30,0,30,0
1713349133097,MATH 20C,B01,494070,Zhang; Ming,23,0,30,7
1713349133097,MATH 20C,B02,494071,Zhang; Ming,27,0,30,3
1713349133097,MATH 20C,B03,494072,Zhang; Ming,29,0,30,1
1713349133097,MATH 20C,B04,494073,Zhang; Ming,29,0,30,1
1713349134122,MATH 20D,A01,494075,Staff,22,0,30,8
1713349134122,MATH 20D,A02,494076,Staff,29,0,30,1
1713349135150,MATH 20E,A01,494079,Staff,24,0,30,6
1713349135150,MATH 20E,A02,494080,Staff,26,0,30,4
1713349135150,MATH 20E,B01,494082,Staff,25,0,30,5
1713349135150,MATH 20E,B02,494083,Staff,25,0,30,5
1713349136198,MATH 103A,A01,494085,Aliabadi Sr.; Mohsen,12,0,30,18
1713349136198,MATH 103A,A02,494086,Aliabadi Sr.; Mohsen,28,0,30,2
1713349136198,MATH 103A,B01,494088,Aliabadi Sr.; Mohsen,19,0,30,11
1713349136198,MATH 103A,B02,494089,Aliabadi Sr.; Mohsen,27,0,30,3
1713349137224,MATH 109,A01,494091,Staff,30,0,30,0
1713349137224,MATH 109,A02,494092,Staff,29,0,30,1
1713349137224,MATH 109,B01,494094,Staff,27,0,30,3
1713349137224,MATH 109,B02,494095,Staff,29,0,30,1
1713349138260,MATH 142A,A01,494097,Chow; Bennett,13,0,30,17
1713349138260,MATH 142A,A02,494098,Chow; Bennett,23,0,30,7
1713349138260,MATH 142A,B01,494100,Chow; Bennett,19,0,30,11
1713349138260,MATH 142A,B02,494101,Chow; Bennett,29,0,30,1
1713349140313,MATH 168A,A01,516677,Dumitriu; Ioana,16,0,35,19
1713349141341,MATH 170A,A01,516679,Dumitriu; Ioana,18,0,30,12
1713349141341,MATH 170A,A02,516680,Dumitriu; Ioana,28,0,30,2
1713349142367,MATH 193A,A01,494107,Staff,12,0,30,18
1713349142367,MATH 193A,A02,494108,Staff,18,0,30,12
1713349142367,MATH 193A,A03,494109,Staff,29,0,30,1
1713349142367,MATH 193A,A04,494110,Staff,22,0,30,8
1713349145446,MGT 16,A00,491930,McKay; Michael J,92,0,98,6
1713349146546,MGT 18,A00,491992,McKay; Michael J,96,0,98,2
1713349147572,MGT 71,A00,492003,Staff,63,0,98,35
1713349148597,MGT 103,A00,505209,Eberhard; Craig A,80,0,98,18
1713349149623,MGT 131A,A00,505210,Anderson; John Charles,89,0,98,9
1713349151675,MGT 153,A00,492077,Perols; Johan Lars,15,0,90,75
1713349154757,MGT 164,A00,492222,McKay; Mary A,91,0,98,7
1713349155783,MGT 172,A00,492245,Staff,59,0,60,1
1713349155783,MGT 172,B00,505526,Hedges; Kathleen,65,0,98,33
1713349156814,MGT 181,A00,505669,Dunn; Louis Jean,78,0,98,20
1713349157841,MMW 14,A01,494399,Staff,15,0,28,13
1713349157841,MMW 14,A02,494400,Staff,25,0,28,3
1713349157841,MMW 14,A03,494401,Staff,28,0,28,0
1713349157841,MMW 14,A04,494402,Staff,28,0,28,0
1713349157841,MMW 14,B01,494404,Carreras; Maria Victoria,8,0,28,20
1713349157841,MMW 14,B02,494405,Carreras; Maria Victoria,25,0,28,3
1713349157841,MMW 14,B03,494406,Carreras; Maria Victoria,27,0,28,1
1713349157841,MMW 14,B04,494407,Carreras; Maria Victoria,28,0,28,0
1713349158866,MMW 14GS,A00,506250,Chang; Edmond Yi-Teh,0,0,0,0
1713349159892,MMW 121R,A01,494415,Adamiak; Patrick John,9,0,28,19
1713349159892,MMW 121R,A02,494416,Adamiak; Patrick John,24,0,28,4
1713349160923,MUS 1A,A01,494113,Staff,12,0,25,13
1713349160923,MUS 1A,A02,494114,Staff,24,0,25,1
1713349161948,MUS 4,A01,494116,Staff,23,0,25,2
1713349161948,MUS 4,A02,494117,Staff,22,0,25,3
1713349162975,MUS 5R,A01,494236,Dubnov; Shlomo,4,0,25,21
1713349162975,MUS 5R,A02,494237,Dubnov; Shlomo,25,0,25,0
1713349164002,MUS 6,A01,494122,Staff,9,0,25,16
1713349164002,MUS 6,A02,494123,Staff,23,0,25,2
1713349165027,MUS 7,A01,494125,Staff,16,0,25,9
1713349165027,MUS 7,A02,494126,Staff,24,0,25,1
1713349166056,MUS 11,A01,494128,Staff,23,0,25,2
1713349166056,MUS 11,A02,494129,Staff,24,0,25,1
1713349167090,MUS 13,A01,494131,Staff,25,0,25,0
1713349167090,MUS 13,A02,494132,Staff,25,0,25,0
1713349168117,MUS 15,A01,494134,Staff,16,0,25,9
1713349168117,MUS 15,A02,494135,Staff,25,0,25,0
1713349168117,MUS 15,B01,494137,Staff,24,0,25,1
1713349169148,MUS 80,A00,494232,Staff,24,0,25,1
1713349169148,MUS 80,B00,494233,Staff,25,0,25,0
1713349169148,MUS 80,C00,494234,Staff,23,0,25,2
1713349170184,MUS 95C,A00,494141,Staff,69,0,75,6
1713349171213,MUS 114,A00,494142,Staff,39,0,50,11
1713349172248,NANO 15,A01,490636,Drews; Aaron,7,0,7,0
1713349173281,PHIL 1,A00,490578,Grush; Rick Scott,49,0,50,1
1713349174324,PHIL 10,A01,490580,Grush; Rick Scott,33,0,35,2
1713349174324,PHIL 10,A02,490586,Grush; Rick Scott,32,0,35,3
1713349175351,PHIL 27,A01,490591,Staff,22,0,25,3
1713349175351,PHIL 27,A02,490592,Staff,25,0,25,0
1713349175351,PHIL 27,A03,490593,Staff,25,0,25,0
1713349175351,PHIL 27,A04,490598,Staff,25,0,25,0
1713349176376,PHIL 32,A01,490611,Staff,20,0,20,0
1713349176376,PHIL 32,A02,490618,Staff,20,0,20,0
1713349177405,PHIL 90,A00,490624,Staff,40,0,40,0
1713349178429,PHIL 136,A00,490627,Cohen; Jonathan David,37,0,40,3
1713349179457,PHIL 155,A00,490634,Staff,61,0,70,9
1713349180484,PHYS 1A,A00,491610,Staff,245,0,250,5
1713349181513,PHYS 1AL,001,491616,Tsai; Philbert S,27,0,30,3
1713349181513,PHYS 1AL,002,491618,Tsai; Philbert S,30,0,30,0
1713349182537,PHYS 1B,A00,491623,Staff,235,0,250,15
1713349183569,PHYS 1BL,001,491626,Tsai; Philbert S,18,0,30,12
1713349183569,PHYS 1BL,002,491628,Tsai; Philbert S,26,0,30,4
1713349184593,PHYS 1C,A00,491632,Staff,211,0,245,34
1713349185619,PHYS 1CL,001,491635,Tsai; Philbert S,2,0,30,28
1713349185619,PHYS 1CL,002,491643,Tsai; Philbert S,22,0,30,8
1713349186647,PHYS 2AR,A01,491651,Meyertholen; Andrew D.,44,0,50,6
1713349187672,PHYS 2B,A01,491659,Staff,105,0,115,10
1713349188698,PHYS 2BL,A01,491685,Staff,21,0,24,3
1713349188698,PHYS 2BL,A02,491700,Staff,21,0,24,3
1713349189724,PHYS 2C,A01,505161,Staff,101,0,115,14
1713349190754,PHYS 4A,A01,491704,Grinstein; Benjamin,99,0,100,1
1713349191803,POLI 5D,A01,494144,Staff,3,0,5,2
1713349191803,POLI 5D,B01,626283,Dai; Yinlin,5,0,5,0
1713349192829,POLI 12,A00,494145,Staff,43,0,45,2
1713349194285,POLI 13R,A00,494146,Forman; Fonna,45,0,50,5
1713349195315,POLI 27,A01,494148,Staff,54,0,60,6
1713349196342,POLI 30,A00,494149,Staff,49,0,50,1
1713349197370,POLI 100DA,A00,494150,Staff,20,0,25,5
1713349199425,POLI 100I,A00,494152,Staff,27,0,30,3
1713349200456,POLI 104B,A00,494153,Smith; Glenn Chatmas,53,0,55,2
1713349201480,POLI 104F,A00,494154,Staff,28,0,30,2
1713349202508,POLI 104I,A00,494155,Smith; Glenn Chatmas,29,0,30,1
1713349203533,POLI 110C,A00,494156,Ingham; Sean,23,0,25,2
1713349204557,POLI 117R,A00,494157,Forman; Fonna,5,0,20,15
1713349205584,POLI 118,A00,494158,Ingham; Sean,21,0,25,4
1713349206610,POLI 120H,A00,494159,Fisk; David Lee,39,0,45,6
1713349207636,POLI 131CR,A00,494160,Hoston; Germaine,35,0,45,10
1713349208663,POLI 133J,A00,494161,Staff,31,0,35,4
1713349209690,POLI 135,A00,494162,Fisk; David Lee,33,0,35,2
1713349210717,POLI 140A,A00,494164,Staff,18,0,30,12
1713349211741,POLI 142I,A00,494165,Staff,30,0,30,0
1713349212767,POLI 144D,A00,494166,Staff,22,0,25,3
1713349213792,POLI 151,A00,494167,Staff,30,0,30,0
1713349214816,POLI 153,A00,494168,Staff,33,0,35,2
1713349215843,POLI 160AA,A00,494169,Staff,33,0,40,7
1713349216868,POLI 162,A00,494170,Mignozzetti; Umberto,17,0,25,8
1713349217896,POLI 171,A00,494171,Mignozzetti; Umberto,18,0,25,7
1713349218924,PSYC 1,A00,494172,Staff,95,0,100,5
1713349219950,PSYC 2,A00,494173,Moranton; Nirelia Melbina-,33,0,50,17
1713349220974,PSYC 3,A00,494174,Staff,29,0,30,1
1713349222020,PSYC 6,A00,494175,Staff,17,0,20,3
1713349223050,PSYC 60,A01,494177,Staff,37,0,45,8
1713349224075,PSYC 70,A01,505724,Geller; Emma Harlan,42,0,45,3
1713349225101,PSYC 101,A00,494180,Heyman; Gail D.,83,0,100,17
1713349226132,PSYC 105,A00,494181,Geller; Emma Harlan,51,0,90,39
1713349227162,PSYC 106,A00,494182,Dobkins; Karen R.,26,0,45,19
1713349228188,PSYC 108,A00,494183,Adrian; Julia Anna,89,0,100,11
1713349229216,PSYC 114,A01,494185,Winkielman; Piotr,0,4,30,30
1713349230241,PSYC 122,A00,494186,Moranton; Nirelia Melbina-,27,0,50,23
1713349231266,PSYC 124,A00,494187,Chapman; Eddie Nathaniel,69,0,80,11
1713349232291,PSYC 131,A00,494188,Anagnostaras; Stephan,39,0,80,41
1713349233315,PSYC 144,A00,494189,Staff,1,1,50,49
1713349234340,PSYC 154,A00,494190,Lacefield; Katharine I,105,0,180,75
1713349235370,PSYC 162,A00,494191,Wixted; John T,70,0,100,30
1713349236400,PSYC 172,A00,494192,Gorman; Michael R.,36,0,45,9
1713349237427,PSYC 178,A00,494193,Glaser; Dale,32,0,45,13
1713349238453,PSYC 193,A00,505725,Chapman; Eddie Nathaniel,20,0,20,0
1713349239486,RELI 145GS,A00,519817,Rahimi; Babak,17,0,20,3
1713349240513,SE 101A,A01,490862,Chadha; Mayank,23,0,25,2
1713349241539,SE 101C,A01,490924,Krysl; Petr,15,0,20,5
1713349242569,SE 110A,A01,490928,Staff,19,0,20,1
1713349243596,SE 130A,A00,490929,Morrison; Machel Leigh,53,0,70,17
1713349244627,SIO 1,A01,519325,Staff,39,0,40,1
1713349245656,SIO 30,A01,519327,Staff,38,0,40,2
1713349246685,SIO 40,A00,519328,Staff,39,0,40,1
1713349247713,SIO 46GS,A00,519819,Cook; Geoffrey W,15,0,25,10
1713349248747,SIO 109R,A00,494197,Forman; Fonna,0,3,20,20
1713349249776,SIO 121GS,A00,519827,Cook; Geoffrey W,15,0,25,10
1713349250858,SIO 132,A01,519330,Staff,38,0,40,2
1713349251891,SIO 133,A01,519397,Staff,37,0,40,3
1713349252916,SIO 139,A00,519396,Kacev; David,29,0,40,11
1713349253944,SOCI 1,A01,494199,Thorpe; Charles Robert,21,0,30,9
1713349253944,SOCI 1,A02,494200,Thorpe; Charles Robert,30,0,30,0
1713349253944,SOCI 1,A03,494201,Thorpe; Charles Robert,29,0,30,1
1713349253944,SOCI 1,A04,494202,Thorpe; Charles Robert,29,0,30,1
1713349253944,SOCI 1,A05,494203,Thorpe; Charles Robert,29,0,30,1
1713349253944,SOCI 1,A06,494204,Thorpe; Charles Robert,30,0,30,0
1713349253944,SOCI 1,A07,494205,Thorpe; Charles Robert,28,0,30,2
1713349254974,SOCI 60,A01,494207,Staff,33,0,40,7
1713349254974,SOCI 60,A02,494208,Staff,39,0,40,1
1713349256002,SOCI 100,A01,494210,Payne; Christine Anna,25,0,30,5
1713349256002,SOCI 100,A02,494211,Payne; Christine Anna,26,0,30,4
1713349257027,SOCI 109M,A00,494212,Staff,20,0,20,0
1713349258053,SOCI 110,A00,494213,Staff,34,0,40,6
1713349260112,SOCI 118E,A00,494215,Ng; Kwai,37,0,40,3
1713349261139,SOCI 125,A00,494216,Calderon-Zaks; Michael Aar,39,0,45,6
1713349262168,SOCI 126,A01,494218,Jones; Makeba,3,0,5,2
1713349263198,SOCI 131,A00,494219,Thorpe; Charles Robert,25,0,30,5
1713349265252,SOCI 135,A00,494221,Payne; Christine Anna,28,0,50,22
1713349266290,SOCI 136E,A00,626690,Ruiz; Jonathan Joseph,24,0,25,1
1713349267321,SOCI 138GS,A00,494222,Navon; Daniel,23,0,28,5
1713349269370,SOCI 145,A00,494224,Staff,40,0,45,5
1713349270395,SOCI 153,A00,494225,Staff,28,0,30,2
1713349271423,SOCI 160E,A00,494226,Ng; Kwai,27,0,40,13
1713349272448,SOCI 180,A00,494227,Staff,29,0,30,1
1713349273473,SOCI 189GS,A00,494228,Ribas Norris; Janet Vanesa,11,0,11,0
1713349274500,SOCI 190GS,A00,553232,Ribas Norris; Janet Vanesa,11,0,11,0
1713349275529,SOMI 220,A00,627178,Schneid; Stephen David,30,0,30,0
1713349276556,SYN 2,001,490768,Staff,13,0,15,2
1713349276556,SYN 2,002,490769,Staff,14,0,15,1
1713349276556,SYN 2,004,490775,Staff,0,0,0,0
1713349276556,SYN 2,003,490774,Staff,0,0,0,0
1713349276556,SYN 2,005,490776,Staff,0,0,0,0
1713349277586,SYN 2R,001,490779,Staff,10,0,15,5
1713349277586,SYN 2R,002,514635,Staff,14,0,15,1
1713349278616,SYN 100,A01,490783,Staff,8,0,20,12
1713349278616,SYN 100,B01,490787,Staff,10,0,20,10
1713349278616,SYN 100,C01,490789,Staff,10,0,20,10
1713349279642,SYN 150,A00,490817,Staff,14,0,15,1
1713349279642,SYN 150,B00,514610,Staff,15,0,15,0
1713349280682,TDAC 1,A00,492753,Walsh; Kim C.,19,0,20,1
1713349280682,TDAC 1,B00,492754,Harting; Carla Kelso,18,0,20,2
1713349280682,TDAC 1,C00,513995,Salovey; Todd,15,0,20,5
1713349281711,TDAC 101,A00,492766,Harting; Carla Kelso,17,0,20,3
1713349282740,TDAC 102,A00,492768,Basso; Beatrice,19,0,20,1
1713349283767,TDDE 111,A00,492769,Staff,25,0,25,0
1713349284801,TDDE 131,A00,492770,Staff,15,0,15,0
1713349284801,TDDE 131,B00,492771,Staff,15,0,15,0
1713349285826,TDDE 131GS,A00,523716,Guirguis; Mark C,23,0,28,5
1713349286875,TDGE 1,A01,492756,Salovey; Todd,56,0,60,4
1713349287905,TDGE 5,A01,492758,Staff,23,0,25,2
1713349288930,TDGE 10,A00,492759,Fulton; Julia,203,0,220,17
1713349289956,TDGE 11,A00,492760,Castro; Robert Jess,198,0,200,2
1713349292006,TDGE 124,A00,492772,Fulton; Julia,180,0,220,40
1713349293045,TDGE 125,A00,492773,Meyer; Ursula,38,0,50,12
1713349293045,TDGE 125,B00,492774,Staff,49,0,50,1
1713349293045,TDGE 125,C00,523565,Staff,48,0,50,2
1713349294072,TDGE 125GS,A00,523580,Guirguis; Mark C,23,0,28,5
1713349295099,TDGE 127,A00,492775,Havis; Allan,33,0,50,17
1713349296129,TDHT 101,A00,492776,Staff,34,0,35,1
1713349297153,TDMV 1,A00,492762,Caligagan; Maria T.,29,0,30,1
1713349297153,TDMV 1,B00,492763,Arcidiacono; Kristin,26,0,30,4
1713349298179,TDMV 2,A00,492764,Weinberg; Sadie,27,0,30,3
1713349299203,TDMV 3,A00,492765,Mack; Kara Shanai',37,0,40,3
1713349300228,TDMV 138,A00,492777,Mack; Kara Shanai',32,0,40,8
1713349301262,TDMV 140,A00,492778,Lima; Paulo Henrique,40,0,40,0
1713349302298,TDMV 142,A00,492779,Caligagan; Maria T.,33,0,40,7
1713349302298,TDMV 142,B00,492780,Caligagan; Tony,37,0,40,3
1713349303329,TDMV 143,A00,492781,Fyall; Daunte Edward,39,0,40,1
1713349304363,USP 1,A01,492401,Kwak; Nancy,27,0,35,8
1713349305398,USP 2,A01,492453,Hinds; Juli Beth,35,0,35,0
1713349306424,USP 3,A01,492516,Staff,28,0,35,7
1713349307454,USP 4,A00,492522,McTague; Sarah,16,0,25,9
1713349308479,USP 100,A00,492523,Staff,32,0,35,3
1713349309511,USP 101,A00,492524,Staff,13,0,15,2
1713349310540,USP 105,A00,492525,Staff,21,0,25,4
1713349311568,USP 151,A00,492526,Shenkman; Michael Thomas,32,0,35,3
1713349312598,USP 170,A00,492545,Hinds; Juli Beth,32,0,35,3
1713349313624,USP 171GS,A00,492608,Bussell; Mirle Rabinowitz,24,0,28,4
1713349314654,USP 183GS,A00,492613,Peerson; Susan,24,0,28,4
1713349315682,VIS 30,A01,490693,Yoldas; Pinar,19,0,22,3
1713349315682,VIS 30,A02,490694,Yoldas; Pinar,18,0,22,4
1713349316721,VIS 83,A00,490695,Kester; Grant,63,0,75,12
1713349317747,VIS 105D,A00,490696,Staff,22,0,25,3
1713349318773,VIS 124CN,A00,490699,Rose; Jordan M,64,0,75,11
1713349319803,VIS 125GS,A00,511221,Williams; Alena J,21,0,22,1
1713349320829,VIS 128D,A00,490700,Staff,73,0,75,2
1713349321858,VIS 151,A01,490717,Staff,33,0,34,1
1713349321858,VIS 151,A02,490766,Staff,32,0,34,2
1713349322884,VIS 154GS,A00,511972,Williams; Alena J,21,0,22,1
1713349323914,VIS 160A,A00,490767,Stone; Patricia,7,0,10,3
1713349324950,WCWP 10A,A00,490638,Staff,14,0,15,1
1713349324950,WCWP 10A,B00,490640,Staff,15,0,15,0
1713349325979,WCWP 10B,A00,490641,Staff,0,0,0,0
1713349325979,WCWP 10B,B00,490642,Staff,14,0,15,1
1713349325979,WCWP 10B,C00,490644,Staff,13,0,15,2
1713349325979,WCWP 10B,D00,490647,Staff,0,0,0,0
1713349327008,WCWP 100,A00,490655,Staff,0,0,0,0
1713349327008,WCWP 100,B00,490687,Staff,10,0,15,5
1713349329140,ANAR 153,A00,487222,Braswell; Geoffrey E.,53,0,60,7
1713349330171,ANBI 134,A00,487223,Staff,5,0,20,15
1713349331199,ANBI 143GS,A00,487224,Noel; Geoffroy Pierre Jean,18,0,24,6
1713349332228,ANBI 144GS,A00,519548,Noel; Geoffroy Pierre Jean,18,0,24,6
1713349333275,ANSC 101,A00,487225,Staff,17,0,20,3
1713349334301,ANSC 125,A00,487227,Brenner; Suzanne A,38,0,40,2
1713349336357,ANSC 146,A00,487229,Staff,35,0,40,5
1713349337385,ANSC 148,A00,487230,Olivas Hernandez; Olga Lid,39,0,40,1
1713349338419,ANSC 150,A00,504165,Sloane; Julia Kathryn,18,0,20,2
1713349339449,ANSC 180,A00,487232,Staff,14,0,15,1
1713349340485,ANSC 188,A00,627155,Staff,37,0,40,3
1713349341510,ANTH 5,A00,519529,Semendeferi; Ekaterini,15,0,15,0
1713349342537,ANTH 10,A00,487219,Staff,58,0,60,2
1713349343562,ANTH 23,A01,487221,Staff,17,0,20,3
1713349344588,ANTH 102,A00,487233,Wilder; Linnea Lorene,49,0,60,11
1713349345618,ANTH 103,A00,487234,Varma; Saiba,54,0,60,6
1713349346648,ANTH 105,A00,487235,Stewart; Alexander B,54,0,60,6
1713349347679,BENG 100,A01,516685,Taylor Amos; Alyssa C,25,0,30,5
1713349348713,BIBC 102,A01,491316,Flagg; Matthew Paul,3,0,88,85
1713349348713,BIBC 102,A02,491366,Flagg; Matthew Paul,78,0,88,10
1713349349739,BIBC 103,A01,491486,Boumechache; Miyyada,16,0,24,8
1713349349739,BIBC 103,A02,491487,Boumechache; Miyyada,24,0,24,0
1713349350768,BICD 100,A01,516882,Staff,72,0,75,3
1713349350768,BICD 100,A02,516890,Staff,69,0,75,6
1713349351795,BICD 102GS,A00,491488,Lo; Stanley M.,26,0,28,2
1713349352827,BIEB 136GS,A00,516940,Holway; David A. & Shurin; Jonathan,18,0,24,6
1713349353861,BIEB 137GS,A01,517034,Holway; David A. & Shurin; Jonathan,18,0,24,6
1713349354946,BIEB 138GS,A01,491492,Pirino; Giorgia,21,0,28,7
1713349355982,BILD 1,A01,491296,Staff,60,0,63,3
1713349355982,BILD 1,A02,491297,Staff,63,0,63,0
1713349357010,BILD 4,A01,517099,Gonzalez Gamboa; Ivonne,22,0,24,2
1713349357010,BILD 4,A02,517100,Gonzalez Gamboa; Ivonne,24,0,24,0
1713349358038,BILD 60GS,A00,491309,Lo; Stanley M.,26,0,28,2
1713349359065,BIMM 100,A01,517136,Staff,82,0,100,18
1713349360094,BIMM 110,A01,517182,Staff,52,0,100,48
1713349361137,BIMM 120,A01,517228,Pickett; Brooke Elizabeth,28,0,63,35
1713349361137,BIMM 120,A02,517240,Pickett; Brooke Elizabeth,44,0,63,19
1713349362167,BIMM 132GS,A01,491498,Pirino; Giorgia,21,0,28,7
1713349363199,BIMM 143,A01,491589,Bozinovic; Goran,12,0,40,28
1713349364228,BIPN 100,A01,491594,Armour; Jon Christopher,83,0,100,17
1713349365257,BIPN 140,A01,491602,Marino; Marc J,23,0,50,27
1713349367315,CAT 125,A00,515973,Staff,18,0,20,2
1713349368341,CAT 125GS,A00,515974,Rahimi; Babak,16,0,20,4
1713349369379,CAT 125R,A00,515980,Staff,12,0,20,8
1713349369379,CAT 125R,B00,515981,Tosun; Adriana,19,0,20,1
1713349369379,CAT 125R,C00,515987,Hyland; Tina Mae,0,5,20,20
1713349369379,CAT 125R,D00,515988,Bronstein; Phoebe Malan,16,0,20,4
1713349370406,CENG 15,A01,488699,Drews; Aaron,25,0,25,0
1713349371440,CENG 100,A00,505196,Opatkiewicz; Justin Paul,25,0,25,0
1713349372471,CGS 2A,A01,489598,Staff,32,0,35,3
1713349373496,CGS 112,A00,489599,Staff,15,0,15,0
1713349374526,CGS 119,A00,489603,Staff,10,0,10,0
1713349375552,CGS 120,A00,489604,Staff,13,0,15,2
1713349376577,CGS 150,A00,489607,Staff,15,0,15,0
1713349377611,CHEM 6A,A01,488715,Staff,97,0,100,3
1713349378637,CHEM 6B,A01,488719,Piercy; Marc Anthony,99,0,100,1
1713349379667,CHEM 6C,A01,488723,Albizati; Kim F.,93,0,100,7
1713349380703,CHEM 7L,A01,488728,Schurmeier; Kimberly,18,0,24,6
1713349380703,CHEM 7L,A02,488730,Schurmeier; Kimberly,23,0,24,1
1713349380703,CHEM 7L,A03,488734,Schurmeier; Kimberly,20,0,24,4
1713349380703,CHEM 7L,A04,488763,Schurmeier; Kimberly,23,0,24,1
1713349380703,CHEM 7L,B01,488798,Schurmeier; Kimberly,16,0,24,8
1713349380703,CHEM 7L,B02,488801,Schurmeier; Kimberly,22,0,24,2
1713349380703,CHEM 7L,B03,488808,Schurmeier; Kimberly,22,0,24,2
1713349380703,CHEM 7L,B04,488811,Schurmeier; Kimberly,24,0,24,0
1713349381728,CHEM 11,A01,488897,Stallings; Dontarie M,94,0,100,6
1713349382760,CHEM 40A,A01,488913,Albizati; Kim F.,83,0,100,17
1713349383792,CHEM 40B,A01,488920,Weizman; Haim,42,0,50,8
1713349383792,CHEM 40B,A02,488938,Weizman; Haim,43,0,50,7
1713349384823,CHEM 41A,A01,489029,Klosterman; Jeremy K,57,0,60,3
1713349385848,CHEM 41C,A01,500436,Tor; Yitzhak,54,0,60,6
1713349386879,CHEM 43A,A01,500426,Weizman; Haim,0,1,24,24
1713349386879,CHEM 43A,A02,500430,Weizman; Haim,6,0,24,18
1713349386879,CHEM 43A,B01,514041,Klosterman; Jeremy K,14,0,24,10
1713349386879,CHEM 43A,B02,514047,Klosterman; Jeremy K,23,0,24,1
1713349387905,CHEM 108,A01,489140,Jennings; Patricia A.,6,0,24,18
1713349387905,CHEM 108,A02,489142,Jennings; Patricia A.,14,0,24,10
1713349388928,CHEM 114A,A01,489147,Stallings; Dontarie M,65,0,100,35
1713349389969,CHIN 169A,A00,489171,Wang; Xiao,19,0,20,1
1713349392025,COGS 3,A01,518827,Boyle; Mary E. T.,25,0,40,15
1713349393054,COGS 11,A01,489175,Staff,27,0,30,3
1713349394082,COGS 14A,A01,518829,Staff,50,0,60,10
1713349395109,COGS 14B,A01,489177,Hoffman; Drew Ellen,62,0,75,13
1713349396136,COGS 100,A01,489181,Allen; Michael Gordon,62,0,75,13
1713349397163,COGS 101A,A01,489183,Staff,45,0,60,15
1713349398188,COGS 101B,A01,489185,Allen; Michael Gordon,6,0,30,24
1713349399221,COGS 101C,A01,526786,Staff,23,0,30,7
1713349401276,COGS 107A,A01,489189,Boyle; Mary E. T.,16,0,35,19
1713349402310,COGS 107B,A01,627144,Mooshagian; Eric Frederick,59,0,60,1
1713349403336,COGS 118A,A01,489191,Staff,0,46,40,40
1713349405386,COGS 171GS,A01,489194,Pineda; Jaime A,19,0,28,9
1713349406417,COGS 172,A01,489196,Staff,1,0,30,29
1713349407443,COGS 174GS,A01,489264,Pineda; Jaime A,19,0,28,9
1713349408468,COGS 180,A01,627150,Staff,28,0,30,2
1713349409499,COGS 186,A01,489274,Staff,0,3,30,30
1713349410525,COMM 10,A01,489276,Staff,23,0,25,2
1713349410525,COMM 10,A02,489303,Staff,23,0,25,2
1713349411554,COMM 100A,A01,489312,Staff,14,0,25,11
1713349411554,COMM 100A,A02,489313,Staff,24,0,25,1
1713349412585,COMM 106T,A00,512540,Staff,33,0,35,2
1713349413613,COMM 107,A00,489347,Staff,27,0,35,8
1713349414638,COMM 109P,A00,489358,Staff,31,0,35,4
1713349415664,COMM 132,A00,489361,McKenna; Denise,27,0,30,3
1713349416696,COMM 146,A00,489362,Halm; Gavin Patrick,26,0,30,4
1713349417722,COMM 190,A00,489363,Abuelhiga; Soraya Jill,17,0,23,6
1713349418755,CSE 8A,A50,489366,Staff,21,0,25,4
1713349418755,CSE 8A,A51,489367,Staff,24,0,25,1
1713349419782,CSE 11,A01,489398,Cao; Yingjun,72,0,100,28
1713349420814,CSE 12,A01,489487,Staff,43,0,50,7
1713349421843,CSE 20,A01,489497,Staff,47,0,50,3
1713349422870,CSE 21,A01,489517,Braun; Oliver,42,0,50,8
1713349423897,CSE 101,A01,489524,Braun; Oliver,0,35,50,50
1713349424926,CSE 105,A01,512594,Jones; Miles E,72,0,100,28
1713349424926,CSE 105,B01,512598,Jones; Miles E,50,0,100,50
1713349425954,CSE 140,A01,489538,Staff,39,0,50,11
1713349426984,CSE 141,A01,489550,Eldon; John,67,0,100,33
1713349428018,CSE 141L,A01,489571,Eldon; John,65,0,100,35
1713349429045,CSE 151A,A01,489583,Solares; Edwin A,139,0,200,61
1713349430077,CSE 175,A01,510886,Kumar; Rakesh,30,0,30,0
1713349431110,CSE 190,A00,516828,Dubnov; Shlomo,37,0,49,12
1713349432137,DOC 100D,A00,489667,Pass; Natalye Joann,19,0,25,6
1713349433164,DSC 10,A01,624268,Staff,72,0,75,3
1713349434190,DSC 20,A01,624476,Staff,50,0,50,0
1713349435216,DSC 40A,A01,624608,Staff,39,0,40,1
1713349436246,DSGN 1,A01,489179,Rill; Bryan,32,0,50,18
1713349437274,ECE 17,A01,490489,Sahay; Rajeev,18,0,30,12
1713349438300,ECE 65,A50,490492,Staff,11,0,20,9
1713349438300,ECE 65,A51,490493,Staff,18,0,20,2
1713349439328,ECON 1,A01,489715,Famulari; Melissa,67,0,70,3
1713349440566,ECON 2,A01,489717,Levkoff; Steven B.,67,0,70,3
1713349441598,ECON 3,A01,489948,Staff,70,0,70,0
1713349443658,ECON 5,A01,490103,Staff,27,0,30,3
1713349443658,ECON 5,B01,626281,Dai; Yinlin,45,0,45,0
1713349444687,ECON 100A,A01,490127,Famulari; Melissa,62,0,70,8
1713349445713,ECON 100B,A01,490129,Staff,64,0,70,6
1713349446739,ECON 109,A01,490187,Shishkin; Denis,27,0,35,8
1713349447764,ECON 110A,A01,490190,Levkoff; Steven B.,59,0,70,11
1713349448797,ECON 120A,A01,490245,Dai; Yinlin,59,0,70,11
1713349449824,ECON 120B,A01,490247,Nieto-Barthaburu; Augusto,40,0,70,30
1713349450852,ECON 120C,A01,490253,Sun; Yixiao,30,0,35,5
1713349450852,ECON 120C,B01,490255,Sun; Yixiao,34,0,35,1
1713349451881,ECON 129,A00,490256,Eckert; Fabian Paul,22,0,35,13
1713349452911,ECON 131,A00,490257,Nieto-Barthaburu; Augusto,0,6,35,35
1713349453941,ECON 138,A00,490258,Bharadwaj; Prashant,13,0,35,22
1713349453941,ECON 138,B00,490259,Bharadwaj; Prashant,15,0,35,20
1713349454966,ECON 159,A00,490260,Hendrickson; Gerald M.,0,9,0,0
1713349455996,ECON 178,A01,553995,Zhu; Ying,24,0,35,11
1713349457024,EDS 40,A01,512576,Black; Alison Michelle,20,0,20,0
1713349458070,EDS 107,A01,515848,Staff,30,0,30,0
1713349459150,EDS 110R,A01,490262,Staff,26,0,30,4
1713349460177,EDS 112,A01,490264,Chapman; Thandeka K,40,0,50,10
1713349461203,EDS 113,A00,490266,Staff,25,0,30,5
1713349462229,EDS 118,A00,490267,Warstadt; Melissa Fawn,18,0,30,12
1713349463255,EDS 124BR,A00,490268,Eguchi; Emi,4,0,25,21
1713349463255,EDS 124BR,B00,490269,Eguchi; Emi,23,0,25,2
1713349464281,EDS 126,A01,490271,Jones; Makeba,43,0,50,7
1713349465307,EDS 135,A01,490316,Staff,19,0,20,1
1713349466331,ENVR 142GS,A00,519514,Chang; Edmond Yi-Teh,26,0,28,2
1713349467363,ETHN 103,A00,490504,Staff,24,0,36,12
1713349468390,ETHN 103A,A00,490505,Man; Simeon S,3,0,9,6
1713349469415,ETHN 109,A00,490506,Staff,28,0,30,2
1713349470443,ETHN 118,A00,490507,Staff,35,0,36,1
1713349471469,ETHN 119,A00,490508,Staff,32,0,36,4
1713349472497,ETHN 121R,A00,490518,Choi; Esther Min,21,0,36,15
1713349473521,ETHN 127,A00,490528,Staff,14,0,15,1
1713349474550,ETHN 139,A00,490573,Staff,10,0,10,0
1713349475580,ETHN 150,A00,490575,Staff,15,0,15,0
1713349476606,GLBH 20,A00,491705,Elwardani; Nile Regina,38,0,40,2
1713349477635,GLBH 101,A00,491706,Staff,20,0,20,0
1713349478660,GLBH 111,A01,491708,Burgos; Jose L.,15,0,15,0
1713349479686,GLBH 146,A00,491709,Staff,8,0,20,12
1713349480733,GLBH 148,A00,491710,Olivas Hernandez; Olga Lid,10,0,20,10
1713349481762,GLBH 150,A00,491711,Sloane; Julia Kathryn,19,0,20,1
1713349482787,HIEA 131,A00,491760,Staff,28,0,32,4
1713349483816,HIEA 153,A00,491762,Staff,28,0,30,2
1713349484846,HIEU 124,A00,491811,Staff,26,0,32,6
1713349485875,HIEU 124GS,A00,491812,Markman; Kristina,27,0,28,1
1713349486901,HIEU 147,A00,491813,Staff,30,0,32,2
1713349487927,HIEU 149GS,A00,491816,Caldwell; Michael Alan,28,0,28,0
1713349488955,HILD 2C,A01,491713,Hendrickson; Gerald M.,26,0,30,4
1713349489980,HILD 7B,A01,491715,Kwak; Nancy,0,3,30,30
1713349491005,HILD 10,A01,491717,Staff,9,0,20,11
1713349492030,HILD 30GS,A00,491719,Edington; Claire Ellen,23,0,28,5
1713349493057,HINE 109,A00,491818,Shafir; Nir,26,0,32,6
1713349494083,HINE 128,A00,491821,Shafir; Nir,30,0,32,2
1713349495109,HISC 117,A00,491830,Staff,27,0,32,5
1713349496139,HIUS 103,A00,491834,Man; Simeon S,14,0,23,9
1713349497164,HIUS 108B,A00,491835,Staff,27,0,30,3
1713349498194,HIUS 141,A00,491836,Hendrickson; Gerald M.,28,0,32,4
1713349499222,HIUS 149,A00,491839,Staff,24,0,32,8
1713349500252,HUM 3,A01,512617,Crum; Matthew Stephen,42,0,50,8
1713349500252,HUM 3,A02,512618,Crum; Matthew Stephen,48,0,50,2
1713349501282,HUM 3GS,A00,512663,Markman; Kristina,0,0,0,1
1713349501282,HUM 3GS,B00,512664,Staff,0,0,0,0
1713349502307,HUM 4,A01,512620,West; Geoffrey Scott,22,0,50,28
1713349503333,HUM 4GS,A00,512666,Lyon; Antony J.,0,0,0,5
1713349504362,HUM 4R,A01,512625,Watkins; Eric,49,0,50,1
1713349505390,HUM 5,A01,512649,Zavodny; Tatiana Sophia,20,0,50,30
1713349505390,HUM 5,B01,512661,Zroka; Ryan Edward,48,0,50,2
1713349506447,INTL 190,A00,490577,Segui; Alan S,0,0,0,5
1713349507478,JAPN 20AR,A01,491267,Ross; Kayoko F,7,0,20,13
1713349508511,JAPN 180,A00,491285,Berman; Michael David,33,0,40,7
1713349509547,LATI 50,A01,502536,Kokinis; Troy Andreas,16,0,22,6
1713349509547,LATI 50,A02,502551,Kokinis; Troy Andreas,22,0,22,0
1713349509547,LATI 50,A03,502650,Kokinis; Troy Andreas,22,0,22,0
1713349509547,LATI 50,A04,502909,Kokinis; Troy Andreas,21,0,22,1
1713349510575,LATI 160,A01,502920,Kokinis; Troy Andreas,30,0,30,0
1713349511607,LIFR 1A,A00,490494,Van Moer; Vinciane G,17,0,20,3
1713349512633,LIFR 1AX,A00,490495,Van Moer; Vinciane G,17,0,20,3
1713349513664,LIFR 1B,A00,490496,Van Moer; Vinciane G,17,0,20,3
1713349514693,LIFR 1BX,A00,490497,Van Moer; Vinciane G,17,0,20,3
1713349515717,LIGN 8,A00,505198,McIntosh; Justin Daniel,134,0,150,16
1713349516743,LIGN 9GS,A00,491239,Lott; Margaret S.,18,0,20,2
1713349517773,LIGN 101,A01,505200,McIntosh; Justin Daniel,22,0,30,8
1713349518798,LIGN 120,A01,491244,Staff,22,0,30,8
1713349519823,LIGN 149GS,A00,491245,Lott; Margaret S.,18,0,20,2
1713349520853,LIGN 170,A00,491247,Staff,22,0,30,8
1713349521884,LISP 1D,A00,490498,Munoz Sanchez; Alicia,8,0,14,6
1713349521884,LISP 1D,B00,490499,Munoz Sanchez; Alicia,4,0,14,10
1713349521884,LISP 1D,C00,490500,Munoz Sanchez; Alicia,7,0,14,7
1713349521884,LISP 1D,D00,490501,Munoz Sanchez; Alicia,10,0,14,4
1713349522912,LISP 1DX,A00,490502,Munoz Sanchez; Alicia,11,0,28,17
1713349522912,LISP 1DX,B00,490503,Munoz Sanchez; Alicia,16,0,28,12
1713349524965,LTAM 110,A00,491847,Staff,22,0,25,3
1713349525989,LTCS 119,A00,491848,Staff,11,0,15,4
1713349527018,LTCS 130,A00,491849,Staff,24,0,25,1
1713349529074,LTEA 120C,A00,491852,Staff,32,0,40,8
1713349530100,LTEN 130GS,A00,491853,Lyon; Antony J.,23,0,28,5
1713349531188,LTEN 148,A00,491855,Staff,23,0,25,2
1713349532213,LTEN 159,A00,491856,Staff,20,0,25,5
1713349533242,LTEN 180,A00,491857,Staff,8,0,15,7
1713349535298,LTSP 123GS,A00,505928,Bessett; Ryan Matthew,24,0,28,4
1713349536325,LTSP 174GS,A00,506037,Bessett; Ryan Matthew,24,0,28,4
1713349538376,LTWR 102,A00,491861,Staff,9,0,15,6
1713349539402,LTWR 106,A00,491862,Staff,8,0,15,7
1713349540434,MAE 11,A00,490930,Bahadori; Mohammad Yousef,94,0,100,6
1713349541466,MAE 30A,A00,490931,Qi; Huihui,37,0,40,3
1713349542489,MAE 101A,A00,491036,Sadeghizadeh; Zahra,91,0,100,9
1713349543527,MAE 101C,A00,491037,Seshadri; Kalyanasundaram,63,0,100,37
1713349544557,MAE 113,A00,491040,Seshadri; Kalyanasundaram,64,0,80,16
1713349545587,MAE 131A,A00,491041,Ghazinejad; Maziar,37,0,40,3
1713349546611,MAE 142,A00,491053,Staff,39,0,40,1
1713349547635,MAE 143A,A00,491054,Staff,29,0,50,21
1713349548664,MAE 150,A00,491092,Truong; Phuong Thi Ngoc,23,0,35,12
1713349549691,MATH 3C,A01,494031,Pardo Guerra; Sebastian,30,0,30,0
1713349549691,MATH 3C,A02,494032,Pardo Guerra; Sebastian,29,0,30,1
1713349550718,MATH 10A,A01,494034,Staff,27,0,30,3
1713349550718,MATH 10A,A02,494035,Staff,28,0,30,2
1713349550718,MATH 10A,B01,494037,Staff,27,0,30,3
1713349550718,MATH 10A,B02,494038,Staff,29,0,30,1
1713349551758,MATH 10B,A01,494040,Habib; Yousaf,22,0,30,8
1713349551758,MATH 10B,A02,494041,Habib; Yousaf,28,0,30,2
1713349551758,MATH 10B,A03,494042,Habib; Yousaf,29,0,30,1
1713349551758,MATH 10B,A04,494043,Habib; Yousaf,30,0,30,0
1713349551758,MATH 10B,B01,494045,Habib; Yousaf,25,0,30,5
1713349551758,MATH 10B,B02,494046,Habib; Yousaf,30,0,30,0
1713349551758,MATH 10B,B03,494047,Habib; Yousaf,30,0,30,0
1713349551758,MATH 10B,B04,494048,Habib; Yousaf,30,0,30,0
1713349552786,MATH 18,A01,494050,Kemp; Todd Aahron,25,0,30,5
1713349552786,MATH 18,A02,494051,Kemp; Todd Aahron,29,0,30,1
1713349552786,MATH 18,B01,494054,Kemp; Todd Aahron,25,0,30,5
1713349552786,MATH 18,B02,494055,Kemp; Todd Aahron,29,0,30,1
1713349553812,MATH 20A,A01,494059,Suk; Andrew Hoon,30,0,30,0
1713349554846,MATH 20B,A01,494061,Briones; Jor-el Thomas Caparas,33,0,35,2
1713349554846,MATH 20B,B01,494063,Bach; Quang Tran,34,0,35,1
1713349555875,MATH 20C,A01,494065,Staff,28,0,30,2
1713349555875,MATH 20C,A02,494066,Staff,30,0,30,0
1713349555875,MATH 20C,A03,494067,Staff,30,0,30,0
1713349555875,MATH 20C,A04,494068,Staff,30,0,30,0
1713349555875,MATH 20C,B01,494070,Zhang; Ming,23,0,30,7
1713349555875,MATH 20C,B02,494071,Zhang; Ming,27,0,30,3
1713349555875,MATH 20C,B03,494072,Zhang; Ming,29,0,30,1
1713349555875,MATH 20C,B04,494073,Zhang; Ming,29,0,30,1
1713349556901,MATH 20D,A01,494075,Staff,22,0,30,8
1713349556901,MATH 20D,A02,494076,Staff,29,0,30,1
1713349557931,MATH 20E,A01,494079,Staff,24,0,30,6
1713349557931,MATH 20E,A02,494080,Staff,26,0,30,4
1713349557931,MATH 20E,B01,494082,Staff,25,0,30,5
1713349557931,MATH 20E,B02,494083,Staff,25,0,30,5
1713349558961,MATH 103A,A01,494085,Aliabadi Sr.; Mohsen,12,0,30,18
1713349558961,MATH 103A,A02,494086,Aliabadi Sr.; Mohsen,28,0,30,2
1713349558961,MATH 103A,B01,494088,Aliabadi Sr.; Mohsen,19,0,30,11
1713349558961,MATH 103A,B02,494089,Aliabadi Sr.; Mohsen,27,0,30,3
1713349559988,MATH 109,A01,494091,Staff,30,0,30,0
1713349559988,MATH 109,A02,494092,Staff,29,0,30,1
1713349559988,MATH 109,B01,494094,Staff,27,0,30,3
1713349559988,MATH 109,B02,494095,Staff,29,0,30,1
1713349561019,MATH 142A,A01,494097,Chow; Bennett,13,0,30,17
1713349561019,MATH 142A,A02,494098,Chow; Bennett,23,0,30,7
1713349561019,MATH 142A,B01,494100,Chow; Bennett,19,0,30,11
1713349561019,MATH 142A,B02,494101,Chow; Bennett,29,0,30,1
1713349563132,MATH 168A,A01,516677,Dumitriu; Ioana,16,0,35,19
1713349564161,MATH 170A,A01,516679,Dumitriu; Ioana,18,0,30,12
1713349564161,MATH 170A,A02,516680,Dumitriu; Ioana,28,0,30,2
1713349565191,MATH 193A,A01,494107,Staff,12,0,30,18
1713349565191,MATH 193A,A02,494108,Staff,18,0,30,12
1713349565191,MATH 193A,A03,494109,Staff,29,0,30,1
1713349565191,MATH 193A,A04,494110,Staff,22,0,30,8
1713349568273,MGT 16,A00,491930,McKay; Michael J,92,0,98,6
1713349569302,MGT 18,A00,491992,McKay; Michael J,96,0,98,2
1713349570332,MGT 71,A00,492003,Staff,63,0,98,35
1713349571369,MGT 103,A00,505209,Eberhard; Craig A,80,0,98,18
1713349572395,MGT 131A,A00,505210,Anderson; John Charles,89,0,98,9
1713349574449,MGT 153,A00,492077,Perols; Johan Lars,15,0,90,75
1713349577538,MGT 164,A00,492222,McKay; Mary A,91,0,98,7
1713349578564,MGT 172,A00,492245,Staff,59,0,60,1
1713349578564,MGT 172,B00,505526,Hedges; Kathleen,65,0,98,33
1713349579595,MGT 181,A00,505669,Dunn; Louis Jean,78,0,98,20
1713349580625,MMW 14,A01,494399,Staff,15,0,28,13
1713349580625,MMW 14,A02,494400,Staff,25,0,28,3
1713349580625,MMW 14,A03,494401,Staff,28,0,28,0
1713349580625,MMW 14,A04,494402,Staff,28,0,28,0
1713349580625,MMW 14,B01,494404,Carreras; Maria Victoria,8,0,28,20
1713349580625,MMW 14,B02,494405,Carreras; Maria Victoria,25,0,28,3
1713349580625,MMW 14,B03,494406,Carreras; Maria Victoria,27,0,28,1
1713349580625,MMW 14,B04,494407,Carreras; Maria Victoria,28,0,28,0
1713349581655,MMW 14GS,A00,506250,Chang; Edmond Yi-Teh,0,0,0,0
1713349582684,MMW 121R,A01,494415,Adamiak; Patrick John,9,0,28,19
1713349582684,MMW 121R,A02,494416,Adamiak; Patrick John,24,0,28,4
1713349583710,MUS 1A,A01,494113,Staff,12,0,25,13
1713349583710,MUS 1A,A02,494114,Staff,24,0,25,1
1713349584736,MUS 4,A01,494116,Staff,23,0,25,2
1713349584736,MUS 4,A02,494117,Staff,22,0,25,3
1713349585770,MUS 5R,A01,494236,Dubnov; Shlomo,4,0,25,21
1713349585770,MUS 5R,A02,494237,Dubnov; Shlomo,25,0,25,0
1713349586796,MUS 6,A01,494122,Staff,9,0,25,16
1713349586796,MUS 6,A02,494123,Staff,23,0,25,2
1713349587826,MUS 7,A01,494125,Staff,16,0,25,9
1713349587826,MUS 7,A02,494126,Staff,24,0,25,1
1713349588851,MUS 11,A01,494128,Staff,23,0,25,2
1713349588851,MUS 11,A02,494129,Staff,24,0,25,1
1713349589883,MUS 13,A01,494131,Staff,25,0,25,0
1713349589883,MUS 13,A02,494132,Staff,25,0,25,0
1713349590913,MUS 15,A01,494134,Staff,16,0,25,9
1713349590913,MUS 15,A02,494135,Staff,25,0,25,0
1713349590913,MUS 15,B01,494137,Staff,24,0,25,1
1713349591942,MUS 80,A00,494232,Staff,24,0,25,1
1713349591942,MUS 80,B00,494233,Staff,25,0,25,0
1713349591942,MUS 80,C00,494234,Staff,23,0,25,2
1713349592968,MUS 95C,A00,494141,Staff,69,0,75,6
1713349593999,MUS 114,A00,494142,Staff,39,0,50,11
1713349595031,NANO 15,A01,490636,Drews; Aaron,7,0,7,0
1713349596058,PHIL 1,A00,490578,Grush; Rick Scott,49,0,50,1
1713349597085,PHIL 10,A01,490580,Grush; Rick Scott,33,0,35,2
1713349597085,PHIL 10,A02,490586,Grush; Rick Scott,32,0,35,3
1713349598111,PHIL 27,A01,490591,Staff,22,0,25,3
1713349598111,PHIL 27,A02,490592,Staff,25,0,25,0
1713349598111,PHIL 27,A03,490593,Staff,25,0,25,0
1713349598111,PHIL 27,A04,490598,Staff,25,0,25,0
1713349599139,PHIL 32,A01,490611,Staff,20,0,20,0
1713349599139,PHIL 32,A02,490618,Staff,20,0,20,0
1713349600165,PHIL 90,A00,490624,Staff,40,0,40,0
1713349601191,PHIL 136,A00,490627,Cohen; Jonathan David,37,0,40,3
1713349602219,PHIL 155,A00,490634,Staff,61,0,70,9
1713349603246,PHYS 1A,A00,491610,Staff,245,0,250,5
1713349604273,PHYS 1AL,001,491616,Tsai; Philbert S,27,0,30,3
1713349604273,PHYS 1AL,002,491618,Tsai; Philbert S,30,0,30,0
1713349605297,PHYS 1B,A00,491623,Staff,235,0,250,15
1713349606331,PHYS 1BL,001,491626,Tsai; Philbert S,18,0,30,12
1713349606331,PHYS 1BL,002,491628,Tsai; Philbert S,26,0,30,4
1713349607360,PHYS 1C,A00,491632,Staff,211,0,245,34
1713349608384,PHYS 1CL,001,491635,Tsai; Philbert S,2,0,30,28
1713349608384,PHYS 1CL,002,491643,Tsai; Philbert S,22,0,30,8
1713349609469,PHYS 2AR,A01,491651,Meyertholen; Andrew D.,44,0,50,6
1713349610494,PHYS 2B,A01,491659,Staff,105,0,115,10
1713349611519,PHYS 2BL,A01,491685,Staff,21,0,24,3
1713349611519,PHYS 2BL,A02,491700,Staff,21,0,24,3
1713349612547,PHYS 2C,A01,505161,Staff,101,0,115,14
1713349613575,PHYS 4A,A01,491704,Grinstein; Benjamin,99,0,100,1
1713349614610,POLI 5D,A01,494144,Staff,3,0,5,2
1713349614610,POLI 5D,B01,626283,Dai; Yinlin,5,0,5,0
1713349615641,POLI 12,A00,494145,Staff,43,0,45,2
1713349616666,POLI 13R,A00,494146,Forman; Fonna,45,0,50,5
1713349617694,POLI 27,A01,494148,Staff,54,0,60,6
1713349618720,POLI 30,A00,494149,Staff,49,0,50,1
1713349619751,POLI 100DA,A00,494150,Staff,20,0,25,5
1713349621800,POLI 100I,A00,494152,Staff,27,0,30,3
1713349622833,POLI 104B,A00,494153,Smith; Glenn Chatmas,53,0,55,2
1713349623870,POLI 104F,A00,494154,Staff,28,0,30,2
1713349624895,POLI 104I,A00,494155,Smith; Glenn Chatmas,29,0,30,1
1713349625923,POLI 110C,A00,494156,Ingham; Sean,23,0,25,2
1713349626950,POLI 117R,A00,494157,Forman; Fonna,5,0,20,15
1713349627976,POLI 118,A00,494158,Ingham; Sean,21,0,25,4
1713349629000,POLI 120H,A00,494159,Fisk; David Lee,39,0,45,6
1713349630029,POLI 131CR,A00,494160,Hoston; Germaine,35,0,45,10
1713349631054,POLI 133J,A00,494161,Staff,31,0,35,4
1713349632081,POLI 135,A00,494162,Fisk; David Lee,33,0,35,2
1713349633109,POLI 140A,A00,494164,Staff,18,0,30,12
1713349634134,POLI 142I,A00,494165,Staff,30,0,30,0
1713349635160,POLI 144D,A00,494166,Staff,22,0,25,3
1713349636191,POLI 151,A00,494167,Staff,30,0,30,0
1713349637217,POLI 153,A00,494168,Staff,33,0,35,2
1713349638240,POLI 160AA,A00,494169,Staff,33,0,40,7
1713349639273,POLI 162,A00,494170,Mignozzetti; Umberto,17,0,25,8
1713349640302,POLI 171,A00,494171,Mignozzetti; Umberto,18,0,25,7
1713349641334,PSYC 1,A00,494172,Staff,95,0,100,5
1713349642363,PSYC 2,A00,494173,Moranton; Nirelia Melbina-,33,0,50,17
1713349643390,PSYC 3,A00,494174,Staff,29,0,30,1
1713349644416,PSYC 6,A00,494175,Staff,17,0,20,3
1713349645444,PSYC 60,A01,494177,Staff,37,0,45,8
1713349646471,PSYC 70,A01,505724,Geller; Emma Harlan,42,0,45,3
1713349647494,PSYC 101,A00,494180,Heyman; Gail D.,83,0,100,17
1713349648519,PSYC 105,A00,494181,Geller; Emma Harlan,51,0,90,39
1713349649549,PSYC 106,A00,494182,Dobkins; Karen R.,26,0,45,19
1713349650577,PSYC 108,A00,494183,Adrian; Julia Anna,89,0,100,11
1713349651602,PSYC 114,A01,494185,Winkielman; Piotr,0,4,30,30
1713349652632,PSYC 122,A00,494186,Moranton; Nirelia Melbina-,27,0,50,23
1713349653659,PSYC 124,A00,494187,Chapman; Eddie Nathaniel,69,0,80,11
1713349654684,PSYC 131,A00,494188,Anagnostaras; Stephan,39,0,80,41
1713349655708,PSYC 144,A00,494189,Staff,1,1,50,49
1713349656735,PSYC 154,A00,494190,Lacefield; Katharine I,105,0,180,75
1713349657761,PSYC 162,A00,494191,Wixted; John T,70,0,100,30
1713349658791,PSYC 172,A00,494192,Gorman; Michael R.,36,0,45,9
1713349659821,PSYC 178,A00,494193,Glaser; Dale,32,0,45,13
1713349660846,PSYC 193,A00,505725,Chapman; Eddie Nathaniel,20,0,20,0
1713349661878,RELI 145GS,A00,519817,Rahimi; Babak,17,0,20,3
1713349662905,SE 101A,A01,490862,Chadha; Mayank,23,0,25,2
1713349663930,SE 101C,A01,490924,Krysl; Petr,15,0,20,5
1713349664953,SE 110A,A01,490928,Staff,19,0,20,1
1713349665980,SE 130A,A00,490929,Morrison; Machel Leigh,53,0,70,17
1713349667061,SIO 1,A01,519325,Staff,39,0,40,1
1713349668088,SIO 30,A01,519327,Staff,38,0,40,2
1713349669114,SIO 40,A00,519328,Staff,39,0,40,1
1713349670139,SIO 46GS,A00,519819,Cook; Geoffrey W,15,0,25,10
1713349671167,SIO 109R,A00,494197,Forman; Fonna,0,3,20,20
1713349672196,SIO 121GS,A00,519827,Cook; Geoffrey W,15,0,25,10
1713349673225,SIO 132,A01,519330,Staff,38,0,40,2
1713349674253,SIO 133,A01,519397,Staff,37,0,40,3
1713349675281,SIO 139,A00,519396,Kacev; David,29,0,40,11
1713349676315,SOCI 1,A01,494199,Thorpe; Charles Robert,21,0,30,9
1713349676315,SOCI 1,A02,494200,Thorpe; Charles Robert,30,0,30,0
1713349676315,SOCI 1,A03,494201,Thorpe; Charles Robert,29,0,30,1
1713349676315,SOCI 1,A04,494202,Thorpe; Charles Robert,29,0,30,1
1713349676315,SOCI 1,A05,494203,Thorpe; Charles Robert,29,0,30,1
1713349676315,SOCI 1,A06,494204,Thorpe; Charles Robert,30,0,30,0
1713349676315,SOCI 1,A07,494205,Thorpe; Charles Robert,28,0,30,2
1713349677341,SOCI 60,A01,494207,Staff,33,0,40,7
1713349677341,SOCI 60,A02,494208,Staff,39,0,40,1
1713349678367,SOCI 100,A01,494210,Payne; Christine Anna,25,0,30,5
1713349678367,SOCI 100,A02,494211,Payne; Christine Anna,26,0,30,4
1713349679392,SOCI 109M,A00,494212,Staff,20,0,20,0
1713349680418,SOCI 110,A00,494213,Staff,34,0,40,6
1713349682473,SOCI 118E,A00,494215,Ng; Kwai,37,0,40,3
1713349683499,SOCI 125,A00,494216,Calderon-Zaks; Michael Aar,39,0,45,6
1713349684529,SOCI 126,A01,494218,Jones; Makeba,3,0,5,2
1713349685554,SOCI 131,A00,494219,Thorpe; Charles Robert,25,0,30,5
1713349687603,SOCI 135,A00,494221,Payne; Christine Anna,28,0,50,22
1713349688631,SOCI 136E,A00,626690,Ruiz; Jonathan Joseph,24,0,25,1
1713349689659,SOCI 138GS,A00,494222,Navon; Daniel,23,0,28,5
1713349691714,SOCI 145,A00,494224,Staff,40,0,45,5
1713349692738,SOCI 153,A00,494225,Staff,28,0,30,2
1713349693762,SOCI 160E,A00,494226,Ng; Kwai,27,0,40,13
1713349694789,SOCI 180,A00,494227,Staff,29,0,30,1
1713349695812,SOCI 189GS,A00,494228,Ribas Norris; Janet Vanesa,11,0,11,0
1713349696844,SOCI 190GS,A00,553232,Ribas Norris; Janet Vanesa,11,0,11,0
1713349697874,SOMI 220,A00,627178,Schneid; Stephen David,30,0,30,0
1713349698900,SYN 2,001,490768,Staff,13,0,15,2
1713349698900,SYN 2,002,490769,Staff,14,0,15,1
1713349698900,SYN 2,004,490775,Staff,0,0,0,0
1713349698900,SYN 2,003,490774,Staff,0,0,0,0
1713349698900,SYN 2,005,490776,Staff,0,0,0,0
1713349699931,SYN 2R,001,490779,Staff,10,0,15,5
1713349699931,SYN 2R,002,514635,Staff,14,0,15,1
1713349700958,SYN 100,A01,490783,Staff,8,0,20,12
1713349700958,SYN 100,B01,490787,Staff,10,0,20,10
1713349700958,SYN 100,C01,490789,Staff,10,0,20,10
1713349701987,SYN 150,A00,490817,Staff,14,0,15,1
1713349701987,SYN 150,B00,514610,Staff,15,0,15,0
1713349703015,TDAC 1,A00,492753,Walsh; Kim C.,19,0,20,1
1713349703015,TDAC 1,B00,492754,Harting; Carla Kelso,18,0,20,2
1713349703015,TDAC 1,C00,513995,Salovey; Todd,15,0,20,5
1713349704047,TDAC 101,A00,492766,Harting; Carla Kelso,17,0,20,3
1713349705073,TDAC 102,A00,492768,Basso; Beatrice,19,0,20,1
1713349706098,TDDE 111,A00,492769,Staff,25,0,25,0
1713349707127,TDDE 131,A00,492770,Staff,15,0,15,0
1713349707127,TDDE 131,B00,492771,Staff,15,0,15,0
1713349708152,TDDE 131GS,A00,523716,Guirguis; Mark C,23,0,28,5
1713349709179,TDGE 1,A01,492756,Salovey; Todd,56,0,60,4
1713349710208,TDGE 5,A01,492758,Staff,23,0,25,2
1713349711236,TDGE 10,A00,492759,Fulton; Julia,203,0,220,17
1713349712261,TDGE 11,A00,492760,Castro; Robert Jess,198,0,200,2
1713349714311,TDGE 124,A00,492772,Fulton; Julia,180,0,220,40
1713349715344,TDGE 125,A00,492773,Meyer; Ursula,38,0,50,12
1713349715344,TDGE 125,B00,492774,Staff,49,0,50,1
1713349715344,TDGE 125,C00,523565,Staff,48,0,50,2
1713349716368,TDGE 125GS,A00,523580,Guirguis; Mark C,23,0,28,5
1713349717392,TDGE 127,A00,492775,Havis; Allan,33,0,50,17
1713349718418,TDHT 101,A00,492776,Staff,34,0,35,1
1713349719442,TDMV 1,A00,492762,Caligagan; Maria T.,29,0,30,1
1713349719442,TDMV 1,B00,492763,Arcidiacono; Kristin,26,0,30,4
1713349720470,TDMV 2,A00,492764,Weinberg; Sadie,27,0,30,3
1713349721494,TDMV 3,A00,492765,Mack; Kara Shanai',37,0,40,3
1713349722519,TDMV 138,A00,492777,Mack; Kara Shanai',32,0,40,8
1713349723542,TDMV 140,A00,492778,Lima; Paulo Henrique,40,0,40,0
1713349724571,TDMV 142,A00,492779,Caligagan; Maria T.,33,0,40,7
1713349724571,TDMV 142,B00,492780,Caligagan; Tony,37,0,40,3
1713349725600,TDMV 143,A00,492781,Fyall; Daunte Edward,39,0,40,1
1713349726633,USP 1,A01,492401,Kwak; Nancy,27,0,35,8
1713349727663,USP 2,A01,492453,Hinds; Juli Beth,35,0,35,0
1713349728687,USP 3,A01,492516,Staff,28,0,35,7
1713349729713,USP 4,A00,492522,McTague; Sarah,16,0,25,9
1713349730744,USP 100,A00,492523,Staff,32,0,35,3
1713349731769,USP 101,A00,492524,Staff,13,0,15,2
1713349732795,USP 105,A00,492525,Staff,21,0,25,4
1713349733821,USP 151,A00,492526,Shenkman; Michael Thomas,32,0,35,3
1713349734850,USP 170,A00,492545,Hinds; Juli Beth,32,0,35,3
1713349735875,USP 171GS,A00,492608,Bussell; Mirle Rabinowitz,24,0,28,4
1713349736899,USP 183GS,A00,492613,Peerson; Susan,24,0,28,4
1713349737925,VIS 30,A01,490693,Yoldas; Pinar,19,0,22,3
1713349737925,VIS 30,A02,490694,Yoldas; Pinar,18,0,22,4
1713349738956,VIS 83,A00,490695,Kester; Grant,63,0,75,12
1713349739981,VIS 105D,A00,490696,Staff,22,0,25,3
1713349741005,VIS 124CN,A00,490699,Rose; Jordan M,64,0,75,11
1713349742084,VIS 125GS,A00,511221,Williams; Alena J,21,0,22,1
1713349743115,VIS 128D,A00,490700,Staff,73,0,75,2
1713349744142,VIS 151,A01,490717,Staff,33,0,34,1
1713349744142,VIS 151,A02,490766,Staff,32,0,34,2
1713349745170,VIS 154GS,A00,511972,Williams; Alena J,21,0,22,1
1713349746199,VIS 160A,A00,490767,Stone; Patricia,7,0,10,3
1713349747228,WCWP 10A,A00,490638,Staff,14,0,15,1
1713349747228,WCWP 10A,B00,490640,Staff,15,0,15,0
1713349748255,WCWP 10B,A00,490641,Staff,0,0,0,0
1713349748255,WCWP 10B,B00,490642,Staff,14,0,15,1
1713349748255,WCWP 10B,C00,490644,Staff,13,0,15,2
1713349748255,WCWP 10B,D00,490647,Staff,0,0,0,0
1713349749282,WCWP 100,A00,490655,Staff,0,0,0,0
1713349749282,WCWP 100,B00,490687,Staff,10,0,15,5
1713349751385,ANAR 153,A00,487222,Braswell; Geoffrey E.,53,0,60,7
1713349752413,ANBI 134,A00,487223,Staff,5,0,20,15
1713349753439,ANBI 143GS,A00,487224,Noel; Geoffroy Pierre Jean,18,0,24,6
1713349754465,ANBI 144GS,A00,519548,Noel; Geoffroy Pierre Jean,18,0,24,6
1713349755494,ANSC 101,A00,487225,Staff,17,0,20,3
1713349756520,ANSC 125,A00,487227,Brenner; Suzanne A,38,0,40,2
1713349758573,ANSC 146,A00,487229,Staff,35,0,40,5
1713349759600,ANSC 148,A00,487230,Olivas Hernandez; Olga Lid,39,0,40,1
1713349760628,ANSC 150,A00,504165,Sloane; Julia Kathryn,18,0,20,2
1713349761659,ANSC 180,A00,487232,Staff,14,0,15,1
1713349762685,ANSC 188,A00,627155,Staff,37,0,40,3
1713349763710,ANTH 5,A00,519529,Semendeferi; Ekaterini,15,0,15,0
1713349764738,ANTH 10,A00,487219,Staff,58,0,60,2
1713349765768,ANTH 23,A01,487221,Staff,17,0,20,3
1713349766801,ANTH 102,A00,487233,Wilder; Linnea Lorene,49,0,60,11
1713349767828,ANTH 103,A00,487234,Varma; Saiba,54,0,60,6
1713349768861,ANTH 105,A00,487235,Stewart; Alexander B,54,0,60,6
1713349769893,BENG 100,A01,516685,Taylor Amos; Alyssa C,25,0,30,5
1713349771001,BIBC 102,A01,491316,Flagg; Matthew Paul,3,0,88,85
1713349771001,BIBC 102,A02,491366,Flagg; Matthew Paul,78,0,88,10
1713349772034,BIBC 103,A01,491486,Boumechache; Miyyada,16,0,24,8
1713349772034,BIBC 103,A02,491487,Boumechache; Miyyada,24,0,24,0
1713349773065,BICD 100,A01,516882,Staff,72,0,75,3
1713349773065,BICD 100,A02,516890,Staff,69,0,75,6
1713349774094,BICD 102GS,A00,491488,Lo; Stanley M.,26,0,28,2
1713349775120,BIEB 136GS,A00,516940,Holway; David A. & Shurin; Jonathan,18,0,24,6
1713349776151,BIEB 137GS,A01,517034,Holway; David A. & Shurin; Jonathan,18,0,24,6
1713349777177,BIEB 138GS,A01,491492,Pirino; Giorgia,21,0,28,7
1713349778203,BILD 1,A01,491296,Staff,60,0,63,3
1713349778203,BILD 1,A02,491297,Staff,63,0,63,0
1713349779228,BILD 4,A01,517099,Gonzalez Gamboa; Ivonne,21,0,24,3
1713349779228,BILD 4,A02,517100,Gonzalez Gamboa; Ivonne,24,0,24,0
1713349780260,BILD 60GS,A00,491309,Lo; Stanley M.,26,0,28,2
1713349781288,BIMM 100,A01,517136,Staff,82,0,100,18
1713349782314,BIMM 110,A01,517182,Staff,52,0,100,48
1713349783342,BIMM 120,A01,517228,Pickett; Brooke Elizabeth,28,0,63,35
1713349783342,BIMM 120,A02,517240,Pickett; Brooke Elizabeth,44,0,63,19
1713349784373,BIMM 132GS,A01,491498,Pirino; Giorgia,21,0,28,7
1713349785405,BIMM 143,A01,491589,Bozinovic; Goran,12,0,40,28
1713349786432,BIPN 100,A01,491594,Armour; Jon Christopher,83,0,100,17
1713349787459,BIPN 140,A01,491602,Marino; Marc J,23,0,50,27
1713349789515,CAT 125,A00,515973,Staff,18,0,20,2
1713349790541,CAT 125GS,A00,515974,Rahimi; Babak,16,0,20,4
1713349791575,CAT 125R,A00,515980,Staff,12,0,20,8
1713349791575,CAT 125R,B00,515981,Tosun; Adriana,19,0,20,1
1713349791575,CAT 125R,C00,515987,Hyland; Tina Mae,0,5,20,20
1713349791575,CAT 125R,D00,515988,Bronstein; Phoebe Malan,16,0,20,4
1713349792601,CENG 15,A01,488699,Drews; Aaron,25,0,25,0
1713349793629,CENG 100,A00,505196,Opatkiewicz; Justin Paul,25,0,25,0
1713349794661,CGS 2A,A01,489598,Staff,32,0,35,3
1713349795687,CGS 112,A00,489599,Staff,15,0,15,0
1713349796715,CGS 119,A00,489603,Staff,10,0,10,0
1713349797744,CGS 120,A00,489604,Staff,13,0,15,2
1713349798773,CGS 150,A00,489607,Staff,15,0,15,0
1713349799801,CHEM 6A,A01,488715,Staff,97,0,100,3
1713349800834,CHEM 6B,A01,488719,Piercy; Marc Anthony,99,0,100,1
1713349801861,CHEM 6C,A01,488723,Albizati; Kim F.,92,0,100,8
1713349802896,CHEM 7L,A01,488728,Schurmeier; Kimberly,18,0,24,6
1713349802896,CHEM 7L,A02,488730,Schurmeier; Kimberly,23,0,24,1
1713349802896,CHEM 7L,A03,488734,Schurmeier; Kimberly,20,0,24,4
1713349802896,CHEM 7L,A04,488763,Schurmeier; Kimberly,23,0,24,1
1713349802896,CHEM 7L,B01,488798,Schurmeier; Kimberly,16,0,24,8
1713349802896,CHEM 7L,B02,488801,Schurmeier; Kimberly,22,0,24,2
1713349802896,CHEM 7L,B03,488808,Schurmeier; Kimberly,22,0,24,2
1713349802896,CHEM 7L,B04,488811,Schurmeier; Kimberly,24,0,24,0
1713349803928,CHEM 11,A01,488897,Stallings; Dontarie M,94,0,100,6
1713349804952,CHEM 40A,A01,488913,Albizati; Kim F.,83,0,100,17
1713349805986,CHEM 40B,A01,488920,Weizman; Haim,42,0,50,8
1713349805986,CHEM 40B,A02,488938,Weizman; Haim,43,0,50,7
1713349807011,CHEM 41A,A01,489029,Klosterman; Jeremy K,57,0,60,3
1713349808042,CHEM 41C,A01,500436,Tor; Yitzhak,54,0,60,6
1713349809069,CHEM 43A,A01,500426,Weizman; Haim,0,1,24,24
1713349809069,CHEM 43A,A02,500430,Weizman; Haim,6,0,24,18
1713349809069,CHEM 43A,B01,514041,Klosterman; Jeremy K,14,0,24,10
1713349809069,CHEM 43A,B02,514047,Klosterman; Jeremy K,23,0,24,1
1713349810095,CHEM 108,A01,489140,Jennings; Patricia A.,6,0,24,18
1713349810095,CHEM 108,A02,489142,Jennings; Patricia A.,14,0,24,10
1713349811126,CHEM 114A,A01,489147,Stallings; Dontarie M,65,0,100,35
1713349812156,CHIN 169A,A00,489171,Wang; Xiao,19,0,20,1
1713349814211,COGS 3,A01,518827,Boyle; Mary E. T.,25,0,40,15
1713349815235,COGS 11,A01,489175,Staff,27,0,30,3
1713349816260,COGS 14A,A01,518829,Staff,50,0,60,10
1713349817288,COGS 14B,A01,489177,Hoffman; Drew Ellen,62,0,75,13
1713349818314,COGS 100,A01,489181,Allen; Michael Gordon,62,0,75,13
1713349819345,COGS 101A,A01,489183,Staff,45,0,60,15
1713349820370,COGS 101B,A01,489185,Allen; Michael Gordon,6,0,30,24
1713349821398,COGS 101C,A01,526786,Staff,23,0,30,7
1713349823458,COGS 107A,A01,489189,Boyle; Mary E. T.,16,0,35,19
1713349824485,COGS 107B,A01,627144,Mooshagian; Eric Frederick,59,0,60,1
1713349825510,COGS 118A,A01,489191,Staff,0,46,40,40
1713349827564,COGS 171GS,A01,489194,Pineda; Jaime A,19,0,28,9
1713349828590,COGS 172,A01,489196,Staff,1,0,30,29
1713349829621,COGS 174GS,A01,489264,Pineda; Jaime A,19,0,28,9
1713349830654,COGS 180,A01,627150,Staff,28,0,30,2
1713349831683,COGS 186,A01,489274,Staff,0,3,30,30
1713349832709,COMM 10,A01,489276,Staff,23,0,25,2
1713349832709,COMM 10,A02,489303,Staff,23,0,25,2
1713349833734,COMM 100A,A01,489312,Staff,14,0,25,11
1713349833734,COMM 100A,A02,489313,Staff,24,0,25,1
1713349834762,COMM 106T,A00,512540,Staff,33,0,35,2
1713349835787,COMM 107,A00,489347,Staff,27,0,35,8
1713349836811,COMM 109P,A00,489358,Staff,31,0,35,4
1713349837836,COMM 132,A00,489361,McKenna; Denise,27,0,30,3
1713349838863,COMM 146,A00,489362,Halm; Gavin Patrick,26,0,30,4
1713349839894,COMM 190,A00,489363,Abuelhiga; Soraya Jill,17,0,23,6
1713349840929,CSE 8A,A50,489366,Staff,21,0,25,4
1713349840929,CSE 8A,A51,489367,Staff,24,0,25,1
1713349841954,CSE 11,A01,489398,Cao; Yingjun,72,0,100,28
1713349842984,CSE 12,A01,489487,Staff,43,0,50,7
1713349844012,CSE 20,A01,489497,Staff,47,0,50,3
1713349845043,CSE 21,A01,489517,Braun; Oliver,42,0,50,8
1713349846075,CSE 101,A01,489524,Braun; Oliver,0,35,50,50
1713349847102,CSE 105,A01,512594,Jones; Miles E,72,0,100,28
1713349847102,CSE 105,B01,512598,Jones; Miles E,50,0,100,50
1713349848133,CSE 140,A01,489538,Staff,39,0,50,11
1713349849161,CSE 141,A01,489550,Eldon; John,67,0,100,33
1713349850186,CSE 141L,A01,489571,Eldon; John,65,0,100,35
1713349851213,CSE 151A,A01,489583,Solares; Edwin A,139,0,200,61
1713349852238,CSE 175,A01,510886,Kumar; Rakesh,30,0,30,0
1713349853277,CSE 190,A00,516828,Dubnov; Shlomo,37,0,49,12
1713349854306,DOC 100D,A00,489667,Pass; Natalye Joann,19,0,25,6
1713349855333,DSC 10,A01,624268,Staff,72,0,75,3
1713349856363,DSC 20,A01,624476,Staff,50,0,50,0
1713349857391,DSC 40A,A01,624608,Staff,39,0,40,1
1713349858418,DSGN 1,A01,489179,Rill; Bryan,32,0,50,18
1713349859445,ECE 17,A01,490489,Sahay; Rajeev,18,0,30,12
1713349860473,ECE 65,A50,490492,Staff,11,0,20,9
1713349860473,ECE 65,A51,490493,Staff,18,0,20,2
1713349861499,ECON 1,A01,489715,Famulari; Melissa,67,0,70,3
1713349862528,ECON 2,A01,489717,Levkoff; Steven B.,67,0,70,3
1713349863558,ECON 3,A01,489948,Staff,70,0,70,0
1713349865614,ECON 5,A01,490103,Staff,27,0,30,3
1713349865614,ECON 5,B01,626281,Dai; Yinlin,45,0,45,0
1713349866640,ECON 100A,A01,490127,Famulari; Melissa,62,0,70,8
1713349867665,ECON 100B,A01,490129,Staff,64,0,70,6
1713349868695,ECON 109,A01,490187,Shishkin; Denis,27,0,35,8
1713349869727,ECON 110A,A01,490190,Levkoff; Steven B.,59,0,70,11
1713349870753,ECON 120A,A01,490245,Dai; Yinlin,59,0,70,11
1713349871783,ECON 120B,A01,490247,Nieto-Barthaburu; Augusto,40,0,70,30
1713349872810,ECON 120C,A01,490253,Sun; Yixiao,30,0,35,5
1713349872810,ECON 120C,B01,490255,Sun; Yixiao,34,0,35,1
1713349873840,ECON 129,A00,490256,Eckert; Fabian Paul,22,0,35,13
1713349874926,ECON 131,A00,490257,Nieto-Barthaburu; Augusto,0,6,35,35
1713349875952,ECON 138,A00,490258,Bharadwaj; Prashant,13,0,35,22
1713349875952,ECON 138,B00,490259,Bharadwaj; Prashant,15,0,35,20
1713349876978,ECON 159,A00,490260,Hendrickson; Gerald M.,0,9,0,0
1713349878013,ECON 178,A01,553995,Zhu; Ying,24,0,35,11
1713349879041,EDS 40,A01,512576,Black; Alison Michelle,20,0,20,0
1713349880067,EDS 107,A01,515848,Staff,30,0,30,0
1713349881098,EDS 110R,A01,490262,Staff,26,0,30,4
1713349882130,EDS 112,A01,490264,Chapman; Thandeka K,40,0,50,10
1713349883158,EDS 113,A00,490266,Staff,25,0,30,5
1713349884186,EDS 118,A00,490267,Warstadt; Melissa Fawn,18,0,30,12
1713349885211,EDS 124BR,A00,490268,Eguchi; Emi,4,0,25,21
1713349885211,EDS 124BR,B00,490269,Eguchi; Emi,23,0,25,2
1713349886245,EDS 126,A01,490271,Jones; Makeba,43,0,50,7
1713349887271,EDS 135,A01,490316,Staff,19,0,20,1
1713349888296,ENVR 142GS,A00,519514,Chang; Edmond Yi-Teh,26,0,28,2
1713349889321,ETHN 103,A00,490504,Staff,24,0,36,12
1713349890349,ETHN 103A,A00,490505,Man; Simeon S,3,0,9,6
1713349891374,ETHN 109,A00,490506,Staff,28,0,30,2
1713349892403,ETHN 118,A00,490507,Staff,35,0,36,1
1713349893428,ETHN 119,A00,490508,Staff,32,0,36,4
1713349894455,ETHN 121R,A00,490518,Choi; Esther Min,21,0,36,15
1713349895484,ETHN 127,A00,490528,Staff,14,0,15,1
1713349896508,ETHN 139,A00,490573,Staff,10,0,10,0
1713349897533,ETHN 150,A00,490575,Staff,15,0,15,0
1713349898560,GLBH 20,A00,491705,Elwardani; Nile Regina,38,0,40,2
1713349899589,GLBH 101,A00,491706,Staff,20,0,20,0
1713349900613,GLBH 111,A01,491708,Burgos; Jose L.,15,0,15,0
1713349901642,GLBH 146,A00,491709,Staff,8,0,20,12
1713349902671,GLBH 148,A00,491710,Olivas Hernandez; Olga Lid,10,0,20,10
1713349903697,GLBH 150,A00,491711,Sloane; Julia Kathryn,19,0,20,1
1713349904723,HIEA 131,A00,491760,Staff,28,0,32,4
1713349905751,HIEA 153,A00,491762,Staff,28,0,30,2
1713349906780,HIEU 124,A00,491811,Staff,26,0,32,6
1713349907811,HIEU 124GS,A00,491812,Markman; Kristina,27,0,28,1
1713349908837,HIEU 147,A00,491813,Staff,30,0,32,2
1713349909867,HIEU 149GS,A00,491816,Caldwell; Michael Alan,28,0,28,0
1713349910897,HILD 2C,A01,491713,Hendrickson; Gerald M.,26,0,30,4
1713349911922,HILD 7B,A01,491715,Kwak; Nancy,0,3,30,30
1713349912948,HILD 10,A01,491717,Staff,9,0,20,11
1713349913973,HILD 30GS,A00,491719,Edington; Claire Ellen,23,0,28,5
1713349914999,HINE 109,A00,491818,Shafir; Nir,26,0,32,6
1713349916024,HINE 128,A00,491821,Shafir; Nir,30,0,32,2
1713349917054,HISC 117,A00,491830,Staff,27,0,32,5
1713349918081,HIUS 103,A00,491834,Man; Simeon S,14,0,23,9
1713349919109,HIUS 108B,A00,491835,Staff,27,0,30,3
1713349920139,HIUS 141,A00,491836,Hendrickson; Gerald M.,28,0,32,4
1713349921163,HIUS 149,A00,491839,Staff,24,0,32,8
1713349922191,HUM 3,A01,512617,Crum; Matthew Stephen,42,0,50,8
1713349922191,HUM 3,A02,512618,Crum; Matthew Stephen,48,0,50,2
1713349923216,HUM 3GS,A00,512663,Markman; Kristina,0,0,0,1
1713349923216,HUM 3GS,B00,512664,Staff,0,0,0,0
1713349924246,HUM 4,A01,512620,West; Geoffrey Scott,22,0,50,28
1713349925272,HUM 4GS,A00,512666,Lyon; Antony J.,0,0,0,5
1713349926302,HUM 4R,A01,512625,Watkins; Eric,49,0,50,1
1713349927332,HUM 5,A01,512649,Zavodny; Tatiana Sophia,20,0,50,30
1713349927332,HUM 5,B01,512661,Zroka; Ryan Edward,48,0,50,2
1713349928358,INTL 190,A00,490577,Segui; Alan S,0,0,0,5
1713349929387,JAPN 20AR,A01,491267,Ross; Kayoko F,7,0,20,13
1713349930417,JAPN 180,A00,491285,Berman; Michael David,33,0,40,7
1713349931445,LATI 50,A01,502536,Kokinis; Troy Andreas,16,0,22,6
1713349931445,LATI 50,A02,502551,Kokinis; Troy Andreas,22,0,22,0
1713349931445,LATI 50,A03,502650,Kokinis; Troy Andreas,22,0,22,0
1713349931445,LATI 50,A04,502909,Kokinis; Troy Andreas,21,0,22,1
1713349932472,LATI 160,A01,502920,Kokinis; Troy Andreas,30,0,30,0
1713349933500,LIFR 1A,A00,490494,Van Moer; Vinciane G,17,0,20,3
1713349934525,LIFR 1AX,A00,490495,Van Moer; Vinciane G,17,0,20,3
1713349935550,LIFR 1B,A00,490496,Van Moer; Vinciane G,17,0,20,3
1713349936575,LIFR 1BX,A00,490497,Van Moer; Vinciane G,17,0,20,3
1713349937606,LIGN 8,A00,505198,McIntosh; Justin Daniel,134,0,150,16
1713349938635,LIGN 9GS,A00,491239,Lott; Margaret S.,18,0,20,2
1713349939661,LIGN 101,A01,505200,McIntosh; Justin Daniel,22,0,30,8
1713349940690,LIGN 120,A01,491244,Staff,22,0,30,8
1713349941714,LIGN 149GS,A00,491245,Lott; Margaret S.,18,0,20,2
1713349942741,LIGN 170,A00,491247,Staff,22,0,30,8
1713349943767,LISP 1D,A00,490498,Munoz Sanchez; Alicia,8,0,14,6
1713349943767,LISP 1D,B00,490499,Munoz Sanchez; Alicia,4,0,14,10
1713349943767,LISP 1D,C00,490500,Munoz Sanchez; Alicia,7,0,14,7
1713349943767,LISP 1D,D00,490501,Munoz Sanchez; Alicia,10,0,14,4
1713349944801,LISP 1DX,A00,490502,Munoz Sanchez; Alicia,11,0,28,17
1713349944801,LISP 1DX,B00,490503,Munoz Sanchez; Alicia,16,0,28,12
1713349946857,LTAM 110,A00,491847,Staff,22,0,25,3
1713349947883,LTCS 119,A00,491848,Staff,11,0,15,4
1713349948914,LTCS 130,A00,491849,Staff,24,0,25,1
1713349950972,LTEA 120C,A00,491852,Staff,32,0,40,8
1713349952002,LTEN 130GS,A00,491853,Lyon; Antony J.,23,0,28,5
1713349953027,LTEN 148,A00,491855,Staff,23,0,25,2
1713349954057,LTEN 159,A00,491856,Staff,20,0,25,5
1713349955083,LTEN 180,A00,491857,Staff,8,0,15,7
1713349957135,LTSP 123GS,A00,505928,Bessett; Ryan Matthew,24,0,28,4
1713349958163,LTSP 174GS,A00,506037,Bessett; Ryan Matthew,24,0,28,4
1713349960215,LTWR 102,A00,491861,Staff,9,0,15,6
1713349961241,LTWR 106,A00,491862,Staff,8,0,15,7
1713349962267,MAE 11,A00,490930,Bahadori; Mohammad Yousef,94,0,100,6
1713349963294,MAE 30A,A00,490931,Qi; Huihui,37,0,40,3
1713349964318,MAE 101A,A00,491036,Sadeghizadeh; Zahra,91,0,100,9
1713349965346,MAE 101C,A00,491037,Seshadri; Kalyanasundaram,63,0,100,37
1713349966372,MAE 113,A00,491040,Seshadri; Kalyanasundaram,64,0,80,16
1713349967399,MAE 131A,A00,491041,Ghazinejad; Maziar,37,0,40,3
1713349968425,MAE 142,A00,491053,Staff,39,0,40,1
1713349969450,MAE 143A,A00,491054,Staff,29,0,50,21
1713349970476,MAE 150,A00,491092,Truong; Phuong Thi Ngoc,23,0,35,12
1713349971505,MATH 3C,A01,494031,Pardo Guerra; Sebastian,30,0,30,0
1713349971505,MATH 3C,A02,494032,Pardo Guerra; Sebastian,29,0,30,1
1713349972535,MATH 10A,A01,494034,Staff,27,0,30,3
1713349972535,MATH 10A,A02,494035,Staff,28,0,30,2
1713349972535,MATH 10A,B01,494037,Staff,27,0,30,3
1713349972535,MATH 10A,B02,494038,Staff,29,0,30,1
1713349973574,MATH 10B,A01,494040,Habib; Yousaf,22,0,30,8
1713349973574,MATH 10B,A02,494041,Habib; Yousaf,28,0,30,2
1713349973574,MATH 10B,A03,494042,Habib; Yousaf,29,0,30,1
1713349973574,MATH 10B,A04,494043,Habib; Yousaf,30,0,30,0
1713349973574,MATH 10B,B01,494045,Habib; Yousaf,25,0,30,5
1713349973574,MATH 10B,B02,494046,Habib; Yousaf,30,0,30,0
1713349973574,MATH 10B,B03,494047,Habib; Yousaf,30,0,30,0
1713349973574,MATH 10B,B04,494048,Habib; Yousaf,30,0,30,0
1713349974609,MATH 18,A01,494050,Kemp; Todd Aahron,25,0,30,5
1713349974609,MATH 18,A02,494051,Kemp; Todd Aahron,29,0,30,1
1713349974609,MATH 18,B01,494054,Kemp; Todd Aahron,25,0,30,5
1713349974609,MATH 18,B02,494055,Kemp; Todd Aahron,29,0,30,1
1713349975640,MATH 20A,A01,494059,Suk; Andrew Hoon,30,0,30,0
1713349976668,MATH 20B,A01,494061,Briones; Jor-el Thomas Caparas,33,0,35,2
1713349976668,MATH 20B,B01,494063,Bach; Quang Tran,34,0,35,1
1713349977696,MATH 20C,A01,494065,Staff,28,0,30,2
1713349977696,MATH 20C,A02,494066,Staff,30,0,30,0
1713349977696,MATH 20C,A03,494067,Staff,30,0,30,0
1713349977696,MATH 20C,A04,494068,Staff,30,0,30,0
1713349977696,MATH 20C,B01,494070,Zhang; Ming,23,0,30,7
1713349977696,MATH 20C,B02,494071,Zhang; Ming,27,0,30,3
1713349977696,MATH 20C,B03,494072,Zhang; Ming,29,0,30,1
1713349977696,MATH 20C,B04,494073,Zhang; Ming,29,0,30,1
1713349978777,MATH 20D,A01,494075,Staff,22,0,30,8
1713349978777,MATH 20D,A02,494076,Staff,29,0,30,1
1713349979809,MATH 20E,A01,494079,Staff,24,0,30,6
1713349979809,MATH 20E,A02,494080,Staff,26,0,30,4
1713349979809,MATH 20E,B01,494082,Staff,25,0,30,5
1713349979809,MATH 20E,B02,494083,Staff,25,0,30,5
1713349980837,MATH 103A,A01,494085,Aliabadi Sr.; Mohsen,12,0,30,18
1713349980837,MATH 103A,A02,494086,Aliabadi Sr.; Mohsen,28,0,30,2
1713349980837,MATH 103A,B01,494088,Aliabadi Sr.; Mohsen,19,0,30,11
1713349980837,MATH 103A,B02,494089,Aliabadi Sr.; Mohsen,27,0,30,3
1713349981862,MATH 109,A01,494091,Staff,30,0,30,0
1713349981862,MATH 109,A02,494092,Staff,29,0,30,1
1713349981862,MATH 109,B01,494094,Staff,27,0,30,3
1713349981862,MATH 109,B02,494095,Staff,29,0,30,1
1713349982890,MATH 142A,A01,494097,Chow; Bennett,13,0,30,17
1713349982890,MATH 142A,A02,494098,Chow; Bennett,23,0,30,7
1713349982890,MATH 142A,B01,494100,Chow; Bennett,19,0,30,11
1713349982890,MATH 142A,B02,494101,Chow; Bennett,29,0,30,1
1713349984942,MATH 168A,A01,516677,Dumitriu; Ioana,16,0,35,19
1713349985968,MATH 170A,A01,516679,Dumitriu; Ioana,18,0,30,12
1713349985968,MATH 170A,A02,516680,Dumitriu; Ioana,28,0,30,2
1713349986998,MATH 193A,A01,494107,Staff,12,0,30,18
1713349986998,MATH 193A,A02,494108,Staff,18,0,30,12
1713349986998,MATH 193A,A03,494109,Staff,29,0,30,1
1713349986998,MATH 193A,A04,494110,Staff,22,0,30,8
1713349990075,MGT 16,A00,491930,McKay; Michael J,92,0,98,6
1713349991103,MGT 18,A00,491992,McKay; Michael J,96,0,98,2
1713349992128,MGT 71,A00,492003,Staff,63,0,98,35
1713349993153,MGT 103,A00,505209,Eberhard; Craig A,80,0,98,18
1713349994183,MGT 131A,A00,505210,Anderson; John Charles,89,0,98,9
1713349996235,MGT 153,A00,492077,Perols; Johan Lars,15,0,90,75
1713349999320,MGT 164,A00,492222,McKay; Mary A,91,0,98,7
1713350000356,MGT 172,A00,492245,Staff,59,0,60,1
1713350000356,MGT 172,B00,505526,Hedges; Kathleen,65,0,98,33
1713350001382,MGT 181,A00,505669,Dunn; Louis Jean,78,0,98,20
1713350002415,MMW 14,A01,494399,Staff,15,0,28,13
1713350002415,MMW 14,A02,494400,Staff,25,0,28,3
1713350002415,MMW 14,A03,494401,Staff,28,0,28,0
1713350002415,MMW 14,A04,494402,Staff,28,0,28,0
1713350002415,MMW 14,B01,494404,Carreras; Maria Victoria,8,0,28,20
1713350002415,MMW 14,B02,494405,Carreras; Maria Victoria,25,0,28,3
1713350002415,MMW 14,B03,494406,Carreras; Maria Victoria,27,0,28,1
1713350002415,MMW 14,B04,494407,Carreras; Maria Victoria,28,0,28,0
1713350003439,MMW 14GS,A00,506250,Chang; Edmond Yi-Teh,0,0,0,0
1713350004470,MMW 121R,A01,494415,Adamiak; Patrick John,9,0,28,19
1713350004470,MMW 121R,A02,494416,Adamiak; Patrick John,24,0,28,4
1713350005499,MUS 1A,A01,494113,Staff,12,0,25,13
1713350005499,MUS 1A,A02,494114,Staff,24,0,25,1
1713350006525,MUS 4,A01,494116,Staff,23,0,25,2
1713350006525,MUS 4,A02,494117,Staff,22,0,25,3
1713350007552,MUS 5R,A01,494236,Dubnov; Shlomo,4,0,25,21
1713350007552,MUS 5R,A02,494237,Dubnov; Shlomo,25,0,25,0
1713350008578,MUS 6,A01,494122,Staff,9,0,25,16
1713350008578,MUS 6,A02,494123,Staff,23,0,25,2
1713350009606,MUS 7,A01,494125,Staff,16,0,25,9
1713350009606,MUS 7,A02,494126,Staff,24,0,25,1
1713350010633,MUS 11,A01,494128,Staff,23,0,25,2
1713350010633,MUS 11,A02,494129,Staff,24,0,25,1
1713350011658,MUS 13,A01,494131,Staff,25,0,25,0
1713350011658,MUS 13,A02,494132,Staff,25,0,25,0
1713350012689,MUS 15,A01,494134,Staff,16,0,25,9
1713350012689,MUS 15,A02,494135,Staff,25,0,25,0
1713350012689,MUS 15,B01,494137,Staff,24,0,25,1
1713350013720,MUS 80,A00,494232,Staff,24,0,25,1
1713350013720,MUS 80,B00,494233,Staff,25,0,25,0
1713350013720,MUS 80,C00,494234,Staff,23,0,25,2
1713350014745,MUS 95C,A00,494141,Staff,69,0,75,6
1713350015770,MUS 114,A00,494142,Staff,39,0,50,11
1713350016803,NANO 15,A01,490636,Drews; Aaron,7,0,7,0
1713350017830,PHIL 1,A00,490578,Grush; Rick Scott,49,0,50,1
1713350018857,PHIL 10,A01,490580,Grush; Rick Scott,33,0,35,2
1713350018857,PHIL 10,A02,490586,Grush; Rick Scott,32,0,35,3
1713350019887,PHIL 27,A01,490591,Staff,22,0,25,3
1713350019887,PHIL 27,A02,490592,Staff,25,0,25,0
1713350019887,PHIL 27,A03,490593,Staff,25,0,25,0
1713350019887,PHIL 27,A04,490598,Staff,25,0,25,0
1713350020916,PHIL 32,A01,490611,Staff,20,0,20,0
1713350020916,PHIL 32,A02,490618,Staff,20,0,20,0
1713350021942,PHIL 90,A00,490624,Staff,40,0,40,0
1713350022968,PHIL 136,A00,490627,Cohen; Jonathan David,37,0,40,3
1713350023994,PHIL 155,A00,490634,Staff,61,0,70,9
1713350025024,PHYS 1A,A00,491610,Staff,245,0,250,5
1713350026050,PHYS 1AL,001,491616,Tsai; Philbert S,27,0,30,3
1713350026050,PHYS 1AL,002,491618,Tsai; Philbert S,30,0,30,0
1713350027075,PHYS 1B,A00,491623,Staff,235,0,250,15
1713350028104,PHYS 1BL,001,491626,Tsai; Philbert S,18,0,30,12
1713350028104,PHYS 1BL,002,491628,Tsai; Philbert S,26,0,30,4
1713350029132,PHYS 1C,A00,491632,Staff,211,0,245,34
1713350030157,PHYS 1CL,001,491635,Tsai; Philbert S,2,0,30,28
1713350030157,PHYS 1CL,002,491643,Tsai; Philbert S,22,0,30,8
1713350031183,PHYS 2AR,A01,491651,Meyertholen; Andrew D.,44,0,50,6
1713350032210,PHYS 2B,A01,491659,Staff,105,0,115,10
1713350033237,PHYS 2BL,A01,491685,Staff,21,0,24,3
1713350033237,PHYS 2BL,A02,491700,Staff,21,0,24,3
1713350034271,PHYS 2C,A01,505161,Staff,101,0,115,14
1713350035299,PHYS 4A,A01,491704,Grinstein; Benjamin,99,0,100,1
1713350036327,POLI 5D,A01,494144,Staff,3,0,5,2
1713350036327,POLI 5D,B01,626283,Dai; Yinlin,5,0,5,0
1713350037354,POLI 12,A00,494145,Staff,43,0,45,2
1713350038384,POLI 13R,A00,494146,Forman; Fonna,45,0,50,5
1713350039411,POLI 27,A01,494148,Staff,54,0,60,6
1713350040437,POLI 30,A00,494149,Staff,49,0,50,1
1713350041468,POLI 100DA,A00,494150,Staff,20,0,25,5
1713350043525,POLI 100I,A00,494152,Staff,27,0,30,3
1713350044557,POLI 104B,A00,494153,Smith; Glenn Chatmas,53,0,55,2
1713350045583,POLI 104F,A00,494154,Staff,28,0,30,2
1713350046609,POLI 104I,A00,494155,Smith; Glenn Chatmas,29,0,30,1
1713350047638,POLI 110C,A00,494156,Ingham; Sean,23,0,25,2
1713350048668,POLI 117R,A00,494157,Forman; Fonna,5,0,20,15
1713350049694,POLI 118,A00,494158,Ingham; Sean,21,0,25,4
1713350050726,POLI 120H,A00,494159,Fisk; David Lee,39,0,45,6
1713350051751,POLI 131CR,A00,494160,Hoston; Germaine,35,0,45,10
1713350052782,POLI 133J,A00,494161,Staff,31,0,35,4
1713350053810,POLI 135,A00,494162,Fisk; David Lee,33,0,35,2
1713350054836,POLI 140A,A00,494164,Staff,18,0,30,12
1713350055862,POLI 142I,A00,494165,Staff,30,0,30,0
1713350056890,POLI 144D,A00,494166,Staff,22,0,25,3
1713350057917,POLI 151,A00,494167,Staff,30,0,30,0
1713350058943,POLI 153,A00,494168,Staff,33,0,35,2
1713350059973,POLI 160AA,A00,494169,Staff,33,0,40,7
1713350061000,POLI 162,A00,494170,Mignozzetti; Umberto,17,0,25,8
1713350062028,POLI 171,A00,494171,Mignozzetti; Umberto,18,0,25,7
1713350063054,PSYC 1,A00,494172,Staff,95,0,100,5
1713350064083,PSYC 2,A00,494173,Moranton; Nirelia Melbina-,33,0,50,17
1713350065114,PSYC 3,A00,494174,Staff,29,0,30,1
1713350066143,PSYC 6,A00,494175,Staff,17,0,20,3
1713350067174,PSYC 60,A01,494177,Staff,37,0,45,8
1713350068199,PSYC 70,A01,505724,Geller; Emma Harlan,42,0,45,3
1713350069225,PSYC 101,A00,494180,Heyman; Gail D.,83,0,100,17
1713350070255,PSYC 105,A00,494181,Geller; Emma Harlan,51,0,90,39
1713350071282,PSYC 106,A00,494182,Dobkins; Karen R.,26,0,45,19
1713350072308,PSYC 108,A00,494183,Adrian; Julia Anna,89,0,100,11
1713350073338,PSYC 114,A01,494185,Winkielman; Piotr,0,4,30,30
1713350074364,PSYC 122,A00,494186,Moranton; Nirelia Melbina-,27,0,50,23
1713350075397,PSYC 124,A00,494187,Chapman; Eddie Nathaniel,69,0,80,11
1713350076423,PSYC 131,A00,494188,Anagnostaras; Stephan,39,0,80,41
1713350077448,PSYC 144,A00,494189,Staff,1,1,50,49
1713350078478,PSYC 154,A00,494190,Lacefield; Katharine I,105,0,180,75
1713350079503,PSYC 162,A00,494191,Wixted; John T,70,0,100,30
1713350080529,PSYC 172,A00,494192,Gorman; Michael R.,36,0,45,9
1713350081555,PSYC 178,A00,494193,Glaser; Dale,32,0,45,13
1713350082635,PSYC 193,A00,505725,Chapman; Eddie Nathaniel,20,0,20,0
1713350083665,RELI 145GS,A00,519817,Rahimi; Babak,17,0,20,3
1713350084704,SE 101A,A01,490862,Chadha; Mayank,23,0,25,2
1713350085733,SE 101C,A01,490924,Krysl; Petr,15,0,20,5
1713350086760,SE 110A,A01,490928,Staff,19,0,20,1
1713350087790,SE 130A,A00,490929,Morrison; Machel Leigh,53,0,70,17
1713350088819,SIO 1,A01,519325,Staff,39,0,40,1
1713350089845,SIO 30,A01,519327,Staff,38,0,40,2
1713350090870,SIO 40,A00,519328,Staff,39,0,40,1
1713350091896,SIO 46GS,A00,519819,Cook; Geoffrey W,15,0,25,10
1713350092925,SIO 109R,A00,494197,Forman; Fonna,0,3,20,20
1713350093949,SIO 121GS,A00,519827,Cook; Geoffrey W,15,0,25,10
1713350094974,SIO 132,A01,519330,Staff,38,0,40,2
1713350096001,SIO 133,A01,519397,Staff,37,0,40,3
1713350097026,SIO 139,A00,519396,Kacev; David,29,0,40,11
1713350098054,SOCI 1,A01,494199,Thorpe; Charles Robert,21,0,30,9
1713350098054,SOCI 1,A02,494200,Thorpe; Charles Robert,30,0,30,0
1713350098054,SOCI 1,A03,494201,Thorpe; Charles Robert,29,0,30,1
1713350098054,SOCI 1,A04,494202,Thorpe; Charles Robert,29,0,30,1
1713350098054,SOCI 1,A05,494203,Thorpe; Charles Robert,29,0,30,1
1713350098054,SOCI 1,A06,494204,Thorpe; Charles Robert,30,0,30,0
1713350098054,SOCI 1,A07,494205,Thorpe; Charles Robert,28,0,30,2
1713350099084,SOCI 60,A01,494207,Staff,33,0,40,7
1713350099084,SOCI 60,A02,494208,Staff,39,0,40,1
1713350100109,SOCI 100,A01,494210,Payne; Christine Anna,25,0,30,5
1713350100109,SOCI 100,A02,494211,Payne; Christine Anna,26,0,30,4
1713350101138,SOCI 109M,A00,494212,Staff,20,0,20,0
1713350102164,SOCI 110,A00,494213,Staff,34,0,40,6
1713350104221,SOCI 118E,A00,494215,Ng; Kwai,37,0,40,3
1713350105246,SOCI 125,A00,494216,Calderon-Zaks; Michael Aar,39,0,45,6
1713350106275,SOCI 126,A01,494218,Jones; Makeba,3,0,5,2
1713350107301,SOCI 131,A00,494219,Thorpe; Charles Robert,25,0,30,5
1713350109355,SOCI 135,A00,494221,Payne; Christine Anna,28,0,50,22
1713350110382,SOCI 136E,A00,626690,Ruiz; Jonathan Joseph,24,0,25,1
1713350111408,SOCI 138GS,A00,494222,Navon; Daniel,23,0,28,5
1713350113456,SOCI 145,A00,494224,Staff,40,0,45,5
1713350114482,SOCI 153,A00,494225,Staff,28,0,30,2
1713350115508,SOCI 160E,A00,494226,Ng; Kwai,27,0,40,13
1713350116534,SOCI 180,A00,494227,Staff,29,0,30,1
1713350117564,SOCI 189GS,A00,494228,Ribas Norris; Janet Vanesa,11,0,11,0
1713350118590,SOCI 190GS,A00,553232,Ribas Norris; Janet Vanesa,11,0,11,0
1713350119618,SOMI 220,A00,627178,Schneid; Stephen David,30,0,30,0
1713350120644,SYN 2,001,490768,Staff,13,0,15,2
1713350120644,SYN 2,002,490769,Staff,14,0,15,1
1713350120644,SYN 2,004,490775,Staff,0,0,0,0
1713350120644,SYN 2,003,490774,Staff,0,0,0,0
1713350120644,SYN 2,005,490776,Staff,0,0,0,0
1713350121673,SYN 2R,001,490779,Staff,10,0,15,5
1713350121673,SYN 2R,002,514635,Staff,14,0,15,1
1713350122704,SYN 100,A01,490783,Staff,8,0,20,12
1713350122704,SYN 100,B01,490787,Staff,10,0,20,10
1713350122704,SYN 100,C01,490789,Staff,10,0,20,10
1713350123732,SYN 150,A00,490817,Staff,14,0,15,1
1713350123732,SYN 150,B00,514610,Staff,15,0,15,0
1713350124761,TDAC 1,A00,492753,Walsh; Kim C.,19,0,20,1
1713350124761,TDAC 1,B00,492754,Harting; Carla Kelso,18,0,20,2
1713350124761,TDAC 1,C00,513995,Salovey; Todd,15,0,20,5
1713350125787,TDAC 101,A00,492766,Harting; Carla Kelso,17,0,20,3
1713350126813,TDAC 102,A00,492768,Basso; Beatrice,19,0,20,1
1713350127841,TDDE 111,A00,492769,Staff,25,0,25,0
1713350128866,TDDE 131,A00,492770,Staff,15,0,15,0
1713350128866,TDDE 131,B00,492771,Staff,15,0,15,0
1713350129893,TDDE 131GS,A00,523716,Guirguis; Mark C,23,0,28,5
1713350130918,TDGE 1,A01,492756,Salovey; Todd,56,0,60,4
1713350131944,TDGE 5,A01,492758,Staff,23,0,25,2
1713350132970,TDGE 10,A00,492759,Fulton; Julia,203,0,220,17
1713350133996,TDGE 11,A00,492760,Castro; Robert Jess,198,0,200,2
1713350136046,TDGE 124,A00,492772,Fulton; Julia,180,0,220,40
1713350137075,TDGE 125,A00,492773,Meyer; Ursula,38,0,50,12
1713350137075,TDGE 125,B00,492774,Staff,49,0,50,1
1713350137075,TDGE 125,C00,523565,Staff,48,0,50,2
1713350138100,TDGE 125GS,A00,523580,Guirguis; Mark C,23,0,28,5
1713350139126,TDGE 127,A00,492775,Havis; Allan,33,0,50,17
1713350140155,TDHT 101,A00,492776,Staff,34,0,35,1
1713350141187,TDMV 1,A00,492762,Caligagan; Maria T.,29,0,30,1
1713350141187,TDMV 1,B00,492763,Arcidiacono; Kristin,26,0,30,4
1713350142213,TDMV 2,A00,492764,Weinberg; Sadie,27,0,30,3
1713350143238,TDMV 3,A00,492765,Mack; Kara Shanai',37,0,40,3
1713350144263,TDMV 138,A00,492777,Mack; Kara Shanai',32,0,40,8
1713350145288,TDMV 140,A00,492778,Lima; Paulo Henrique,40,0,40,0
1713350146314,TDMV 142,A00,492779,Caligagan; Maria T.,33,0,40,7
1713350146314,TDMV 142,B00,492780,Caligagan; Tony,37,0,40,3
1713350147339,TDMV 143,A00,492781,Fyall; Daunte Edward,39,0,40,1
1713350148366,USP 1,A01,492401,Kwak; Nancy,27,0,35,8
1713350149392,USP 2,A01,492453,Hinds; Juli Beth,35,0,35,0
1713350150418,USP 3,A01,492516,Staff,28,0,35,7
1713350151443,USP 4,A00,492522,McTague; Sarah,16,0,25,9
1713350152468,USP 100,A00,492523,Staff,32,0,35,3
1713350153498,USP 101,A00,492524,Staff,13,0,15,2
1713350154524,USP 105,A00,492525,Staff,21,0,25,4
1713350155550,USP 151,A00,492526,Shenkman; Michael Thomas,32,0,35,3
1713350156574,USP 170,A00,492545,Hinds; Juli Beth,32,0,35,3
1713350157599,USP 171GS,A00,492608,Bussell; Mirle Rabinowitz,24,0,28,4
1713350158624,USP 183GS,A00,492613,Peerson; Susan,24,0,28,4
1713350159654,VIS 30,A01,490693,Yoldas; Pinar,19,0,22,3
1713350159654,VIS 30,A02,490694,Yoldas; Pinar,18,0,22,4
1713350160691,VIS 83,A00,490695,Kester; Grant,63,0,75,12
1713350161722,VIS 105D,A00,490696,Staff,22,0,25,3
1713350162748,VIS 124CN,A00,490699,Rose; Jordan M,64,0,75,11
1713350163780,VIS 125GS,A00,511221,Williams; Alena J,21,0,22,1
1713350164805,VIS 128D,A00,490700,Staff,73,0,75,2
1713350165828,VIS 151,A01,490717,Staff,33,0,34,1
1713350165828,VIS 151,A02,490766,Staff,32,0,34,2
1713350166853,VIS 154GS,A00,511972,Williams; Alena J,21,0,22,1
1713350167879,VIS 160A,A00,490767,Stone; Patricia,7,0,10,3
1713350168905,WCWP 10A,A00,490638,Staff,14,0,15,1
1713350168905,WCWP 10A,B00,490640,Staff,15,0,15,0
1713350169931,WCWP 10B,A00,490641,Staff,0,0,0,0
1713350169931,WCWP 10B,B00,490642,Staff,14,0,15,1
1713350169931,WCWP 10B,C00,490644,Staff,13,0,15,2
1713350169931,WCWP 10B,D00,490647,Staff,0,0,0,0
1713350170959,WCWP 100,A00,490655,Staff,0,0,0,0
1713350170959,WCWP 100,B00,490687,Staff,10,0,15,5
1713350173097,ANAR 153,A00,487222,Braswell; Geoffrey E.,53,0,60,7
1713350174122,ANBI 134,A00,487223,Staff,5,0,20,15
1713350175153,ANBI 143GS,A00,487224,Noel; Geoffroy Pierre Jean,18,0,24,6
1713350176178,ANBI 144GS,A00,519548,Noel; Geoffroy Pierre Jean,18,0,24,6
1713350177206,ANSC 101,A00,487225,Staff,17,0,20,3
1713350178237,ANSC 125,A00,487227,Brenner; Suzanne A,38,0,40,2
1713350180288,ANSC 146,A00,487229,Staff,35,0,40,5
1713350181313,ANSC 148,A00,487230,Olivas Hernandez; Olga Lid,39,0,40,1
1713350182347,ANSC 150,A00,504165,Sloane; Julia Kathryn,18,0,20,2
1713350183374,ANSC 180,A00,487232,Staff,14,0,15,1
1713350184403,ANSC 188,A00,627155,Staff,37,0,40,3
1713350185430,ANTH 5,A00,519529,Semendeferi; Ekaterini,15,0,15,0
1713350186511,ANTH 10,A00,487219,Staff,58,0,60,2
1713350196682,ANTH 23,A01,487221,Staff,17,0,20,3
1713350197711,ANTH 102,A00,487233,Wilder; Linnea Lorene,49,0,60,11
1713350198746,ANTH 103,A00,487234,Varma; Saiba,54,0,60,6
1713350199773,ANTH 105,A00,487235,Stewart; Alexander B,54,0,60,6
1713350200802,BENG 100,A01,516685,Taylor Amos; Alyssa C,25,0,30,5
1713350201838,BIBC 102,A01,491316,Flagg; Matthew Paul,3,0,88,85
1713350201838,BIBC 102,A02,491366,Flagg; Matthew Paul,78,0,88,10
1713350202867,BIBC 103,A01,491486,Boumechache; Miyyada,16,0,24,8
1713350202867,BIBC 103,A02,491487,Boumechache; Miyyada,24,0,24,0
1713350203895,BICD 100,A01,516882,Staff,72,0,75,3
1713350203895,BICD 100,A02,516890,Staff,69,0,75,6
1713350204922,BICD 102GS,A00,491488,Lo; Stanley M.,26,0,28,2
1713350205955,BIEB 136GS,A00,516940,Holway; David A. & Shurin; Jonathan,18,0,24,6
1713350206980,BIEB 137GS,A01,517034,Holway; David A. & Shurin; Jonathan,18,0,24,6
1713350208006,BIEB 138GS,A01,491492,Pirino; Giorgia,21,0,28,7
1713350209032,BILD 1,A01,491296,Staff,60,0,63,3
1713350209032,BILD 1,A02,491297,Staff,63,0,63,0
1713350210063,BILD 4,A01,517099,Gonzalez Gamboa; Ivonne,21,0,24,3
1713350210063,BILD 4,A02,517100,Gonzalez Gamboa; Ivonne,24,0,24,0
1713350211089,BILD 60GS,A00,491309,Lo; Stanley M.,26,0,28,2
1713350212119,BIMM 100,A01,517136,Staff,82,0,100,18
1713350213146,BIMM 110,A01,517182,Staff,52,0,100,48
1713350214173,BIMM 120,A01,517228,Pickett; Brooke Elizabeth,28,0,63,35
1713350214173,BIMM 120,A02,517240,Pickett; Brooke Elizabeth,44,0,63,19
1713350215204,BIMM 132GS,A01,491498,Pirino; Giorgia,21,0,28,7
1713350216230,BIMM 143,A01,491589,Bozinovic; Goran,12,0,40,28
1713350217255,BIPN 100,A01,491594,Armour; Jon Christopher,83,0,100,17
1713350218283,BIPN 140,A01,491602,Marino; Marc J,23,0,50,27
1713350220339,CAT 125,A00,515973,Staff,18,0,20,2
1713350221365,CAT 125GS,A00,515974,Rahimi; Babak,16,0,20,4
1713350222394,CAT 125R,A00,515980,Staff,12,0,20,8
1713350222394,CAT 125R,B00,515981,Tosun; Adriana,19,0,20,1
1713350222394,CAT 125R,C00,515987,Hyland; Tina Mae,0,5,20,20
1713350222394,CAT 125R,D00,515988,Bronstein; Phoebe Malan,16,0,20,4
1713350223423,CENG 15,A01,488699,Drews; Aaron,25,0,25,0
1713350224450,CENG 100,A00,505196,Opatkiewicz; Justin Paul,25,0,25,0
1713350225477,CGS 2A,A01,489598,Staff,32,0,35,3
1713350226502,CGS 112,A00,489599,Staff,15,0,15,0
1713350227527,CGS 119,A00,489603,Staff,10,0,10,0
1713350228557,CGS 120,A00,489604,Staff,13,0,15,2
1713350229584,CGS 150,A00,489607,Staff,15,0,15,0
1713350230610,CHEM 6A,A01,488715,Staff,97,0,100,3
1713350231644,CHEM 6B,A01,488719,Piercy; Marc Anthony,99,0,100,1
1713350232671,CHEM 6C,A01,488723,Albizati; Kim F.,92,0,100,8
1713350233697,CHEM 7L,A01,488728,Schurmeier; Kimberly,18,0,24,6
1713350233697,CHEM 7L,A02,488730,Schurmeier; Kimberly,23,0,24,1
1713350233697,CHEM 7L,A03,488734,Schurmeier; Kimberly,20,0,24,4
1713350233697,CHEM 7L,A04,488763,Schurmeier; Kimberly,23,0,24,1
1713350233697,CHEM 7L,B01,488798,Schurmeier; Kimberly,16,0,24,8
1713350233697,CHEM 7L,B02,488801,Schurmeier; Kimberly,22,0,24,2
1713350233697,CHEM 7L,B03,488808,Schurmeier; Kimberly,22,0,24,2
1713350233697,CHEM 7L,B04,488811,Schurmeier; Kimberly,24,0,24,0
1713350234722,CHEM 11,A01,488897,Stallings; Dontarie M,94,0,100,6
1713350235751,CHEM 40A,A01,488913,Albizati; Kim F.,83,0,100,17
1713350236777,CHEM 40B,A01,488920,Weizman; Haim,42,0,50,8
1713350236777,CHEM 40B,A02,488938,Weizman; Haim,43,0,50,7
1713350237809,CHEM 41A,A01,489029,Klosterman; Jeremy K,57,0,60,3
1713350238835,CHEM 41C,A01,500436,Tor; Yitzhak,54,0,60,6
1713350239863,CHEM 43A,A01,500426,Weizman; Haim,0,1,24,24
1713350239863,CHEM 43A,A02,500430,Weizman; Haim,6,0,24,18
1713350239863,CHEM 43A,B01,514041,Klosterman; Jeremy K,14,0,24,10
1713350239863,CHEM 43A,B02,514047,Klosterman; Jeremy K,23,0,24,1
1713350240896,CHEM 108,A01,489140,Jennings; Patricia A.,5,0,24,19
1713350240896,CHEM 108,A02,489142,Jennings; Patricia A.,14,0,24,10
1713350241922,CHEM 114A,A01,489147,Stallings; Dontarie M,65,0,100,35
1713350242954,CHIN 169A,A00,489171,Wang; Xiao,19,0,20,1
1713350245003,COGS 3,A01,518827,Boyle; Mary E. T.,25,0,40,15
1713350246028,COGS 11,A01,489175,Staff,27,0,30,3
1713350247054,COGS 14A,A01,518829,Staff,50,0,60,10
1713350248088,COGS 14B,A01,489177,Hoffman; Drew Ellen,62,0,75,13
1713350249119,COGS 100,A01,489181,Allen; Michael Gordon,62,0,75,13
1713350250147,COGS 101A,A01,489183,Staff,45,0,60,15
1713350251172,COGS 101B,A01,489185,Allen; Michael Gordon,6,0,30,24
1713350252201,COGS 101C,A01,526786,Staff,23,0,30,7
1713350254254,COGS 107A,A01,489189,Boyle; Mary E. T.,16,0,35,19
1713350255284,COGS 107B,A01,627144,Mooshagian; Eric Frederick,59,0,60,1
1713350256308,COGS 118A,A01,489191,Staff,0,46,40,40
1713350258366,COGS 171GS,A01,489194,Pineda; Jaime A,19,0,28,9
1713350259394,COGS 172,A01,489196,Staff,1,0,30,29
1713350260421,COGS 174GS,A01,489264,Pineda; Jaime A,19,0,28,9
1713350261447,COGS 180,A01,627150,Staff,28,0,30,2
1713350262473,COGS 186,A01,489274,Staff,0,3,30,30
1713350263497,COMM 10,A01,489276,Staff,23,0,25,2
1713350263497,COMM 10,A02,489303,Staff,23,0,25,2
1713350264522,COMM 100A,A01,489312,Staff,14,0,25,11
1713350264522,COMM 100A,A02,489313,Staff,24,0,25,1
1713350265548,COMM 106T,A00,512540,Staff,33,0,35,2
1713350266573,COMM 107,A00,489347,Staff,27,0,35,8
1713350267601,COMM 109P,A00,489358,Staff,31,0,35,4
1713350268627,COMM 132,A00,489361,McKenna; Denise,27,0,30,3
1713350269659,COMM 146,A00,489362,Halm; Gavin Patrick,25,0,30,5
1713350270684,COMM 190,A00,489363,Abuelhiga; Soraya Jill,17,0,23,6
1713350271720,CSE 8A,A50,489366,Staff,21,0,25,4
1713350271720,CSE 8A,A51,489367,Staff,24,0,25,1
1713350272752,CSE 11,A01,489398,Cao; Yingjun,72,0,100,28
1713350273783,CSE 12,A01,489487,Staff,43,0,50,7
1713350274807,CSE 20,A01,489497,Staff,47,0,50,3
1713350275831,CSE 21,A01,489517,Braun; Oliver,42,0,50,8
1713350276856,CSE 101,A01,489524,Braun; Oliver,0,35,50,50
1713350277884,CSE 105,A01,512594,Jones; Miles E,72,0,100,28
1713350277884,CSE 105,B01,512598,Jones; Miles E,50,0,100,50
1713350278911,CSE 140,A01,489538,Staff,39,0,50,11
1713350279943,CSE 141,A01,489550,Eldon; John,67,0,100,33
1713350280970,CSE 141L,A01,489571,Eldon; John,65,0,100,35
1713350281998,CSE 151A,A01,489583,Solares; Edwin A,139,0,200,61
1713350283025,CSE 175,A01,510886,Kumar; Rakesh,30,0,30,0
1713350284058,CSE 190,A00,516828,Dubnov; Shlomo,37,0,49,12
1713350285089,DOC 100D,A00,489667,Pass; Natalye Joann,19,0,25,6
1713350286121,DSC 10,A01,624268,Staff,72,0,75,3
1713350287149,DSC 20,A01,624476,Staff,50,0,50,0
1713350288175,DSC 40A,A01,624608,Staff,39,0,40,1
1713350289200,DSGN 1,A01,489179,Rill; Bryan,32,0,50,18
1713350290235,ECE 17,A01,490489,Sahay; Rajeev,18,0,30,12
1713350291260,ECE 65,A50,490492,Staff,11,0,20,9
1713350291260,ECE 65,A51,490493,Staff,18,0,20,2
1713350292287,ECON 1,A01,489715,Famulari; Melissa,67,0,70,3
1713350293313,ECON 2,A01,489717,Levkoff; Steven B.,67,0,70,3
1713350294339,ECON 3,A01,489948,Staff,70,0,70,0
1713350296392,ECON 5,A01,490103,Staff,27,0,30,3
1713350296392,ECON 5,B01,626281,Dai; Yinlin,45,0,45,0
1713350297418,ECON 100A,A01,490127,Famulari; Melissa,62,0,70,8
1713350298442,ECON 100B,A01,490129,Staff,64,0,70,6
1713350299525,ECON 109,A01,490187,Shishkin; Denis,27,0,35,8
1713350300558,ECON 110A,A01,490190,Levkoff; Steven B.,59,0,70,11
1713350301583,ECON 120A,A01,490245,Dai; Yinlin,59,0,70,11
1713350302610,ECON 120B,A01,490247,Nieto-Barthaburu; Augusto,40,0,70,30
1713350303637,ECON 120C,A01,490253,Sun; Yixiao,30,0,35,5
1713350303637,ECON 120C,B01,490255,Sun; Yixiao,34,0,35,1
1713350304663,ECON 129,A00,490256,Eckert; Fabian Paul,22,0,35,13
1713350305687,ECON 131,A00,490257,Nieto-Barthaburu; Augusto,0,6,35,35
1713350306720,ECON 138,A00,490258,Bharadwaj; Prashant,13,0,35,22
1713350306720,ECON 138,B00,490259,Bharadwaj; Prashant,15,0,35,20
1713350307746,ECON 159,A00,490260,Hendrickson; Gerald M.,0,9,0,0
1713350308780,ECON 178,A01,553995,Zhu; Ying,24,0,35,11
1713350309813,EDS 40,A01,512576,Black; Alison Michelle,20,0,20,0
1713350310839,EDS 107,A01,515848,Staff,30,0,30,0
1713350311865,EDS 110R,A01,490262,Staff,26,0,30,4
1713350312892,EDS 112,A01,490264,Chapman; Thandeka K,40,0,50,10
1713350313919,EDS 113,A00,490266,Staff,25,0,30,5
1713350314947,EDS 118,A00,490267,Warstadt; Melissa Fawn,18,0,30,12
1713350315971,EDS 124BR,A00,490268,Eguchi; Emi,4,0,25,21
1713350315971,EDS 124BR,B00,490269,Eguchi; Emi,23,0,25,2
1713350316997,EDS 126,A01,490271,Jones; Makeba,43,0,50,7
1713350318025,EDS 135,A01,490316,Staff,19,0,20,1
1713350319060,ENVR 142GS,A00,519514,Chang; Edmond Yi-Teh,26,0,28,2
1713350320086,ETHN 103,A00,490504,Staff,24,0,36,12
1713350321116,ETHN 103A,A00,490505,Man; Simeon S,3,0,9,6
1713350322147,ETHN 109,A00,490506,Staff,28,0,30,2
1713350323174,ETHN 118,A00,490507,Staff,35,0,36,1
1713350324202,ETHN 119,A00,490508,Staff,32,0,36,4
1713350325228,ETHN 121R,A00,490518,Choi; Esther Min,21,0,36,15
1713350326252,ETHN 127,A00,490528,Staff,14,0,15,1
1713350327279,ETHN 139,A00,490573,Staff,10,0,10,0
1713350328303,ETHN 150,A00,490575,Staff,15,0,15,0
1713350329332,GLBH 20,A00,491705,Elwardani; Nile Regina,38,0,40,2
1713350330359,GLBH 101,A00,491706,Staff,20,0,20,0
1713350331386,GLBH 111,A01,491708,Burgos; Jose L.,15,0,15,0
1713350332414,GLBH 146,A00,491709,Staff,8,0,20,12
1713350333440,GLBH 148,A00,491710,Olivas Hernandez; Olga Lid,10,0,20,10
1713350334471,GLBH 150,A00,491711,Sloane; Julia Kathryn,19,0,20,1
1713350335496,HIEA 131,A00,491760,Staff,28,0,32,4
1713350336524,HIEA 153,A00,491762,Staff,28,0,30,2
1713350337549,HIEU 124,A00,491811,Staff,26,0,32,6
1713350338576,HIEU 124GS,A00,491812,Markman; Kristina,27,0,28,1
1713350339607,HIEU 147,A00,491813,Staff,30,0,32,2
1713350340636,HIEU 149GS,A00,491816,Caldwell; Michael Alan,28,0,28,0
1713350341668,HILD 2C,A01,491713,Hendrickson; Gerald M.,26,0,30,4
1713350342698,HILD 7B,A01,491715,Kwak; Nancy,0,3,30,30
1713350343723,HILD 10,A01,491717,Staff,9,0,20,11
1713350344751,HILD 30GS,A00,491719,Edington; Claire Ellen,23,0,28,5
1713350345777,HINE 109,A00,491818,Shafir; Nir,26,0,32,6
1713350346803,HINE 128,A00,491821,Shafir; Nir,30,0,32,2
1713350347829,HISC 117,A00,491830,Staff,27,0,32,5
1713350348861,HIUS 103,A00,491834,Man; Simeon S,14,0,23,9
1713350349890,HIUS 108B,A00,491835,Staff,27,0,30,3
1713350350913,HIUS 141,A00,491836,Hendrickson; Gerald M.,28,0,32,4
1713350351942,HIUS 149,A00,491839,Staff,24,0,32,8
1713350352968,HUM 3,A01,512617,Crum; Matthew Stephen,42,0,50,8
1713350352968,HUM 3,A02,512618,Crum; Matthew Stephen,48,0,50,2
1713350353992,HUM 3GS,A00,512663,Markman; Kristina,0,0,0,1
1713350353992,HUM 3GS,B00,512664,Staff,0,0,0,0
1713350355025,HUM 4,A01,512620,West; Geoffrey Scott,22,0,50,28
1713350356056,HUM 4GS,A00,512666,Lyon; Antony J.,0,0,0,5
1713350357086,HUM 4R,A01,512625,Watkins; Eric,49,0,50,1
1713350358112,HUM 5,A01,512649,Zavodny; Tatiana Sophia,20,0,50,30
1713350358112,HUM 5,B01,512661,Zroka; Ryan Edward,48,0,50,2
1713350359142,INTL 190,A00,490577,Segui; Alan S,0,0,0,5
1713350360171,JAPN 20AR,A01,491267,Ross; Kayoko F,7,0,20,13
1713350361196,JAPN 180,A00,491285,Berman; Michael David,33,0,40,7
1713350362224,LATI 50,A01,502536,Kokinis; Troy Andreas,16,0,22,6
1713350362224,LATI 50,A02,502551,Kokinis; Troy Andreas,22,0,22,0
1713350362224,LATI 50,A03,502650,Kokinis; Troy Andreas,22,0,22,0
1713350362224,LATI 50,A04,502909,Kokinis; Troy Andreas,21,0,22,1
1713350363250,LATI 160,A01,502920,Kokinis; Troy Andreas,30,0,30,0
1713350364283,LIFR 1A,A00,490494,Van Moer; Vinciane G,17,0,20,3
1713350365308,LIFR 1AX,A00,490495,Van Moer; Vinciane G,17,0,20,3
1713350366334,LIFR 1B,A00,490496,Van Moer; Vinciane G,17,0,20,3
1713350367364,LIFR 1BX,A00,490497,Van Moer; Vinciane G,17,0,20,3
1713350368389,LIGN 8,A00,505198,McIntosh; Justin Daniel,134,0,150,16
1713350369416,LIGN 9GS,A00,491239,Lott; Margaret S.,18,0,20,2
1713350370446,LIGN 101,A01,505200,McIntosh; Justin Daniel,22,0,30,8
1713350371475,LIGN 120,A01,491244,Staff,22,0,30,8
1713350372503,LIGN 149GS,A00,491245,Lott; Margaret S.,18,0,20,2
1713350373531,LIGN 170,A00,491247,Staff,22,0,30,8
1713350374556,LISP 1D,A00,490498,Munoz Sanchez; Alicia,8,0,14,6
1713350374556,LISP 1D,B00,490499,Munoz Sanchez; Alicia,4,0,14,10
1713350374556,LISP 1D,C00,490500,Munoz Sanchez; Alicia,7,0,14,7
1713350374556,LISP 1D,D00,490501,Munoz Sanchez; Alicia,10,0,14,4
1713350375586,LISP 1DX,A00,490502,Munoz Sanchez; Alicia,11,0,28,17
1713350375586,LISP 1DX,B00,490503,Munoz Sanchez; Alicia,16,0,28,12
1713350377637,LTAM 110,A00,491847,Staff,22,0,25,3
1713350378667,LTCS 119,A00,491848,Staff,11,0,15,4
1713350379699,LTCS 130,A00,491849,Staff,24,0,25,1
1713350381759,LTEA 120C,A00,491852,Staff,32,0,40,8
1713350382786,LTEN 130GS,A00,491853,Lyon; Antony J.,23,0,28,5
1713350383809,LTEN 148,A00,491855,Staff,23,0,25,2
1713350384837,LTEN 159,A00,491856,Staff,20,0,25,5
1713350385863,LTEN 180,A00,491857,Staff,8,0,15,7
1713350387918,LTSP 123GS,A00,505928,Bessett; Ryan Matthew,24,0,28,4
1713350388943,LTSP 174GS,A00,506037,Bessett; Ryan Matthew,24,0,28,4
1713350390997,LTWR 102,A00,491861,Staff,9,0,15,6
1713350392027,LTWR 106,A00,491862,Staff,8,0,15,7
1713350393055,MAE 11,A00,490930,Bahadori; Mohammad Yousef,94,0,100,6
1713350394080,MAE 30A,A00,490931,Qi; Huihui,37,0,40,3
1713350395113,MAE 101A,A00,491036,Sadeghizadeh; Zahra,91,0,100,9
1713350396139,MAE 101C,A00,491037,Seshadri; Kalyanasundaram,63,0,100,37
1713350397167,MAE 113,A00,491040,Seshadri; Kalyanasundaram,64,0,80,16
1713350398199,MAE 131A,A00,491041,Ghazinejad; Maziar,37,0,40,3
1713350399226,MAE 142,A00,491053,Staff,39,0,40,1
1713350400253,MAE 143A,A00,491054,Staff,29,0,50,21
1713350401280,MAE 150,A00,491092,Truong; Phuong Thi Ngoc,23,0,35,12
1713350402308,MATH 3C,A01,494031,Pardo Guerra; Sebastian,30,0,30,0
1713350402308,MATH 3C,A02,494032,Pardo Guerra; Sebastian,29,0,30,1
1713350403395,MATH 10A,A01,494034,Staff,27,0,30,3
1713350403395,MATH 10A,A02,494035,Staff,28,0,30,2
1713350403395,MATH 10A,B01,494037,Staff,27,0,30,3
1713350403395,MATH 10A,B02,494038,Staff,29,0,30,1
1713350404425,MATH 10B,A01,494040,Habib; Yousaf,22,0,30,8
1713350404425,MATH 10B,A02,494041,Habib; Yousaf,28,0,30,2
1713350404425,MATH 10B,A03,494042,Habib; Yousaf,29,0,30,1
1713350404425,MATH 10B,A04,494043,Habib; Yousaf,30,0,30,0
1713350404425,MATH 10B,B01,494045,Habib; Yousaf,25,0,30,5
1713350404425,MATH 10B,B02,494046,Habib; Yousaf,30,0,30,0
1713350404425,MATH 10B,B03,494047,Habib; Yousaf,30,0,30,0
1713350404425,MATH 10B,B04,494048,Habib; Yousaf,30,0,30,0
1713350405455,MATH 18,A01,494050,Kemp; Todd Aahron,25,0,30,5
1713350405455,MATH 18,A02,494051,Kemp; Todd Aahron,29,0,30,1
1713350405455,MATH 18,B01,494054,Kemp; Todd Aahron,25,0,30,5
1713350405455,MATH 18,B02,494055,Kemp; Todd Aahron,29,0,30,1
1713350406487,MATH 20A,A01,494059,Suk; Andrew Hoon,30,0,30,0
1713350407514,MATH 20B,A01,494061,Briones; Jor-el Thomas Caparas,33,0,35,2
1713350407514,MATH 20B,B01,494063,Bach; Quang Tran,34,0,35,1
1713350408544,MATH 20C,A01,494065,Staff,28,0,30,2
1713350408544,MATH 20C,A02,494066,Staff,30,0,30,0
1713350408544,MATH 20C,A03,494067,Staff,30,0,30,0
1713350408544,MATH 20C,A04,494068,Staff,30,0,30,0
1713350408544,MATH 20C,B01,494070,Zhang; Ming,23,0,30,7
1713350408544,MATH 20C,B02,494071,Zhang; Ming,27,0,30,3
1713350408544,MATH 20C,B03,494072,Zhang; Ming,29,0,30,1
1713350408544,MATH 20C,B04,494073,Zhang; Ming,29,0,30,1
1713350409569,MATH 20D,A01,494075,Staff,22,0,30,8
1713350409569,MATH 20D,A02,494076,Staff,29,0,30,1
1713350410595,MATH 20E,A01,494079,Staff,24,0,30,6
1713350410595,MATH 20E,A02,494080,Staff,26,0,30,4
1713350410595,MATH 20E,B01,494082,Staff,25,0,30,5
1713350410595,MATH 20E,B02,494083,Staff,25,0,30,5
1713350411621,MATH 103A,A01,494085,Aliabadi Sr.; Mohsen,12,0,30,18
1713350411621,MATH 103A,A02,494086,Aliabadi Sr.; Mohsen,28,0,30,2
1713350411621,MATH 103A,B01,494088,Aliabadi Sr.; Mohsen,19,0,30,11
1713350411621,MATH 103A,B02,494089,Aliabadi Sr.; Mohsen,27,0,30,3
1713350412655,MATH 109,A01,494091,Staff,30,0,30,0
1713350412655,MATH 109,A02,494092,Staff,29,0,30,1
1713350412655,MATH 109,B01,494094,Staff,27,0,30,3
1713350412655,MATH 109,B02,494095,Staff,29,0,30,1
1713350413690,MATH 142A,A01,494097,Chow; Bennett,13,0,30,17
1713350413690,MATH 142A,A02,494098,Chow; Bennett,23,0,30,7
1713350413690,MATH 142A,B01,494100,Chow; Bennett,19,0,30,11
1713350413690,MATH 142A,B02,494101,Chow; Bennett,29,0,30,1
1713350415750,MATH 168A,A01,516677,Dumitriu; Ioana,16,0,35,19
1713350416779,MATH 170A,A01,516679,Dumitriu; Ioana,18,0,30,12
1713350416779,MATH 170A,A02,516680,Dumitriu; Ioana,28,0,30,2
1713350417804,MATH 193A,A01,494107,Staff,12,0,30,18
1713350417804,MATH 193A,A02,494108,Staff,18,0,30,12
1713350417804,MATH 193A,A03,494109,Staff,29,0,30,1
1713350417804,MATH 193A,A04,494110,Staff,22,0,30,8
1713350420896,MGT 16,A00,491930,McKay; Michael J,92,0,98,6
1713350421928,MGT 18,A00,491992,McKay; Michael J,96,0,98,2
1713350422956,MGT 71,A00,492003,Staff,63,0,98,35
1713350423987,MGT 103,A00,505209,Eberhard; Craig A,80,0,98,18
1713350425016,MGT 131A,A00,505210,Anderson; John Charles,89,0,98,9
1713350427067,MGT 153,A00,492077,Perols; Johan Lars,15,0,90,75
1713350430144,MGT 164,A00,492222,McKay; Mary A,91,0,98,7
1713350431180,MGT 172,A00,492245,Staff,59,0,60,1
1713350431180,MGT 172,B00,505526,Hedges; Kathleen,65,0,98,33
1713350432211,MGT 181,A00,505669,Dunn; Louis Jean,78,0,98,20
1713350433247,MMW 14,A01,494399,Staff,15,0,28,13
1713350433247,MMW 14,A02,494400,Staff,25,0,28,3
1713350433247,MMW 14,A03,494401,Staff,28,0,28,0
1713350433247,MMW 14,A04,494402,Staff,28,0,28,0
1713350433247,MMW 14,B01,494404,Carreras; Maria Victoria,8,0,28,20
1713350433247,MMW 14,B02,494405,Carreras; Maria Victoria,25,0,28,3
1713350433247,MMW 14,B03,494406,Carreras; Maria Victoria,27,0,28,1
1713350433247,MMW 14,B04,494407,Carreras; Maria Victoria,28,0,28,0
1713350434278,MMW 14GS,A00,506250,Chang; Edmond Yi-Teh,0,0,0,0
1713350435306,MMW 121R,A01,494415,Adamiak; Patrick John,9,0,28,19
1713350435306,MMW 121R,A02,494416,Adamiak; Patrick John,24,0,28,4
1713350436330,MUS 1A,A01,494113,Staff,12,0,25,13
1713350436330,MUS 1A,A02,494114,Staff,24,0,25,1
1713350437359,MUS 4,A01,494116,Staff,23,0,25,2
1713350437359,MUS 4,A02,494117,Staff,22,0,25,3
1713350438390,MUS 5R,A01,494236,Dubnov; Shlomo,4,0,25,21
1713350438390,MUS 5R,A02,494237,Dubnov; Shlomo,25,0,25,0
1713350439419,MUS 6,A01,494122,Staff,9,0,25,16
1713350439419,MUS 6,A02,494123,Staff,23,0,25,2
1713350440444,MUS 7,A01,494125,Staff,16,0,25,9
1713350440444,MUS 7,A02,494126,Staff,24,0,25,1
1713350441470,MUS 11,A01,494128,Staff,23,0,25,2
1713350441470,MUS 11,A02,494129,Staff,24,0,25,1
1713350442493,MUS 13,A01,494131,Staff,25,0,25,0
1713350442493,MUS 13,A02,494132,Staff,25,0,25,0
1713350443519,MUS 15,A01,494134,Staff,16,0,25,9
1713350443519,MUS 15,A02,494135,Staff,25,0,25,0
1713350443519,MUS 15,B01,494137,Staff,24,0,25,1
1713350444545,MUS 80,A00,494232,Staff,24,0,25,1
1713350444545,MUS 80,B00,494233,Staff,25,0,25,0
1713350444545,MUS 80,C00,494234,Staff,23,0,25,2
1713350445569,MUS 95C,A00,494141,Staff,69,0,75,6
1713350446593,MUS 114,A00,494142,Staff,39,0,50,11
1713350447628,NANO 15,A01,490636,Drews; Aaron,7,0,7,0
1713350448660,PHIL 1,A00,490578,Grush; Rick Scott,49,0,50,1
1713350449692,PHIL 10,A01,490580,Grush; Rick Scott,33,0,35,2
1713350449692,PHIL 10,A02,490586,Grush; Rick Scott,32,0,35,3
1713350450722,PHIL 27,A01,490591,Staff,22,0,25,3
1713350450722,PHIL 27,A02,490592,Staff,25,0,25,0
1713350450722,PHIL 27,A03,490593,Staff,25,0,25,0
1713350450722,PHIL 27,A04,490598,Staff,25,0,25,0
1713350451751,PHIL 32,A01,490611,Staff,20,0,20,0
1713350451751,PHIL 32,A02,490618,Staff,20,0,20,0
1713350452780,PHIL 90,A00,490624,Staff,40,0,40,0
1713350453806,PHIL 136,A00,490627,Cohen; Jonathan David,37,0,40,3
1713350454831,PHIL 155,A00,490634,Staff,61,0,70,9
1713350455857,PHYS 1A,A00,491610,Staff,245,0,250,5
1713350456883,PHYS 1AL,001,491616,Tsai; Philbert S,27,0,30,3
1713350456883,PHYS 1AL,002,491618,Tsai; Philbert S,30,0,30,0
1713350457908,PHYS 1B,A00,491623,Staff,235,0,250,15
1713350458938,PHYS 1BL,001,491626,Tsai; Philbert S,18,0,30,12
1713350458938,PHYS 1BL,002,491628,Tsai; Philbert S,26,0,30,4
1713350459967,PHYS 1C,A00,491632,Staff,211,0,245,34
1713350460991,PHYS 1CL,001,491635,Tsai; Philbert S,2,0,30,28
1713350460991,PHYS 1CL,002,491643,Tsai; Philbert S,22,0,30,8
1713350462018,PHYS 2AR,A01,491651,Meyertholen; Andrew D.,44,0,50,6
1713350463043,PHYS 2B,A01,491659,Staff,105,0,115,10
1713350464069,PHYS 2BL,A01,491685,Staff,21,0,24,3
1713350464069,PHYS 2BL,A02,491700,Staff,21,0,24,3
1713350465094,PHYS 2C,A01,505161,Staff,101,0,115,14
1713350466120,PHYS 4A,A01,491704,Grinstein; Benjamin,99,0,100,1
1713350467147,POLI 5D,A01,494144,Staff,3,0,5,2
1713350467147,POLI 5D,B01,626283,Dai; Yinlin,5,0,5,0
1713350468172,POLI 12,A00,494145,Staff,43,0,45,2
1713350469198,POLI 13R,A00,494146,Forman; Fonna,45,0,50,5
1713350470227,POLI 27,A01,494148,Staff,54,0,60,6
1713350471250,POLI 30,A00,494149,Staff,49,0,50,1
1713350472276,POLI 100DA,A00,494150,Staff,20,0,25,5
1713350474327,POLI 100I,A00,494152,Staff,27,0,30,3
1713350475353,POLI 104B,A00,494153,Smith; Glenn Chatmas,53,0,55,2
1713350476377,POLI 104F,A00,494154,Staff,28,0,30,2
1713350477400,POLI 104I,A00,494155,Smith; Glenn Chatmas,29,0,30,1
1713350478430,POLI 110C,A00,494156,Ingham; Sean,23,0,25,2
1713350479457,POLI 117R,A00,494157,Forman; Fonna,5,0,20,15
1713350480483,POLI 118,A00,494158,Ingham; Sean,21,0,25,4
1713350481512,POLI 120H,A00,494159,Fisk; David Lee,39,0,45,6
1713350482608,POLI 131CR,A00,494160,Hoston; Germaine,35,0,45,10
1713350483641,POLI 133J,A00,494161,Staff,31,0,35,4
1713350484666,POLI 135,A00,494162,Fisk; David Lee,33,0,35,2
1713350485690,POLI 140A,A00,494164,Staff,18,0,30,12
1713350486720,POLI 142I,A00,494165,Staff,30,0,30,0
1713350487745,POLI 144D,A00,494166,Staff,22,0,25,3
1713350488771,POLI 151,A00,494167,Staff,30,0,30,0
1713350489796,POLI 153,A00,494168,Staff,33,0,35,2
1713350490821,POLI 160AA,A00,494169,Staff,33,0,40,7
1713350491853,POLI 162,A00,494170,Mignozzetti; Umberto,17,0,25,8
1713350492883,POLI 171,A00,494171,Mignozzetti; Umberto,18,0,25,7
1713350493910,PSYC 1,A00,494172,Staff,95,0,100,5
1713350494940,PSYC 2,A00,494173,Moranton; Nirelia Melbina-,33,0,50,17
1713350495971,PSYC 3,A00,494174,Staff,29,0,30,1
1713350496998,PSYC 6,A00,494175,Staff,17,0,20,3
1713350498023,PSYC 60,A01,494177,Staff,37,0,45,8
1713350499050,PSYC 70,A01,505724,Geller; Emma Harlan,42,0,45,3
1713350500081,PSYC 101,A00,494180,Heyman; Gail D.,83,0,100,17
1713350501108,PSYC 105,A00,494181,Geller; Emma Harlan,51,0,90,39
1713350502135,PSYC 106,A00,494182,Dobkins; Karen R.,26,0,45,19
1713350503161,PSYC 108,A00,494183,Adrian; Julia Anna,89,0,100,11
1713350504188,PSYC 114,A01,494185,Winkielman; Piotr,0,4,30,30
1713350505223,PSYC 122,A00,494186,Moranton; Nirelia Melbina-,27,0,50,23
1713350506251,PSYC 124,A00,494187,Chapman; Eddie Nathaniel,69,0,80,11
1713350507331,PSYC 131,A00,494188,Anagnostaras; Stephan,39,0,80,41
1713350508356,PSYC 144,A00,494189,Staff,1,1,50,49
1713350509386,PSYC 154,A00,494190,Lacefield; Katharine I,105,0,180,75
1713350510414,PSYC 162,A00,494191,Wixted; John T,70,0,100,30
1713350511439,PSYC 172,A00,494192,Gorman; Michael R.,36,0,45,9
1713350512465,PSYC 178,A00,494193,Glaser; Dale,32,0,45,13
1713350513495,PSYC 193,A00,505725,Chapman; Eddie Nathaniel,20,0,20,0
1713350514520,RELI 145GS,A00,519817,Rahimi; Babak,17,0,20,3
1713350515555,SE 101A,A01,490862,Chadha; Mayank,23,0,25,2
1713350516579,SE 101C,A01,490924,Krysl; Petr,15,0,20,5
1713350517606,SE 110A,A01,490928,Staff,19,0,20,1
1713350518633,SE 130A,A00,490929,Morrison; Machel Leigh,53,0,70,17
1713350519659,SIO 1,A01,519325,Staff,39,0,40,1
1713350520688,SIO 30,A01,519327,Staff,38,0,40,2
1713350521716,SIO 40,A00,519328,Staff,39,0,40,1
1713350522743,SIO 46GS,A00,519819,Cook; Geoffrey W,15,0,25,10
1713350523770,SIO 109R,A00,494197,Forman; Fonna,0,3,20,20
1713350524796,SIO 121GS,A00,519827,Cook; Geoffrey W,15,0,25,10
1713350525827,SIO 132,A01,519330,Staff,38,0,40,2
1713350526853,SIO 133,A01,519397,Staff,37,0,40,3
1713350527880,SIO 139,A00,519396,Kacev; David,29,0,40,11
1713350528914,SOCI 1,A01,494199,Thorpe; Charles Robert,21,0,30,9
1713350528914,SOCI 1,A02,494200,Thorpe; Charles Robert,30,0,30,0
1713350528914,SOCI 1,A03,494201,Thorpe; Charles Robert,29,0,30,1
1713350528914,SOCI 1,A04,494202,Thorpe; Charles Robert,29,0,30,1
1713350528914,SOCI 1,A05,494203,Thorpe; Charles Robert,29,0,30,1
1713350528914,SOCI 1,A06,494204,Thorpe; Charles Robert,30,0,30,0
1713350528914,SOCI 1,A07,494205,Thorpe; Charles Robert,28,0,30,2
1713350529940,SOCI 60,A01,494207,Staff,33,0,40,7
1713350529940,SOCI 60,A02,494208,Staff,39,0,40,1
1713350530967,SOCI 100,A01,494210,Payne; Christine Anna,25,0,30,5
1713350530967,SOCI 100,A02,494211,Payne; Christine Anna,26,0,30,4
1713350531999,SOCI 109M,A00,494212,Staff,20,0,20,0
1713350533023,SOCI 110,A00,494213,Staff,34,0,40,6
1713350535075,SOCI 118E,A00,494215,Ng; Kwai,37,0,40,3
1713350536105,SOCI 125,A00,494216,Calderon-Zaks; Michael Aar,39,0,45,6
1713350537131,SOCI 126,A01,494218,Jones; Makeba,3,0,5,2
1713350538159,SOCI 131,A00,494219,Thorpe; Charles Robert,25,0,30,5
1713350540250,SOCI 135,A00,494221,Payne; Christine Anna,28,0,50,22
1713350541278,SOCI 136E,A00,626690,Ruiz; Jonathan Joseph,24,0,25,1
1713350542307,SOCI 138GS,A00,494222,Navon; Daniel,23,0,28,5
1713350544362,SOCI 145,A00,494224,Staff,40,0,45,5
1713350545389,SOCI 153,A00,494225,Staff,28,0,30,2
1713350546415,SOCI 160E,A00,494226,Ng; Kwai,27,0,40,13
1713350547443,SOCI 180,A00,494227,Staff,29,0,30,1
1713350548471,SOCI 189GS,A00,494228,Ribas Norris; Janet Vanesa,11,0,11,0
1713350549498,SOCI 190GS,A00,553232,Ribas Norris; Janet Vanesa,11,0,11,0
1713350550527,SOMI 220,A00,627178,Schneid; Stephen David,30,0,30,0
1713350551556,SYN 2,001,490768,Staff,13,0,15,2
1713350551556,SYN 2,002,490769,Staff,14,0,15,1
1713350551556,SYN 2,004,490775,Staff,0,0,0,0
1713350551556,SYN 2,003,490774,Staff,0,0,0,0
1713350551556,SYN 2,005,490776,Staff,0,0,0,0
1713350552589,SYN 2R,001,490779,Staff,10,0,15,5
1713350552589,SYN 2R,002,514635,Staff,14,0,15,1
1713350553614,SYN 100,A01,490783,Staff,8,0,20,12
1713350553614,SYN 100,B01,490787,Staff,10,0,20,10
1713350553614,SYN 100,C01,490789,Staff,10,0,20,10
1713350554640,SYN 150,A00,490817,Staff,14,0,15,1
1713350554640,SYN 150,B00,514610,Staff,15,0,15,0
1713350555669,TDAC 1,A00,492753,Walsh; Kim C.,19,0,20,1
1713350555669,TDAC 1,B00,492754,Harting; Carla Kelso,18,0,20,2
1713350555669,TDAC 1,C00,513995,Salovey; Todd,15,0,20,5
1713350556696,TDAC 101,A00,492766,Harting; Carla Kelso,17,0,20,3
1713350557721,TDAC 102,A00,492768,Basso; Beatrice,19,0,20,1
1713350558748,TDDE 111,A00,492769,Staff,25,0,25,0
1713350559781,TDDE 131,A00,492770,Staff,15,0,15,0
1713350559781,TDDE 131,B00,492771,Staff,15,0,15,0
1713350560809,TDDE 131GS,A00,523716,Guirguis; Mark C,23,0,28,5
1713350561836,TDGE 1,A01,492756,Salovey; Todd,56,0,60,4
1713350562863,TDGE 5,A01,492758,Staff,23,0,25,2
1713350563898,TDGE 10,A00,492759,Fulton; Julia,203,0,220,17
1713350564931,TDGE 11,A00,492760,Castro; Robert Jess,198,0,200,2
1713350566983,TDGE 124,A00,492772,Fulton; Julia,180,0,220,40
1713350568015,TDGE 125,A00,492773,Meyer; Ursula,38,0,50,12
1713350568015,TDGE 125,B00,492774,Staff,49,0,50,1
1713350568015,TDGE 125,C00,523565,Staff,48,0,50,2
1713350569040,TDGE 125GS,A00,523580,Guirguis; Mark C,23,0,28,5
1713350570067,TDGE 127,A00,492775,Havis; Allan,33,0,50,17
1713350571090,TDHT 101,A00,492776,Staff,34,0,35,1
1713350572117,TDMV 1,A00,492762,Caligagan; Maria T.,29,0,30,1
1713350572117,TDMV 1,B00,492763,Arcidiacono; Kristin,26,0,30,4
1713350573144,TDMV 2,A00,492764,Weinberg; Sadie,27,0,30,3
1713350574175,TDMV 3,A00,492765,Mack; Kara Shanai',37,0,40,3
1713350575204,TDMV 138,A00,492777,Mack; Kara Shanai',32,0,40,8
1713350576233,TDMV 140,A00,492778,Lima; Paulo Henrique,40,0,40,0
1713350577257,TDMV 142,A00,492779,Caligagan; Maria T.,33,0,40,7
1713350577257,TDMV 142,B00,492780,Caligagan; Tony,37,0,40,3
1713350578283,TDMV 143,A00,492781,Fyall; Daunte Edward,39,0,40,1
1713350579313,USP 1,A01,492401,Kwak; Nancy,27,0,35,8
1713350580340,USP 2,A01,492453,Hinds; Juli Beth,35,0,35,0
1713350581364,USP 3,A01,492516,Staff,28,0,35,7
1713350582389,USP 4,A00,492522,McTague; Sarah,16,0,25,9
1713350583414,USP 100,A00,492523,Staff,32,0,35,3
1713350584440,USP 101,A00,492524,Staff,13,0,15,2
1713350585470,USP 105,A00,492525,Staff,21,0,25,4
1713350586495,USP 151,A00,492526,Shenkman; Michael Thomas,32,0,35,3
1713350587523,USP 170,A00,492545,Hinds; Juli Beth,32,0,35,3
1713350588551,USP 171GS,A00,492608,Bussell; Mirle Rabinowitz,24,0,28,4
1713350589577,USP 183GS,A00,492613,Peerson; Susan,24,0,28,4
1713350590604,VIS 30,A01,490693,Yoldas; Pinar,19,0,22,3
1713350590604,VIS 30,A02,490694,Yoldas; Pinar,18,0,22,4
1713350591629,VIS 83,A00,490695,Kester; Grant,63,0,75,12
1713350592658,VIS 105D,A00,490696,Staff,22,0,25,3
1713350593684,VIS 124CN,A00,490699,Rose; Jordan M,64,0,75,11
1713350594714,VIS 125GS,A00,511221,Williams; Alena J,21,0,22,1
1713350595747,VIS 128D,A00,490700,Staff,73,0,75,2
1713350596773,VIS 151,A01,490717,Staff,33,0,34,1
1713350596773,VIS 151,A02,490766,Staff,32,0,34,2
1713350597798,VIS 154GS,A00,511972,Williams; Alena J,21,0,22,1
1713350598829,VIS 160A,A00,490767,Stone; Patricia,7,0,10,3
1713350599861,WCWP 10A,A00,490638,Staff,14,0,15,1
1713350599861,WCWP 10A,B00,490640,Staff,15,0,15,0
1713350600888,WCWP 10B,A00,490641,Staff,0,0,0,0
1713350600888,WCWP 10B,B00,490642,Staff,14,0,15,1
1713350600888,WCWP 10B,C00,490644,Staff,13,0,15,2
1713350600888,WCWP 10B,D00,490647,Staff,0,0,0,0
1713350601916,WCWP 100,A00,490655,Staff,0,0,0,0
1713350601916,WCWP 100,B00,490687,Staff,10,0,15,5
1713350604041,ANAR 153,A00,487222,Braswell; Geoffrey E.,53,0,60,7
1713350605071,ANBI 134,A00,487223,Staff,5,0,20,15
1713350606096,ANBI 143GS,A00,487224,Noel; Geoffroy Pierre Jean,18,0,24,6
1713350607122,ANBI 144GS,A00,519548,Noel; Geoffroy Pierre Jean,18,0,24,6
1713350608152,ANSC 101,A00,487225,Staff,17,0,20,3
1713350609185,ANSC 125,A00,487227,Brenner; Suzanne A,38,0,40,2
1713350611292,ANSC 146,A00,487229,Staff,35,0,40,5
1713350612319,ANSC 148,A00,487230,Olivas Hernandez; Olga Lid,39,0,40,1
1713350613352,ANSC 150,A00,504165,Sloane; Julia Kathryn,18,0,20,2
1713350614377,ANSC 180,A00,487232,Staff,14,0,15,1
1713350615403,ANSC 188,A00,627155,Staff,37,0,40,3
1713350616428,ANTH 5,A00,519529,Semendeferi; Ekaterini,15,0,15,0
1713350617458,ANTH 10,A00,487219,Staff,58,0,60,2
1713350618484,ANTH 23,A01,487221,Staff,17,0,20,3
1713350619511,ANTH 102,A00,487233,Wilder; Linnea Lorene,49,0,60,11
1713350620541,ANTH 103,A00,487234,Varma; Saiba,54,0,60,6
1713350621569,ANTH 105,A00,487235,Stewart; Alexander B,54,0,60,6
1713350622595,BENG 100,A01,516685,Taylor Amos; Alyssa C,25,0,30,5
1713350623623,BIBC 102,A01,491316,Flagg; Matthew Paul,3,0,88,85
1713350623623,BIBC 102,A02,491366,Flagg; Matthew Paul,78,0,88,10
1713350624651,BIBC 103,A01,491486,Boumechache; Miyyada,16,0,24,8
1713350624651,BIBC 103,A02,491487,Boumechache; Miyyada,24,0,24,0
1713350625687,BICD 100,A01,516882,Staff,72,0,75,3
1713350625687,BICD 100,A02,516890,Staff,69,0,75,6
1713350626713,BICD 102GS,A00,491488,Lo; Stanley M.,26,0,28,2
1713350627741,BIEB 136GS,A00,516940,Holway; David A. & Shurin; Jonathan,18,0,24,6
1713350628766,BIEB 137GS,A01,517034,Holway; David A. & Shurin; Jonathan,18,0,24,6
1713350629796,BIEB 138GS,A01,491492,Pirino; Giorgia,21,0,28,7
1713350630823,BILD 1,A01,491296,Staff,60,0,63,3
1713350630823,BILD 1,A02,491297,Staff,63,0,63,0
1713350631850,BILD 4,A01,517099,Gonzalez Gamboa; Ivonne,21,0,24,3
1713350631850,BILD 4,A02,517100,Gonzalez Gamboa; Ivonne,24,0,24,0
1713350632876,BILD 60GS,A00,491309,Lo; Stanley M.,26,0,28,2
1713350633906,BIMM 100,A01,517136,Staff,82,0,100,18
1713350634932,BIMM 110,A01,517182,Staff,52,0,100,48
1713350635959,BIMM 120,A01,517228,Pickett; Brooke Elizabeth,28,0,63,35
1713350635959,BIMM 120,A02,517240,Pickett; Brooke Elizabeth,44,0,63,19
1713350636990,BIMM 132GS,A01,491498,Pirino; Giorgia,21,0,28,7
1713350638021,BIMM 143,A01,491589,Bozinovic; Goran,12,0,40,28
1713350639052,BIPN 100,A01,491594,Armour; Jon Christopher,83,0,100,17
1713350640079,BIPN 140,A01,491602,Marino; Marc J,23,0,50,27
1713350642131,CAT 125,A00,515973,Staff,18,0,20,2
1713350643161,CAT 125GS,A00,515974,Rahimi; Babak,16,0,20,4
1713350644192,CAT 125R,A00,515980,Staff,12,0,20,8
1713350644192,CAT 125R,B00,515981,Tosun; Adriana,19,0,20,1
1713350644192,CAT 125R,C00,515987,Hyland; Tina Mae,0,5,20,20
1713350644192,CAT 125R,D00,515988,Bronstein; Phoebe Malan,16,0,20,4
1713350645226,CENG 15,A01,488699,Drews; Aaron,25,0,25,0
1713350646259,CENG 100,A00,505196,Opatkiewicz; Justin Paul,25,0,25,0
1713350647287,CGS 2A,A01,489598,Staff,32,0,35,3
1713350648314,CGS 112,A00,489599,Staff,15,0,15,0
1713350649340,CGS 119,A00,489603,Staff,10,0,10,0
1713350650369,CGS 120,A00,489604,Staff,13,0,15,2
1713350651395,CGS 150,A00,489607,Staff,15,0,15,0
1713350652422,CHEM 6A,A01,488715,Staff,97,0,100,3
1713350653453,CHEM 6B,A01,488719,Piercy; Marc Anthony,99,0,100,1
1713350654484,CHEM 6C,A01,488723,Albizati; Kim F.,92,0,100,8
1713350655512,CHEM 7L,A01,488728,Schurmeier; Kimberly,18,0,24,6
1713350655512,CHEM 7L,A02,488730,Schurmeier; Kimberly,23,0,24,1
1713350655512,CHEM 7L,A03,488734,Schurmeier; Kimberly,20,0,24,4
1713350655512,CHEM 7L,A04,488763,Schurmeier; Kimberly,23,0,24,1
1713350655512,CHEM 7L,B01,488798,Schurmeier; Kimberly,16,0,24,8
1713350655512,CHEM 7L,B02,488801,Schurmeier; Kimberly,22,0,24,2
1713350655512,CHEM 7L,B03,488808,Schurmeier; Kimberly,22,0,24,2
1713350655512,CHEM 7L,B04,488811,Schurmeier; Kimberly,24,0,24,0
1713350656537,CHEM 11,A01,488897,Stallings; Dontarie M,94,0,100,6
1713350657568,CHEM 40A,A01,488913,Albizati; Kim F.,83,0,100,17
1713350658594,CHEM 40B,A01,488920,Weizman; Haim,42,0,50,8
1713350658594,CHEM 40B,A02,488938,Weizman; Haim,43,0,50,7
1713350659621,CHEM 41A,A01,489029,Klosterman; Jeremy K,57,0,60,3
1713350660656,CHEM 41C,A01,500436,Tor; Yitzhak,54,0,60,6
1713350661684,CHEM 43A,A01,500426,Weizman; Haim,0,1,24,24
1713350661684,CHEM 43A,A02,500430,Weizman; Haim,6,0,24,18
1713350661684,CHEM 43A,B01,514041,Klosterman; Jeremy K,14,0,24,10
1713350661684,CHEM 43A,B02,514047,Klosterman; Jeremy K,23,0,24,1
1713350662716,CHEM 108,A01,489140,Jennings; Patricia A.,5,0,24,19
1713350662716,CHEM 108,A02,489142,Jennings; Patricia A.,14,0,24,10
1713350663748,CHEM 114A,A01,489147,Stallings; Dontarie M,65,0,100,35
1713350664773,CHIN 169A,A00,489171,Wang; Xiao,19,0,20,1
1713350666837,COGS 3,A01,518827,Boyle; Mary E. T.,25,0,40,15
1713350667863,COGS 11,A01,489175,Staff,27,0,30,3
1713350668889,COGS 14A,A01,518829,Staff,50,0,60,10
1713350669914,COGS 14B,A01,489177,Hoffman; Drew Ellen,62,0,75,13
1713350670941,COGS 100,A01,489181,Allen; Michael Gordon,62,0,75,13
1713350671967,COGS 101A,A01,489183,Staff,45,0,60,15
1713350672997,COGS 101B,A01,489185,Allen; Michael Gordon,6,0,30,24
1713350674028,COGS 101C,A01,526786,Staff,23,0,30,7
1713350676086,COGS 107A,A01,489189,Boyle; Mary E. T.,16,0,35,19
1713350677112,COGS 107B,A01,627144,Mooshagian; Eric Frederick,59,0,60,1
1713350678139,COGS 118A,A01,489191,Staff,0,46,40,40
1713350680195,COGS 171GS,A01,489194,Pineda; Jaime A,19,0,28,9
1713350681225,COGS 172,A01,489196,Staff,1,0,30,29
1713350682253,COGS 174GS,A01,489264,Pineda; Jaime A,19,0,28,9
1713350683279,COGS 180,A01,627150,Staff,28,0,30,2
1713350684311,COGS 186,A01,489274,Staff,0,3,30,30
1713350685336,COMM 10,A01,489276,Staff,23,0,25,2
1713350685336,COMM 10,A02,489303,Staff,23,0,25,2
1713350686361,COMM 100A,A01,489312,Staff,14,0,25,11
1713350686361,COMM 100A,A02,489313,Staff,24,0,25,1
1713350687390,COMM 106T,A00,512540,Staff,33,0,35,2
1713350688419,COMM 107,A00,489347,Staff,27,0,35,8
1713350689449,COMM 109P,A00,489358,Staff,31,0,35,4
1713350690479,COMM 132,A00,489361,McKenna; Denise,27,0,30,3
1713350691504,COMM 146,A00,489362,Halm; Gavin Patrick,25,0,30,5
1713350692531,COMM 190,A00,489363,Abuelhiga; Soraya Jill,17,0,23,6
1713350693559,CSE 8A,A50,489366,Staff,21,0,25,4
1713350693559,CSE 8A,A51,489367,Staff,24,0,25,1
1713350694583,CSE 11,A01,489398,Cao; Yingjun,72,0,100,28
1713350695611,CSE 12,A01,489487,Staff,43,0,50,7
1713350696641,CSE 20,A01,489497,Staff,47,0,50,3
1713350697666,CSE 21,A01,489517,Braun; Oliver,42,0,50,8
1713350698696,CSE 101,A01,489524,Braun; Oliver,0,35,50,50
1713350699728,CSE 105,A01,512594,Jones; Miles E,72,0,100,28
1713350699728,CSE 105,B01,512598,Jones; Miles E,50,0,100,50
1713350700755,CSE 140,A01,489538,Staff,39,0,50,11
1713350701784,CSE 141,A01,489550,Eldon; John,67,0,100,33
1713350702813,CSE 141L,A01,489571,Eldon; John,65,0,100,35
1713350703838,CSE 151A,A01,489583,Solares; Edwin A,139,0,200,61
1713350704870,CSE 175,A01,510886,Kumar; Rakesh,30,0,30,0
1713350705895,CSE 190,A00,516828,Dubnov; Shlomo,37,0,49,12
1713350706923,DOC 100D,A00,489667,Pass; Natalye Joann,19,0,25,6
1713350707956,DSC 10,A01,624268,Staff,72,0,75,3
1713350708985,DSC 20,A01,624476,Staff,50,0,50,0
1713350710011,DSC 40A,A01,624608,Staff,39,0,40,1
1713350711039,DSGN 1,A01,489179,Rill; Bryan,32,0,50,18
1713350712067,ECE 17,A01,490489,Sahay; Rajeev,18,0,30,12
1713350713097,ECE 65,A50,490492,Staff,11,0,20,9
1713350713097,ECE 65,A51,490493,Staff,18,0,20,2
1713350714129,ECON 1,A01,489715,Famulari; Melissa,67,0,70,3
1713350715211,ECON 2,A01,489717,Levkoff; Steven B.,67,0,70,3
1713350716238,ECON 3,A01,489948,Staff,69,0,70,1
1713350718293,ECON 5,A01,490103,Staff,27,0,30,3
1713350718293,ECON 5,B01,626281,Dai; Yinlin,45,0,45,0
1713350719319,ECON 100A,A01,490127,Famulari; Melissa,62,0,70,8
1713350720343,ECON 100B,A01,490129,Staff,64,0,70,6
1713350721369,ECON 109,A01,490187,Shishkin; Denis,27,0,35,8
1713350722393,ECON 110A,A01,490190,Levkoff; Steven B.,59,0,70,11
1713350723425,ECON 120A,A01,490245,Dai; Yinlin,59,0,70,11
1713350724450,ECON 120B,A01,490247,Nieto-Barthaburu; Augusto,40,0,70,30
1713350725476,ECON 120C,A01,490253,Sun; Yixiao,30,0,35,5
1713350725476,ECON 120C,B01,490255,Sun; Yixiao,34,0,35,1
1713350726501,ECON 129,A00,490256,Eckert; Fabian Paul,22,0,35,13
1713350727525,ECON 131,A00,490257,Nieto-Barthaburu; Augusto,0,6,35,35
1713350728558,ECON 138,A00,490258,Bharadwaj; Prashant,13,0,35,22
1713350728558,ECON 138,B00,490259,Bharadwaj; Prashant,15,0,35,20
1713350729583,ECON 159,A00,490260,Hendrickson; Gerald M.,0,9,0,0
1713350730615,ECON 178,A01,553995,Zhu; Ying,24,0,35,11
1713350731641,EDS 40,A01,512576,Black; Alison Michelle,20,0,20,0
1713350732670,EDS 107,A01,515848,Staff,30,0,30,0
1713350733701,EDS 110R,A01,490262,Staff,26,0,30,4
1713350734730,EDS 112,A01,490264,Chapman; Thandeka K,40,0,50,10
1713350735754,EDS 113,A00,490266,Staff,25,0,30,5
1713350736778,EDS 118,A00,490267,Warstadt; Melissa Fawn,18,0,30,12
1713350737810,EDS 124BR,A00,490268,Eguchi; Emi,4,0,25,21
1713350737810,EDS 124BR,B00,490269,Eguchi; Emi,23,0,25,2
1713350738840,EDS 126,A01,490271,Jones; Makeba,43,0,50,7
1713350739868,EDS 135,A01,490316,Staff,19,0,20,1
1713350740898,ENVR 142GS,A00,519514,Chang; Edmond Yi-Teh,26,0,28,2
1713350741929,ETHN 103,A00,490504,Staff,24,0,36,12
1713350742955,ETHN 103A,A00,490505,Man; Simeon S,3,0,9,6
1713350743980,ETHN 109,A00,490506,Staff,28,0,30,2
1713350745006,ETHN 118,A00,490507,Staff,35,0,36,1
1713350746036,ETHN 119,A00,490508,Staff,32,0,36,4
1713350747063,ETHN 121R,A00,490518,Choi; Esther Min,21,0,36,15
1713350748091,ETHN 127,A00,490528,Staff,14,0,15,1
1713350749115,ETHN 139,A00,490573,Staff,10,0,10,0
1713350750145,ETHN 150,A00,490575,Staff,15,0,15,0
1713350751179,GLBH 20,A00,491705,Elwardani; Nile Regina,38,0,40,2
1713350752207,GLBH 101,A00,491706,Staff,20,0,20,0
1713350753232,GLBH 111,A01,491708,Burgos; Jose L.,15,0,15,0
1713350754259,GLBH 146,A00,491709,Staff,8,0,20,12
1713350755287,GLBH 148,A00,491710,Olivas Hernandez; Olga Lid,10,0,20,10
1713350756319,GLBH 150,A00,491711,Sloane; Julia Kathryn,19,0,20,1
1713350757344,HIEA 131,A00,491760,Staff,28,0,32,4
1713350758369,HIEA 153,A00,491762,Staff,28,0,30,2
1713350759395,HIEU 124,A00,491811,Staff,26,0,32,6
1713350760427,HIEU 124GS,A00,491812,Markman; Kristina,27,0,28,1
1713350761459,HIEU 147,A00,491813,Staff,30,0,32,2
1713350762488,HIEU 149GS,A00,491816,Caldwell; Michael Alan,28,0,28,0
1713350763520,HILD 2C,A01,491713,Hendrickson; Gerald M.,26,0,30,4
1713350764552,HILD 7B,A01,491715,Kwak; Nancy,0,3,30,30
1713350765579,HILD 10,A01,491717,Staff,9,0,20,11
1713350766605,HILD 30GS,A00,491719,Edington; Claire Ellen,23,0,28,5
1713350767629,HINE 109,A00,491818,Shafir; Nir,26,0,32,6
1713350768659,HINE 128,A00,491821,Shafir; Nir,30,0,32,2
1713350769687,HISC 117,A00,491830,Staff,27,0,32,5
1713350770713,HIUS 103,A00,491834,Man; Simeon S,14,0,23,9
1713350771739,HIUS 108B,A00,491835,Staff,27,0,30,3
1713350772764,HIUS 141,A00,491836,Hendrickson; Gerald M.,28,0,32,4
1713350773792,HIUS 149,A00,491839,Staff,24,0,32,8
1713350774819,HUM 3,A01,512617,Crum; Matthew Stephen,42,0,50,8
1713350774819,HUM 3,A02,512618,Crum; Matthew Stephen,48,0,50,2
1713350775849,HUM 3GS,A00,512663,Markman; Kristina,0,0,0,1
1713350775849,HUM 3GS,B00,512664,Staff,0,0,0,0
1713350776880,HUM 4,A01,512620,West; Geoffrey Scott,22,0,50,28
1713350777905,HUM 4GS,A00,512666,Lyon; Antony J.,0,0,0,5
1713350778937,HUM 4R,A01,512625,Watkins; Eric,49,0,50,1
1713350779965,HUM 5,A01,512649,Zavodny; Tatiana Sophia,20,0,50,30
1713350779965,HUM 5,B01,512661,Zroka; Ryan Edward,48,0,50,2
1713350780992,INTL 190,A00,490577,Segui; Alan S,0,0,0,5
1713350782025,JAPN 20AR,A01,491267,Ross; Kayoko F,7,0,20,13
1713350783052,JAPN 180,A00,491285,Berman; Michael David,33,0,40,7
1713350784086,LATI 50,A01,502536,Kokinis; Troy Andreas,16,0,22,6
1713350784086,LATI 50,A02,502551,Kokinis; Troy Andreas,22,0,22,0
1713350784086,LATI 50,A03,502650,Kokinis; Troy Andreas,22,0,22,0
1713350784086,LATI 50,A04,502909,Kokinis; Troy Andreas,21,0,22,1
1713350785111,LATI 160,A01,502920,Kokinis; Troy Andreas,30,0,30,0
1713350786139,LIFR 1A,A00,490494,Van Moer; Vinciane G,17,0,20,3
1713350787164,LIFR 1AX,A00,490495,Van Moer; Vinciane G,17,0,20,3
1713350788190,LIFR 1B,A00,490496,Van Moer; Vinciane G,17,0,20,3
1713350789216,LIFR 1BX,A00,490497,Van Moer; Vinciane G,17,0,20,3
1713350790244,LIGN 8,A00,505198,McIntosh; Justin Daniel,134,0,150,16
1713350791269,LIGN 9GS,A00,491239,Lott; Margaret S.,18,0,20,2
1713350792301,LIGN 101,A01,505200,McIntosh; Justin Daniel,22,0,30,8
1713350793326,LIGN 120,A01,491244,Staff,22,0,30,8
1713350794355,LIGN 149GS,A00,491245,Lott; Margaret S.,18,0,20,2
1713350795380,LIGN 170,A00,491247,Staff,22,0,30,8
1713350796410,LISP 1D,A00,490498,Munoz Sanchez; Alicia,8,0,14,6
1713350796410,LISP 1D,B00,490499,Munoz Sanchez; Alicia,4,0,14,10
1713350796410,LISP 1D,C00,490500,Munoz Sanchez; Alicia,7,0,14,7
1713350796410,LISP 1D,D00,490501,Munoz Sanchez; Alicia,10,0,14,4
1713350797435,LISP 1DX,A00,490502,Munoz Sanchez; Alicia,11,0,28,17
1713350797435,LISP 1DX,B00,490503,Munoz Sanchez; Alicia,16,0,28,12
1713350799494,LTAM 110,A00,491847,Staff,22,0,25,3
1713350800519,LTCS 119,A00,491848,Staff,11,0,15,4
1713350801543,LTCS 130,A00,491849,Staff,24,0,25,1
1713350803597,LTEA 120C,A00,491852,Staff,32,0,40,8
1713350804623,LTEN 130GS,A00,491853,Lyon; Antony J.,23,0,28,5
1713350805647,LTEN 148,A00,491855,Staff,23,0,25,2
1713350806672,LTEN 159,A00,491856,Staff,20,0,25,5
1713350807697,LTEN 180,A00,491857,Staff,8,0,15,7
1713350809751,LTSP 123GS,A00,505928,Bessett; Ryan Matthew,24,0,28,4
1713350810776,LTSP 174GS,A00,506037,Bessett; Ryan Matthew,24,0,28,4
1713350812837,LTWR 102,A00,491861,Staff,9,0,15,6
1713350813867,LTWR 106,A00,491862,Staff,8,0,15,7
1713350814896,MAE 11,A00,490930,Bahadori; Mohammad Yousef,94,0,100,6
1713350815928,MAE 30A,A00,490931,Qi; Huihui,37,0,40,3
1713350816954,MAE 101A,A00,491036,Sadeghizadeh; Zahra,91,0,100,9
1713350818038,MAE 101C,A00,491037,Seshadri; Kalyanasundaram,63,0,100,37
1713350819119,MAE 113,A00,491040,Seshadri; Kalyanasundaram,64,0,80,16
1713350820146,MAE 131A,A00,491041,Ghazinejad; Maziar,37,0,40,3
1713350821169,MAE 142,A00,491053,Staff,39,0,40,1
1713350822195,MAE 143A,A00,491054,Staff,29,0,50,21
1713350823222,MAE 150,A00,491092,Truong; Phuong Thi Ngoc,23,0,35,12
1713350824255,MATH 3C,A01,494031,Pardo Guerra; Sebastian,30,0,30,0
1713350824255,MATH 3C,A02,494032,Pardo Guerra; Sebastian,29,0,30,1
1713350825284,MATH 10A,A01,494034,Staff,27,0,30,3
1713350825284,MATH 10A,A02,494035,Staff,28,0,30,2
1713350825284,MATH 10A,B01,494037,Staff,27,0,30,3
1713350825284,MATH 10A,B02,494038,Staff,29,0,30,1
1713350826322,MATH 10B,A01,494040,Habib; Yousaf,22,0,30,8
1713350826322,MATH 10B,A02,494041,Habib; Yousaf,28,0,30,2
1713350826322,MATH 10B,A03,494042,Habib; Yousaf,29,0,30,1
1713350826322,MATH 10B,A04,494043,Habib; Yousaf,30,0,30,0
1713350826322,MATH 10B,B01,494045,Habib; Yousaf,25,0,30,5
1713350826322,MATH 10B,B02,494046,Habib; Yousaf,30,0,30,0
1713350826322,MATH 10B,B03,494047,Habib; Yousaf,30,0,30,0
1713350826322,MATH 10B,B04,494048,Habib; Yousaf,30,0,30,0
1713350827350,MATH 18,A01,494050,Kemp; Todd Aahron,25,0,30,5
1713350827350,MATH 18,A02,494051,Kemp; Todd Aahron,29,0,30,1
1713350827350,MATH 18,B01,494054,Kemp; Todd Aahron,25,0,30,5
1713350827350,MATH 18,B02,494055,Kemp; Todd Aahron,29,0,30,1
1713350828380,MATH 20A,A01,494059,Suk; Andrew Hoon,30,0,30,0
1713350829404,MATH 20B,A01,494061,Briones; Jor-el Thomas Caparas,33,0,35,2
1713350829404,MATH 20B,B01,494063,Bach; Quang Tran,34,0,35,1
1713350830435,MATH 20C,A01,494065,Staff,28,0,30,2
1713350830435,MATH 20C,A02,494066,Staff,30,0,30,0
1713350830435,MATH 20C,A03,494067,Staff,30,0,30,0
1713350830435,MATH 20C,A04,494068,Staff,30,0,30,0
1713350830435,MATH 20C,B01,494070,Zhang; Ming,23,0,30,7
1713350830435,MATH 20C,B02,494071,Zhang; Ming,27,0,30,3
1713350830435,MATH 20C,B03,494072,Zhang; Ming,29,0,30,1
1713350830435,MATH 20C,B04,494073,Zhang; Ming,29,0,30,1
1713350831460,MATH 20D,A01,494075,Staff,22,0,30,8
1713350831460,MATH 20D,A02,494076,Staff,29,0,30,1
1713350832491,MATH 20E,A01,494079,Staff,24,0,30,6
1713350832491,MATH 20E,A02,494080,Staff,26,0,30,4
1713350832491,MATH 20E,B01,494082,Staff,25,0,30,5
1713350832491,MATH 20E,B02,494083,Staff,25,0,30,5
1713350833526,MATH 103A,A01,494085,Aliabadi Sr.; Mohsen,12,0,30,18
1713350833526,MATH 103A,A02,494086,Aliabadi Sr.; Mohsen,28,0,30,2
1713350833526,MATH 103A,B01,494088,Aliabadi Sr.; Mohsen,19,0,30,11
1713350833526,MATH 103A,B02,494089,Aliabadi Sr.; Mohsen,27,0,30,3
1713350834557,MATH 109,A01,494091,Staff,30,0,30,0
1713350834557,MATH 109,A02,494092,Staff,29,0,30,1
1713350834557,MATH 109,B01,494094,Staff,27,0,30,3
1713350834557,MATH 109,B02,494095,Staff,29,0,30,1
1713350835591,MATH 142A,A01,494097,Chow; Bennett,13,0,30,17
1713350835591,MATH 142A,A02,494098,Chow; Bennett,23,0,30,7
1713350835591,MATH 142A,B01,494100,Chow; Bennett,19,0,30,11
1713350835591,MATH 142A,B02,494101,Chow; Bennett,29,0,30,1
1713350837647,MATH 168A,A01,516677,Dumitriu; Ioana,16,0,35,19
1713350838672,MATH 170A,A01,516679,Dumitriu; Ioana,18,0,30,12
1713350838672,MATH 170A,A02,516680,Dumitriu; Ioana,28,0,30,2
1713350839700,MATH 193A,A01,494107,Staff,12,0,30,18
1713350839700,MATH 193A,A02,494108,Staff,18,0,30,12
1713350839700,MATH 193A,A03,494109,Staff,29,0,30,1
1713350839700,MATH 193A,A04,494110,Staff,22,0,30,8
1713350842787,MGT 16,A00,491930,McKay; Michael J,92,0,98,6
1713350843813,MGT 18,A00,491992,McKay; Michael J,96,0,98,2
1713350844844,MGT 71,A00,492003,Staff,63,0,98,35
1713350845875,MGT 103,A00,505209,Eberhard; Craig A,80,0,98,18
1713350846901,MGT 131A,A00,505210,Anderson; John Charles,89,0,98,9
1713350848965,MGT 153,A00,492077,Perols; Johan Lars,15,0,90,75
1713350852078,MGT 164,A00,492222,McKay; Mary A,91,0,98,7
1713350853113,MGT 172,A00,492245,Staff,59,0,60,1
1713350853113,MGT 172,B00,505526,Hedges; Kathleen,65,0,98,33
1713350854143,MGT 181,A00,505669,Dunn; Louis Jean,78,0,98,20
1713350855178,MMW 14,A01,494399,Staff,15,0,28,13
1713350855178,MMW 14,A02,494400,Staff,25,0,28,3
1713350855178,MMW 14,A03,494401,Staff,28,0,28,0
1713350855178,MMW 14,A04,494402,Staff,28,0,28,0
1713350855178,MMW 14,B01,494404,Carreras; Maria Victoria,8,0,28,20
1713350855178,MMW 14,B02,494405,Carreras; Maria Victoria,25,0,28,3
1713350855178,MMW 14,B03,494406,Carreras; Maria Victoria,27,0,28,1
1713350855178,MMW 14,B04,494407,Carreras; Maria Victoria,28,0,28,0
1713350856209,MMW 14GS,A00,506250,Chang; Edmond Yi-Teh,0,0,0,0
1713350857237,MMW 121R,A01,494415,Adamiak; Patrick John,9,0,28,19
1713350857237,MMW 121R,A02,494416,Adamiak; Patrick John,24,0,28,4
1713350858264,MUS 1A,A01,494113,Staff,12,0,25,13
1713350858264,MUS 1A,A02,494114,Staff,24,0,25,1
1713350859300,MUS 4,A01,494116,Staff,23,0,25,2
1713350859300,MUS 4,A02,494117,Staff,22,0,25,3
1713350860327,MUS 5R,A01,494236,Dubnov; Shlomo,4,0,25,21
1713350860327,MUS 5R,A02,494237,Dubnov; Shlomo,25,0,25,0
1713350861353,MUS 6,A01,494122,Staff,9,0,25,16
1713350861353,MUS 6,A02,494123,Staff,23,0,25,2
1713350862385,MUS 7,A01,494125,Staff,16,0,25,9
1713350862385,MUS 7,A02,494126,Staff,24,0,25,1
1713350863415,MUS 11,A01,494128,Staff,23,0,25,2
1713350863415,MUS 11,A02,494129,Staff,24,0,25,1
1713350864447,MUS 13,A01,494131,Staff,25,0,25,0
1713350864447,MUS 13,A02,494132,Staff,25,0,25,0
1713350865473,MUS 15,A01,494134,Staff,16,0,25,9
1713350865473,MUS 15,A02,494135,Staff,25,0,25,0
1713350865473,MUS 15,B01,494137,Staff,24,0,25,1
1713350866499,MUS 80,A00,494232,Staff,24,0,25,1
1713350866499,MUS 80,B00,494233,Staff,25,0,25,0
1713350866499,MUS 80,C00,494234,Staff,23,0,25,2
1713350867525,MUS 95C,A00,494141,Staff,69,0,75,6
1713350868553,MUS 114,A00,494142,Staff,39,0,50,11
1713350869580,NANO 15,A01,490636,Drews; Aaron,7,0,7,0
1713350870606,PHIL 1,A00,490578,Grush; Rick Scott,49,0,50,1
1713350871644,PHIL 10,A01,490580,Grush; Rick Scott,33,0,35,2
1713350871644,PHIL 10,A02,490586,Grush; Rick Scott,32,0,35,3
1713350872670,PHIL 27,A01,490591,Staff,22,0,25,3
1713350872670,PHIL 27,A02,490592,Staff,25,0,25,0
1713350872670,PHIL 27,A03,490593,Staff,25,0,25,0
1713350872670,PHIL 27,A04,490598,Staff,25,0,25,0
1713350873697,PHIL 32,A01,490611,Staff,20,0,20,0
1713350873697,PHIL 32,A02,490618,Staff,20,0,20,0
1713350874730,PHIL 90,A00,490624,Staff,40,0,40,0
1713350875757,PHIL 136,A00,490627,Cohen; Jonathan David,37,0,40,3
1713350876782,PHIL 155,A00,490634,Staff,61,0,70,9
1713350877810,PHYS 1A,A00,491610,Staff,245,0,250,5
1713350878837,PHYS 1AL,001,491616,Tsai; Philbert S,27,0,30,3
1713350878837,PHYS 1AL,002,491618,Tsai; Philbert S,30,0,30,0
1713350879867,PHYS 1B,A00,491623,Staff,235,0,250,15
1713350880901,PHYS 1BL,001,491626,Tsai; Philbert S,18,0,30,12
1713350880901,PHYS 1BL,002,491628,Tsai; Philbert S,26,0,30,4
1713350881932,PHYS 1C,A00,491632,Staff,211,0,245,34
1713350882961,PHYS 1CL,001,491635,Tsai; Philbert S,2,0,30,28
1713350882961,PHYS 1CL,002,491643,Tsai; Philbert S,22,0,30,8
1713350883990,PHYS 2AR,A01,491651,Meyertholen; Andrew D.,44,0,50,6
1713350885014,PHYS 2B,A01,491659,Staff,105,0,115,10
1713350886049,PHYS 2BL,A01,491685,Staff,21,0,24,3
1713350886049,PHYS 2BL,A02,491700,Staff,21,0,24,3
1713350887077,PHYS 2C,A01,505161,Staff,101,0,115,14
1713350888103,PHYS 4A,A01,491704,Grinstein; Benjamin,99,0,100,1
1713350889129,POLI 5D,A01,494144,Staff,3,0,5,2
1713350889129,POLI 5D,B01,626283,Dai; Yinlin,5,0,5,0
1713350890159,POLI 12,A00,494145,Staff,43,0,45,2
1713350891186,POLI 13R,A00,494146,Forman; Fonna,45,0,50,5
1713350892217,POLI 27,A01,494148,Staff,54,0,60,6
1713350893243,POLI 30,A00,494149,Staff,49,0,50,1
1713350894269,POLI 100DA,A00,494150,Staff,20,0,25,5
1713350896326,POLI 100I,A00,494152,Staff,27,0,30,3
1713350897353,POLI 104B,A00,494153,Smith; Glenn Chatmas,53,0,55,2
1713350898381,POLI 104F,A00,494154,Staff,28,0,30,2
1713350899413,POLI 104I,A00,494155,Smith; Glenn Chatmas,29,0,30,1
1713350900445,POLI 110C,A00,494156,Ingham; Sean,23,0,25,2
1713350901471,POLI 117R,A00,494157,Forman; Fonna,5,0,20,15
1713350902497,POLI 118,A00,494158,Ingham; Sean,21,0,25,4
1713350903527,POLI 120H,A00,494159,Fisk; David Lee,39,0,45,6
1713350904554,POLI 131CR,A00,494160,Hoston; Germaine,35,0,45,10
1713350905580,POLI 133J,A00,494161,Staff,31,0,35,4
1713350906606,POLI 135,A00,494162,Fisk; David Lee,33,0,35,2
1713350907632,POLI 140A,A00,494164,Staff,18,0,30,12
1713350908660,POLI 142I,A00,494165,Staff,30,0,30,0
1713350909688,POLI 144D,A00,494166,Staff,22,0,25,3
1713350910718,POLI 151,A00,494167,Staff,30,0,30,0
1713350911751,POLI 153,A00,494168,Staff,33,0,35,2
1713350912777,POLI 160AA,A00,494169,Staff,33,0,40,7
1713350913807,POLI 162,A00,494170,Mignozzetti; Umberto,17,0,25,8
1713350914833,POLI 171,A00,494171,Mignozzetti; Umberto,18,0,25,7
1713350915858,PSYC 1,A00,494172,Staff,95,0,100,5
1713350916883,PSYC 2,A00,494173,Moranton; Nirelia Melbina-,33,0,50,17
1713350917910,PSYC 3,A00,494174,Staff,29,0,30,1
1713350918934,PSYC 6,A00,494175,Staff,17,0,20,3
1713350919960,PSYC 60,A01,494177,Staff,37,0,45,8
1713350920997,PSYC 70,A01,505724,Geller; Emma Harlan,42,0,45,3
1713350922023,PSYC 101,A00,494180,Heyman; Gail D.,83,0,100,17
1713350923109,PSYC 105,A00,494181,Geller; Emma Harlan,51,0,90,39
1713350924141,PSYC 106,A00,494182,Dobkins; Karen R.,26,0,45,19
1713350925167,PSYC 108,A00,494183,Adrian; Julia Anna,89,0,100,11
1713350926195,PSYC 114,A01,494185,Winkielman; Piotr,0,4,30,30
1713350927221,PSYC 122,A00,494186,Moranton; Nirelia Melbina-,27,0,50,23
1713350928247,PSYC 124,A00,494187,Chapman; Eddie Nathaniel,69,0,80,11
1713350929277,PSYC 131,A00,494188,Anagnostaras; Stephan,39,0,80,41
1713350930302,PSYC 144,A00,494189,Staff,1,1,50,49
1713350931336,PSYC 154,A00,494190,Lacefield; Katharine I,105,0,180,75
1713350932366,PSYC 162,A00,494191,Wixted; John T,70,0,100,30
1713350933394,PSYC 172,A00,494192,Gorman; Michael R.,36,0,45,9
1713350934420,PSYC 178,A00,494193,Glaser; Dale,32,0,45,13
1713350935445,PSYC 193,A00,505725,Chapman; Eddie Nathaniel,20,0,20,0
1713350936471,RELI 145GS,A00,519817,Rahimi; Babak,17,0,20,3
1713350937504,SE 101A,A01,490862,Chadha; Mayank,23,0,25,2
1713350938535,SE 101C,A01,490924,Krysl; Petr,15,0,20,5
1713350939562,SE 110A,A01,490928,Staff,19,0,20,1
1713350940590,SE 130A,A00,490929,Morrison; Machel Leigh,53,0,70,17
1713350941628,SIO 1,A01,519325,Staff,39,0,40,1
1713350942654,SIO 30,A01,519327,Staff,38,0,40,2
1713350943684,SIO 40,A00,519328,Staff,39,0,40,1
1713350944709,SIO 46GS,A00,519819,Cook; Geoffrey W,15,0,25,10
1713350945740,SIO 109R,A00,494197,Forman; Fonna,0,3,20,20
1713350946769,SIO 121GS,A00,519827,Cook; Geoffrey W,15,0,25,10
1713350947795,SIO 132,A01,519330,Staff,38,0,40,2
1713350948826,SIO 133,A01,519397,Staff,37,0,40,3
1713350949850,SIO 139,A00,519396,Kacev; David,29,0,40,11
1713350950891,SOCI 1,A01,494199,Thorpe; Charles Robert,21,0,30,9
1713350950891,SOCI 1,A02,494200,Thorpe; Charles Robert,30,0,30,0
1713350950891,SOCI 1,A03,494201,Thorpe; Charles Robert,29,0,30,1
1713350950891,SOCI 1,A04,494202,Thorpe; Charles Robert,29,0,30,1
1713350950891,SOCI 1,A05,494203,Thorpe; Charles Robert,29,0,30,1
1713350950891,SOCI 1,A06,494204,Thorpe; Charles Robert,30,0,30,0
1713350950891,SOCI 1,A07,494205,Thorpe; Charles Robert,28,0,30,2
1713350951918,SOCI 60,A01,494207,Staff,33,0,40,7
1713350951918,SOCI 60,A02,494208,Staff,39,0,40,1
1713350952945,SOCI 100,A01,494210,Payne; Christine Anna,25,0,30,5
1713350952945,SOCI 100,A02,494211,Payne; Christine Anna,26,0,30,4
1713350953971,SOCI 109M,A00,494212,Staff,20,0,20,0
1713350955003,SOCI 110,A00,494213,Staff,34,0,40,6
1713350957056,SOCI 118E,A00,494215,Ng; Kwai,37,0,40,3
1713350958088,SOCI 125,A00,494216,Calderon-Zaks; Michael Aar,39,0,45,6
1713350959119,SOCI 126,A01,494218,Jones; Makeba,3,0,5,2
1713350960146,SOCI 131,A00,494219,Thorpe; Charles Robert,25,0,30,5
1713350962205,SOCI 135,A00,494221,Payne; Christine Anna,28,0,50,22
1713350963240,SOCI 136E,A00,626690,Ruiz; Jonathan Joseph,24,0,25,1
1713350964265,SOCI 138GS,A00,494222,Navon; Daniel,23,0,28,5
1713350966318,SOCI 145,A00,494224,Staff,40,0,45,5
1713350967344,SOCI 153,A00,494225,Staff,28,0,30,2
1713350968371,SOCI 160E,A00,494226,Ng; Kwai,27,0,40,13
1713350969396,SOCI 180,A00,494227,Staff,29,0,30,1
1713350970427,SOCI 189GS,A00,494228,Ribas Norris; Janet Vanesa,11,0,11,0
1713350971459,SOCI 190GS,A00,553232,Ribas Norris; Janet Vanesa,11,0,11,0
1713350972483,SOMI 220,A00,627178,Schneid; Stephen David,30,0,30,0
1713350973516,SYN 2,001,490768,Staff,13,0,15,2
1713350973516,SYN 2,002,490769,Staff,14,0,15,1
1713350973516,SYN 2,004,490775,Staff,0,0,0,0
1713350973516,SYN 2,003,490774,Staff,0,0,0,0
1713350973516,SYN 2,005,490776,Staff,0,0,0,0
1713350974550,SYN 2R,001,490779,Staff,10,0,15,5
1713350974550,SYN 2R,002,514635,Staff,14,0,15,1
1713350975584,SYN 100,A01,490783,Staff,8,0,20,12
1713350975584,SYN 100,B01,490787,Staff,10,0,20,10
1713350975584,SYN 100,C01,490789,Staff,10,0,20,10
1713350976608,SYN 150,A00,490817,Staff,14,0,15,1
1713350976608,SYN 150,B00,514610,Staff,15,0,15,0
1713350977654,TDAC 1,A00,492753,Walsh; Kim C.,19,0,20,1
1713350977654,TDAC 1,B00,492754,Harting; Carla Kelso,18,0,20,2
1713350977654,TDAC 1,C00,513995,Salovey; Todd,15,0,20,5
1713350978686,TDAC 101,A00,492766,Harting; Carla Kelso,17,0,20,3
1713350979718,TDAC 102,A00,492768,Basso; Beatrice,19,0,20,1
1713350980750,TDDE 111,A00,492769,Staff,25,0,25,0
1713350981782,TDDE 131,A00,492770,Staff,15,0,15,0
1713350981782,TDDE 131,B00,492771,Staff,15,0,15,0
1713350982809,TDDE 131GS,A00,523716,Guirguis; Mark C,23,0,28,5
1713350983843,TDGE 1,A01,492756,Salovey; Todd,56,0,60,4
1713350984867,TDGE 5,A01,492758,Staff,23,0,25,2
1713350985900,TDGE 10,A00,492759,Fulton; Julia,203,0,220,17
1713350986931,TDGE 11,A00,492760,Castro; Robert Jess,198,0,200,2
1713350988992,TDGE 124,A00,492772,Fulton; Julia,180,0,220,40
1713350990027,TDGE 125,A00,492773,Meyer; Ursula,38,0,50,12
1713350990027,TDGE 125,B00,492774,Staff,49,0,50,1
1713350990027,TDGE 125,C00,523565,Staff,48,0,50,2
1713350991061,TDGE 125GS,A00,523580,Guirguis; Mark C,23,0,28,5
1713350992104,TDGE 127,A00,492775,Havis; Allan,33,0,50,17
1713350993130,TDHT 101,A00,492776,Staff,34,0,35,1
1713350994163,TDMV 1,A00,492762,Caligagan; Maria T.,29,0,30,1
1713350994163,TDMV 1,B00,492763,Arcidiacono; Kristin,26,0,30,4
1713350995192,TDMV 2,A00,492764,Weinberg; Sadie,27,0,30,3
1713350996226,TDMV 3,A00,492765,Mack; Kara Shanai',37,0,40,3
1713350997251,TDMV 138,A00,492777,Mack; Kara Shanai',32,0,40,8
1713350998286,TDMV 140,A00,492778,Lima; Paulo Henrique,40,0,40,0
1713350999312,TDMV 142,A00,492779,Caligagan; Maria T.,33,0,40,7
1713350999312,TDMV 142,B00,492780,Caligagan; Tony,37,0,40,3
1713351000343,TDMV 143,A00,492781,Fyall; Daunte Edward,39,0,40,1
1713351001370,USP 1,A01,492401,Kwak; Nancy,27,0,35,8
1713351002397,USP 2,A01,492453,Hinds; Juli Beth,35,0,35,0
1713351003425,USP 3,A01,492516,Staff,28,0,35,7
1713351004452,USP 4,A00,492522,McTague; Sarah,16,0,25,9
1713351005482,USP 100,A00,492523,Staff,32,0,35,3
1713351006513,USP 101,A00,492524,Staff,13,0,15,2
1713351007539,USP 105,A00,492525,Staff,21,0,25,4
1713351008565,USP 151,A00,492526,Shenkman; Michael Thomas,32,0,35,3
1713351009595,USP 170,A00,492545,Hinds; Juli Beth,32,0,35,3
1713351010623,USP 171GS,A00,492608,Bussell; Mirle Rabinowitz,24,0,28,4
1713351011649,USP 183GS,A00,492613,Peerson; Susan,24,0,28,4
1713351012683,VIS 30,A01,490693,Yoldas; Pinar,19,0,22,3
1713351012683,VIS 30,A02,490694,Yoldas; Pinar,18,0,22,4
1713351013708,VIS 83,A00,490695,Kester; Grant,63,0,75,12
1713351014737,VIS 105D,A00,490696,Staff,22,0,25,3
1713351015816,VIS 124CN,A00,490699,Rose; Jordan M,64,0,75,11
1713351016848,VIS 125GS,A00,511221,Williams; Alena J,21,0,22,1
1713351017873,VIS 128D,A00,490700,Staff,73,0,75,2
1713351018899,VIS 151,A01,490717,Staff,33,0,34,1
1713351018899,VIS 151,A02,490766,Staff,32,0,34,2
1713351019925,VIS 154GS,A00,511972,Williams; Alena J,21,0,22,1
1713351020968,VIS 160A,A00,490767,Stone; Patricia,7,0,10,3
1713351021995,WCWP 10A,A00,490638,Staff,14,0,15,1
1713351021995,WCWP 10A,B00,490640,Staff,15,0,15,0
1713351023027,WCWP 10B,A00,490641,Staff,0,0,0,0
1713351023027,WCWP 10B,B00,490642,Staff,14,0,15,1
1713351023027,WCWP 10B,C00,490644,Staff,13,0,15,2
1713351023027,WCWP 10B,D00,490647,Staff,0,0,0,0
1713351024055,WCWP 100,A00,490655,Staff,0,0,0,0
1713351024055,WCWP 100,B00,490687,Staff,10,0,15,5
1713351026236,ANAR 153,A00,487222,Braswell; Geoffrey E.,53,0,60,7
1713351027313,ANBI 134,A00,487223,Staff,5,0,20,15
1713351028342,ANBI 143GS,A00,487224,Noel; Geoffroy Pierre Jean,18,0,24,6
1713351029367,ANBI 144GS,A00,519548,Noel; Geoffroy Pierre Jean,18,0,24,6
1713351030392,ANSC 101,A00,487225,Staff,17,0,20,3
1713351031424,ANSC 125,A00,487227,Brenner; Suzanne A,38,0,40,2
1713351033479,ANSC 146,A00,487229,Staff,35,0,40,5
1713351034506,ANSC 148,A00,487230,Olivas Hernandez; Olga Lid,39,0,40,1
1713351035532,ANSC 150,A00,504165,Sloane; Julia Kathryn,18,0,20,2
1713351036557,ANSC 180,A00,487232,Staff,14,0,15,1
1713351037584,ANSC 188,A00,627155,Staff,37,0,40,3
1713351038619,ANTH 5,A00,519529,Semendeferi; Ekaterini,15,0,15,0
1713351039647,ANTH 10,A00,487219,Staff,58,0,60,2
1713351040671,ANTH 23,A01,487221,Staff,17,0,20,3
1713351041699,ANTH 102,A00,487233,Wilder; Linnea Lorene,49,0,60,11
1713351042733,ANTH 103,A00,487234,Varma; Saiba,54,0,60,6
1713351043758,ANTH 105,A00,487235,Stewart; Alexander B,54,0,60,6
1713351044786,BENG 100,A01,516685,Taylor Amos; Alyssa C,25,0,30,5
1713351045814,BIBC 102,A01,491316,Flagg; Matthew Paul,3,0,88,85
1713351045814,BIBC 102,A02,491366,Flagg; Matthew Paul,78,0,88,10
1713351046842,BIBC 103,A01,491486,Boumechache; Miyyada,16,0,24,8
1713351046842,BIBC 103,A02,491487,Boumechache; Miyyada,24,0,24,0
1713351047868,BICD 100,A01,516882,Staff,72,0,75,3
1713351047868,BICD 100,A02,516890,Staff,69,0,75,6
1713351048896,BICD 102GS,A00,491488,Lo; Stanley M.,26,0,28,2
1713351049922,BIEB 136GS,A00,516940,Holway; David A. & Shurin; Jonathan,18,0,24,6
1713351050952,BIEB 137GS,A01,517034,Holway; David A. & Shurin; Jonathan,18,0,24,6
1713351052033,BIEB 138GS,A01,491492,Pirino; Giorgia,21,0,28,7
1713351053063,BILD 1,A01,491296,Staff,60,0,63,3
1713351053063,BILD 1,A02,491297,Staff,63,0,63,0
1713351054095,BILD 4,A01,517099,Gonzalez Gamboa; Ivonne,21,0,24,3
1713351054095,BILD 4,A02,517100,Gonzalez Gamboa; Ivonne,24,0,24,0
1713351055121,BILD 60GS,A00,491309,Lo; Stanley M.,26,0,28,2
1713351056151,BIMM 100,A01,517136,Staff,82,0,100,18
1713351057176,BIMM 110,A01,517182,Staff,52,0,100,48
1713351058203,BIMM 120,A01,517228,Pickett; Brooke Elizabeth,28,0,63,35
1713351058203,BIMM 120,A02,517240,Pickett; Brooke Elizabeth,44,0,63,19
1713351059230,BIMM 132GS,A01,491498,Pirino; Giorgia,21,0,28,7
1713351060256,BIMM 143,A01,491589,Bozinovic; Goran,12,0,40,28
1713351061291,BIPN 100,A01,491594,Armour; Jon Christopher,83,0,100,17
1713351062319,BIPN 140,A01,491602,Marino; Marc J,23,0,50,27
1713351064375,CAT 125,A00,515973,Staff,18,0,20,2
1713351065402,CAT 125GS,A00,515974,Rahimi; Babak,16,0,20,4
1713351066440,CAT 125R,A00,515980,Staff,12,0,20,8
1713351066440,CAT 125R,B00,515981,Tosun; Adriana,19,0,20,1
1713351066440,CAT 125R,C00,515987,Hyland; Tina Mae,0,5,20,20
1713351066440,CAT 125R,D00,515988,Bronstein; Phoebe Malan,16,0,20,4
1713351067468,CENG 15,A01,488699,Drews; Aaron,25,0,25,0
1713351068495,CENG 100,A00,505196,Opatkiewicz; Justin Paul,25,0,25,0
1713351069526,CGS 2A,A01,489598,Staff,32,0,35,3
1713351070551,CGS 112,A00,489599,Staff,15,0,15,0
1713351071577,CGS 119,A00,489603,Staff,10,0,10,0
1713351072603,CGS 120,A00,489604,Staff,13,0,15,2
1713351073629,CGS 150,A00,489607,Staff,15,0,15,0
1713351074653,CHEM 6A,A01,488715,Staff,97,0,100,3
1713351075680,CHEM 6B,A01,488719,Piercy; Marc Anthony,99,0,100,1
1713351076706,CHEM 6C,A01,488723,Albizati; Kim F.,92,0,100,8
1713351077746,CHEM 7L,A01,488728,Schurmeier; Kimberly,18,0,24,6
1713351077746,CHEM 7L,A02,488730,Schurmeier; Kimberly,23,0,24,1
1713351077746,CHEM 7L,A03,488734,Schurmeier; Kimberly,20,0,24,4
1713351077746,CHEM 7L,A04,488763,Schurmeier; Kimberly,23,0,24,1
1713351077746,CHEM 7L,B01,488798,Schurmeier; Kimberly,16,0,24,8
1713351077746,CHEM 7L,B02,488801,Schurmeier; Kimberly,22,0,24,2
1713351077746,CHEM 7L,B03,488808,Schurmeier; Kimberly,22,0,24,2
1713351077746,CHEM 7L,B04,488811,Schurmeier; Kimberly,24,0,24,0
1713351078780,CHEM 11,A01,488897,Stallings; Dontarie M,94,0,100,6
1713351079811,CHEM 40A,A01,488913,Albizati; Kim F.,83,0,100,17
1713351080838,CHEM 40B,A01,488920,Weizman; Haim,42,0,50,8
1713351080838,CHEM 40B,A02,488938,Weizman; Haim,43,0,50,7
1713351081864,CHEM 41A,A01,489029,Klosterman; Jeremy K,57,0,60,3
1713351082893,CHEM 41C,A01,500436,Tor; Yitzhak,53,0,60,7
1713351083929,CHEM 43A,A01,500426,Weizman; Haim,0,1,24,24
1713351083929,CHEM 43A,A02,500430,Weizman; Haim,6,0,24,18
1713351083929,CHEM 43A,B01,514041,Klosterman; Jeremy K,14,0,24,10
1713351083929,CHEM 43A,B02,514047,Klosterman; Jeremy K,23,0,24,1
1713351084962,CHEM 108,A01,489140,Jennings; Patricia A.,5,0,24,19
1713351084962,CHEM 108,A02,489142,Jennings; Patricia A.,14,0,24,10
1713351085992,CHEM 114A,A01,489147,Stallings; Dontarie M,65,0,100,35
1713351087018,CHIN 169A,A00,489171,Wang; Xiao,19,0,20,1
1713351089086,COGS 3,A01,518827,Boyle; Mary E. T.,25,0,40,15
1713351090113,COGS 11,A01,489175,Staff,27,0,30,3
1713351091138,COGS 14A,A01,518829,Staff,50,0,60,10
1713351092173,COGS 14B,A01,489177,Hoffman; Drew Ellen,62,0,75,13
1713351093199,COGS 100,A01,489181,Allen; Michael Gordon,62,0,75,13
1713351094225,COGS 101A,A01,489183,Staff,45,0,60,15
1713351095252,COGS 101B,A01,489185,Allen; Michael Gordon,6,0,30,24
1713351096279,COGS 101C,A01,526786,Staff,23,0,30,7
1713351098331,COGS 107A,A01,489189,Boyle; Mary E. T.,16,0,35,19
1713351099358,COGS 107B,A01,627144,Mooshagian; Eric Frederick,59,0,60,1
1713351100388,COGS 118A,A01,489191,Staff,0,46,40,40
1713351102445,COGS 171GS,A01,489194,Pineda; Jaime A,19,0,28,9
1713351103475,COGS 172,A01,489196,Staff,1,0,30,29
1713351104504,COGS 174GS,A01,489264,Pineda; Jaime A,19,0,28,9
1713351105527,COGS 180,A01,627150,Staff,28,0,30,2
1713351106558,COGS 186,A01,489274,Staff,0,3,30,30
1713351107587,COMM 10,A01,489276,Staff,23,0,25,2
1713351107587,COMM 10,A02,489303,Staff,23,0,25,2
1713351108613,COMM 100A,A01,489312,Staff,14,0,25,11
1713351108613,COMM 100A,A02,489313,Staff,24,0,25,1
1713351109639,COMM 106T,A00,512540,Staff,33,0,35,2
1713351110667,COMM 107,A00,489347,Staff,27,0,35,8
1713351111693,COMM 109P,A00,489358,Staff,31,0,35,4
1713351112726,COMM 132,A00,489361,McKenna; Denise,27,0,30,3
1713351113753,COMM 146,A00,489362,Halm; Gavin Patrick,25,0,30,5
1713351114784,COMM 190,A00,489363,Abuelhiga; Soraya Jill,17,0,23,6
1713351115812,CSE 8A,A50,489366,Staff,21,0,25,4
1713351115812,CSE 8A,A51,489367,Staff,24,0,25,1
1713351116846,CSE 11,A01,489398,Cao; Yingjun,72,0,100,28
1713351117879,CSE 12,A01,489487,Staff,43,0,50,7
1713351118906,CSE 20,A01,489497,Staff,47,0,50,3
1713351119931,CSE 21,A01,489517,Braun; Oliver,42,0,50,8
1713351120959,CSE 101,A01,489524,Braun; Oliver,0,35,50,50
1713351121984,CSE 105,A01,512594,Jones; Miles E,72,0,100,28
1713351121984,CSE 105,B01,512598,Jones; Miles E,50,0,100,50
1713351123011,CSE 140,A01,489538,Staff,39,0,50,11
1713351124038,CSE 141,A01,489550,Eldon; John,67,0,100,33
1713351125066,CSE 141L,A01,489571,Eldon; John,65,0,100,35
1713351126099,CSE 151A,A01,489583,Solares; Edwin A,139,0,200,61
1713351127132,CSE 175,A01,510886,Kumar; Rakesh,30,0,30,0
1713351128158,CSE 190,A00,516828,Dubnov; Shlomo,37,0,49,12
1713351129187,DOC 100D,A00,489667,Pass; Natalye Joann,19,0,25,6
1713351130219,DSC 10,A01,624268,Staff,72,0,75,3
1713351131305,DSC 20,A01,624476,Staff,50,0,50,0
1713351132329,DSC 40A,A01,624608,Staff,39,0,40,1
1713351133356,DSGN 1,A01,489179,Rill; Bryan,32,0,50,18
1713351134390,ECE 17,A01,490489,Sahay; Rajeev,18,0,30,12
1713351135420,ECE 65,A50,490492,Staff,11,0,20,9
1713351135420,ECE 65,A51,490493,Staff,18,0,20,2
1713351136447,ECON 1,A01,489715,Famulari; Melissa,67,0,70,3
1713351137474,ECON 2,A01,489717,Levkoff; Steven B.,67,0,70,3
1713351138504,ECON 3,A01,489948,Staff,69,0,70,1
1713351140564,ECON 5,A01,490103,Staff,27,0,30,3
1713351140564,ECON 5,B01,626281,Dai; Yinlin,45,0,45,0
1713351141589,ECON 100A,A01,490127,Famulari; Melissa,62,0,70,8
1713351142618,ECON 100B,A01,490129,Staff,64,0,70,6
1713351143645,ECON 109,A01,490187,Shishkin; Denis,27,0,35,8
1713351144674,ECON 110A,A01,490190,Levkoff; Steven B.,59,0,70,11
1713351145701,ECON 120A,A01,490245,Dai; Yinlin,59,0,70,11
1713351146743,ECON 120B,A01,490247,Nieto-Barthaburu; Augusto,40,0,70,30
1713351147779,ECON 120C,A01,490253,Sun; Yixiao,30,0,35,5
1713351147779,ECON 120C,B01,490255,Sun; Yixiao,34,0,35,1
1713351148813,ECON 129,A00,490256,Eckert; Fabian Paul,22,0,35,13
1713351149845,ECON 131,A00,490257,Nieto-Barthaburu; Augusto,0,6,35,35
1713351150874,ECON 138,A00,490258,Bharadwaj; Prashant,13,0,35,22
1713351150874,ECON 138,B00,490259,Bharadwaj; Prashant,15,0,35,20
1713351151901,ECON 159,A00,490260,Hendrickson; Gerald M.,0,9,0,0
1713351152938,ECON 178,A01,553995,Zhu; Ying,24,0,35,11
1713351153965,EDS 40,A01,512576,Black; Alison Michelle,20,0,20,0
1713351154997,EDS 107,A01,515848,Staff,30,0,30,0
1713351156024,EDS 110R,A01,490262,Staff,26,0,30,4
1713351157049,EDS 112,A01,490264,Chapman; Thandeka K,40,0,50,10
1713351158074,EDS 113,A00,490266,Staff,25,0,30,5
1713351159100,EDS 118,A00,490267,Warstadt; Melissa Fawn,18,0,30,12
1713351160128,EDS 124BR,A00,490268,Eguchi; Emi,4,0,25,21
1713351160128,EDS 124BR,B00,490269,Eguchi; Emi,23,0,25,2
1713351161158,EDS 126,A01,490271,Jones; Makeba,43,0,50,7
1713351162186,EDS 135,A01,490316,Staff,19,0,20,1
1713351163213,ENVR 142GS,A00,519514,Chang; Edmond Yi-Teh,26,0,28,2
1713351164242,ETHN 103,A00,490504,Staff,24,0,36,12
1713351165272,ETHN 103A,A00,490505,Man; Simeon S,3,0,9,6
1713351166297,ETHN 109,A00,490506,Staff,28,0,30,2
1713351167323,ETHN 118,A00,490507,Staff,35,0,36,1
1713351168350,ETHN 119,A00,490508,Staff,32,0,36,4
1713351169381,ETHN 121R,A00,490518,Choi; Esther Min,21,0,36,15
1713351170407,ETHN 127,A00,490528,Staff,14,0,15,1
1713351171443,ETHN 139,A00,490573,Staff,10,0,10,0
1713351172471,ETHN 150,A00,490575,Staff,15,0,15,0
1713351173502,GLBH 20,A00,491705,Elwardani; Nile Regina,38,0,40,2
1713351174548,GLBH 101,A00,491706,Staff,20,0,20,0
1713351175574,GLBH 111,A01,491708,Burgos; Jose L.,15,0,15,0
1713351176602,GLBH 146,A00,491709,Staff,8,0,20,12
1713351177628,GLBH 148,A00,491710,Olivas Hernandez; Olga Lid,10,0,20,10
1713351178654,GLBH 150,A00,491711,Sloane; Julia Kathryn,19,0,20,1
1713351179681,HIEA 131,A00,491760,Staff,28,0,32,4
1713351180708,HIEA 153,A00,491762,Staff,28,0,30,2
1713351181736,HIEU 124,A00,491811,Staff,26,0,32,6
1713351182761,HIEU 124GS,A00,491812,Markman; Kristina,27,0,28,1
1713351183792,HIEU 147,A00,491813,Staff,30,0,32,2
1713351184826,HIEU 149GS,A00,491816,Caldwell; Michael Alan,28,0,28,0
1713351185851,HILD 2C,A01,491713,Hendrickson; Gerald M.,26,0,30,4
1713351186877,HILD 7B,A01,491715,Kwak; Nancy,0,3,30,30
1713351187907,HILD 10,A01,491717,Staff,9,0,20,11
1713351188932,HILD 30GS,A00,491719,Edington; Claire Ellen,23,0,28,5
1713351189961,HINE 109,A00,491818,Shafir; Nir,26,0,32,6
1713351190988,HINE 128,A00,491821,Shafir; Nir,30,0,32,2
1713351192016,HISC 117,A00,491830,Staff,27,0,32,5
1713351193042,HIUS 103,A00,491834,Man; Simeon S,14,0,23,9
1713351194071,HIUS 108B,A00,491835,Staff,27,0,30,3
1713351195098,HIUS 141,A00,491836,Hendrickson; Gerald M.,28,0,32,4
1713351196124,HIUS 149,A00,491839,Staff,24,0,32,8
1713351197156,HUM 3,A01,512617,Crum; Matthew Stephen,42,0,50,8
1713351197156,HUM 3,A02,512618,Crum; Matthew Stephen,48,0,50,2
1713351198182,HUM 3GS,A00,512663,Markman; Kristina,0,0,0,1
1713351198182,HUM 3GS,B00,512664,Staff,0,0,0,0
1713351199215,HUM 4,A01,512620,West; Geoffrey Scott,22,0,50,28
1713351200241,HUM 4GS,A00,512666,Lyon; Antony J.,0,0,0,5
1713351201270,HUM 4R,A01,512625,Watkins; Eric,49,0,50,1
1713351202302,HUM 5,A01,512649,Zavodny; Tatiana Sophia,20,0,50,30
1713351202302,HUM 5,B01,512661,Zroka; Ryan Edward,48,0,50,2
1713351203328,INTL 190,A00,490577,Segui; Alan S,0,0,0,5
1713351204355,JAPN 20AR,A01,491267,Ross; Kayoko F,7,0,20,13
1713351205386,JAPN 180,A00,491285,Berman; Michael David,33,0,40,7
1713351206420,LATI 50,A01,502536,Kokinis; Troy Andreas,16,0,22,6
1713351206420,LATI 50,A02,502551,Kokinis; Troy Andreas,22,0,22,0
1713351206420,LATI 50,A03,502650,Kokinis; Troy Andreas,22,0,22,0
1713351206420,LATI 50,A04,502909,Kokinis; Troy Andreas,21,0,22,1
1713351207446,LATI 160,A01,502920,Kokinis; Troy Andreas,30,0,30,0
1713351208473,LIFR 1A,A00,490494,Van Moer; Vinciane G,17,0,20,3
1713351209497,LIFR 1AX,A00,490495,Van Moer; Vinciane G,17,0,20,3
1713351210530,LIFR 1B,A00,490496,Van Moer; Vinciane G,17,0,20,3
1713351211555,LIFR 1BX,A00,490497,Van Moer; Vinciane G,17,0,20,3
1713351212589,LIGN 8,A00,505198,McIntosh; Justin Daniel,134,0,150,16
1713351213614,LIGN 9GS,A00,491239,Lott; Margaret S.,18,0,20,2
1713351214646,LIGN 101,A01,505200,McIntosh; Justin Daniel,22,0,30,8
1713351215671,LIGN 120,A01,491244,Staff,22,0,30,8
1713351216700,LIGN 149GS,A00,491245,Lott; Margaret S.,18,0,20,2
1713351217727,LIGN 170,A00,491247,Staff,22,0,30,8
1713351218752,LISP 1D,A00,490498,Munoz Sanchez; Alicia,8,0,14,6
1713351218752,LISP 1D,B00,490499,Munoz Sanchez; Alicia,4,0,14,10
1713351218752,LISP 1D,C00,490500,Munoz Sanchez; Alicia,7,0,14,7
1713351218752,LISP 1D,D00,490501,Munoz Sanchez; Alicia,10,0,14,4
1713351219778,LISP 1DX,A00,490502,Munoz Sanchez; Alicia,11,0,28,17
1713351219778,LISP 1DX,B00,490503,Munoz Sanchez; Alicia,16,0,28,12
1713351221829,LTAM 110,A00,491847,Staff,22,0,25,3
1713351222854,LTCS 119,A00,491848,Staff,11,0,15,4
1713351223879,LTCS 130,A00,491849,Staff,24,0,25,1
1713351225932,LTEA 120C,A00,491852,Staff,32,0,40,8
1713351226961,LTEN 130GS,A00,491853,Lyon; Antony J.,23,0,28,5
1713351227987,LTEN 148,A00,491855,Staff,23,0,25,2
1713351229029,LTEN 159,A00,491856,Staff,20,0,25,5
1713351230055,LTEN 180,A00,491857,Staff,8,0,15,7
1713351232112,LTSP 123GS,A00,505928,Bessett; Ryan Matthew,24,0,28,4
1713351233137,LTSP 174GS,A00,506037,Bessett; Ryan Matthew,24,0,28,4
1713351235247,LTWR 102,A00,491861,Staff,9,0,15,6
1713351236274,LTWR 106,A00,491862,Staff,8,0,15,7
1713351237301,MAE 11,A00,490930,Bahadori; Mohammad Yousef,94,0,100,6
1713351238329,MAE 30A,A00,490931,Qi; Huihui,37,0,40,3
1713351239358,MAE 101A,A00,491036,Sadeghizadeh; Zahra,91,0,100,9
1713351240385,MAE 101C,A00,491037,Seshadri; Kalyanasundaram,63,0,100,37
1713351241411,MAE 113,A00,491040,Seshadri; Kalyanasundaram,64,0,80,16
1713351242444,MAE 131A,A00,491041,Ghazinejad; Maziar,37,0,40,3
1713351243480,MAE 142,A00,491053,Staff,39,0,40,1
1713351244513,MAE 143A,A00,491054,Staff,29,0,50,21
1713351245540,MAE 150,A00,491092,Truong; Phuong Thi Ngoc,23,0,35,12
1713351246574,MATH 3C,A01,494031,Pardo Guerra; Sebastian,30,0,30,0
1713351246574,MATH 3C,A02,494032,Pardo Guerra; Sebastian,29,0,30,1
1713351247606,MATH 10A,A01,494034,Staff,27,0,30,3
1713351247606,MATH 10A,A02,494035,Staff,28,0,30,2
1713351247606,MATH 10A,B01,494037,Staff,27,0,30,3
1713351247606,MATH 10A,B02,494038,Staff,29,0,30,1
1713351248634,MATH 10B,A01,494040,Habib; Yousaf,22,0,30,8
1713351248634,MATH 10B,A02,494041,Habib; Yousaf,28,0,30,2
1713351248634,MATH 10B,A03,494042,Habib; Yousaf,29,0,30,1
1713351248634,MATH 10B,A04,494043,Habib; Yousaf,30,0,30,0
1713351248634,MATH 10B,B01,494045,Habib; Yousaf,25,0,30,5
1713351248634,MATH 10B,B02,494046,Habib; Yousaf,30,0,30,0
1713351248634,MATH 10B,B03,494047,Habib; Yousaf,30,0,30,0
1713351248634,MATH 10B,B04,494048,Habib; Yousaf,30,0,30,0
1713351249667,MATH 18,A01,494050,Kemp; Todd Aahron,25,0,30,5
1713351249667,MATH 18,A02,494051,Kemp; Todd Aahron,29,0,30,1
1713351249667,MATH 18,B01,494054,Kemp; Todd Aahron,25,0,30,5
1713351249667,MATH 18,B02,494055,Kemp; Todd Aahron,29,0,30,1
1713351250699,MATH 20A,A01,494059,Suk; Andrew Hoon,30,0,30,0
1713351251727,MATH 20B,A01,494061,Briones; Jor-el Thomas Caparas,33,0,35,2
1713351251727,MATH 20B,B01,494063,Bach; Quang Tran,34,0,35,1
1713351252761,MATH 20C,A01,494065,Staff,28,0,30,2
1713351252761,MATH 20C,A02,494066,Staff,30,0,30,0
1713351252761,MATH 20C,A03,494067,Staff,30,0,30,0
1713351252761,MATH 20C,A04,494068,Staff,30,0,30,0
1713351252761,MATH 20C,B01,494070,Zhang; Ming,23,0,30,7
1713351252761,MATH 20C,B02,494071,Zhang; Ming,27,0,30,3
1713351252761,MATH 20C,B03,494072,Zhang; Ming,29,0,30,1
1713351252761,MATH 20C,B04,494073,Zhang; Ming,29,0,30,1
1713351253793,MATH 20D,A01,494075,Staff,22,0,30,8
1713351253793,MATH 20D,A02,494076,Staff,29,0,30,1
1713351254824,MATH 20E,A01,494079,Staff,24,0,30,6
1713351254824,MATH 20E,A02,494080,Staff,26,0,30,4
1713351254824,MATH 20E,B01,494082,Staff,25,0,30,5
1713351254824,MATH 20E,B02,494083,Staff,25,0,30,5
1713351255850,MATH 103A,A01,494085,Aliabadi Sr.; Mohsen,12,0,30,18
1713351255850,MATH 103A,A02,494086,Aliabadi Sr.; Mohsen,28,0,30,2
1713351255850,MATH 103A,B01,494088,Aliabadi Sr.; Mohsen,19,0,30,11
1713351255850,MATH 103A,B02,494089,Aliabadi Sr.; Mohsen,27,0,30,3
1713351256884,MATH 109,A01,494091,Staff,30,0,30,0
1713351256884,MATH 109,A02,494092,Staff,29,0,30,1
1713351256884,MATH 109,B01,494094,Staff,27,0,30,3
1713351256884,MATH 109,B02,494095,Staff,29,0,30,1
1713351257922,MATH 142A,A01,494097,Chow; Bennett,13,0,30,17
1713351257922,MATH 142A,A02,494098,Chow; Bennett,23,0,30,7
1713351257922,MATH 142A,B01,494100,Chow; Bennett,19,0,30,11
1713351257922,MATH 142A,B02,494101,Chow; Bennett,29,0,30,1
1713351259982,MATH 168A,A01,516677,Dumitriu; Ioana,16,0,35,19
1713351261008,MATH 170A,A01,516679,Dumitriu; Ioana,18,0,30,12
1713351261008,MATH 170A,A02,516680,Dumitriu; Ioana,28,0,30,2
1713351262034,MATH 193A,A01,494107,Staff,12,0,30,18
1713351262034,MATH 193A,A02,494108,Staff,18,0,30,12
1713351262034,MATH 193A,A03,494109,Staff,29,0,30,1
1713351262034,MATH 193A,A04,494110,Staff,22,0,30,8
1713351265119,MGT 16,A00,491930,McKay; Michael J,92,0,98,6
1713351266147,MGT 18,A00,491992,McKay; Michael J,96,0,98,2
1713351267175,MGT 71,A00,492003,Staff,63,0,98,35
1713351268201,MGT 103,A00,505209,Eberhard; Craig A,80,0,98,18
1713351269229,MGT 131A,A00,505210,Anderson; John Charles,89,0,98,9
1713351271281,MGT 153,A00,492077,Perols; Johan Lars,15,0,90,75
1713351274370,MGT 164,A00,492222,McKay; Mary A,91,0,98,7
1713351275395,MGT 172,A00,492245,Staff,59,0,60,1
1713351275395,MGT 172,B00,505526,Hedges; Kathleen,65,0,98,33
1713351276433,MGT 181,A00,505669,Dunn; Louis Jean,78,0,98,20
1713351277459,MMW 14,A01,494399,Staff,15,0,28,13
1713351277459,MMW 14,A02,494400,Staff,25,0,28,3
1713351277459,MMW 14,A03,494401,Staff,28,0,28,0
1713351277459,MMW 14,A04,494402,Staff,28,0,28,0
1713351277459,MMW 14,B01,494404,Carreras; Maria Victoria,8,0,28,20
1713351277459,MMW 14,B02,494405,Carreras; Maria Victoria,25,0,28,3
1713351277459,MMW 14,B03,494406,Carreras; Maria Victoria,27,0,28,1
1713351277459,MMW 14,B04,494407,Carreras; Maria Victoria,28,0,28,0
1713351278485,MMW 14GS,A00,506250,Chang; Edmond Yi-Teh,0,0,0,0
1713351279511,MMW 121R,A01,494415,Adamiak; Patrick John,9,0,28,19
1713351279511,MMW 121R,A02,494416,Adamiak; Patrick John,24,0,28,4
1713351280546,MUS 1A,A01,494113,Staff,12,0,25,13
1713351280546,MUS 1A,A02,494114,Staff,24,0,25,1
1713351281572,MUS 4,A01,494116,Staff,23,0,25,2
1713351281572,MUS 4,A02,494117,Staff,22,0,25,3
1713351282599,MUS 5R,A01,494236,Dubnov; Shlomo,4,0,25,21
1713351282599,MUS 5R,A02,494237,Dubnov; Shlomo,25,0,25,0
1713351283629,MUS 6,A01,494122,Staff,9,0,25,16
1713351283629,MUS 6,A02,494123,Staff,23,0,25,2
1713351284657,MUS 7,A01,494125,Staff,16,0,25,9
1713351284657,MUS 7,A02,494126,Staff,24,0,25,1
1713351285682,MUS 11,A01,494128,Staff,23,0,25,2
1713351285682,MUS 11,A02,494129,Staff,24,0,25,1
1713351286709,MUS 13,A01,494131,Staff,25,0,25,0
1713351286709,MUS 13,A02,494132,Staff,25,0,25,0
1713351287735,MUS 15,A01,494134,Staff,16,0,25,9
1713351287735,MUS 15,A02,494135,Staff,25,0,25,0
1713351287735,MUS 15,B01,494137,Staff,24,0,25,1
1713351288767,MUS 80,A00,494232,Staff,24,0,25,1
1713351288767,MUS 80,B00,494233,Staff,25,0,25,0
1713351288767,MUS 80,C00,494234,Staff,23,0,25,2
1713351289794,MUS 95C,A00,494141,Staff,69,0,75,6
1713351290823,MUS 114,A00,494142,Staff,39,0,50,11
1713351291850,NANO 15,A01,490636,Drews; Aaron,7,0,7,0
1713351292875,PHIL 1,A00,490578,Grush; Rick Scott,49,0,50,1
1713351293901,PHIL 10,A01,490580,Grush; Rick Scott,33,0,35,2
1713351293901,PHIL 10,A02,490586,Grush; Rick Scott,32,0,35,3
1713351294931,PHIL 27,A01,490591,Staff,22,0,25,3
1713351294931,PHIL 27,A02,490592,Staff,25,0,25,0
1713351294931,PHIL 27,A03,490593,Staff,25,0,25,0
1713351294931,PHIL 27,A04,490598,Staff,25,0,25,0
1713351295955,PHIL 32,A01,490611,Staff,20,0,20,0
1713351295955,PHIL 32,A02,490618,Staff,20,0,20,0
1713351296987,PHIL 90,A00,490624,Staff,40,0,40,0
1713351298017,PHIL 136,A00,490627,Cohen; Jonathan David,37,0,40,3
1713351299052,PHIL 155,A00,490634,Staff,61,0,70,9
1713351300103,PHYS 1A,A00,491610,Staff,245,0,250,5
1713351301127,PHYS 1AL,001,491616,Tsai; Philbert S,27,0,30,3
1713351301127,PHYS 1AL,002,491618,Tsai; Philbert S,30,0,30,0
1713351302152,PHYS 1B,A00,491623,Staff,235,0,250,15
1713351303178,PHYS 1BL,001,491626,Tsai; Philbert S,18,0,30,12
1713351303178,PHYS 1BL,002,491628,Tsai; Philbert S,26,0,30,4
1713351304287,PHYS 1C,A00,491632,Staff,211,0,245,34
1713351305317,PHYS 1CL,001,491635,Tsai; Philbert S,2,0,30,28
1713351305317,PHYS 1CL,002,491643,Tsai; Philbert S,22,0,30,8
1713351306350,PHYS 2AR,A01,491651,Meyertholen; Andrew D.,44,0,50,6
1713351307382,PHYS 2B,A01,491659,Staff,105,0,115,10
1713351308407,PHYS 2BL,A01,491685,Staff,21,0,24,3
1713351308407,PHYS 2BL,A02,491700,Staff,21,0,24,3
1713351309437,PHYS 2C,A01,505161,Staff,101,0,115,14
1713351310464,PHYS 4A,A01,491704,Grinstein; Benjamin,99,0,100,1
1713351311497,POLI 5D,A01,494144,Staff,3,0,5,2
1713351311497,POLI 5D,B01,626283,Dai; Yinlin,5,0,5,0
1713351312530,POLI 12,A00,494145,Staff,43,0,45,2
1713351313555,POLI 13R,A00,494146,Forman; Fonna,45,0,50,5
1713351314581,POLI 27,A01,494148,Staff,54,0,60,6
1713351315610,POLI 30,A00,494149,Staff,49,0,50,1
1713351316644,POLI 100DA,A00,494150,Staff,20,0,25,5
1713351318698,POLI 100I,A00,494152,Staff,27,0,30,3
1713351319730,POLI 104B,A00,494153,Smith; Glenn Chatmas,53,0,55,2
1713351320756,POLI 104F,A00,494154,Staff,28,0,30,2
1713351321784,POLI 104I,A00,494155,Smith; Glenn Chatmas,29,0,30,1
1713351322812,POLI 110C,A00,494156,Ingham; Sean,23,0,25,2
1713351323837,POLI 117R,A00,494157,Forman; Fonna,5,0,20,15
1713351324864,POLI 118,A00,494158,Ingham; Sean,21,0,25,4
1713351325890,POLI 120H,A00,494159,Fisk; David Lee,39,0,45,6
1713351326921,POLI 131CR,A00,494160,Hoston; Germaine,35,0,45,10
1713351327947,POLI 133J,A00,494161,Staff,31,0,35,4
1713351328972,POLI 135,A00,494162,Fisk; David Lee,33,0,35,2
1713351330002,POLI 140A,A00,494164,Staff,18,0,30,12
1713351331027,POLI 142I,A00,494165,Staff,30,0,30,0
1713351332053,POLI 144D,A00,494166,Staff,22,0,25,3
1713351333078,POLI 151,A00,494167,Staff,30,0,30,0
1713351334107,POLI 153,A00,494168,Staff,33,0,35,2
1713351335138,POLI 160AA,A00,494169,Staff,33,0,40,7
1713351336163,POLI 162,A00,494170,Mignozzetti; Umberto,17,0,25,8
1713351337192,POLI 171,A00,494171,Mignozzetti; Umberto,18,0,25,7
1713351338217,PSYC 1,A00,494172,Staff,95,0,100,5
1713351339302,PSYC 2,A00,494173,Moranton; Nirelia Melbina-,33,0,50,17
1713351340330,PSYC 3,A00,494174,Staff,29,0,30,1
1713351341362,PSYC 6,A00,494175,Staff,17,0,20,3
1713351342388,PSYC 60,A01,494177,Staff,37,0,45,8
1713351343415,PSYC 70,A01,505724,Geller; Emma Harlan,42,0,45,3
1713351344441,PSYC 101,A00,494180,Heyman; Gail D.,83,0,100,17
1713351345466,PSYC 105,A00,494181,Geller; Emma Harlan,51,0,90,39
1713351346496,PSYC 106,A00,494182,Dobkins; Karen R.,26,0,45,19
1713351347523,PSYC 108,A00,494183,Adrian; Julia Anna,89,0,100,11
1713351348549,PSYC 114,A01,494185,Winkielman; Piotr,0,4,30,30
1713351349578,PSYC 122,A00,494186,Moranton; Nirelia Melbina-,27,0,50,23
1713351350609,PSYC 124,A00,494187,Chapman; Eddie Nathaniel,69,0,80,11
1713351351640,PSYC 131,A00,494188,Anagnostaras; Stephan,39,0,80,41
1713351352665,PSYC 144,A00,494189,Staff,1,1,50,49
1713351353692,PSYC 154,A00,494190,Lacefield; Katharine I,105,0,180,75
1713351354718,PSYC 162,A00,494191,Wixted; John T,70,0,100,30
1713351355751,PSYC 172,A00,494192,Gorman; Michael R.,36,0,45,9
1713351356778,PSYC 178,A00,494193,Glaser; Dale,32,0,45,13
1713351357807,PSYC 193,A00,505725,Chapman; Eddie Nathaniel,20,0,20,0
1713351358834,RELI 145GS,A00,519817,Rahimi; Babak,17,0,20,3
1713351359860,SE 101A,A01,490862,Chadha; Mayank,23,0,25,2
1713351360885,SE 101C,A01,490924,Krysl; Petr,15,0,20,5
1713351361910,SE 110A,A01,490928,Staff,19,0,20,1
1713351362936,SE 130A,A00,490929,Morrison; Machel Leigh,53,0,70,17
1713351363961,SIO 1,A01,519325,Staff,39,0,40,1
1713351364985,SIO 30,A01,519327,Staff,38,0,40,2
1713351366014,SIO 40,A00,519328,Staff,39,0,40,1
1713351367043,SIO 46GS,A00,519819,Cook; Geoffrey W,15,0,25,10
1713351368073,SIO 109R,A00,494197,Forman; Fonna,0,3,20,20
1713351369104,SIO 121GS,A00,519827,Cook; Geoffrey W,15,0,25,10
1713351370129,SIO 132,A01,519330,Staff,38,0,40,2
1713351371159,SIO 133,A01,519397,Staff,37,0,40,3
1713351372185,SIO 139,A00,519396,Kacev; David,29,0,40,11
1713351373218,SOCI 1,A01,494199,Thorpe; Charles Robert,21,0,30,9
1713351373218,SOCI 1,A02,494200,Thorpe; Charles Robert,30,0,30,0
1713351373218,SOCI 1,A03,494201,Thorpe; Charles Robert,29,0,30,1
1713351373218,SOCI 1,A04,494202,Thorpe; Charles Robert,29,0,30,1
1713351373218,SOCI 1,A05,494203,Thorpe; Charles Robert,29,0,30,1
1713351373218,SOCI 1,A06,494204,Thorpe; Charles Robert,30,0,30,0
1713351373218,SOCI 1,A07,494205,Thorpe; Charles Robert,28,0,30,2
1713351374254,SOCI 60,A01,494207,Staff,33,0,40,7
1713351374254,SOCI 60,A02,494208,Staff,39,0,40,1
1713351375285,SOCI 100,A01,494210,Payne; Christine Anna,25,0,30,5
1713351375285,SOCI 100,A02,494211,Payne; Christine Anna,26,0,30,4
1713351376317,SOCI 109M,A00,494212,Staff,20,0,20,0
1713351377349,SOCI 110,A00,494213,Staff,34,0,40,6
1713351379407,SOCI 118E,A00,494215,Ng; Kwai,37,0,40,3
1713351380432,SOCI 125,A00,494216,Calderon-Zaks; Michael Aar,39,0,45,6
1713351381458,SOCI 126,A01,494218,Jones; Makeba,3,0,5,2
1713351382484,SOCI 131,A00,494219,Thorpe; Charles Robert,25,0,30,5
1713351384538,SOCI 135,A00,494221,Payne; Christine Anna,28,0,50,22
1713351385564,SOCI 136E,A00,626690,Ruiz; Jonathan Joseph,24,0,25,1
1713351386591,SOCI 138GS,A00,494222,Navon; Daniel,23,0,28,5
1713351388651,SOCI 145,A00,494224,Staff,40,0,45,5
1713351389677,SOCI 153,A00,494225,Staff,28,0,30,2
1713351390703,SOCI 160E,A00,494226,Ng; Kwai,27,0,40,13
1713351391732,SOCI 180,A00,494227,Staff,29,0,30,1
1713351392762,SOCI 189GS,A00,494228,Ribas Norris; Janet Vanesa,11,0,11,0
1713351393794,SOCI 190GS,A00,553232,Ribas Norris; Janet Vanesa,11,0,11,0
1713351394822,SOMI 220,A00,627178,Schneid; Stephen David,30,0,30,0
1713351395855,SYN 2,001,490768,Staff,13,0,15,2
1713351395855,SYN 2,002,490769,Staff,14,0,15,1
1713351395855,SYN 2,004,490775,Staff,0,0,0,0
1713351395855,SYN 2,003,490774,Staff,0,0,0,0
1713351395855,SYN 2,005,490776,Staff,0,0,0,0
1713351396887,SYN 2R,001,490779,Staff,10,0,15,5
1713351396887,SYN 2R,002,514635,Staff,14,0,15,1
1713351397920,SYN 100,A01,490783,Staff,8,0,20,12
1713351397920,SYN 100,B01,490787,Staff,10,0,20,10
1713351397920,SYN 100,C01,490789,Staff,10,0,20,10
1713351398945,SYN 150,A00,490817,Staff,14,0,15,1
1713351398945,SYN 150,B00,514610,Staff,15,0,15,0
1713351399975,TDAC 1,A00,492753,Walsh; Kim C.,19,0,20,1
1713351399975,TDAC 1,B00,492754,Harting; Carla Kelso,18,0,20,2
1713351399975,TDAC 1,C00,513995,Salovey; Todd,15,0,20,5
1713351401008,TDAC 101,A00,492766,Harting; Carla Kelso,17,0,20,3
1713351402034,TDAC 102,A00,492768,Basso; Beatrice,19,0,20,1
1713351403064,TDDE 111,A00,492769,Staff,25,0,25,0
1713351404091,TDDE 131,A00,492770,Staff,15,0,15,0
1713351404091,TDDE 131,B00,492771,Staff,15,0,15,0
1713351405128,TDDE 131GS,A00,523716,Guirguis; Mark C,23,0,28,5
1713351406167,TDGE 1,A01,492756,Salovey; Todd,56,0,60,4
1713351407192,TDGE 5,A01,492758,Staff,23,0,25,2
1713351408218,TDGE 10,A00,492759,Fulton; Julia,203,0,220,17
1713351409245,TDGE 11,A00,492760,Castro; Robert Jess,198,0,200,2
1713351411410,TDGE 124,A00,492772,Fulton; Julia,180,0,220,40
1713351412446,TDGE 125,A00,492773,Meyer; Ursula,38,0,50,12
1713351412446,TDGE 125,B00,492774,Staff,49,0,50,1
1713351412446,TDGE 125,C00,523565,Staff,48,0,50,2
1713351413476,TDGE 125GS,A00,523580,Guirguis; Mark C,23,0,28,5
1713351414511,TDGE 127,A00,492775,Havis; Allan,33,0,50,17
1713351415540,TDHT 101,A00,492776,Staff,34,0,35,1
1713351416575,TDMV 1,A00,492762,Caligagan; Maria T.,29,0,30,1
1713351416575,TDMV 1,B00,492763,Arcidiacono; Kristin,26,0,30,4
1713351417599,TDMV 2,A00,492764,Weinberg; Sadie,27,0,30,3
1713351418633,TDMV 3,A00,492765,Mack; Kara Shanai',37,0,40,3
1713351419659,TDMV 138,A00,492777,Mack; Kara Shanai',32,0,40,8
1713351420686,TDMV 140,A00,492778,Lima; Paulo Henrique,40,0,40,0
1713351421713,TDMV 142,A00,492779,Caligagan; Maria T.,33,0,40,7
1713351421713,TDMV 142,B00,492780,Caligagan; Tony,37,0,40,3
1713351422742,TDMV 143,A00,492781,Fyall; Daunte Edward,39,0,40,1
1713351423772,USP 1,A01,492401,Kwak; Nancy,27,0,35,8
1713351424799,USP 2,A01,492453,Hinds; Juli Beth,35,0,35,0
1713351425824,USP 3,A01,492516,Staff,28,0,35,7
1713351426850,USP 4,A00,492522,McTague; Sarah,16,0,25,9
1713351427875,USP 100,A00,492523,Staff,32,0,35,3
1713351428904,USP 101,A00,492524,Staff,13,0,15,2
1713351429933,USP 105,A00,492525,Staff,21,0,25,4
1713351430958,USP 151,A00,492526,Shenkman; Michael Thomas,32,0,35,3
1713351431984,USP 170,A00,492545,Hinds; Juli Beth,32,0,35,3
1713351433014,USP 171GS,A00,492608,Bussell; Mirle Rabinowitz,24,0,28,4
1713351434040,USP 183GS,A00,492613,Peerson; Susan,24,0,28,4
1713351435066,VIS 30,A01,490693,Yoldas; Pinar,19,0,22,3
1713351435066,VIS 30,A02,490694,Yoldas; Pinar,18,0,22,4
1713351436092,VIS 83,A00,490695,Kester; Grant,63,0,75,12
1713351437126,VIS 105D,A00,490696,Staff,22,0,25,3
1713351438150,VIS 124CN,A00,490699,Rose; Jordan M,64,0,75,11
1713351439176,VIS 125GS,A00,511221,Williams; Alena J,21,0,22,1
1713351440200,VIS 128D,A00,490700,Staff,73,0,75,2
1713351441226,VIS 151,A01,490717,Staff,33,0,34,1
1713351441226,VIS 151,A02,490766,Staff,32,0,34,2
1713351442251,VIS 154GS,A00,511972,Williams; Alena J,21,0,22,1
1713351443340,VIS 160A,A00,490767,Stone; Patricia,7,0,10,3
1713351444374,WCWP 10A,A00,490638,Staff,14,0,15,1
1713351444374,WCWP 10A,B00,490640,Staff,15,0,15,0
1713351445400,WCWP 10B,A00,490641,Staff,0,0,0,0
1713351445400,WCWP 10B,B00,490642,Staff,14,0,15,1
1713351445400,WCWP 10B,C00,490644,Staff,13,0,15,2
1713351445400,WCWP 10B,D00,490647,Staff,0,0,0,0
1713351446427,WCWP 100,A00,490655,Staff,0,0,0,0
1713351446427,WCWP 100,B00,490687,Staff,10,0,15,5
1713351448529,ANAR 153,A00,487222,Braswell; Geoffrey E.,53,0,60,7
1713351449553,ANBI 134,A00,487223,Staff,5,0,20,15
1713351450579,ANBI 143GS,A00,487224,Noel; Geoffroy Pierre Jean,18,0,24,6
1713351451605,ANBI 144GS,A00,519548,Noel; Geoffroy Pierre Jean,18,0,24,6
1713351452636,ANSC 101,A00,487225,Staff,17,0,20,3
1713351453661,ANSC 125,A00,487227,Brenner; Suzanne A,38,0,40,2
1713351455720,ANSC 146,A00,487229,Staff,35,0,40,5
1713351456749,ANSC 148,A00,487230,Olivas Hernandez; Olga Lid,39,0,40,1
1713351457773,ANSC 150,A00,504165,Sloane; Julia Kathryn,18,0,20,2
1713351458797,ANSC 180,A00,487232,Staff,14,0,15,1
1713351459826,ANSC 188,A00,627155,Staff,37,0,40,3
1713351460852,ANTH 5,A00,519529,Semendeferi; Ekaterini,15,0,15,0
1713351461877,ANTH 10,A00,487219,Staff,58,0,60,2
1713351462903,ANTH 23,A01,487221,Staff,17,0,20,3
1713351463930,ANTH 102,A00,487233,Wilder; Linnea Lorene,49,0,60,11
1713351464958,ANTH 103,A00,487234,Varma; Saiba,54,0,60,6
1713351465986,ANTH 105,A00,487235,Stewart; Alexander B,54,0,60,6
1713351467012,BENG 100,A01,516685,Taylor Amos; Alyssa C,25,0,30,5
1713351468039,BIBC 102,A01,491316,Flagg; Matthew Paul,3,0,88,85
1713351468039,BIBC 102,A02,491366,Flagg; Matthew Paul,78,0,88,10
1713351469070,BIBC 103,A01,491486,Boumechache; Miyyada,16,0,24,8
1713351469070,BIBC 103,A02,491487,Boumechache; Miyyada,24,0,24,0
1713351470096,BICD 100,A01,516882,Staff,72,0,75,3
1713351470096,BICD 100,A02,516890,Staff,69,0,75,6
1713351471125,BICD 102GS,A00,491488,Lo; Stanley M.,26,0,28,2
1713351472159,BIEB 136GS,A00,516940,Holway; David A. & Shurin; Jonathan,18,0,24,6
1713351473184,BIEB 137GS,A01,517034,Holway; David A. & Shurin; Jonathan,18,0,24,6
1713351474215,BIEB 138GS,A01,491492,Pirino; Giorgia,21,0,28,7
1713351475241,BILD 1,A01,491296,Staff,60,0,63,3
1713351475241,BILD 1,A02,491297,Staff,63,0,63,0
1713351476268,BILD 4,A01,517099,Gonzalez Gamboa; Ivonne,21,0,24,3
1713351476268,BILD 4,A02,517100,Gonzalez Gamboa; Ivonne,24,0,24,0
1713351477292,BILD 60GS,A00,491309,Lo; Stanley M.,26,0,28,2
1713351478323,BIMM 100,A01,517136,Staff,82,0,100,18
1713351479356,BIMM 110,A01,517182,Staff,52,0,100,48
1713351480382,BIMM 120,A01,517228,Pickett; Brooke Elizabeth,28,0,63,35
1713351480382,BIMM 120,A02,517240,Pickett; Brooke Elizabeth,44,0,63,19
1713351481408,BIMM 132GS,A01,491498,Pirino; Giorgia,21,0,28,7
1713351482441,BIMM 143,A01,491589,Bozinovic; Goran,12,0,40,28
1713351483467,BIPN 100,A01,491594,Armour; Jon Christopher,83,0,100,17
1713351484494,BIPN 140,A01,491602,Marino; Marc J,23,0,50,27
1713351486550,CAT 125,A00,515973,Staff,18,0,20,2
1713351487575,CAT 125GS,A00,515974,Rahimi; Babak,16,0,20,4
1713351488610,CAT 125R,A00,515980,Staff,12,0,20,8
1713351488610,CAT 125R,B00,515981,Tosun; Adriana,19,0,20,1
1713351488610,CAT 125R,C00,515987,Hyland; Tina Mae,0,5,20,20
1713351488610,CAT 125R,D00,515988,Bronstein; Phoebe Malan,16,0,20,4
1713351489636,CENG 15,A01,488699,Drews; Aaron,25,0,25,0
1713351490662,CENG 100,A00,505196,Opatkiewicz; Justin Paul,25,0,25,0
1713351491693,CGS 2A,A01,489598,Staff,32,0,35,3
1713351492718,CGS 112,A00,489599,Staff,15,0,15,0
1713351493746,CGS 119,A00,489603,Staff,10,0,10,0
1713351494772,CGS 120,A00,489604,Staff,13,0,15,2
1713351495800,CGS 150,A00,489607,Staff,15,0,15,0
1713351496826,CHEM 6A,A01,488715,Staff,97,0,100,3
1713351497859,CHEM 6B,A01,488719,Piercy; Marc Anthony,99,0,100,1
1713351498891,CHEM 6C,A01,488723,Albizati; Kim F.,92,0,100,8
1713351499920,CHEM 7L,A01,488728,Schurmeier; Kimberly,18,0,24,6
1713351499920,CHEM 7L,A02,488730,Schurmeier; Kimberly,23,0,24,1
1713351499920,CHEM 7L,A03,488734,Schurmeier; Kimberly,20,0,24,4
1713351499920,CHEM 7L,A04,488763,Schurmeier; Kimberly,23,0,24,1
1713351499920,CHEM 7L,B01,488798,Schurmeier; Kimberly,16,0,24,8
1713351499920,CHEM 7L,B02,488801,Schurmeier; Kimberly,22,0,24,2
1713351499920,CHEM 7L,B03,488808,Schurmeier; Kimberly,22,0,24,2
1713351499920,CHEM 7L,B04,488811,Schurmeier; Kimberly,24,0,24,0
1713351500945,CHEM 11,A01,488897,Stallings; Dontarie M,94,0,100,6
1713351501981,CHEM 40A,A01,488913,Albizati; Kim F.,83,0,100,17
1713351503011,CHEM 40B,A01,488920,Weizman; Haim,42,0,50,8
1713351503011,CHEM 40B,A02,488938,Weizman; Haim,43,0,50,7
1713351504038,CHEM 41A,A01,489029,Klosterman; Jeremy K,57,0,60,3
1713351505064,CHEM 41C,A01,500436,Tor; Yitzhak,53,0,60,7
1713351506102,CHEM 43A,A01,500426,Weizman; Haim,0,1,24,24
1713351506102,CHEM 43A,A02,500430,Weizman; Haim,6,0,24,18
1713351506102,CHEM 43A,B01,514041,Klosterman; Jeremy K,14,0,24,10
1713351506102,CHEM 43A,B02,514047,Klosterman; Jeremy K,23,0,24,1
1713351507133,CHEM 108,A01,489140,Jennings; Patricia A.,5,0,24,19
1713351507133,CHEM 108,A02,489142,Jennings; Patricia A.,14,0,24,10
1713351508165,CHEM 114A,A01,489147,Stallings; Dontarie M,65,0,100,35
1713351509191,CHIN 169A,A00,489171,Wang; Xiao,19,0,20,1
1713351511242,COGS 3,A01,518827,Boyle; Mary E. T.,25,0,40,15
1713351512268,COGS 11,A01,489175,Staff,27,0,30,3
1713351513299,COGS 14A,A01,518829,Staff,50,0,60,10
1713351514325,COGS 14B,A01,489177,Hoffman; Drew Ellen,62,0,75,13
1713351515357,COGS 100,A01,489181,Allen; Michael Gordon,62,0,75,13
1713351516640,COGS 101A,A01,489183,Staff,45,0,60,15
1713351517665,COGS 101B,A01,489185,Allen; Michael Gordon,6,0,30,24
1713351518688,COGS 101C,A01,526786,Staff,23,0,30,7
1713351520743,COGS 107A,A01,489189,Boyle; Mary E. T.,16,0,35,19
1713351521775,COGS 107B,A01,627144,Mooshagian; Eric Frederick,59,0,60,1
1713351522799,COGS 118A,A01,489191,Staff,0,46,40,40
1713351524848,COGS 171GS,A01,489194,Pineda; Jaime A,19,0,28,9
1713351525873,COGS 172,A01,489196,Staff,1,0,30,29
1713351526903,COGS 174GS,A01,489264,Pineda; Jaime A,19,0,28,9
1713351527928,COGS 180,A01,627150,Staff,28,0,30,2
1713351528954,COGS 186,A01,489274,Staff,0,3,30,30
1713351529985,COMM 10,A01,489276,Staff,23,0,25,2
1713351529985,COMM 10,A02,489303,Staff,23,0,25,2
1713351531017,COMM 100A,A01,489312,Staff,14,0,25,11
1713351531017,COMM 100A,A02,489313,Staff,24,0,25,1
1713351532041,COMM 106T,A00,512540,Staff,33,0,35,2
1713351533071,COMM 107,A00,489347,Staff,27,0,35,8
1713351534098,COMM 109P,A00,489358,Staff,31,0,35,4
1713351535124,COMM 132,A00,489361,McKenna; Denise,27,0,30,3
1713351536151,COMM 146,A00,489362,Halm; Gavin Patrick,25,0,30,5
1713351537177,COMM 190,A00,489363,Abuelhiga; Soraya Jill,17,0,23,6
1713351538205,CSE 8A,A50,489366,Staff,21,0,25,4
1713351538205,CSE 8A,A51,489367,Staff,24,0,25,1
1713351539231,CSE 11,A01,489398,Cao; Yingjun,72,0,100,28
1713351540269,CSE 12,A01,489487,Staff,43,0,50,7
1713351541295,CSE 20,A01,489497,Staff,47,0,50,3
1713351542319,CSE 21,A01,489517,Braun; Oliver,42,0,50,8
1713351543444,CSE 101,A01,489524,Braun; Oliver,0,35,50,50
1713351544471,CSE 105,A01,512594,Jones; Miles E,72,0,100,28
1713351544471,CSE 105,B01,512598,Jones; Miles E,50,0,100,50
1713351545497,CSE 140,A01,489538,Staff,39,0,50,11
1713351546523,CSE 141,A01,489550,Eldon; John,67,0,100,33
1713351547611,CSE 141L,A01,489571,Eldon; John,65,0,100,35
1713351548638,CSE 151A,A01,489583,Solares; Edwin A,139,0,200,61
1713351549662,CSE 175,A01,510886,Kumar; Rakesh,30,0,30,0
1713351550692,CSE 190,A00,516828,Dubnov; Shlomo,37,0,49,12
1713351551718,DOC 100D,A00,489667,Pass; Natalye Joann,19,0,25,6
1713351552743,DSC 10,A01,624268,Staff,72,0,75,3
1713351553775,DSC 20,A01,624476,Staff,50,0,50,0
1713351554801,DSC 40A,A01,624608,Staff,39,0,40,1
1713351555831,DSGN 1,A01,489179,Rill; Bryan,32,0,50,18
1713351556865,ECE 17,A01,490489,Sahay; Rajeev,18,0,30,12
1713351557893,ECE 65,A50,490492,Staff,11,0,20,9
1713351557893,ECE 65,A51,490493,Staff,18,0,20,2
1713351558921,ECON 1,A01,489715,Famulari; Melissa,67,0,70,3
1713351559947,ECON 2,A01,489717,Levkoff; Steven B.,67,0,70,3
1713351560973,ECON 3,A01,489948,Staff,69,0,70,1
1713351563026,ECON 5,A01,490103,Staff,27,0,30,3
1713351563026,ECON 5,B01,626281,Dai; Yinlin,45,0,45,0
1713351564053,ECON 100A,A01,490127,Famulari; Melissa,62,0,70,8
1713351565078,ECON 100B,A01,490129,Staff,64,0,70,6
1713351566103,ECON 109,A01,490187,Shishkin; Denis,27,0,35,8
1713351567129,ECON 110A,A01,490190,Levkoff; Steven B.,59,0,70,11
1713351568157,ECON 120A,A01,490245,Dai; Yinlin,59,0,70,11
1713351569187,ECON 120B,A01,490247,Nieto-Barthaburu; Augusto,40,0,70,30
1713351570221,ECON 120C,A01,490253,Sun; Yixiao,30,0,35,5
1713351570221,ECON 120C,B01,490255,Sun; Yixiao,34,0,35,1
1713351571246,ECON 129,A00,490256,Eckert; Fabian Paul,22,0,35,13
1713351572270,ECON 131,A00,490257,Nieto-Barthaburu; Augusto,0,6,35,35
1713351573294,ECON 138,A00,490258,Bharadwaj; Prashant,13,0,35,22
1713351573294,ECON 138,B00,490259,Bharadwaj; Prashant,15,0,35,20
1713351574320,ECON 159,A00,490260,Hendrickson; Gerald M.,0,9,0,0
1713351575347,ECON 178,A01,553995,Zhu; Ying,24,0,35,11
1713351576378,EDS 40,A01,512576,Black; Alison Michelle,20,0,20,0
1713351577407,EDS 107,A01,515848,Staff,30,0,30,0
1713351578436,EDS 110R,A01,490262,Staff,26,0,30,4
1713351579459,EDS 112,A01,490264,Chapman; Thandeka K,40,0,50,10
1713351580484,EDS 113,A00,490266,Staff,25,0,30,5
1713351581510,EDS 118,A00,490267,Warstadt; Melissa Fawn,18,0,30,12
1713351582538,EDS 124BR,A00,490268,Eguchi; Emi,4,0,25,21
1713351582538,EDS 124BR,B00,490269,Eguchi; Emi,23,0,25,2
1713351583563,EDS 126,A01,490271,Jones; Makeba,43,0,50,7
1713351584588,EDS 135,A01,490316,Staff,19,0,20,1
1713351585618,ENVR 142GS,A00,519514,Chang; Edmond Yi-Teh,26,0,28,2
1713351586647,ETHN 103,A00,490504,Staff,24,0,36,12
1713351587671,ETHN 103A,A00,490505,Man; Simeon S,3,0,9,6
1713351588697,ETHN 109,A00,490506,Staff,28,0,30,2
1713351589727,ETHN 118,A00,490507,Staff,35,0,36,1
1713351590752,ETHN 119,A00,490508,Staff,32,0,36,4
1713351591777,ETHN 121R,A00,490518,Choi; Esther Min,21,0,36,15
1713351592801,ETHN 127,A00,490528,Staff,14,0,15,1
1713351593827,ETHN 139,A00,490573,Staff,10,0,10,0
1713351594855,ETHN 150,A00,490575,Staff,15,0,15,0
1713351595880,GLBH 20,A00,491705,Elwardani; Nile Regina,38,0,40,2
1713351596907,GLBH 101,A00,491706,Staff,20,0,20,0
1713351597933,GLBH 111,A01,491708,Burgos; Jose L.,15,0,15,0
1713351598960,GLBH 146,A00,491709,Staff,8,0,20,12
1713351599986,GLBH 148,A00,491710,Olivas Hernandez; Olga Lid,10,0,20,10
1713351601017,GLBH 150,A00,491711,Sloane; Julia Kathryn,19,0,20,1
1713351602041,HIEA 131,A00,491760,Staff,28,0,32,4
1713351603067,HIEA 153,A00,491762,Staff,28,0,30,2
1713351604094,HIEU 124,A00,491811,Staff,26,0,32,6
1713351605119,HIEU 124GS,A00,491812,Markman; Kristina,27,0,28,1
1713351606142,HIEU 147,A00,491813,Staff,30,0,32,2
1713351607175,HIEU 149GS,A00,491816,Caldwell; Michael Alan,28,0,28,0
1713351608199,HILD 2C,A01,491713,Hendrickson; Gerald M.,26,0,30,4
1713351609224,HILD 7B,A01,491715,Kwak; Nancy,0,3,30,30
1713351610252,HILD 10,A01,491717,Staff,9,0,20,11
1713351611276,HILD 30GS,A00,491719,Edington; Claire Ellen,23,0,28,5
1713351612314,HINE 109,A00,491818,Shafir; Nir,26,0,32,6
1713351613338,HINE 128,A00,491821,Shafir; Nir,30,0,32,2
1713351614363,HISC 117,A00,491830,Staff,27,0,32,5
1713351615388,HIUS 103,A00,491834,Man; Simeon S,14,0,23,9
1713351616417,HIUS 108B,A00,491835,Staff,27,0,30,3
1713351617451,HIUS 141,A00,491836,Hendrickson; Gerald M.,28,0,32,4
1713351618479,HIUS 149,A00,491839,Staff,24,0,32,8
1713351619505,HUM 3,A01,512617,Crum; Matthew Stephen,42,0,50,8
1713351619505,HUM 3,A02,512618,Crum; Matthew Stephen,48,0,50,2
1713351620531,HUM 3GS,A00,512663,Markman; Kristina,0,0,0,1
1713351620531,HUM 3GS,B00,512664,Staff,0,0,0,0
1713351621564,HUM 4,A01,512620,West; Geoffrey Scott,22,0,50,28
1713351622594,HUM 4GS,A00,512666,Lyon; Antony J.,0,0,0,5
1713351623619,HUM 4R,A01,512625,Watkins; Eric,49,0,50,1
1713351624646,HUM 5,A01,512649,Zavodny; Tatiana Sophia,20,0,50,30
1713351624646,HUM 5,B01,512661,Zroka; Ryan Edward,48,0,50,2
1713351625672,INTL 190,A00,490577,Segui; Alan S,0,0,0,5
1713351626704,JAPN 20AR,A01,491267,Ross; Kayoko F,7,0,20,13
1713351627731,JAPN 180,A00,491285,Berman; Michael David,33,0,40,7
1713351628758,LATI 50,A01,502536,Kokinis; Troy Andreas,16,0,22,6
1713351628758,LATI 50,A02,502551,Kokinis; Troy Andreas,22,0,22,0
1713351628758,LATI 50,A03,502650,Kokinis; Troy Andreas,22,0,22,0
1713351628758,LATI 50,A04,502909,Kokinis; Troy Andreas,21,0,22,1
1713351629788,LATI 160,A01,502920,Kokinis; Troy Andreas,30,0,30,0
1713351630821,LIFR 1A,A00,490494,Van Moer; Vinciane G,17,0,20,3
1713351631850,LIFR 1AX,A00,490495,Van Moer; Vinciane G,17,0,20,3
1713351632878,LIFR 1B,A00,490496,Van Moer; Vinciane G,17,0,20,3
1713351633901,LIFR 1BX,A00,490497,Van Moer; Vinciane G,17,0,20,3
1713351634927,LIGN 8,A00,505198,McIntosh; Justin Daniel,134,0,150,16
1713351635954,LIGN 9GS,A00,491239,Lott; Margaret S.,18,0,20,2
1713351636980,LIGN 101,A01,505200,McIntosh; Justin Daniel,22,0,30,8
1713351638006,LIGN 120,A01,491244,Staff,22,0,30,8
1713351639032,LIGN 149GS,A00,491245,Lott; Margaret S.,18,0,20,2
1713351640055,LIGN 170,A00,491247,Staff,22,0,30,8
1713351641087,LISP 1D,A00,490498,Munoz Sanchez; Alicia,8,0,14,6
1713351641087,LISP 1D,B00,490499,Munoz Sanchez; Alicia,4,0,14,10
1713351641087,LISP 1D,C00,490500,Munoz Sanchez; Alicia,7,0,14,7
1713351641087,LISP 1D,D00,490501,Munoz Sanchez; Alicia,10,0,14,4
1713351642110,LISP 1DX,A00,490502,Munoz Sanchez; Alicia,11,0,28,17
1713351642110,LISP 1DX,B00,490503,Munoz Sanchez; Alicia,16,0,28,12
1713351644167,LTAM 110,A00,491847,Staff,22,0,25,3
1713351645192,LTCS 119,A00,491848,Staff,11,0,15,4
1713351646225,LTCS 130,A00,491849,Staff,24,0,25,1
1713351648280,LTEA 120C,A00,491852,Staff,32,0,40,8
1713351649312,LTEN 130GS,A00,491853,Lyon; Antony J.,23,0,28,5
1713351650338,LTEN 148,A00,491855,Staff,23,0,25,2
1713351651418,LTEN 159,A00,491856,Staff,20,0,25,5
1713351652444,LTEN 180,A00,491857,Staff,8,0,15,7
1713351654495,LTSP 123GS,A00,505928,Bessett; Ryan Matthew,24,0,28,4
1713351655523,LTSP 174GS,A00,506037,Bessett; Ryan Matthew,24,0,28,4
1713351657581,LTWR 102,A00,491861,Staff,9,0,15,6
1713351658608,LTWR 106,A00,491862,Staff,8,0,15,7
1713351659636,MAE 11,A00,490930,Bahadori; Mohammad Yousef,94,0,100,6
1713351660667,MAE 30A,A00,490931,Qi; Huihui,37,0,40,3
1713351661692,MAE 101A,A00,491036,Sadeghizadeh; Zahra,91,0,100,9
1713351662722,MAE 101C,A00,491037,Seshadri; Kalyanasundaram,63,0,100,37
1713351663750,MAE 113,A00,491040,Seshadri; Kalyanasundaram,64,0,80,16
1713351664775,MAE 131A,A00,491041,Ghazinejad; Maziar,37,0,40,3
1713351665801,MAE 142,A00,491053,Staff,39,0,40,1
1713351666827,MAE 143A,A00,491054,Staff,29,0,50,21
1713351667861,MAE 150,A00,491092,Truong; Phuong Thi Ngoc,23,0,35,12
1713351668894,MATH 3C,A01,494031,Pardo Guerra; Sebastian,30,0,30,0
1713351668894,MATH 3C,A02,494032,Pardo Guerra; Sebastian,29,0,30,1
1713351669922,MATH 10A,A01,494034,Staff,27,0,30,3
1713351669922,MATH 10A,A02,494035,Staff,28,0,30,2
1713351669922,MATH 10A,B01,494037,Staff,27,0,30,3
1713351669922,MATH 10A,B02,494038,Staff,29,0,30,1
1713351670950,MATH 10B,A01,494040,Habib; Yousaf,22,0,30,8
1713351670950,MATH 10B,A02,494041,Habib; Yousaf,28,0,30,2
1713351670950,MATH 10B,A03,494042,Habib; Yousaf,29,0,30,1
1713351670950,MATH 10B,A04,494043,Habib; Yousaf,30,0,30,0
1713351670950,MATH 10B,B01,494045,Habib; Yousaf,25,0,30,5
1713351670950,MATH 10B,B02,494046,Habib; Yousaf,30,0,30,0
1713351670950,MATH 10B,B03,494047,Habib; Yousaf,30,0,30,0
1713351670950,MATH 10B,B04,494048,Habib; Yousaf,30,0,30,0
1713351671987,MATH 18,A01,494050,Kemp; Todd Aahron,25,0,30,5
1713351671987,MATH 18,A02,494051,Kemp; Todd Aahron,29,0,30,1
1713351671987,MATH 18,B01,494054,Kemp; Todd Aahron,25,0,30,5
1713351671987,MATH 18,B02,494055,Kemp; Todd Aahron,29,0,30,1
1713351673015,MATH 20A,A01,494059,Suk; Andrew Hoon,30,0,30,0
1713351674042,MATH 20B,A01,494061,Briones; Jor-el Thomas Caparas,33,0,35,2
1713351674042,MATH 20B,B01,494063,Bach; Quang Tran,34,0,35,1
1713351675077,MATH 20C,A01,494065,Staff,28,0,30,2
1713351675077,MATH 20C,A02,494066,Staff,30,0,30,0
1713351675077,MATH 20C,A03,494067,Staff,30,0,30,0
1713351675077,MATH 20C,A04,494068,Staff,30,0,30,0
1713351675077,MATH 20C,B01,494070,Zhang; Ming,23,0,30,7
1713351675077,MATH 20C,B02,494071,Zhang; Ming,27,0,30,3
1713351675077,MATH 20C,B03,494072,Zhang; Ming,29,0,30,1
1713351675077,MATH 20C,B04,494073,Zhang; Ming,29,0,30,1
1713351676103,MATH 20D,A01,494075,Staff,22,0,30,8
1713351676103,MATH 20D,A02,494076,Staff,29,0,30,1
1713351677127,MATH 20E,A01,494079,Staff,24,0,30,6
1713351677127,MATH 20E,A02,494080,Staff,26,0,30,4
1713351677127,MATH 20E,B01,494082,Staff,25,0,30,5
1713351677127,MATH 20E,B02,494083,Staff,25,0,30,5
1713351678158,MATH 103A,A01,494085,Aliabadi Sr.; Mohsen,12,0,30,18
1713351678158,MATH 103A,A02,494086,Aliabadi Sr.; Mohsen,28,0,30,2
1713351678158,MATH 103A,B01,494088,Aliabadi Sr.; Mohsen,19,0,30,11
1713351678158,MATH 103A,B02,494089,Aliabadi Sr.; Mohsen,27,0,30,3
1713351679193,MATH 109,A01,494091,Staff,30,0,30,0
1713351679193,MATH 109,A02,494092,Staff,29,0,30,1
1713351679193,MATH 109,B01,494094,Staff,27,0,30,3
1713351679193,MATH 109,B02,494095,Staff,29,0,30,1
1713351680232,MATH 142A,A01,494097,Chow; Bennett,13,0,30,17
1713351680232,MATH 142A,A02,494098,Chow; Bennett,23,0,30,7
1713351680232,MATH 142A,B01,494100,Chow; Bennett,19,0,30,11
1713351680232,MATH 142A,B02,494101,Chow; Bennett,29,0,30,1
1713351682291,MATH 168A,A01,516677,Dumitriu; Ioana,16,0,35,19
1713351683326,MATH 170A,A01,516679,Dumitriu; Ioana,18,0,30,12
1713351683326,MATH 170A,A02,516680,Dumitriu; Ioana,28,0,30,2
1713351684357,MATH 193A,A01,494107,Staff,12,0,30,18
1713351684357,MATH 193A,A02,494108,Staff,17,0,30,13
1713351684357,MATH 193A,A03,494109,Staff,29,0,30,1
1713351684357,MATH 193A,A04,494110,Staff,22,0,30,8
1713351687443,MGT 16,A00,491930,McKay; Michael J,92,0,98,6
1713351688470,MGT 18,A00,491992,McKay; Michael J,96,0,98,2
1713351689498,MGT 71,A00,492003,Staff,63,0,98,35
1713351690523,MGT 103,A00,505209,Eberhard; Craig A,80,0,98,18
1713351691555,MGT 131A,A00,505210,Anderson; John Charles,89,0,98,9
1713351693604,MGT 153,A00,492077,Perols; Johan Lars,15,0,90,75
1713351696686,MGT 164,A00,492222,McKay; Mary A,91,0,98,7
1713351697721,MGT 172,A00,492245,Staff,59,0,60,1
1713351697721,MGT 172,B00,505526,Hedges; Kathleen,65,0,98,33
1713351698747,MGT 181,A00,505669,Dunn; Louis Jean,78,0,98,20
1713351699775,MMW 14,A01,494399,Staff,15,0,28,13
1713351699775,MMW 14,A02,494400,Staff,25,0,28,3
1713351699775,MMW 14,A03,494401,Staff,28,0,28,0
1713351699775,MMW 14,A04,494402,Staff,28,0,28,0
1713351699775,MMW 14,B01,494404,Carreras; Maria Victoria,8,0,28,20
1713351699775,MMW 14,B02,494405,Carreras; Maria Victoria,25,0,28,3
1713351699775,MMW 14,B03,494406,Carreras; Maria Victoria,27,0,28,1
1713351699775,MMW 14,B04,494407,Carreras; Maria Victoria,28,0,28,0
1713351700800,MMW 14GS,A00,506250,Chang; Edmond Yi-Teh,0,0,0,0
1713351701825,MMW 121R,A01,494415,Adamiak; Patrick John,9,0,28,19
1713351701825,MMW 121R,A02,494416,Adamiak; Patrick John,24,0,28,4
1713351702855,MUS 1A,A01,494113,Staff,12,0,25,13
1713351702855,MUS 1A,A02,494114,Staff,24,0,25,1
1713351703880,MUS 4,A01,494116,Staff,23,0,25,2
1713351703880,MUS 4,A02,494117,Staff,22,0,25,3
1713351704906,MUS 5R,A01,494236,Dubnov; Shlomo,4,0,25,21
1713351704906,MUS 5R,A02,494237,Dubnov; Shlomo,25,0,25,0
1713351705932,MUS 6,A01,494122,Staff,9,0,25,16
1713351705932,MUS 6,A02,494123,Staff,23,0,25,2
1713351706955,MUS 7,A01,494125,Staff,16,0,25,9
1713351706955,MUS 7,A02,494126,Staff,24,0,25,1
1713351707984,MUS 11,A01,494128,Staff,23,0,25,2
1713351707984,MUS 11,A02,494129,Staff,24,0,25,1
1713351709107,MUS 13,A01,494131,Staff,25,0,25,0
1713351709107,MUS 13,A02,494132,Staff,25,0,25,0
1713351710137,MUS 15,A01,494134,Staff,16,0,25,9
1713351710137,MUS 15,A02,494135,Staff,25,0,25,0
1713351710137,MUS 15,B01,494137,Staff,24,0,25,1
1713351711168,MUS 80,A00,494232,Staff,24,0,25,1
1713351711168,MUS 80,B00,494233,Staff,25,0,25,0
1713351711168,MUS 80,C00,494234,Staff,23,0,25,2
1713351712193,MUS 95C,A00,494141,Staff,69,0,75,6
1713351713218,MUS 114,A00,494142,Staff,39,0,50,11
1713351714252,NANO 15,A01,490636,Drews; Aaron,7,0,7,0
1713351715283,PHIL 1,A00,490578,Grush; Rick Scott,49,0,50,1
1713351716308,PHIL 10,A01,490580,Grush; Rick Scott,33,0,35,2
1713351716308,PHIL 10,A02,490586,Grush; Rick Scott,32,0,35,3
1713351717334,PHIL 27,A01,490591,Staff,22,0,25,3
1713351717334,PHIL 27,A02,490592,Staff,25,0,25,0
1713351717334,PHIL 27,A03,490593,Staff,25,0,25,0
1713351717334,PHIL 27,A04,490598,Staff,25,0,25,0
1713351718360,PHIL 32,A01,490611,Staff,20,0,20,0
1713351718360,PHIL 32,A02,490618,Staff,20,0,20,0
1713351719385,PHIL 90,A00,490624,Staff,40,0,40,0
1713351720412,PHIL 136,A00,490627,Cohen; Jonathan David,37,0,40,3
1713351721441,PHIL 155,A00,490634,Staff,61,0,70,9
1713351722474,PHYS 1A,A00,491610,Staff,245,0,250,5
1713351723500,PHYS 1AL,001,491616,Tsai; Philbert S,27,0,30,3
1713351723500,PHYS 1AL,002,491618,Tsai; Philbert S,30,0,30,0
1713351724525,PHYS 1B,A00,491623,Staff,235,0,250,15
1713351725549,PHYS 1BL,001,491626,Tsai; Philbert S,18,0,30,12
1713351725549,PHYS 1BL,002,491628,Tsai; Philbert S,26,0,30,4
1713351726577,PHYS 1C,A00,491632,Staff,211,0,245,34
1713351727600,PHYS 1CL,001,491635,Tsai; Philbert S,2,0,30,28
1713351727600,PHYS 1CL,002,491643,Tsai; Philbert S,22,0,30,8
1713351728626,PHYS 2AR,A01,491651,Meyertholen; Andrew D.,44,0,50,6
1713351729657,PHYS 2B,A01,491659,Staff,105,0,115,10
1713351730680,PHYS 2BL,A01,491685,Staff,21,0,24,3
1713351730680,PHYS 2BL,A02,491700,Staff,21,0,24,3
1713351731706,PHYS 2C,A01,505161,Staff,101,0,115,14
1713351732736,PHYS 4A,A01,491704,Grinstein; Benjamin,99,0,100,1
1713351733769,POLI 5D,A01,494144,Staff,3,0,5,2
1713351733769,POLI 5D,B01,626283,Dai; Yinlin,5,0,5,0
1713351734799,POLI 12,A00,494145,Staff,43,0,45,2
1713351735824,POLI 13R,A00,494146,Forman; Fonna,45,0,50,5
1713351736853,POLI 27,A01,494148,Staff,54,0,60,6
1713351737883,POLI 30,A00,494149,Staff,49,0,50,1
1713351738908,POLI 100DA,A00,494150,Staff,20,0,25,5
1713351740960,POLI 100I,A00,494152,Staff,27,0,30,3
1713351741992,POLI 104B,A00,494153,Smith; Glenn Chatmas,53,0,55,2
1713351743016,POLI 104F,A00,494154,Staff,28,0,30,2
1713351744041,POLI 104I,A00,494155,Smith; Glenn Chatmas,29,0,30,1
1713351745071,POLI 110C,A00,494156,Ingham; Sean,23,0,25,2
1713351746102,POLI 117R,A00,494157,Forman; Fonna,5,0,20,15
1713351747127,POLI 118,A00,494158,Ingham; Sean,21,0,25,4
1713351748156,POLI 120H,A00,494159,Fisk; David Lee,39,0,45,6
1713351749188,POLI 131CR,A00,494160,Hoston; Germaine,35,0,45,10
1713351750213,POLI 133J,A00,494161,Staff,31,0,35,4
1713351751239,POLI 135,A00,494162,Fisk; David Lee,33,0,35,2
1713351752263,POLI 140A,A00,494164,Staff,18,0,30,12
1713351753291,POLI 142I,A00,494165,Staff,30,0,30,0
1713351754317,POLI 144D,A00,494166,Staff,22,0,25,3
1713351755403,POLI 151,A00,494167,Staff,30,0,30,0
1713351756429,POLI 153,A00,494168,Staff,33,0,35,2
1713351757454,POLI 160AA,A00,494169,Staff,33,0,40,7
1713351758479,POLI 162,A00,494170,Mignozzetti; Umberto,17,0,25,8
1713351759507,POLI 171,A00,494171,Mignozzetti; Umberto,18,0,25,7
1713351760534,PSYC 1,A00,494172,Staff,95,0,100,5
1713351761567,PSYC 2,A00,494173,Moranton; Nirelia Melbina-,33,0,50,17
1713351762596,PSYC 3,A00,494174,Staff,29,0,30,1
1713351763621,PSYC 6,A00,494175,Staff,17,0,20,3
1713351764646,PSYC 60,A01,494177,Staff,37,0,45,8
1713351765677,PSYC 70,A01,505724,Geller; Emma Harlan,42,0,45,3
1713351766702,PSYC 101,A00,494180,Heyman; Gail D.,83,0,100,17
1713351767727,PSYC 105,A00,494181,Geller; Emma Harlan,51,0,90,39
1713351768752,PSYC 106,A00,494182,Dobkins; Karen R.,26,0,45,19
1713351769778,PSYC 108,A00,494183,Adrian; Julia Anna,89,0,100,11
1713351770810,PSYC 114,A01,494185,Winkielman; Piotr,0,4,30,30
1713351771835,PSYC 122,A00,494186,Moranton; Nirelia Melbina-,27,0,50,23
1713351772860,PSYC 124,A00,494187,Chapman; Eddie Nathaniel,69,0,80,11
1713351773899,PSYC 131,A00,494188,Anagnostaras; Stephan,39,0,80,41
1713351774928,PSYC 144,A00,494189,Staff,1,1,50,49
1713351775956,PSYC 154,A00,494190,Lacefield; Katharine I,105,0,180,75
1713351776986,PSYC 162,A00,494191,Wixted; John T,70,0,100,30
1713351778017,PSYC 172,A00,494192,Gorman; Michael R.,36,0,45,9
1713351779047,PSYC 178,A00,494193,Glaser; Dale,32,0,45,13
1713351780082,PSYC 193,A00,505725,Chapman; Eddie Nathaniel,20,0,20,0
1713351781110,RELI 145GS,A00,519817,Rahimi; Babak,17,0,20,3
1713351782145,SE 101A,A01,490862,Chadha; Mayank,23,0,25,2
1713351783171,SE 101C,A01,490924,Krysl; Petr,15,0,20,5
1713351784201,SE 110A,A01,490928,Staff,19,0,20,1
1713351785229,SE 130A,A00,490929,Morrison; Machel Leigh,53,0,70,17
1713351786256,SIO 1,A01,519325,Staff,39,0,40,1
1713351787283,SIO 30,A01,519327,Staff,38,0,40,2
1713351788313,SIO 40,A00,519328,Staff,39,0,40,1
1713351789339,SIO 46GS,A00,519819,Cook; Geoffrey W,15,0,25,10
1713351790366,SIO 109R,A00,494197,Forman; Fonna,0,3,20,20
1713351791396,SIO 121GS,A00,519827,Cook; Geoffrey W,15,0,25,10
1713351792425,SIO 132,A01,519330,Staff,38,0,40,2
1713351793455,SIO 133,A01,519397,Staff,37,0,40,3
1713351794483,SIO 139,A00,519396,Kacev; David,29,0,40,11
1713351795513,SOCI 1,A01,494199,Thorpe; Charles Robert,21,0,30,9
1713351795513,SOCI 1,A02,494200,Thorpe; Charles Robert,30,0,30,0
1713351795513,SOCI 1,A03,494201,Thorpe; Charles Robert,29,0,30,1
1713351795513,SOCI 1,A04,494202,Thorpe; Charles Robert,29,0,30,1
1713351795513,SOCI 1,A05,494203,Thorpe; Charles Robert,29,0,30,1
1713351795513,SOCI 1,A06,494204,Thorpe; Charles Robert,30,0,30,0
1713351795513,SOCI 1,A07,494205,Thorpe; Charles Robert,28,0,30,2
1713351796546,SOCI 60,A01,494207,Staff,33,0,40,7
1713351796546,SOCI 60,A02,494208,Staff,39,0,40,1
1713351797579,SOCI 100,A01,494210,Payne; Christine Anna,25,0,30,5
1713351797579,SOCI 100,A02,494211,Payne; Christine Anna,26,0,30,4
1713351798611,SOCI 109M,A00,494212,Staff,20,0,20,0
1713351799638,SOCI 110,A00,494213,Staff,34,0,40,6
1713351801704,SOCI 118E,A00,494215,Ng; Kwai,37,0,40,3
1713351802739,SOCI 125,A00,494216,Calderon-Zaks; Michael Aar,39,0,45,6
1713351803770,SOCI 126,A01,494218,Jones; Makeba,3,0,5,2
1713351804796,SOCI 131,A00,494219,Thorpe; Charles Robert,25,0,30,5
1713351806848,SOCI 135,A00,494221,Payne; Christine Anna,28,0,50,22
1713351807874,SOCI 136E,A00,626690,Ruiz; Jonathan Joseph,24,0,25,1
1713351808897,SOCI 138GS,A00,494222,Navon; Daniel,23,0,28,5
1713351810954,SOCI 145,A00,494224,Staff,40,0,45,5
1713351811981,SOCI 153,A00,494225,Staff,28,0,30,2
1713351813006,SOCI 160E,A00,494226,Ng; Kwai,27,0,40,13
1713351814032,SOCI 180,A00,494227,Staff,29,0,30,1
1713351815064,SOCI 189GS,A00,494228,Ribas Norris; Janet Vanesa,11,0,11,0
1713351816090,SOCI 190GS,A00,553232,Ribas Norris; Janet Vanesa,11,0,11,0
1713351817123,SOMI 220,A00,627178,Schneid; Stephen David,30,0,30,0
1713351818151,SYN 2,001,490768,Staff,13,0,15,2
1713351818151,SYN 2,002,490769,Staff,14,0,15,1
1713351818151,SYN 2,004,490775,Staff,0,0,0,0
1713351818151,SYN 2,003,490774,Staff,0,0,0,0
1713351818151,SYN 2,005,490776,Staff,0,0,0,0
1713351819176,SYN 2R,001,490779,Staff,10,0,15,5
1713351819176,SYN 2R,002,514635,Staff,14,0,15,1
1713351820205,SYN 100,A01,490783,Staff,8,0,20,12
1713351820205,SYN 100,B01,490787,Staff,10,0,20,10
1713351820205,SYN 100,C01,490789,Staff,10,0,20,10
1713351821229,SYN 150,A00,490817,Staff,14,0,15,1
1713351821229,SYN 150,B00,514610,Staff,15,0,15,0
1713351822269,TDAC 1,A00,492753,Walsh; Kim C.,19,0,20,1
1713351822269,TDAC 1,B00,492754,Harting; Carla Kelso,18,0,20,2
1713351822269,TDAC 1,C00,513995,Salovey; Todd,15,0,20,5
1713351823303,TDAC 101,A00,492766,Harting; Carla Kelso,17,0,20,3
1713351824336,TDAC 102,A00,492768,Basso; Beatrice,19,0,20,1
1713351825364,TDDE 111,A00,492769,Staff,25,0,25,0
1713351826394,TDDE 131,A00,492770,Staff,15,0,15,0
1713351826394,TDDE 131,B00,492771,Staff,15,0,15,0
1713351827427,TDDE 131GS,A00,523716,Guirguis; Mark C,23,0,28,5
1713351828462,TDGE 1,A01,492756,Salovey; Todd,56,0,60,4
1713351829488,TDGE 5,A01,492758,Staff,23,0,25,2
1713351830516,TDGE 10,A00,492759,Fulton; Julia,203,0,220,17
1713351831543,TDGE 11,A00,492760,Castro; Robert Jess,198,0,200,2
1713351833607,TDGE 124,A00,492772,Fulton; Julia,180,0,220,40
1713351834638,TDGE 125,A00,492773,Meyer; Ursula,38,0,50,12
1713351834638,TDGE 125,B00,492774,Staff,49,0,50,1
1713351834638,TDGE 125,C00,523565,Staff,48,0,50,2
1713351835664,TDGE 125GS,A00,523580,Guirguis; Mark C,23,0,28,5
1713351836700,TDGE 127,A00,492775,Havis; Allan,33,0,50,17
1713351837725,TDHT 101,A00,492776,Staff,34,0,35,1
1713351838761,TDMV 1,A00,492762,Caligagan; Maria T.,29,0,30,1
1713351838761,TDMV 1,B00,492763,Arcidiacono; Kristin,26,0,30,4
1713351839788,TDMV 2,A00,492764,Weinberg; Sadie,27,0,30,3
1713351840819,TDMV 3,A00,492765,Mack; Kara Shanai',37,0,40,3
1713351841851,TDMV 138,A00,492777,Mack; Kara Shanai',32,0,40,8
1713351842875,TDMV 140,A00,492778,Lima; Paulo Henrique,40,0,40,0
1713351843903,TDMV 142,A00,492779,Caligagan; Maria T.,33,0,40,7
1713351843903,TDMV 142,B00,492780,Caligagan; Tony,37,0,40,3
1713351844929,TDMV 143,A00,492781,Fyall; Daunte Edward,39,0,40,1
1713351845957,USP 1,A01,492401,Kwak; Nancy,27,0,35,8
1713351846990,USP 2,A01,492453,Hinds; Juli Beth,35,0,35,0
1713351848015,USP 3,A01,492516,Staff,28,0,35,7
1713351849040,USP 4,A00,492522,McTague; Sarah,16,0,25,9
1713351850071,USP 100,A00,492523,Staff,32,0,35,3
1713351851095,USP 101,A00,492524,Staff,13,0,15,2
1713351852125,USP 105,A00,492525,Staff,21,0,25,4
1713351853150,USP 151,A00,492526,Shenkman; Michael Thomas,32,0,35,3
1713351854179,USP 170,A00,492545,Hinds; Juli Beth,32,0,35,3
1713351855205,USP 171GS,A00,492608,Bussell; Mirle Rabinowitz,24,0,28,4
1713351856230,USP 183GS,A00,492613,Peerson; Susan,24,0,28,4
1713351857258,VIS 30,A01,490693,Yoldas; Pinar,19,0,22,3
1713351857258,VIS 30,A02,490694,Yoldas; Pinar,18,0,22,4
1713351858284,VIS 83,A00,490695,Kester; Grant,63,0,75,12
1713351859368,VIS 105D,A00,490696,Staff,22,0,25,3
1713351860394,VIS 124CN,A00,490699,Rose; Jordan M,64,0,75,11
1713351861424,VIS 125GS,A00,511221,Williams; Alena J,21,0,22,1
1713351862449,VIS 128D,A00,490700,Staff,73,0,75,2
1713351863475,VIS 151,A01,490717,Staff,33,0,34,1
1713351863475,VIS 151,A02,490766,Staff,32,0,34,2
1713351864503,VIS 154GS,A00,511972,Williams; Alena J,21,0,22,1
1713351865534,VIS 160A,A00,490767,Stone; Patricia,7,0,10,3
1713351866561,WCWP 10A,A00,490638,Staff,14,0,15,1
1713351866561,WCWP 10A,B00,490640,Staff,15,0,15,0
1713351867593,WCWP 10B,A00,490641,Staff,0,0,0,0
1713351867593,WCWP 10B,B00,490642,Staff,14,0,15,1
1713351867593,WCWP 10B,C00,490644,Staff,13,0,15,2
1713351867593,WCWP 10B,D00,490647,Staff,0,0,0,0
1713351868618,WCWP 100,A00,490655,Staff,0,0,0,0
1713351868618,WCWP 100,B00,490687,Staff,10,0,15,5
1713351870760,ANAR 153,A00,487222,Braswell; Geoffrey E.,53,0,60,7
1713351871788,ANBI 134,A00,487223,Staff,5,0,20,15
1713351872816,ANBI 143GS,A00,487224,Noel; Geoffroy Pierre Jean,18,0,24,6
1713351873842,ANBI 144GS,A00,519548,Noel; Geoffroy Pierre Jean,18,0,24,6
1713351874873,ANSC 101,A00,487225,Staff,17,0,20,3
1713351875903,ANSC 125,A00,487227,Brenner; Suzanne A,38,0,40,2
1713351877954,ANSC 146,A00,487229,Staff,35,0,40,5
1713351878983,ANSC 148,A00,487230,Olivas Hernandez; Olga Lid,39,0,40,1
1713351880016,ANSC 150,A00,504165,Sloane; Julia Kathryn,18,0,20,2
1713351881042,ANSC 180,A00,487232,Staff,14,0,15,1
1713351882073,ANSC 188,A00,627155,Staff,37,0,40,3
1713351883109,ANTH 5,A00,519529,Semendeferi; Ekaterini,15,0,15,0
1713351884138,ANTH 10,A00,487219,Staff,58,0,60,2
1713351885166,ANTH 23,A01,487221,Staff,17,0,20,3
1713351886192,ANTH 102,A00,487233,Wilder; Linnea Lorene,49,0,60,11
1713351887219,ANTH 103,A00,487234,Varma; Saiba,54,0,60,6
1713351888251,ANTH 105,A00,487235,Stewart; Alexander B,54,0,60,6
1713351889277,BENG 100,A01,516685,Taylor Amos; Alyssa C,25,0,30,5
1713351890316,BIBC 102,A01,491316,Flagg; Matthew Paul,3,0,88,85
1713351890316,BIBC 102,A02,491366,Flagg; Matthew Paul,78,0,88,10
1713351891343,BIBC 103,A01,491486,Boumechache; Miyyada,16,0,24,8
1713351891343,BIBC 103,A02,491487,Boumechache; Miyyada,24,0,24,0
1713351892381,BICD 100,A01,516882,Staff,72,0,75,3
1713351892381,BICD 100,A02,516890,Staff,69,0,75,6
1713351893406,BICD 102GS,A00,491488,Lo; Stanley M.,26,0,28,2
1713351894431,BIEB 136GS,A00,516940,Holway; David A. & Shurin; Jonathan,18,0,24,6
1713351895457,BIEB 137GS,A01,517034,Holway; David A. & Shurin; Jonathan,18,0,24,6
1713351896486,BIEB 138GS,A01,491492,Pirino; Giorgia,21,0,28,7
1713351897514,BILD 1,A01,491296,Staff,60,0,63,3
1713351897514,BILD 1,A02,491297,Staff,63,0,63,0
1713351898542,BILD 4,A01,517099,Gonzalez Gamboa; Ivonne,21,0,24,3
1713351898542,BILD 4,A02,517100,Gonzalez Gamboa; Ivonne,24,0,24,0
1713351899571,BILD 60GS,A00,491309,Lo; Stanley M.,26,0,28,2
1713351900599,BIMM 100,A01,517136,Staff,82,0,100,18
1713351901624,BIMM 110,A01,517182,Staff,52,0,100,48
1713351902657,BIMM 120,A01,517228,Pickett; Brooke Elizabeth,28,0,63,35
1713351902657,BIMM 120,A02,517240,Pickett; Brooke Elizabeth,44,0,63,19
1713351903690,BIMM 132GS,A01,491498,Pirino; Giorgia,21,0,28,7
1713351904715,BIMM 143,A01,491589,Bozinovic; Goran,12,0,40,28
1713351905751,BIPN 100,A01,491594,Armour; Jon Christopher,83,0,100,17
1713351906780,BIPN 140,A01,491602,Marino; Marc J,23,0,50,27
1713351908833,CAT 125,A00,515973,Staff,18,0,20,2
1713351909862,CAT 125GS,A00,515974,Rahimi; Babak,16,0,20,4
1713351910891,CAT 125R,A00,515980,Staff,12,0,20,8
1713351910891,CAT 125R,B00,515981,Tosun; Adriana,19,0,20,1
1713351910891,CAT 125R,C00,515987,Hyland; Tina Mae,0,5,20,20
1713351910891,CAT 125R,D00,515988,Bronstein; Phoebe Malan,16,0,20,4
1713351911919,CENG 15,A01,488699,Drews; Aaron,25,0,25,0
1713351912946,CENG 100,A00,505196,Opatkiewicz; Justin Paul,25,0,25,0
1713351913972,CGS 2A,A01,489598,Staff,32,0,35,3
1713351914998,CGS 112,A00,489599,Staff,15,0,15,0
1713351916025,CGS 119,A00,489603,Staff,10,0,10,0
1713351917051,CGS 120,A00,489604,Staff,13,0,15,2
1713351918077,CGS 150,A00,489607,Staff,15,0,15,0
1713351919109,CHEM 6A,A01,488715,Staff,97,0,100,3
1713351920136,CHEM 6B,A01,488719,Piercy; Marc Anthony,98,0,100,2
1713351921161,CHEM 6C,A01,488723,Albizati; Kim F.,92,0,100,8
1713351922190,CHEM 7L,A01,488728,Schurmeier; Kimberly,18,0,24,6
1713351922190,CHEM 7L,A02,488730,Schurmeier; Kimberly,23,0,24,1
1713351922190,CHEM 7L,A03,488734,Schurmeier; Kimberly,20,0,24,4
1713351922190,CHEM 7L,A04,488763,Schurmeier; Kimberly,23,0,24,1
1713351922190,CHEM 7L,B01,488798,Schurmeier; Kimberly,16,0,24,8
1713351922190,CHEM 7L,B02,488801,Schurmeier; Kimberly,22,0,24,2
1713351922190,CHEM 7L,B03,488808,Schurmeier; Kimberly,22,0,24,2
1713351922190,CHEM 7L,B04,488811,Schurmeier; Kimberly,24,0,24,0
1713351923215,CHEM 11,A01,488897,Stallings; Dontarie M,94,0,100,6
1713351924239,CHEM 40A,A01,488913,Albizati; Kim F.,83,0,100,17
1713351925271,CHEM 40B,A01,488920,Weizman; Haim,42,0,50,8
1713351925271,CHEM 40B,A02,488938,Weizman; Haim,43,0,50,7
1713351926298,CHEM 41A,A01,489029,Klosterman; Jeremy K,57,0,60,3
1713351927326,CHEM 41C,A01,500436,Tor; Yitzhak,53,0,60,7
1713351928353,CHEM 43A,A01,500426,Weizman; Haim,0,1,24,24
1713351928353,CHEM 43A,A02,500430,Weizman; Haim,6,0,24,18
1713351928353,CHEM 43A,B01,514041,Klosterman; Jeremy K,14,0,24,10
1713351928353,CHEM 43A,B02,514047,Klosterman; Jeremy K,23,0,24,1
1713351929386,CHEM 108,A01,489140,Jennings; Patricia A.,5,0,24,19
1713351929386,CHEM 108,A02,489142,Jennings; Patricia A.,14,0,24,10
1713351930416,CHEM 114A,A01,489147,Stallings; Dontarie M,65,0,100,35
1713351931440,CHIN 169A,A00,489171,Wang; Xiao,19,0,20,1
1713351933494,COGS 3,A01,518827,Boyle; Mary E. T.,25,0,40,15
1713351934523,COGS 11,A01,489175,Staff,27,0,30,3
1713351935551,COGS 14A,A01,518829,Staff,50,0,60,10
1713351936576,COGS 14B,A01,489177,Hoffman; Drew Ellen,62,0,75,13
1713351937607,COGS 100,A01,489181,Allen; Michael Gordon,62,0,75,13
1713351938633,COGS 101A,A01,489183,Staff,45,0,60,15
1713351939659,COGS 101B,A01,489185,Allen; Michael Gordon,6,0,30,24
1713351940690,COGS 101C,A01,526786,Staff,23,0,30,7
1713351942743,COGS 107A,A01,489189,Boyle; Mary E. T.,16,0,35,19
1713351943770,COGS 107B,A01,627144,Mooshagian; Eric Frederick,59,0,60,1
1713351944795,COGS 118A,A01,489191,Staff,0,46,40,40
1713351946853,COGS 171GS,A01,489194,Pineda; Jaime A,19,0,28,9
1713351947884,COGS 172,A01,489196,Staff,1,0,30,29
1713351948914,COGS 174GS,A01,489264,Pineda; Jaime A,19,0,28,9
1713351949944,COGS 180,A01,627150,Staff,28,0,30,2
1713351950971,COGS 186,A01,489274,Staff,0,3,30,30
1713351952000,COMM 10,A01,489276,Staff,23,0,25,2
1713351952000,COMM 10,A02,489303,Staff,23,0,25,2
1713351953027,COMM 100A,A01,489312,Staff,14,0,25,11
1713351953027,COMM 100A,A02,489313,Staff,24,0,25,1
1713351954061,COMM 106T,A00,512540,Staff,33,0,35,2
1713351955088,COMM 107,A00,489347,Staff,27,0,35,8
1713351956113,COMM 109P,A00,489358,Staff,31,0,35,4
1713351957139,COMM 132,A00,489361,McKenna; Denise,27,0,30,3
1713351958175,COMM 146,A00,489362,Halm; Gavin Patrick,25,0,30,5
1713351959200,COMM 190,A00,489363,Abuelhiga; Soraya Jill,17,0,23,6
1713351960235,CSE 8A,A50,489366,Staff,21,0,25,4
1713351960235,CSE 8A,A51,489367,Staff,24,0,25,1
1713351961263,CSE 11,A01,489398,Cao; Yingjun,72,0,100,28
1713351962295,CSE 12,A01,489487,Staff,43,0,50,7
1713351963488,CSE 20,A01,489497,Staff,47,0,50,3
1713351964516,CSE 21,A01,489517,Braun; Oliver,42,0,50,8
1713351965539,CSE 101,A01,489524,Braun; Oliver,0,35,50,50
1713351966568,CSE 105,A01,512594,Jones; Miles E,72,0,100,28
1713351966568,CSE 105,B01,512598,Jones; Miles E,50,0,100,50
1713351967600,CSE 140,A01,489538,Staff,39,0,50,11
1713351968633,CSE 141,A01,489550,Eldon; John,67,0,100,33
1713351969666,CSE 141L,A01,489571,Eldon; John,65,0,100,35
1713351970705,CSE 151A,A01,489583,Solares; Edwin A,139,0,200,61
1713351971729,CSE 175,A01,510886,Kumar; Rakesh,30,0,30,0
1713351972755,CSE 190,A00,516828,Dubnov; Shlomo,37,0,49,12
1713351973788,DOC 100D,A00,489667,Pass; Natalye Joann,19,0,25,6
1713351974819,DSC 10,A01,624268,Staff,72,0,75,3
1713351975845,DSC 20,A01,624476,Staff,50,0,50,0
1713351976870,DSC 40A,A01,624608,Staff,39,0,40,1
1713351977904,DSGN 1,A01,489179,Rill; Bryan,32,0,50,18
1713351978931,ECE 17,A01,490489,Sahay; Rajeev,18,0,30,12
1713351979959,ECE 65,A50,490492,Staff,11,0,20,9
1713351979959,ECE 65,A51,490493,Staff,18,0,20,2
1713351980986,ECON 1,A01,489715,Famulari; Melissa,67,0,70,3
1713351982017,ECON 2,A01,489717,Levkoff; Steven B.,67,0,70,3
1713351983043,ECON 3,A01,489948,Staff,69,0,70,1
1713351985100,ECON 5,A01,490103,Staff,27,0,30,3
1713351985100,ECON 5,B01,626281,Dai; Yinlin,45,0,45,0
1713351986127,ECON 100A,A01,490127,Famulari; Melissa,62,0,70,8
1713351987152,ECON 100B,A01,490129,Staff,64,0,70,6
1713351988183,ECON 109,A01,490187,Shishkin; Denis,27,0,35,8
1713351989209,ECON 110A,A01,490190,Levkoff; Steven B.,59,0,70,11
1713351990233,ECON 120A,A01,490245,Dai; Yinlin,59,0,70,11
1713351991264,ECON 120B,A01,490247,Nieto-Barthaburu; Augusto,40,0,70,30
1713351992301,ECON 120C,A01,490253,Sun; Yixiao,30,0,35,5
1713351992301,ECON 120C,B01,490255,Sun; Yixiao,34,0,35,1
1713351993331,ECON 129,A00,490256,Eckert; Fabian Paul,22,0,35,13
1713351994357,ECON 131,A00,490257,Nieto-Barthaburu; Augusto,0,6,35,35
1713351995389,ECON 138,A00,490258,Bharadwaj; Prashant,13,0,35,22
1713351995389,ECON 138,B00,490259,Bharadwaj; Prashant,15,0,35,20
1713351996414,ECON 159,A00,490260,Hendrickson; Gerald M.,0,9,0,0
1713351997448,ECON 178,A01,553995,Zhu; Ying,24,0,35,11
1713351998473,EDS 40,A01,512576,Black; Alison Michelle,20,0,20,0
1713351999500,EDS 107,A01,515848,Staff,30,0,30,0
1713352000524,EDS 110R,A01,490262,Staff,26,0,30,4
1713352001556,EDS 112,A01,490264,Chapman; Thandeka K,40,0,50,10
1713352002580,EDS 113,A00,490266,Staff,25,0,30,5
1713352003608,EDS 118,A00,490267,Warstadt; Melissa Fawn,18,0,30,12
1713352004634,EDS 124BR,A00,490268,Eguchi; Emi,4,0,25,21
1713352004634,EDS 124BR,B00,490269,Eguchi; Emi,23,0,25,2
1713352005664,EDS 126,A01,490271,Jones; Makeba,43,0,50,7
1713352006694,EDS 135,A01,490316,Staff,19,0,20,1
1713352007721,ENVR 142GS,A00,519514,Chang; Edmond Yi-Teh,26,0,28,2
1713352008746,ETHN 103,A00,490504,Staff,24,0,36,12
1713352009771,ETHN 103A,A00,490505,Man; Simeon S,3,0,9,6
1713352010800,ETHN 109,A00,490506,Staff,28,0,30,2
1713352011825,ETHN 118,A00,490507,Staff,35,0,36,1
1713352012852,ETHN 119,A00,490508,Staff,32,0,36,4
1713352013876,ETHN 121R,A00,490518,Choi; Esther Min,21,0,36,15
1713352014905,ETHN 127,A00,490528,Staff,14,0,15,1
1713352015935,ETHN 139,A00,490573,Staff,10,0,10,0
1713352016965,ETHN 150,A00,490575,Staff,15,0,15,0
1713352017999,GLBH 20,A00,491705,Elwardani; Nile Regina,38,0,40,2
1713352019026,GLBH 101,A00,491706,Staff,20,0,20,0
1713352020059,GLBH 111,A01,491708,Burgos; Jose L.,15,0,15,0
1713352021084,GLBH 146,A00,491709,Staff,8,0,20,12
1713352022116,GLBH 148,A00,491710,Olivas Hernandez; Olga Lid,10,0,20,10
1713352023154,GLBH 150,A00,491711,Sloane; Julia Kathryn,19,0,20,1
1713352024179,HIEA 131,A00,491760,Staff,28,0,32,4
1713352025204,HIEA 153,A00,491762,Staff,28,0,30,2
1713352026230,HIEU 124,A00,491811,Staff,26,0,32,6
1713352027261,HIEU 124GS,A00,491812,Markman; Kristina,27,0,28,1
1713352028289,HIEU 147,A00,491813,Staff,30,0,32,2
1713352029320,HIEU 149GS,A00,491816,Caldwell; Michael Alan,28,0,28,0
1713352030350,HILD 2C,A01,491713,Hendrickson; Gerald M.,26,0,30,4
1713352031376,HILD 7B,A01,491715,Kwak; Nancy,0,3,30,30
1713352032401,HILD 10,A01,491717,Staff,9,0,20,11
1713352033430,HILD 30GS,A00,491719,Edington; Claire Ellen,23,0,28,5
1713352034456,HINE 109,A00,491818,Shafir; Nir,26,0,32,6
1713352035480,HINE 128,A00,491821,Shafir; Nir,30,0,32,2
1713352036505,HISC 117,A00,491830,Staff,27,0,32,5
1713352037531,HIUS 103,A00,491834,Man; Simeon S,14,0,23,9
1713352038560,HIUS 108B,A00,491835,Staff,27,0,30,3
1713352039590,HIUS 141,A00,491836,Hendrickson; Gerald M.,28,0,32,4
1713352040621,HIUS 149,A00,491839,Staff,24,0,32,8
1713352041647,HUM 3,A01,512617,Crum; Matthew Stephen,42,0,50,8
1713352041647,HUM 3,A02,512618,Crum; Matthew Stephen,48,0,50,2
1713352042673,HUM 3GS,A00,512663,Markman; Kristina,0,0,0,1
1713352042673,HUM 3GS,B00,512664,Staff,0,0,0,0
1713352043699,HUM 4,A01,512620,West; Geoffrey Scott,22,0,50,28
1713352044730,HUM 4GS,A00,512666,Lyon; Antony J.,0,0,0,5
1713352045757,HUM 4R,A01,512625,Watkins; Eric,49,0,50,1
1713352046791,HUM 5,A01,512649,Zavodny; Tatiana Sophia,20,0,50,30
1713352046791,HUM 5,B01,512661,Zroka; Ryan Edward,48,0,50,2
1713352047816,INTL 190,A00,490577,Segui; Alan S,0,0,0,5
1713352048843,JAPN 20AR,A01,491267,Ross; Kayoko F,7,0,20,13
1713352049868,JAPN 180,A00,491285,Berman; Michael David,33,0,40,7
1713352050902,LATI 50,A01,502536,Kokinis; Troy Andreas,16,0,22,6
1713352050902,LATI 50,A02,502551,Kokinis; Troy Andreas,22,0,22,0
1713352050902,LATI 50,A03,502650,Kokinis; Troy Andreas,22,0,22,0
1713352050902,LATI 50,A04,502909,Kokinis; Troy Andreas,21,0,22,1
1713352051931,LATI 160,A01,502920,Kokinis; Troy Andreas,30,0,30,0
1713352052957,LIFR 1A,A00,490494,Van Moer; Vinciane G,17,0,20,3
1713352053989,LIFR 1AX,A00,490495,Van Moer; Vinciane G,17,0,20,3
1713352055014,LIFR 1B,A00,490496,Van Moer; Vinciane G,17,0,20,3
1713352056038,LIFR 1BX,A00,490497,Van Moer; Vinciane G,17,0,20,3
1713352057069,LIGN 8,A00,505198,McIntosh; Justin Daniel,134,0,150,16
1713352058095,LIGN 9GS,A00,491239,Lott; Margaret S.,18,0,20,2
1713352059120,LIGN 101,A01,505200,McIntosh; Justin Daniel,22,0,30,8
1713352060150,LIGN 120,A01,491244,Staff,22,0,30,8
1713352061178,LIGN 149GS,A00,491245,Lott; Margaret S.,18,0,20,2
1713352062203,LIGN 170,A00,491247,Staff,22,0,30,8
1713352063229,LISP 1D,A00,490498,Munoz Sanchez; Alicia,8,0,14,6
1713352063229,LISP 1D,B00,490499,Munoz Sanchez; Alicia,4,0,14,10
1713352063229,LISP 1D,C00,490500,Munoz Sanchez; Alicia,7,0,14,7
1713352063229,LISP 1D,D00,490501,Munoz Sanchez; Alicia,10,0,14,4
1713352064253,LISP 1DX,A00,490502,Munoz Sanchez; Alicia,11,0,28,17
1713352064253,LISP 1DX,B00,490503,Munoz Sanchez; Alicia,16,0,28,12
1713352066303,LTAM 110,A00,491847,Staff,22,0,25,3
1713352067389,LTCS 119,A00,491848,Staff,11,0,15,4
1713352068420,LTCS 130,A00,491849,Staff,24,0,25,1
1713352070469,LTEA 120C,A00,491852,Staff,32,0,40,8
1713352071499,LTEN 130GS,A00,491853,Lyon; Antony J.,23,0,28,5
1713352072528,LTEN 148,A00,491855,Staff,23,0,25,2
1713352073558,LTEN 159,A00,491856,Staff,20,0,25,5
1713352074587,LTEN 180,A00,491857,Staff,8,0,15,7
1713352076645,LTSP 123GS,A00,505928,Bessett; Ryan Matthew,24,0,28,4
1713352077670,LTSP 174GS,A00,506037,Bessett; Ryan Matthew,24,0,28,4
1713352079726,LTWR 102,A00,491861,Staff,9,0,15,6
1713352080756,LTWR 106,A00,491862,Staff,8,0,15,7
1713352081789,MAE 11,A00,490930,Bahadori; Mohammad Yousef,94,0,100,6
1713352082823,MAE 30A,A00,490931,Qi; Huihui,37,0,40,3
1713352083852,MAE 101A,A00,491036,Sadeghizadeh; Zahra,91,0,100,9
1713352084880,MAE 101C,A00,491037,Seshadri; Kalyanasundaram,63,0,100,37
1713352085904,MAE 113,A00,491040,Seshadri; Kalyanasundaram,64,0,80,16
1713352086930,MAE 131A,A00,491041,Ghazinejad; Maziar,37,0,40,3
1713352087955,MAE 142,A00,491053,Staff,39,0,40,1
1713352088983,MAE 143A,A00,491054,Staff,29,0,50,21
1713352090011,MAE 150,A00,491092,Truong; Phuong Thi Ngoc,23,0,35,12
1713352091038,MATH 3C,A01,494031,Pardo Guerra; Sebastian,30,0,30,0
1713352091038,MATH 3C,A02,494032,Pardo Guerra; Sebastian,29,0,30,1
1713352092065,MATH 10A,A01,494034,Staff,27,0,30,3
1713352092065,MATH 10A,A02,494035,Staff,28,0,30,2
1713352092065,MATH 10A,B01,494037,Staff,27,0,30,3
1713352092065,MATH 10A,B02,494038,Staff,29,0,30,1
1713352093090,MATH 10B,A01,494040,Habib; Yousaf,22,0,30,8
1713352093090,MATH 10B,A02,494041,Habib; Yousaf,28,0,30,2
1713352093090,MATH 10B,A03,494042,Habib; Yousaf,29,0,30,1
1713352093090,MATH 10B,A04,494043,Habib; Yousaf,30,0,30,0
1713352093090,MATH 10B,B01,494045,Habib; Yousaf,25,0,30,5
1713352093090,MATH 10B,B02,494046,Habib; Yousaf,30,0,30,0
1713352093090,MATH 10B,B03,494047,Habib; Yousaf,30,0,30,0
1713352093090,MATH 10B,B04,494048,Habib; Yousaf,30,0,30,0
1713352094117,MATH 18,A01,494050,Kemp; Todd Aahron,25,0,30,5
1713352094117,MATH 18,A02,494051,Kemp; Todd Aahron,29,0,30,1
1713352094117,MATH 18,B01,494054,Kemp; Todd Aahron,25,0,30,5
1713352094117,MATH 18,B02,494055,Kemp; Todd Aahron,29,0,30,1
1713352095143,MATH 20A,A01,494059,Suk; Andrew Hoon,30,0,30,0
1713352096174,MATH 20B,A01,494061,Briones; Jor-el Thomas Caparas,33,0,35,2
1713352096174,MATH 20B,B01,494063,Bach; Quang Tran,34,0,35,1
1713352097201,MATH 20C,A01,494065,Staff,28,0,30,2
1713352097201,MATH 20C,A02,494066,Staff,30,0,30,0
1713352097201,MATH 20C,A03,494067,Staff,30,0,30,0
1713352097201,MATH 20C,A04,494068,Staff,30,0,30,0
1713352097201,MATH 20C,B01,494070,Zhang; Ming,23,0,30,7
1713352097201,MATH 20C,B02,494071,Zhang; Ming,27,0,30,3
1713352097201,MATH 20C,B03,494072,Zhang; Ming,29,0,30,1
1713352097201,MATH 20C,B04,494073,Zhang; Ming,29,0,30,1
1713352098227,MATH 20D,A01,494075,Staff,22,0,30,8
1713352098227,MATH 20D,A02,494076,Staff,29,0,30,1
1713352099259,MATH 20E,A01,494079,Staff,24,0,30,6
1713352099259,MATH 20E,A02,494080,Staff,26,0,30,4
1713352099259,MATH 20E,B01,494082,Staff,25,0,30,5
1713352099259,MATH 20E,B02,494083,Staff,25,0,30,5
1713352100290,MATH 103A,A01,494085,Aliabadi Sr.; Mohsen,12,0,30,18
1713352100290,MATH 103A,A02,494086,Aliabadi Sr.; Mohsen,28,0,30,2
1713352100290,MATH 103A,B01,494088,Aliabadi Sr.; Mohsen,19,0,30,11
1713352100290,MATH 103A,B02,494089,Aliabadi Sr.; Mohsen,27,0,30,3
1713352101317,MATH 109,A01,494091,Staff,30,0,30,0
1713352101317,MATH 109,A02,494092,Staff,29,0,30,1
1713352101317,MATH 109,B01,494094,Staff,27,0,30,3
1713352101317,MATH 109,B02,494095,Staff,29,0,30,1
1713352102348,MATH 142A,A01,494097,Chow; Bennett,13,0,30,17
1713352102348,MATH 142A,A02,494098,Chow; Bennett,23,0,30,7
1713352102348,MATH 142A,B01,494100,Chow; Bennett,19,0,30,11
1713352102348,MATH 142A,B02,494101,Chow; Bennett,29,0,30,1
1713352104400,MATH 168A,A01,516677,Dumitriu; Ioana,16,0,35,19
1713352105428,MATH 170A,A01,516679,Dumitriu; Ioana,18,0,30,12
1713352105428,MATH 170A,A02,516680,Dumitriu; Ioana,28,0,30,2
1713352106453,MATH 193A,A01,494107,Staff,12,0,30,18
1713352106453,MATH 193A,A02,494108,Staff,17,0,30,13
1713352106453,MATH 193A,A03,494109,Staff,29,0,30,1
1713352106453,MATH 193A,A04,494110,Staff,22,0,30,8
1713352109536,MGT 16,A00,491930,McKay; Michael J,92,0,98,6
1713352110559,MGT 18,A00,491992,McKay; Michael J,96,0,98,2
1713352111586,MGT 71,A00,492003,Staff,63,0,98,35
1713352112617,MGT 103,A00,505209,Eberhard; Craig A,80,0,98,18
1713352113650,MGT 131A,A00,505210,Anderson; John Charles,89,0,98,9
1713352115703,MGT 153,A00,492077,Perols; Johan Lars,15,0,90,75
1713352118780,MGT 164,A00,492222,McKay; Mary A,91,0,98,7
1713352119808,MGT 172,A00,492245,Staff,59,0,60,1
1713352119808,MGT 172,B00,505526,Hedges; Kathleen,65,0,98,33
1713352120836,MGT 181,A00,505669,Dunn; Louis Jean,78,0,98,20
1713352121863,MMW 14,A01,494399,Staff,15,0,28,13
1713352121863,MMW 14,A02,494400,Staff,25,0,28,3
1713352121863,MMW 14,A03,494401,Staff,28,0,28,0
1713352121863,MMW 14,A04,494402,Staff,28,0,28,0
1713352121863,MMW 14,B01,494404,Carreras; Maria Victoria,8,0,28,20
1713352121863,MMW 14,B02,494405,Carreras; Maria Victoria,25,0,28,3
1713352121863,MMW 14,B03,494406,Carreras; Maria Victoria,27,0,28,1
1713352121863,MMW 14,B04,494407,Carreras; Maria Victoria,28,0,28,0
1713352122889,MMW 14GS,A00,506250,Chang; Edmond Yi-Teh,0,0,0,0
1713352123913,MMW 121R,A01,494415,Adamiak; Patrick John,9,0,28,19
1713352123913,MMW 121R,A02,494416,Adamiak; Patrick John,24,0,28,4
1713352124944,MUS 1A,A01,494113,Staff,12,0,25,13
1713352124944,MUS 1A,A02,494114,Staff,24,0,25,1
1713352126133,MUS 4,A01,494116,Staff,23,0,25,2
1713352126133,MUS 4,A02,494117,Staff,22,0,25,3
1713352127165,MUS 5R,A01,494236,Dubnov; Shlomo,4,0,25,21
1713352127165,MUS 5R,A02,494237,Dubnov; Shlomo,25,0,25,0
1713352128190,MUS 6,A01,494122,Staff,9,0,25,16
1713352128190,MUS 6,A02,494123,Staff,23,0,25,2
1713352129217,MUS 7,A01,494125,Staff,16,0,25,9
1713352129217,MUS 7,A02,494126,Staff,24,0,25,1
1713352130332,MUS 11,A01,494128,Staff,23,0,25,2
1713352130332,MUS 11,A02,494129,Staff,24,0,25,1
1713352131359,MUS 13,A01,494131,Staff,25,0,25,0
1713352131359,MUS 13,A02,494132,Staff,25,0,25,0
1713352132386,MUS 15,A01,494134,Staff,16,0,25,9
1713352132386,MUS 15,A02,494135,Staff,25,0,25,0
1713352132386,MUS 15,B01,494137,Staff,24,0,25,1
1713352134172,MUS 80,A00,494232,Staff,24,0,25,1
1713352134172,MUS 80,B00,494233,Staff,25,0,25,0
1713352134172,MUS 80,C00,494234,Staff,23,0,25,2
1713352135199,MUS 95C,A00,494141,Staff,69,0,75,6
1713352136229,MUS 114,A00,494142,Staff,39,0,50,11
1713352137257,NANO 15,A01,490636,Drews; Aaron,7,0,7,0
1713352138285,PHIL 1,A00,490578,Grush; Rick Scott,49,0,50,1
1713352139312,PHIL 10,A01,490580,Grush; Rick Scott,33,0,35,2
1713352139312,PHIL 10,A02,490586,Grush; Rick Scott,32,0,35,3
1713352140338,PHIL 27,A01,490591,Staff,22,0,25,3
1713352140338,PHIL 27,A02,490592,Staff,25,0,25,0
1713352140338,PHIL 27,A03,490593,Staff,25,0,25,0
1713352140338,PHIL 27,A04,490598,Staff,25,0,25,0
1713352141374,PHIL 32,A01,490611,Staff,20,0,20,0
1713352141374,PHIL 32,A02,490618,Staff,20,0,20,0
1713352142402,PHIL 90,A00,490624,Staff,40,0,40,0
1713352143447,PHIL 136,A00,490627,Cohen; Jonathan David,37,0,40,3
1713352144477,PHIL 155,A00,490634,Staff,61,0,70,9
1713352145508,PHYS 1A,A00,491610,Staff,245,0,250,5
1713352146531,PHYS 1AL,001,491616,Tsai; Philbert S,27,0,30,3
1713352146531,PHYS 1AL,002,491618,Tsai; Philbert S,30,0,30,0
1713352147559,PHYS 1B,A00,491623,Staff,235,0,250,15
1713352148584,PHYS 1BL,001,491626,Tsai; Philbert S,18,0,30,12
1713352148584,PHYS 1BL,002,491628,Tsai; Philbert S,26,0,30,4
1713352149610,PHYS 1C,A00,491632,Staff,211,0,245,34
1713352150640,PHYS 1CL,001,491635,Tsai; Philbert S,2,0,30,28
1713352150640,PHYS 1CL,002,491643,Tsai; Philbert S,22,0,30,8
1713352151667,PHYS 2AR,A01,491651,Meyertholen; Andrew D.,44,0,50,6
1713352152694,PHYS 2B,A01,491659,Staff,105,0,115,10
1713352153720,PHYS 2BL,A01,491685,Staff,21,0,24,3
1713352153720,PHYS 2BL,A02,491700,Staff,21,0,24,3
1713352154751,PHYS 2C,A01,505161,Staff,101,0,115,14
1713352155782,PHYS 4A,A01,491704,Grinstein; Benjamin,99,0,100,1
1713352156817,POLI 5D,A01,494144,Staff,3,0,5,2
1713352156817,POLI 5D,B01,626283,Dai; Yinlin,5,0,5,0
1713352157845,POLI 12,A00,494145,Staff,43,0,45,2
1713352158875,POLI 13R,A00,494146,Forman; Fonna,45,0,50,5
1713352159904,POLI 27,A01,494148,Staff,54,0,60,6
1713352160929,POLI 30,A00,494149,Staff,49,0,50,1
1713352161957,POLI 100DA,A00,494150,Staff,20,0,25,5
1713352164012,POLI 100I,A00,494152,Staff,27,0,30,3
1713352165042,POLI 104B,A00,494153,Smith; Glenn Chatmas,53,0,55,2
1713352166068,POLI 104F,A00,494154,Staff,28,0,30,2
1713352167093,POLI 104I,A00,494155,Smith; Glenn Chatmas,29,0,30,1
1713352168120,POLI 110C,A00,494156,Ingham; Sean,23,0,25,2
1713352169145,POLI 117R,A00,494157,Forman; Fonna,5,0,20,15
1713352170170,POLI 118,A00,494158,Ingham; Sean,21,0,25,4
1713352171196,POLI 120H,A00,494159,Fisk; David Lee,39,0,45,6
1713352172274,POLI 131CR,A00,494160,Hoston; Germaine,35,0,45,10
1713352173303,POLI 133J,A00,494161,Staff,31,0,35,4
1713352174329,POLI 135,A00,494162,Fisk; David Lee,33,0,35,2
1713352175358,POLI 140A,A00,494164,Staff,18,0,30,12
1713352176387,POLI 142I,A00,494165,Staff,30,0,30,0
1713352177413,POLI 144D,A00,494166,Staff,22,0,25,3
1713352178442,POLI 151,A00,494167,Staff,30,0,30,0
1713352179467,POLI 153,A00,494168,Staff,33,0,35,2
1713352180493,POLI 160AA,A00,494169,Staff,33,0,40,7
1713352181518,POLI 162,A00,494170,Mignozzetti; Umberto,17,0,25,8
1713352182549,POLI 171,A00,494171,Mignozzetti; Umberto,18,0,25,7
1713352183576,PSYC 1,A00,494172,Staff,95,0,100,5
1713352184603,PSYC 2,A00,494173,Moranton; Nirelia Melbina-,33,0,50,17
1713352185632,PSYC 3,A00,494174,Staff,29,0,30,1
1713352186660,PSYC 6,A00,494175,Staff,17,0,20,3
1713352187688,PSYC 60,A01,494177,Staff,37,0,45,8
1713352188714,PSYC 70,A01,505724,Geller; Emma Harlan,42,0,45,3
1713352189738,PSYC 101,A00,494180,Heyman; Gail D.,83,0,100,17
1713352190764,PSYC 105,A00,494181,Geller; Emma Harlan,51,0,90,39
1713352191835,PSYC 106,A00,494182,Dobkins; Karen R.,26,0,45,19
1713352192859,PSYC 108,A00,494183,Adrian; Julia Anna,89,0,100,11
1713352193893,PSYC 114,A01,494185,Winkielman; Piotr,0,4,30,30
1713352194919,PSYC 122,A00,494186,Moranton; Nirelia Melbina-,27,0,50,23
1713352195953,PSYC 124,A00,494187,Chapman; Eddie Nathaniel,69,0,80,11
1713352196979,PSYC 131,A00,494188,Anagnostaras; Stephan,39,0,80,41
1713352198006,PSYC 144,A00,494189,Staff,1,1,50,49
1713352199039,PSYC 154,A00,494190,Lacefield; Katharine I,105,0,180,75
1713352200064,PSYC 162,A00,494191,Wixted; John T,70,0,100,30
1713352201095,PSYC 172,A00,494192,Gorman; Michael R.,36,0,45,9
1713352202125,PSYC 178,A00,494193,Glaser; Dale,32,0,45,13
1713352203161,PSYC 193,A00,505725,Chapman; Eddie Nathaniel,20,0,20,0
1713352204191,RELI 145GS,A00,519817,Rahimi; Babak,17,0,20,3
1713352205218,SE 101A,A01,490862,Chadha; Mayank,23,0,25,2
1713352206244,SE 101C,A01,490924,Krysl; Petr,15,0,20,5
1713352207273,SE 110A,A01,490928,Staff,19,0,20,1
1713352208332,SE 130A,A00,490929,Morrison; Machel Leigh,53,0,70,17
1713352209530,SIO 1,A01,519325,Staff,39,0,40,1
1713352210559,SIO 30,A01,519327,Staff,38,0,40,2
1713352211585,SIO 40,A00,519328,Staff,39,0,40,1
1713352212612,SIO 46GS,A00,519819,Cook; Geoffrey W,15,0,25,10
1713352213637,SIO 109R,A00,494197,Forman; Fonna,0,3,20,20
1713352214664,SIO 121GS,A00,519827,Cook; Geoffrey W,15,0,25,10
1713352215691,SIO 132,A01,519330,Staff,38,0,40,2
1713352216721,SIO 133,A01,519397,Staff,37,0,40,3
1713352217746,SIO 139,A00,519396,Kacev; David,29,0,40,11
1713352218781,SOCI 1,A01,494199,Thorpe; Charles Robert,21,0,30,9
1713352218781,SOCI 1,A02,494200,Thorpe; Charles Robert,30,0,30,0
1713352218781,SOCI 1,A03,494201,Thorpe; Charles Robert,29,0,30,1
1713352218781,SOCI 1,A04,494202,Thorpe; Charles Robert,29,0,30,1
1713352218781,SOCI 1,A05,494203,Thorpe; Charles Robert,29,0,30,1
1713352218781,SOCI 1,A06,494204,Thorpe; Charles Robert,30,0,30,0
1713352218781,SOCI 1,A07,494205,Thorpe; Charles Robert,28,0,30,2
1713352219805,SOCI 60,A01,494207,Staff,33,0,40,7
1713352219805,SOCI 60,A02,494208,Staff,39,0,40,1
1713352220833,SOCI 100,A01,494210,Payne; Christine Anna,25,0,30,5
1713352220833,SOCI 100,A02,494211,Payne; Christine Anna,26,0,30,4
1713352221856,SOCI 109M,A00,494212,Staff,20,0,20,0
1713352222882,SOCI 110,A00,494213,Staff,34,0,40,6
1713352225011,SOCI 118E,A00,494215,Ng; Kwai,37,0,40,3
1713352226037,SOCI 125,A00,494216,Calderon-Zaks; Michael Aar,39,0,45,6
1713352227063,SOCI 126,A01,494218,Jones; Makeba,3,0,5,2
1713352228089,SOCI 131,A00,494219,Thorpe; Charles Robert,25,0,30,5
1713352230145,SOCI 135,A00,494221,Payne; Christine Anna,28,0,50,22
1713352231177,SOCI 136E,A00,626690,Ruiz; Jonathan Joseph,24,0,25,1
1713352232208,SOCI 138GS,A00,494222,Navon; Daniel,23,0,28,5
1713352234443,SOCI 145,A00,494224,Staff,40,0,45,5
1713352235472,SOCI 153,A00,494225,Staff,28,0,30,2
1713352236502,SOCI 160E,A00,494226,Ng; Kwai,27,0,40,13
1713352237526,SOCI 180,A00,494227,Staff,29,0,30,1
1713352238551,SOCI 189GS,A00,494228,Ribas Norris; Janet Vanesa,11,0,11,0
1713352239577,SOCI 190GS,A00,553232,Ribas Norris; Janet Vanesa,11,0,11,0
1713352240609,SOMI 220,A00,627178,Schneid; Stephen David,30,0,30,0
1713352241703,SYN 2,001,490768,Staff,13,0,15,2
1713352241703,SYN 2,002,490769,Staff,14,0,15,1
1713352241703,SYN 2,004,490775,Staff,0,0,0,0
1713352241703,SYN 2,003,490774,Staff,0,0,0,0
1713352241703,SYN 2,005,490776,Staff,0,0,0,0
1713352242735,SYN 2R,001,490779,Staff,10,0,15,5
1713352242735,SYN 2R,002,514635,Staff,14,0,15,1
1713352243759,SYN 100,A01,490783,Staff,8,0,20,12
1713352243759,SYN 100,B01,490787,Staff,10,0,20,10
1713352243759,SYN 100,C01,490789,Staff,10,0,20,10
1713352244787,SYN 150,A00,490817,Staff,14,0,15,1
1713352244787,SYN 150,B00,514610,Staff,15,0,15,0
1713352245841,TDAC 1,A00,492753,Walsh; Kim C.,19,0,20,1
1713352245841,TDAC 1,B00,492754,Harting; Carla Kelso,18,0,20,2
1713352245841,TDAC 1,C00,513995,Salovey; Todd,15,0,20,5
1713352246867,TDAC 101,A00,492766,Harting; Carla Kelso,17,0,20,3
1713352247899,TDAC 102,A00,492768,Basso; Beatrice,19,0,20,1
1713352248928,TDDE 111,A00,492769,Staff,25,0,25,0
1713352249959,TDDE 131,A00,492770,Staff,15,0,15,0
1713352249959,TDDE 131,B00,492771,Staff,15,0,15,0
1713352250991,TDDE 131GS,A00,523716,Guirguis; Mark C,23,0,28,5
1713352252018,TDGE 1,A01,492756,Salovey; Todd,56,0,60,4
1713352253042,TDGE 5,A01,492758,Staff,23,0,25,2
1713352254072,TDGE 10,A00,492759,Fulton; Julia,203,0,220,17
1713352255106,TDGE 11,A00,492760,Castro; Robert Jess,198,0,200,2
1713352257159,TDGE 124,A00,492772,Fulton; Julia,180,0,220,40
1713352258186,TDGE 125,A00,492773,Meyer; Ursula,38,0,50,12
1713352258186,TDGE 125,B00,492774,Staff,49,0,50,1
1713352258186,TDGE 125,C00,523565,Staff,48,0,50,2
1713352259216,TDGE 125GS,A00,523580,Guirguis; Mark C,23,0,28,5
1713352260241,TDGE 127,A00,492775,Havis; Allan,33,0,50,17
1713352261268,TDHT 101,A00,492776,Staff,34,0,35,1
1713352262301,TDMV 1,A00,492762,Caligagan; Maria T.,29,0,30,1
1713352262301,TDMV 1,B00,492763,Arcidiacono; Kristin,26,0,30,4
1713352263328,TDMV 2,A00,492764,Weinberg; Sadie,27,0,30,3
1713352264358,TDMV 3,A00,492765,Mack; Kara Shanai',37,0,40,3
1713352265385,TDMV 138,A00,492777,Mack; Kara Shanai',32,0,40,8
1713352266506,TDMV 140,A00,492778,Lima; Paulo Henrique,40,0,40,0
1713352267533,TDMV 142,A00,492779,Caligagan; Maria T.,33,0,40,7
1713352267533,TDMV 142,B00,492780,Caligagan; Tony,37,0,40,3
1713352268558,TDMV 143,A00,492781,Fyall; Daunte Edward,39,0,40,1
1713352269587,USP 1,A01,492401,Kwak; Nancy,27,0,35,8
1713352270613,USP 2,A01,492453,Hinds; Juli Beth,35,0,35,0
1713352271639,USP 3,A01,492516,Staff,28,0,35,7
1713352272674,USP 4,A00,492522,McTague; Sarah,16,0,25,9
1713352273698,USP 100,A00,492523,Staff,32,0,35,3
1713352274726,USP 101,A00,492524,Staff,13,0,15,2
1713352275752,USP 105,A00,492525,Staff,21,0,25,4
1713352276834,USP 151,A00,492526,Shenkman; Michael Thomas,32,0,35,3
1713352277864,USP 170,A00,492545,Hinds; Juli Beth,32,0,35,3
1713352278896,USP 171GS,A00,492608,Bussell; Mirle Rabinowitz,24,0,28,4
1713352279926,USP 183GS,A00,492613,Peerson; Susan,24,0,28,4
1713352280954,VIS 30,A01,490693,Yoldas; Pinar,19,0,22,3
1713352280954,VIS 30,A02,490694,Yoldas; Pinar,18,0,22,4
1713352281981,VIS 83,A00,490695,Kester; Grant,63,0,75,12
1713352283012,VIS 105D,A00,490696,Staff,22,0,25,3
1713352284037,VIS 124CN,A00,490699,Rose; Jordan M,64,0,75,11
1713352285063,VIS 125GS,A00,511221,Williams; Alena J,21,0,22,1
1713352286093,VIS 128D,A00,490700,Staff,73,0,75,2
1713352287122,VIS 151,A01,490717,Staff,33,0,34,1
1713352287122,VIS 151,A02,490766,Staff,32,0,34,2
1713352288151,VIS 154GS,A00,511972,Williams; Alena J,21,0,22,1
1713352289178,VIS 160A,A00,490767,Stone; Patricia,7,0,10,3
1713352290204,WCWP 10A,A00,490638,Staff,14,0,15,1
1713352290204,WCWP 10A,B00,490640,Staff,15,0,15,0
1713352291235,WCWP 10B,A00,490641,Staff,0,0,0,0
1713352291235,WCWP 10B,B00,490642,Staff,14,0,15,1
1713352291235,WCWP 10B,C00,490644,Staff,13,0,15,2
1713352291235,WCWP 10B,D00,490647,Staff,0,0,0,0
1713352292260,WCWP 100,A00,490655,Staff,0,0,0,0
1713352292260,WCWP 100,B00,490687,Staff,10,0,15,5
1713352294396,ANAR 153,A00,487222,Braswell; Geoffrey E.,53,0,60,7
1713352295422,ANBI 134,A00,487223,Staff,5,0,20,15
1713352296447,ANBI 143GS,A00,487224,Noel; Geoffroy Pierre Jean,18,0,24,6
1713352297472,ANBI 144GS,A00,519548,Noel; Geoffroy Pierre Jean,18,0,24,6
1713352298502,ANSC 101,A00,487225,Staff,17,0,20,3
1713352299528,ANSC 125,A00,487227,Brenner; Suzanne A,38,0,40,2
1713352301584,ANSC 146,A00,487229,Staff,35,0,40,5
1713352302612,ANSC 148,A00,487230,Olivas Hernandez; Olga Lid,39,0,40,1
1713352303775,ANSC 150,A00,504165,Sloane; Julia Kathryn,18,0,20,2
1713352304800,ANSC 180,A00,487232,Staff,14,0,15,1
1713352305824,ANSC 188,A00,627155,Staff,37,0,40,3
1713352306849,ANTH 5,A00,519529,Semendeferi; Ekaterini,15,0,15,0
1713352307874,ANTH 10,A00,487219,Staff,58,0,60,2
1713352308906,ANTH 23,A01,487221,Staff,17,0,20,3
1713352309935,ANTH 102,A00,487233,Wilder; Linnea Lorene,49,0,60,11
1713352310962,ANTH 103,A00,487234,Varma; Saiba,54,0,60,6
1713352311991,ANTH 105,A00,487235,Stewart; Alexander B,54,0,60,6
1713352313018,BENG 100,A01,516685,Taylor Amos; Alyssa C,25,0,30,5
1713352314054,BIBC 102,A01,491316,Flagg; Matthew Paul,3,0,88,85
1713352314054,BIBC 102,A02,491366,Flagg; Matthew Paul,78,0,88,10
1713352315087,BIBC 103,A01,491486,Boumechache; Miyyada,16,0,24,8
1713352315087,BIBC 103,A02,491487,Boumechache; Miyyada,24,0,24,0
1713352316194,BICD 100,A01,516882,Staff,72,0,75,3
1713352316194,BICD 100,A02,516890,Staff,69,0,75,6
1713352317220,BICD 102GS,A00,491488,Lo; Stanley M.,26,0,28,2
1713352318256,BIEB 136GS,A00,516940,Holway; David A. & Shurin; Jonathan,18,0,24,6
1713352319285,BIEB 137GS,A01,517034,Holway; David A. & Shurin; Jonathan,18,0,24,6
1713352320310,BIEB 138GS,A01,491492,Pirino; Giorgia,21,0,28,7
1713352321334,BILD 1,A01,491296,Staff,60,0,63,3
1713352321334,BILD 1,A02,491297,Staff,63,0,63,0
1713352322365,BILD 4,A01,517099,Gonzalez Gamboa; Ivonne,21,0,24,3
1713352322365,BILD 4,A02,517100,Gonzalez Gamboa; Ivonne,24,0,24,0
1713352323390,BILD 60GS,A00,491309,Lo; Stanley M.,26,0,28,2
1713352324416,BIMM 100,A01,517136,Staff,82,0,100,18
1713352325444,BIMM 110,A01,517182,Staff,52,0,100,48
1713352326470,BIMM 120,A01,517228,Pickett; Brooke Elizabeth,28,0,63,35
1713352326470,BIMM 120,A02,517240,Pickett; Brooke Elizabeth,44,0,63,19
1713352327496,BIMM 132GS,A01,491498,Pirino; Giorgia,21,0,28,7
1713352328527,BIMM 143,A01,491589,Bozinovic; Goran,12,0,40,28
1713352329554,BIPN 100,A01,491594,Armour; Jon Christopher,83,0,100,17
1713352330582,BIPN 140,A01,491602,Marino; Marc J,23,0,50,27
1713352332669,CAT 125,A00,515973,Staff,18,0,20,2
1713352333695,CAT 125GS,A00,515974,Rahimi; Babak,16,0,20,4
1713352334733,CAT 125R,A00,515980,Staff,12,0,20,8
1713352334733,CAT 125R,B00,515981,Tosun; Adriana,19,0,20,1
1713352334733,CAT 125R,C00,515987,Hyland; Tina Mae,0,5,20,20
1713352334733,CAT 125R,D00,515988,Bronstein; Phoebe Malan,16,0,20,4
1713352335767,CENG 15,A01,488699,Drews; Aaron,25,0,25,0
1713352336825,CENG 100,A00,505196,Opatkiewicz; Justin Paul,25,0,25,0
1713352337857,CGS 2A,A01,489598,Staff,32,0,35,3
1713352338882,CGS 112,A00,489599,Staff,15,0,15,0
1713352339910,CGS 119,A00,489603,Staff,10,0,10,0
1713352340933,CGS 120,A00,489604,Staff,13,0,15,2
1713352341958,CGS 150,A00,489607,Staff,15,0,15,0
1713352342987,CHEM 6A,A01,488715,Staff,97,0,100,3
1713352344018,CHEM 6B,A01,488719,Piercy; Marc Anthony,98,0,100,2
1713352345048,CHEM 6C,A01,488723,Albizati; Kim F.,92,0,100,8
1713352346076,CHEM 7L,A01,488728,Schurmeier; Kimberly,18,0,24,6
1713352346076,CHEM 7L,A02,488730,Schurmeier; Kimberly,23,0,24,1
1713352346076,CHEM 7L,A03,488734,Schurmeier; Kimberly,20,0,24,4
1713352346076,CHEM 7L,A04,488763,Schurmeier; Kimberly,23,0,24,1
1713352346076,CHEM 7L,B01,488798,Schurmeier; Kimberly,16,0,24,8
1713352346076,CHEM 7L,B02,488801,Schurmeier; Kimberly,22,0,24,2
1713352346076,CHEM 7L,B03,488808,Schurmeier; Kimberly,22,0,24,2
1713352346076,CHEM 7L,B04,488811,Schurmeier; Kimberly,24,0,24,0
1713352347102,CHEM 11,A01,488897,Stallings; Dontarie M,94,0,100,6
1713352348135,CHEM 40A,A01,488913,Albizati; Kim F.,83,0,100,17
1713352349170,CHEM 40B,A01,488920,Weizman; Haim,42,0,50,8
1713352349170,CHEM 40B,A02,488938,Weizman; Haim,43,0,50,7
1713352350197,CHEM 41A,A01,489029,Klosterman; Jeremy K,57,0,60,3
1713352351223,CHEM 41C,A01,500436,Tor; Yitzhak,53,0,60,7
1713352352258,CHEM 43A,A01,500426,Weizman; Haim,0,1,24,24
1713352352258,CHEM 43A,A02,500430,Weizman; Haim,6,0,24,18
1713352352258,CHEM 43A,B01,514041,Klosterman; Jeremy K,14,0,24,10
1713352352258,CHEM 43A,B02,514047,Klosterman; Jeremy K,23,0,24,1
1713352353284,CHEM 108,A01,489140,Jennings; Patricia A.,5,0,24,19
1713352353284,CHEM 108,A02,489142,Jennings; Patricia A.,14,0,24,10
1713352354314,CHEM 114A,A01,489147,Stallings; Dontarie M,65,0,100,35
1713352355341,CHIN 169A,A00,489171,Wang; Xiao,19,0,20,1
1713352357393,COGS 3,A01,518827,Boyle; Mary E. T.,25,0,40,15
1713352358419,COGS 11,A01,489175,Staff,27,0,30,3
1713352359443,COGS 14A,A01,518829,Staff,50,0,60,10
1713352360470,COGS 14B,A01,489177,Hoffman; Drew Ellen,62,0,75,13
1713352361497,COGS 100,A01,489181,Allen; Michael Gordon,62,0,75,13
1713352362521,COGS 101A,A01,489183,Staff,45,0,60,15
1713352363547,COGS 101B,A01,489185,Allen; Michael Gordon,6,0,30,24
1713352364574,COGS 101C,A01,526786,Staff,23,0,30,7
1713352366638,COGS 107A,A01,489189,Boyle; Mary E. T.,16,0,35,19
1713352367696,COGS 107B,A01,627144,Mooshagian; Eric Frederick,59,0,60,1
1713352368726,COGS 118A,A01,489191,Staff,0,46,40,40
1713352370776,COGS 171GS,A01,489194,Pineda; Jaime A,19,0,28,9
1713352371803,COGS 172,A01,489196,Staff,1,0,30,29
1713352372828,COGS 174GS,A01,489264,Pineda; Jaime A,19,0,28,9
1713352373854,COGS 180,A01,627150,Staff,28,0,30,2
1713352374881,COGS 186,A01,489274,Staff,0,3,30,30
1713352375910,COMM 10,A01,489276,Staff,23,0,25,2
1713352375910,COMM 10,A02,489303,Staff,23,0,25,2
1713352376936,COMM 100A,A01,489312,Staff,14,0,25,11
1713352376936,COMM 100A,A02,489313,Staff,24,0,25,1
1713352377972,COMM 106T,A00,512540,Staff,33,0,35,2
1713352378997,COMM 107,A00,489347,Staff,27,0,35,8
1713352380024,COMM 109P,A00,489358,Staff,31,0,35,4
1713352381106,COMM 132,A00,489361,McKenna; Denise,27,0,30,3
1713352382168,COMM 146,A00,489362,Halm; Gavin Patrick,25,0,30,5
1713352383209,COMM 190,A00,489363,Abuelhiga; Soraya Jill,17,0,23,6
1713352384260,CSE 8A,A50,489366,Staff,21,0,25,4
1713352384260,CSE 8A,A51,489367,Staff,24,0,25,1
1713352385294,CSE 11,A01,489398,Cao; Yingjun,72,0,100,28
1713352386321,CSE 12,A01,489487,Staff,43,0,50,7
1713352387347,CSE 20,A01,489497,Staff,47,0,50,3
1713352388372,CSE 21,A01,489517,Braun; Oliver,42,0,50,8
1713352389395,CSE 101,A01,489524,Braun; Oliver,0,35,50,50
1713352390429,CSE 105,A01,512594,Jones; Miles E,72,0,100,28
1713352390429,CSE 105,B01,512598,Jones; Miles E,50,0,100,50
1713352391455,CSE 140,A01,489538,Staff,39,0,50,11
1713352392587,CSE 141,A01,489550,Eldon; John,67,0,100,33
1713352393617,CSE 141L,A01,489571,Eldon; John,65,0,100,35
1713352394644,CSE 151A,A01,489583,Solares; Edwin A,139,0,200,61
1713352395670,CSE 175,A01,510886,Kumar; Rakesh,30,0,30,0
1713352396700,CSE 190,A00,516828,Dubnov; Shlomo,37,0,49,12
1713352397731,DOC 100D,A00,489667,Pass; Natalye Joann,19,0,25,6
1713352398757,DSC 10,A01,624268,Staff,72,0,75,3
1713352399783,DSC 20,A01,624476,Staff,50,0,50,0
1713352400808,DSC 40A,A01,624608,Staff,39,0,40,1
1713352401833,DSGN 1,A01,489179,Rill; Bryan,32,0,50,18
1713352402867,ECE 17,A01,490489,Sahay; Rajeev,18,0,30,12
1713352403900,ECE 65,A50,490492,Staff,11,0,20,9
1713352403900,ECE 65,A51,490493,Staff,18,0,20,2
1713352404927,ECON 1,A01,489715,Famulari; Melissa,67,0,70,3
1713352405954,ECON 2,A01,489717,Levkoff; Steven B.,67,0,70,3
1713352406984,ECON 3,A01,489948,Staff,69,0,70,1
1713352409041,ECON 5,A01,490103,Staff,27,0,30,3
1713352409041,ECON 5,B01,626281,Dai; Yinlin,45,0,45,0
1713352410072,ECON 100A,A01,490127,Famulari; Melissa,62,0,70,8
1713352411101,ECON 100B,A01,490129,Staff,64,0,70,6
1713352412132,ECON 109,A01,490187,Shishkin; Denis,27,0,35,8
1713352413292,ECON 110A,A01,490190,Levkoff; Steven B.,59,0,70,11
1713352414318,ECON 120A,A01,490245,Dai; Yinlin,59,0,70,11
1713352415345,ECON 120B,A01,490247,Nieto-Barthaburu; Augusto,40,0,70,30
1713352416372,ECON 120C,A01,490253,Sun; Yixiao,30,0,35,5
1713352416372,ECON 120C,B01,490255,Sun; Yixiao,34,0,35,1
1713352417404,ECON 129,A00,490256,Eckert; Fabian Paul,22,0,35,13
1713352418433,ECON 131,A00,490257,Nieto-Barthaburu; Augusto,0,6,35,35
1713352419465,ECON 138,A00,490258,Bharadwaj; Prashant,13,0,35,22
1713352419465,ECON 138,B00,490259,Bharadwaj; Prashant,15,0,35,20
1713352420494,ECON 159,A00,490260,Hendrickson; Gerald M.,0,9,0,0
1713352421522,ECON 178,A01,553995,Zhu; Ying,24,0,35,11
1713352422556,EDS 40,A01,512576,Black; Alison Michelle,20,0,20,0
1713352423586,EDS 107,A01,515848,Staff,30,0,30,0
1713352424612,EDS 110R,A01,490262,Staff,26,0,30,4
1713352425639,EDS 112,A01,490264,Chapman; Thandeka K,40,0,50,10
1713352426664,EDS 113,A00,490266,Staff,25,0,30,5
1713352427690,EDS 118,A00,490267,Warstadt; Melissa Fawn,18,0,30,12
1713352428719,EDS 124BR,A00,490268,Eguchi; Emi,4,0,25,21
1713352428719,EDS 124BR,B00,490269,Eguchi; Emi,23,0,25,2
1713352429749,EDS 126,A01,490271,Jones; Makeba,43,0,50,7
1713352430779,EDS 135,A01,490316,Staff,19,0,20,1
1713352431805,ENVR 142GS,A00,519514,Chang; Edmond Yi-Teh,26,0,28,2
1713352432829,ETHN 103,A00,490504,Staff,24,0,36,12
1713352433855,ETHN 103A,A00,490505,Man; Simeon S,3,0,9,6
1713352434880,ETHN 109,A00,490506,Staff,28,0,30,2
1713352435906,ETHN 118,A00,490507,Staff,35,0,36,1
1713352436930,ETHN 119,A00,490508,Staff,32,0,36,4
1713352437956,ETHN 121R,A00,490518,Choi; Esther Min,21,0,36,15
1713352438985,ETHN 127,A00,490528,Staff,14,0,15,1
1713352440024,ETHN 139,A00,490573,Staff,10,0,10,0
1713352441054,ETHN 150,A00,490575,Staff,15,0,15,0
1713352442080,GLBH 20,A00,491705,Elwardani; Nile Regina,38,0,40,2
1713352443106,GLBH 101,A00,491706,Staff,20,0,20,0
1713352444129,GLBH 111,A01,491708,Burgos; Jose L.,15,0,15,0
1713352445154,GLBH 146,A00,491709,Staff,8,0,20,12
1713352446187,GLBH 148,A00,491710,Olivas Hernandez; Olga Lid,10,0,20,10
1713352447219,GLBH 150,A00,491711,Sloane; Julia Kathryn,19,0,20,1
1713352448247,HIEA 131,A00,491760,Staff,28,0,32,4
1713352449272,HIEA 153,A00,491762,Staff,28,0,30,2
1713352450298,HIEU 124,A00,491811,Staff,26,0,32,6
1713352451328,HIEU 124GS,A00,491812,Markman; Kristina,27,0,28,1
1713352452358,HIEU 147,A00,491813,Staff,30,0,32,2
1713352453414,HIEU 149GS,A00,491816,Caldwell; Michael Alan,28,0,28,0
1713352454450,HILD 2C,A01,491713,Hendrickson; Gerald M.,26,0,30,4
1713352455482,HILD 7B,A01,491715,Kwak; Nancy,0,3,30,30
1713352456508,HILD 10,A01,491717,Staff,9,0,20,11
1713352457533,HILD 30GS,A00,491719,Edington; Claire Ellen,23,0,28,5
1713352458562,HINE 109,A00,491818,Shafir; Nir,26,0,32,6
1713352459589,HINE 128,A00,491821,Shafir; Nir,30,0,32,2
1713352460615,HISC 117,A00,491830,Staff,27,0,32,5
1713352461641,HIUS 103,A00,491834,Man; Simeon S,14,0,23,9
1713352462668,HIUS 108B,A00,491835,Staff,27,0,30,3
1713352463692,HIUS 141,A00,491836,Hendrickson; Gerald M.,28,0,32,4
1713352464717,HIUS 149,A00,491839,Staff,24,0,32,8
1713352465750,HUM 3,A01,512617,Crum; Matthew Stephen,42,0,50,8
1713352465750,HUM 3,A02,512618,Crum; Matthew Stephen,48,0,50,2
1713352466778,HUM 3GS,A00,512663,Markman; Kristina,0,0,0,1
1713352466778,HUM 3GS,B00,512664,Staff,0,0,0,0
1713352467805,HUM 4,A01,512620,West; Geoffrey Scott,22,0,50,28
1713352468831,HUM 4GS,A00,512666,Lyon; Antony J.,0,0,0,5
1713352469862,HUM 4R,A01,512625,Watkins; Eric,49,0,50,1
1713352470897,HUM 5,A01,512649,Zavodny; Tatiana Sophia,20,0,50,30
1713352470897,HUM 5,B01,512661,Zroka; Ryan Edward,48,0,50,2
1713352471924,INTL 190,A00,490577,Segui; Alan S,0,0,0,5
1713352472960,JAPN 20AR,A01,491267,Ross; Kayoko F,7,0,20,13
1713352473987,JAPN 180,A00,491285,Berman; Michael David,33,0,40,7
1713352475017,LATI 50,A01,502536,Kokinis; Troy Andreas,16,0,22,6
1713352475017,LATI 50,A02,502551,Kokinis; Troy Andreas,22,0,22,0
1713352475017,LATI 50,A03,502650,Kokinis; Troy Andreas,22,0,22,0
1713352475017,LATI 50,A04,502909,Kokinis; Troy Andreas,21,0,22,1
1713352476046,LATI 160,A01,502920,Kokinis; Troy Andreas,30,0,30,0
1713352477207,LIFR 1A,A00,490494,Van Moer; Vinciane G,17,0,20,3
1713352478234,LIFR 1AX,A00,490495,Van Moer; Vinciane G,17,0,20,3
1713352479263,LIFR 1B,A00,490496,Van Moer; Vinciane G,17,0,20,3
1713352480293,LIFR 1BX,A00,490497,Van Moer; Vinciane G,17,0,20,3
1713352481319,LIGN 8,A00,505198,McIntosh; Justin Daniel,134,0,150,16
1713352482346,LIGN 9GS,A00,491239,Lott; Margaret S.,18,0,20,2
1713352483386,LIGN 101,A01,505200,McIntosh; Justin Daniel,22,0,30,8
1713352484411,LIGN 120,A01,491244,Staff,22,0,30,8
1713352485489,LIGN 149GS,A00,491245,Lott; Margaret S.,18,0,20,2
1713352486515,LIGN 170,A00,491247,Staff,22,0,30,8
1713352487541,LISP 1D,A00,490498,Munoz Sanchez; Alicia,8,0,14,6
1713352487541,LISP 1D,B00,490499,Munoz Sanchez; Alicia,4,0,14,10
1713352487541,LISP 1D,C00,490500,Munoz Sanchez; Alicia,7,0,14,7
1713352487541,LISP 1D,D00,490501,Munoz Sanchez; Alicia,10,0,14,4
1713352488571,LISP 1DX,A00,490502,Munoz Sanchez; Alicia,11,0,28,17
1713352488571,LISP 1DX,B00,490503,Munoz Sanchez; Alicia,16,0,28,12
1713352490623,LTAM 110,A00,491847,Staff,22,0,25,3
1713352491648,LTCS 119,A00,491848,Staff,11,0,15,4
1713352492675,LTCS 130,A00,491849,Staff,24,0,25,1
1713352494729,LTEA 120C,A00,491852,Staff,32,0,40,8
1713352495758,LTEN 130GS,A00,491853,Lyon; Antony J.,23,0,28,5
1713352496786,LTEN 148,A00,491855,Staff,23,0,25,2
1713352497813,LTEN 159,A00,491856,Staff,20,0,25,5
1713352498839,LTEN 180,A00,491857,Staff,8,0,15,7
1713352500896,LTSP 123GS,A00,505928,Bessett; Ryan Matthew,24,0,28,4
1713352501921,LTSP 174GS,A00,506037,Bessett; Ryan Matthew,24,0,28,4
1713352503977,LTWR 102,A00,491861,Staff,9,0,15,6
1713352505006,LTWR 106,A00,491862,Staff,8,0,15,7
1713352506039,MAE 11,A00,490930,Bahadori; Mohammad Yousef,94,0,100,6
1713352507065,MAE 30A,A00,490931,Qi; Huihui,37,0,40,3
1713352508095,MAE 101A,A00,491036,Sadeghizadeh; Zahra,91,0,100,9
1713352509121,MAE 101C,A00,491037,Seshadri; Kalyanasundaram,63,0,100,37
1713352510147,MAE 113,A00,491040,Seshadri; Kalyanasundaram,64,0,80,16
1713352511173,MAE 131A,A00,491041,Ghazinejad; Maziar,37,0,40,3
1713352512204,MAE 142,A00,491053,Staff,39,0,40,1
1713352513229,MAE 143A,A00,491054,Staff,29,0,50,21
